"","unitd","DOE.Institution_Name","Year","SportCode","SportName","Total.Revenue","Total.Expense","Total.Profit","Men.Revenue","Men.Expense","Men.Profit","Women.Revenue","Women.Expense","Women.Profit","Male.Athletes","Female.Athletes","Men.Team.Expense","Women.Team.Expense"
"5000",228778,"THE UNIVERSITY OF TEXAS AT AUSTIN                           ","2003-2004",7,"Football",47556281,12948131,34608150,47556281,12948131,34608150,0,0,0,"118",".",3077763,0
"4295",221759,"THE UNIVERSITY OF TENNESSEE                                 ","2003-2004",7,"Football",46704719,12825761,33878958,46704719,12825761,33878958,0,0,0,"130",".",4910195,0
"4508",139959,"UNIVERSITY OF GEORGIA                                       ","2003-2004",7,"Football",42104214,8780360,33323854,42104214,8780360,33323854,0,0,0,"138",".",4692682,0
"4339",134130,"UNIVERSITY OF FLORIDA                                       ","2003-2004",7,"Football",42710967,12571701,30139266,42710967,12571701,30139266,0,0,0,"130",".",3090392,0
"4944",204796,"OHIO STATE UNIVERSITY-MAIN CAMPUS                           ","2003-2004",7,"Football",46242355,16128530,30113825,46242355,16128530,30113825,0,0,0,"103",".",2240787,0
"4707",100751,"UNIVERSITY OF ALABAMA                                       ","2003-2004",7,"Football",39848836,11819450,28029386,39848836,11819450,28029386,0,0,0,"136",".",1541451,0
"4263",170976,"UNIVERSITY OF MICHIGAN-ANN ARBOR                            ","2003-2004",7,"Football",38547937,10638824,27909113,38547937,10638824,27909113,0,0,0,"118",".",1879792,0
"4829",152080,"UNIVERSITY OF NOTRE DAME                                    ","2003-2004",7,"Football",38596090,11393367,27202723,38596090,11393367,27202723,0,0,0,"109",".",1708119,0
"4493",214777,"PENNSYLVANIA STATE UNIVERSITY-MAIN CAMPUS                   ","2003-2004",7,"Football",37112257,10940470,26171787,37112257,10940470,26171787,0,0,0,"111",".",1585503,0
"4378",100858,"AUBURN UNIVERSITY MAIN CAMPUS                               ","2003-2004",7,"Football",37173943,12639218,24534725,37173943,12639218,24534725,0,0,0,"109",".",2270272,0
"4662",159391,"LOUISIANA STATE UNIV &amp; AG &amp; MECH &amp; HEBERT LAWS CTR          ","2003-2004",7,"Football",38381625,15349550,23032075,38381625,15349550,23032075,0,0,0,"131",".",2491333,0
"4982",228723,"TEXAS A &amp; M UNIVERSITY                                      ","2003-2004",7,"Football",31103827,9819342,21284485,31103827,9819342,21284485,0,0,0,"179",".",1415026,0
"5036",207500,"UNIVERSITY OF OKLAHOMA NORMAN CAMPUS                        ","2003-2004",7,"Football",34293061,13728435,20564626,34293061,13728435,20564626,0,0,0,"128",".",868608,0
"4282",181464,"UNIVERSITY OF NEBRASKA AT LINCOLN                           ","2003-2004",7,"Football",30231643,12954126,17277517,30231643,12954126,17277517,0,0,0,"179",".",1861902,0
"4346",236948,"UNIVERSITY OF WASHINGTON-SEATTLE CAMPUS                     ","2003-2004",7,"Football",28569263,12640090,15929173,28569263,12640090,15929173,0,0,0,"104",".",2983085,0
"4644",153658,"UNIVERSITY OF IOWA                                          ","2003-2004",7,"Football",25349769,10334719,15015050,25349769,10334719,15015050,0,0,0,"125",".",670253,0
"4905",106397,"UNIVERSITY OF ARKANSAS MAIN CAMPUS                          ","2003-2004",7,"Football",27337120,12624255,14712865,27337120,12624255,14712865,0,0,0,"127",".",2684398,0
"5064",126614,"UNIVERSITY OF COLORADO AT BOULDER                           ","2003-2004",7,"Football",23061208,9690074,13371134,23061208,9690074,13371134,0,0,0,"114",".",2400196,0
"4960",217882,"CLEMSON UNIVERSITY                                          ","2003-2004",7,"Football",24295351,11568008,12727343,24295351,11568008,12727343,0,0,0,"112",".",2845623,0
"5050",240444,"UNIVERSITY OF WISCONSIN-MADISON                             ","2003-2004",7,"Football",23271101,10806874,12464227,23271101,10806874,12464227,0,0,0,"117",".",2571562,0
"4868",145637,"UNIVERSITY OF ILLINOIS AT URBANA-CHAMPAIGN                  ","2003-2004",7,"Football",19450420,7402662,12047758,19450420,7402662,12047758,0,0,0,"113",".",1408042,0
"4444",209542,"OREGON STATE UNIVERSITY                                     ","2003-2004",7,"Football",20593052,8617413,11975639,20593052,8617413,11975639,0,0,0,"99",".",1732739,0
"3456",157289,"UNIVERSITY OF LOUISVILLE                                    ","2003-2004",2,"Basketball",16504567,4904742,11599825,16465800,3803956,12661844,38767,1100786,-1062019,"16","15",754604,226698
"5056",157085,"UNIVERSITY OF KENTUCKY                                      ","2003-2004",7,"Football",19779329,8201781,11577548,19779329,8201781,11577548,0,0,0,"138",".",4201657,0
"4744",243780,"PURDUE UNIVERSITY-MAIN CAMPUS                               ","2003-2004",7,"Football",21960345,10400498,11559847,21960345,10400498,11559847,0,0,0,"107",".",2595383,0
"4589",123961,"UNIVERSITY OF SOUTHERN CALIFORNIA                           ","2003-2004",7,"Football",26244364,15377942,10866422,26244364,15377942,10866422,0,0,0,"116",".",3798426,0
"4991",233921,"VIRGINIA POLYTECHNIC INSTITUTE AND STATE UNIV               ","2003-2004",7,"Football",24138543,13496687,10641856,24138543,13496687,10641856,0,0,0,"124",".",2102569,0
"4771",171100,"MICHIGAN STATE UNIVERSITY                                   ","2003-2004",7,"Football",21871775,11393664,10478111,21871775,11393664,10478111,0,0,0,"104",".",1254653,0
"4281",135726,"UNIVERSITY OF MIAMI                                         ","2003-2004",7,"Football",23679096,14079192,9599904,23679096,14079192,9599904,0,0,0,"106",".",1898720,0
"4806",134097,"FLORIDA STATE UNIVERSITY                                    ","2003-2004",7,"Football",18399013,8990027,9408986,18399013,8990027,9408986,0,0,0,"105",".",1176759,0
"5046",176017,"UNIVERSITY OF MISSISSIPPI MAIN CAMPUS                       ","2003-2004",7,"Football",16770707,7519496,9251211,16770707,7519496,9251211,0,0,0,"153",".",1931141,0
"4472",155399,"KANSAS STATE UNIVERSITY                                     ","2003-2004",7,"Football",20529001,11408393,9120608,20529001,11408393,9120608,0,0,0,"130",".",3093870,0
"2520",199120,"UNIVERSITY OF NORTH CAROLINA AT CHAPEL HILL                 ","2003-2004",2,"Basketball",13994830,4992239,9002591,13494692,3373808,10120884,500138,1618431,-1118293,"30","13",474531,421593
"1794",104179,"UNIVERSITY OF ARIZONA                                       ","2003-2004",2,"Basketball",14055062,5819425,8235637,13498186,4092331,9405855,556876,1727094,-1170218,"12","18",558493,283595
"4790",178396,"UNIVERSITY OF MISSOURI-COLUMBIA                             ","2003-2004",7,"Football",15062869,6884992,8177877,15062869,6884992,8177877,0,0,0,"128",".",1516843,0
"4480",207388,"OKLAHOMA STATE UNIVERSITY-MAIN CAMPUS                       ","2003-2004",7,"Football",16670801,8764015,7906786,16670801,8764015,7906786,0,0,0,"110",".",2334840,0
"4278",215293,"UNIVERSITY OF PITTSBURGH-MAIN CAMPUS                        ","2003-2004",7,"Football",19351753,11736579,7615174,19351753,11736579,7615174,0,0,0,"103",".",2571495,0
"4414",209551,"UNIVERSITY OF OREGON                                        ","2003-2004",7,"Football",18070390,10822601,7247789,18070390,10822601,7247789,0,0,0,"105",".",1151690,0
"2283",221759,"THE UNIVERSITY OF TENNESSEE                                 ","2003-2004",2,"Basketball",14360657,7147083,7213574,9936205,3586113,6350092,4424452,3560970,863482,"13","11",1317331,835868
"4874",174066,"UNIVERSITY OF MINNESOTA-TWIN CITIES                         ","2003-2004",7,"Football",14484196,7466184,7018012,14484196,7466184,7018012,0,0,0,"126",".",1150470,0
"2293",151351,"INDIANA UNIVERSITY-BLOOMINGTON                              ","2003-2004",2,"Basketball",11192261,4296835,6895426,11131837,2994791,8137046,60424,1302044,-1241620,"15","15",295508,277235
"3005",174066,"UNIVERSITY OF MINNESOTA-TWIN CITIES                         ","2003-2004",2,"Basketball",10499036,3657336,6841700,9558976,2279663,7279313,940060,1377673,-437613,"17","14",462011,369455
"1944",240444,"UNIVERSITY OF WISCONSIN-MADISON                             ","2003-2004",2,"Basketball",11115595,4508076,6607519,10105935,2741254,7364681,1009660,1766822,-757162,"16","13",869665,532275
"5033",218663,"UNIVERSITY OF SOUTH CAROLINA-COLUMBIA                       ","2003-2004",7,"Football",14292557,7933179,6359378,14292557,7933179,6359378,0,0,0,"125",".",993274,0
"4340",238032,"WEST VIRGINIA UNIVERSITY                                    ","2003-2004",7,"Football",17373542,11073320,6300222,17373542,11073320,6300222,0,0,0,"149",".",3171765,0
"4896",104151,"ARIZONA STATE UNIVERSITY-MAIN CAMPUS                        ","2003-2004",7,"Football",17669149,11409157,6259992,17669149,11409157,6259992,0,0,0,"123",".",2656938,0
"2026",145637,"UNIVERSITY OF ILLINOIS AT URBANA-CHAMPAIGN                  ","2003-2004",2,"Basketball",10885744,4734767,6150977,10246970,2983193,7263777,638774,1751574,-1112800,"13","16",687977,444685
"1710",228778,"THE UNIVERSITY OF TEXAS AT AUSTIN                           ","2003-2004",2,"Basketball",14091716,8060200,6031516,11655379,4632376,7023003,2436337,3427824,-991487,"16","14",1250176,1153912
"3021",153658,"UNIVERSITY OF IOWA                                          ","2003-2004",2,"Basketball",10642278,4813734,5828544,9968026,3401890,6566136,674252,1411844,-737592,"14","12",489721,555319
"5075",110662,"UNIVERSITY OF CALIFORNIA-LOS ANGELES                        ","2003-2004",7,"Football",17231998,11503287,5728711,17231998,11503287,5728711,0,0,0,"113",".",1624549,0
"3239",204796,"OHIO STATE UNIVERSITY-MAIN CAMPUS                           ","2003-2004",2,"Basketball",11747796,6059964,5687832,11415903,3732420,7683483,331893,2327544,-1995651,"14","16",922831,570876
"4511",199120,"UNIVERSITY OF NORTH CAROLINA AT CHAPEL HILL                 ","2003-2004",7,"Football",15120192,9482795,5637397,15120192,9482795,5637397,0,0,0,"135",".",1387057,0
"3001",243780,"PURDUE UNIVERSITY-MAIN CAMPUS                               ","2003-2004",2,"Basketball",10423540,4806724,5616816,9184354,2758318,6426036,1239186,2048406,-809220,"15","14",565580,535895
"2429",129020,"UNIVERSITY OF CONNECTICUT                                   ","2003-2004",2,"Basketball",10365790,4789259,5576531,5522587,2652794,2869793,4843203,2136465,2706738,"17","13",1201716,762835
"5068",139755,"GEORGIA INSTITUTE OF TECHNOLOGY-MAIN CAMPUS                 ","2003-2004",7,"Football",13071882,7531087,5540795,13071882,7531087,5540795,0,0,0,"112",".",971692,0
"1938",163286,"UNIVERSITY OF MARYLAND-COLLEGE PARK                         ","2003-2004",2,"Basketball",10724714,5191573,5533141,10625828,3527275,7098553,98886,1664298,-1565412,"13","12",653874,368756
"4528",147767,"NORTHWESTERN UNIVERSITY                                     ","2003-2004",7,"Football",14952742,9503214,5449528,14952742,9503214,5449528,0,0,0,"97",".",1740981,0
"3241",187985,"UNIVERSITY OF NEW MEXICO-MAIN CAMPUS                        ","2003-2004",2,"Basketball",8836245,3529632,5306613,7162629,2187430,4975199,1673616,1342202,331414,"16","13",518475,408622
"4382",176080,"MISSISSIPPI STATE UNIVERSITY                                ","2003-2004",7,"Football",11657366,6520517,5136849,11657366,6520517,5136849,0,0,0,"122",".",1094000,0
"4401",151351,"INDIANA UNIVERSITY-BLOOMINGTON                              ","2003-2004",7,"Football",13566505,8535382,5031123,13566505,8535382,5031123,0,0,0,"109",".",986036,0
"4617",236939,"WASHINGTON STATE UNIVERSITY                                 ","2003-2004",7,"Football",12630209,7668687,4961522,12630209,7668687,4961522,0,0,0,"119",".",2258717,0
"2196",196413,"SYRACUSE UNIVERSITY                                         ","2003-2004",2,"Basketball",12409509,7535825,4873684,11688023,5866784,5821239,721486,1669041,-947555,"17","14",732464,263355
"3407",198419,"DUKE UNIVERSITY                                             ","2003-2004",2,"Basketball",11161821,6411420,4750401,10581992,4873398,5708594,579829,1538022,-958193,"15","13",1502332,580605
"4913",196413,"SYRACUSE UNIVERSITY                                         ","2003-2004",7,"Football",17645953,12976795,4669158,17645953,12976795,4669158,0,0,0,"115",".",1585570,0
"6428",174066,"UNIVERSITY OF MINNESOTA-TWIN CITIES                         ","2003-2004",10,"Ice Hockey",6657757,2313107,4344650,6511311,1462758,5048553,146446,850349,-703903,"26","20",325611,129853
"2985",157085,"UNIVERSITY OF KENTUCKY                                      ","2003-2004",2,"Basketball",11916949,7577659,4339290,11792647,5715033,6077614,124302,1862626,-1738324,"17","16",3199980,877914
"4309",228875,"TEXAS CHRISTIAN UNIVERSITY                                  ","2003-2004",7,"Football",9717071,5461109,4255962,9717071,5461109,4255962,0,0,0,"131",".",1198359,0
"4337",234076,"UNIVERSITY OF VIRGINIA-MAIN CAMPUS                          ","2003-2004",7,"Football",14740242,10785474,3954768,14740242,10785474,3954768,0,0,0,"104",".",1309465,0
"2097",155317,"UNIVERSITY OF KANSAS MAIN CAMPUS                            ","2003-2004",2,"Basketball",10455528,6638372,3817156,10349813,3936863,6412950,105715,2701509,-2595794,"16","20",913955,420700
"2496",195809,"ST JOHN'S UNIVERSITY-NEW YORK                               ","2003-2004",2,"Basketball",7547097,3774453,3772644,6435345,2678645,3756700,1111752,1095808,15944,"16","14",22603,9556
"2634",202480,"UNIVERSITY OF DAYTON                                        ","2003-2004",2,"Basketball",7424967,3885718,3539249,7396063,2502689,4893374,28904,1383029,-1354125,"16","15",616541,252738
"2593",139755,"GEORGIA INSTITUTE OF TECHNOLOGY-MAIN CAMPUS                 ","2003-2004",2,"Basketball",7797910,4295545,3502365,7357650,2700583,4657067,440260,1594962,-1154702,"14","15",278213,214671
"2689",199847,"WAKE FOREST UNIVERSITY                                      ","2003-2004",2,"Basketball",8407140,4917590,3489550,8384325,3405914,4978411,22815,1511676,-1488861,"13","16",348706,214661
"4545",198419,"DUKE UNIVERSITY                                             ","2003-2004",7,"Football",8419473,4953823,3465650,8419473,4953823,3465650,0,0,0,"81",".",1469130,0
"4998",153603,"IOWA STATE UNIVERSITY                                       ","2003-2004",7,"Football",10660310,7212400,3447910,10660310,7212400,3447910,0,0,0,"129",".",886326,0
"4462",160755,"TULANE UNIVERSITY OF LOUISIANA                              ","2003-2004",7,"Football",6447527,3022000,3425527,6447527,3022000,3425527,0,0,0,"92",".",635000,0
"4273",104179,"UNIVERSITY OF ARIZONA                                       ","2003-2004",7,"Football",13266117,9916953,3349164,13266117,9916953,3349164,0,0,0,"104",".",681378,0
"15952",111434,"CANADA COLLEGE                                              ","2003-2004",39,"Total Participants",3194700,9820,3184880,143700,7100,136600,3051000,2720,3048280,"56","27",18150,5835
"17286",122612,"UNIVERSITY OF SAN FRANCISCO                                 ","2003-2004",39,"Total Participants",3843979,810578,3033401,1921475,457354,1464121,1922504,353224,1569280,"122","93",818147,530674
"14278",111434,"CANADA COLLEGE                                              ","2003-2004",26,"Volleyball",3e+06,1100,2998900,0,0,0,3e+06,1100,2998900,".","10",0,1500
"2646",170976,"UNIVERSITY OF MICHIGAN-ANN ARBOR                            ","2003-2004",2,"Basketball",7528012,4748462,2779550,7453271,3271259,4182012,74741,1477203,-1402462,"15","11",756994,326465
"4349",199193,"NORTH CAROLINA STATE UNIVERSITY AT RALEIGH                  ","2003-2004",7,"Football",7979250,5216481,2762769,7979250,5216481,2762769,0,0,0,"115",".",1541000,0
"1943",106397,"UNIVERSITY OF ARKANSAS MAIN CAMPUS                          ","2003-2004",2,"Basketball",10879578,8118091,2761487,10343430,5828315,4515115,536148,2289776,-1753628,"15","12",980188,380495
"2855",207388,"OKLAHOMA STATE UNIVERSITY-MAIN CAMPUS                       ","2003-2004",2,"Basketball",8257731,5585851,2671880,8034921,4229224,3805697,222810,1356627,-1133817,"17","16",1106097,386139
"5042",157289,"UNIVERSITY OF LOUISVILLE                                    ","2003-2004",7,"Football",9771414,7115857,2655557,9771414,7115857,2655557,0,0,0,"110",".",1507595,0
"3269",171100,"MICHIGAN STATE UNIVERSITY                                   ","2003-2004",2,"Basketball",8714127,6098547,2615580,8461432,4346531,4114901,252695,1752016,-1499321,"18","13",597242,406430
"3090",110635,"UNIVERSITY OF CALIFORNIA-BERKELEY                           ","2003-2004",2,"Basketball",7345011,4778778,2566233,6247370,3207166,3040204,1097641,1571612,-473971,"16","14",664808,332667
"2461",147767,"NORTHWESTERN UNIVERSITY                                     ","2003-2004",2,"Basketball",6382120,3869911,2512209,6360807,2467866,3892941,21313,1402045,-1380732,"14","12",421295,359406
"4865",187985,"UNIVERSITY OF NEW MEXICO-MAIN CAMPUS                        ","2003-2004",7,"Football",6728270,4230436,2497834,6728270,4230436,2497834,0,0,0,"145",".",951044,0
"4940",164924,"BOSTON COLLEGE                                              ","2003-2004",7,"Football",14252113,11843511,2408602,14252113,11843511,2408602,0,0,0,"111",".",899388,0
"4450",122409,"SAN DIEGO STATE UNIVERSITY                                  ","2003-2004",7,"Football",7933431,5551209,2382222,7933431,5551209,2382222,0,0,0,"125",".",1235726,0
"3135",110662,"UNIVERSITY OF CALIFORNIA-LOS ANGELES                        ","2003-2004",2,"Basketball",7658106,5286150,2371956,7477173,4003640,3473533,180933,1282510,-1101577,"16","14",372305,145422
"4888",110556,"CALIFORNIA STATE UNIVERSITY-FRESNO                          ","2003-2004",7,"Football",8418701,6078145,2340556,8418701,6078145,2340556,0,0,0,"101",".",1589179,0
"15680",160755,"TULANE UNIVERSITY OF LOUISIANA                              ","2003-2004",39,"Total Participants",4307816,2007000,2300816,1584750,932000,652750,2723066,1075000,1648066,"168","195",1198200,712920
"1769",215293,"UNIVERSITY OF PITTSBURGH-MAIN CAMPUS                        ","2003-2004",2,"Basketball",7029518,4744961,2284557,6560951,3215795,3345156,468567,1529166,-1060599,"16","14",730820,240165
"1965",134097,"FLORIDA STATE UNIVERSITY                                    ","2003-2004",2,"Basketball",7020582,4837433,2183149,6751379,2780954,3970425,269203,2056479,-1787276,"14","15",694813,603704
"4885",160621,"SOUTHERN UNIVERSITY AND A &amp; M COLLEGE                       ","2003-2004",7,"Football",2408783,238527,2170256,2408783,238527,2170256,0,0,0,"88",".",3139,0
"3289",178396,"UNIVERSITY OF MISSOURI-COLUMBIA                             ","2003-2004",2,"Basketball",6988468,4899643,2088825,6810339,3393502,3416837,178129,1506141,-1328012,"12","13",704527,400467
"4625",240727,"UNIVERSITY OF WYOMING                                       ","2003-2004",7,"Football",5545301,3490464,2054837,5545301,3490464,2054837,0,0,0,"103",".",524253,0
"2539",234076,"UNIVERSITY OF VIRGINIA-MAIN CAMPUS                          ","2003-2004",2,"Basketball",7120675,5152273,1968402,6845869,3221039,3624830,274806,1931234,-1656428,"18","15",476411,363348
"2015",122612,"UNIVERSITY OF SAN FRANCISCO                                 ","2003-2004",2,"Basketball",2613362,656482,1956880,1477686,439341,1038345,1135676,217141,918535,"18","16",396245,200792
"5077",133650,"FLORIDA AGRICULTURAL AND MECHANICAL UNIVERSITY              ","2003-2004",7,"Football",2469469,527549,1941920,2469469,527549,1941920,0,0,0,"98",".",432265,0
"3426",207500,"UNIVERSITY OF OKLAHOMA NORMAN CAMPUS                        ","2003-2004",2,"Basketball",6652093,4733042,1919051,6052531,3107466,2945065,599562,1625576,-1026014,"14","16",479084,454654
"4861",133951,"FLORIDA INTERNATIONAL UNIVERSITY                            ","2003-2004",7,"Football",4720141,2836405,1883736,4720141,2836405,1883736,0,0,0,"91",".",600012,0
"4330",110635,"UNIVERSITY OF CALIFORNIA-BERKELEY                           ","2003-2004",7,"Football",12548856,10685345,1863511,12548856,10685345,1863511,0,0,0,"104",".",3199281,0
"4601",230038,"BRIGHAM YOUNG UNIVERSITY                                    ","2003-2004",7,"Football",10367905,8550493,1817412,10367905,8550493,1817412,0,0,0,"133",".",1203385,0
"17344",228875,"TEXAS CHRISTIAN UNIVERSITY                                  ","2003-2004",39,"Total Participants",5757262,3946549,1810713,2463354,2008398,454956,3293908,1938151,1355757,"267","154",2140426,930794
"1921",110556,"CALIFORNIA STATE UNIVERSITY-FRESNO                          ","2003-2004",2,"Basketball",5314403,3589013,1725390,4773552,2163354,2610198,540851,1425659,-884808,"10","14",621692,392073
"1611",199193,"NORTH CAROLINA STATE UNIVERSITY AT RALEIGH                  ","2003-2004",2,"Basketball",5065000,3355491,1709509,5025000,2182486,2842514,40000,1173005,-1133005,"14","16",571000,377000
"5079",197036,"UNITED STATES MILITARY ACADEMY                              ","2003-2004",7,"Football",7432050,5723492,1708558,7432050,5723492,1708558,0,0,0,"130",".",2287552,0
"1915",139959,"UNIVERSITY OF GEORGIA                                       ","2003-2004",2,"Basketball",4429005,2743358,1685647,4357412,1623809,2733603,71593,1119549,-1047956,"15","12",601676,395996
"4487",155317,"UNIVERSITY OF KANSAS MAIN CAMPUS                            ","2003-2004",7,"Football",9361531,7723233,1638298,9361531,7723233,1638298,0,0,0,"138",".",1986845,0
"4512",130943,"UNIVERSITY OF DELAWARE                                      ","2003-2004",7,"Football",4690703,3251752,1438951,4690703,3251752,1438951,0,0,0,"90",".",383958,0
"1850",228796,"THE UNIVERSITY OF TEXAS AT EL PASO                          ","2003-2004",2,"Basketball",3638809,2230202,1408607,3364978,1467600,1897378,273831,762602,-488771,"21","14",451612,218812
"2216",206622,"XAVIER UNIVERSITY                                           ","2003-2004",2,"Basketball",5883959,4495267,1388692,5694895,3045302,2649593,189064,1449965,-1260901,"15","15",1393488,442547
"2583",179566,"SOUTHWEST MISSOURI STATE UNIVERSITY                         ","2003-2004",2,"Basketball",3574944,2239307,1335637,1878468,1144154,734314,1696476,1095153,601323,"16","15",257187,195511
"6418",181394,"UNIVERSITY OF NEBRASKA AT OMAHA                             ","2003-2004",10,"Ice Hockey",2322653,996437,1326216,2322653,996437,1326216,0,0,0,"31",".",445845,0
"12787",191630,"HOBART WILLIAM SMITH COLLEGES                               ","2003-2004",25,"Track and Field, X-Country",1334700,22673,1312027,673200,11558,661642,661500,11115,650385,"7","16",4781,4057
"3324",100751,"UNIVERSITY OF ALABAMA                                       ","2003-2004",2,"Basketball",6411692,5136499,1275193,6292650,3704008,2588642,119042,1432491,-1313449,"15","15",1191735,419994
"3458",240727,"UNIVERSITY OF WYOMING                                       ","2003-2004",2,"Basketball",3812347,2615679,1196668,3022493,1701359,1321134,789854,914320,-124466,"15","15",248477,217356
"2846",236948,"UNIVERSITY OF WASHINGTON-SEATTLE CAMPUS                     ","2003-2004",2,"Basketball",5319879,4153705,1166174,4235886,2492670,1743216,1083993,1661035,-577042,"16","13",565379,434307
"2579",209542,"OREGON STATE UNIVERSITY                                     ","2003-2004",2,"Basketball",4501195,3337893,1163302,4288882,1856214,2432668,212313,1481679,-1269366,"14","23",221930,224968
"4620",221999,"VANDERBILT UNIVERSITY                                       ","2003-2004",7,"Football",13431804,12297865,1133939,13431804,12297865,1133939,0,0,0,"102",".",854713,0
"16984",152363,"SAINT JOSEPHS COLLEGE                                       ","2003-2004",39,"Total Participants",1470491,340686,1129805,724984,177925,547059,745507,162761,582746,"228","117",189353,110879
"1935",182281,"UNIVERSITY OF NEVADA-LAS VEGAS                              ","2003-2004",2,"Basketball",4540708,3412036,1128672,4311432,2209767,2101665,229276,1202269,-972993,"15","16",439553,329235
"3108",214777,"PENNSYLVANIA STATE UNIVERSITY-MAIN CAMPUS                   ","2003-2004",2,"Basketball",5982494,4869475,1113019,5206667,2525461,2681206,775827,2344014,-1568187,"14","12",820002,797256
"4479",237525,"MARSHALL UNIVERSITY                                         ","2003-2004",7,"Football",5432559,4322861,1109698,5432559,4322861,1109698,0,0,0,"119",".",736015,0
"3065",217402,"PROVIDENCE COLLEGE                                          ","2003-2004",2,"Basketball",5438820,4352960,1085860,5409513,3274041,2135472,29307,1078919,-1049612,"14","12",502770,208321
"6446",240444,"UNIVERSITY OF WISCONSIN-MADISON                             ","2003-2004",10,"Ice Hockey",4342203,3287029,1055174,4043199,1977769,2065430,299004,1309260,-1010256,"28","24",774786,284007
"2618",243744,"STANFORD UNIVERSITY                                         ","2003-2004",2,"Basketball",5684476,4645578,1038898,4751267,2663803,2087464,933209,1981775,-1048566,"16","15",311888,126611
"5096",232557,"LIBERTY UNIVERSITY                                          ","2003-2004",7,"Football",1713006,697479,1015527,1713006,697479,1015527,0,0,0,"110",".",344828,0
"1896",157951,"WESTERN KENTUCKY UNIVERSITY                                 ","2003-2004",2,"Basketball",3212075,2197177,1014898,1930178,1113134,817044,1281897,1084043,197854,"15","11",245948,206865
"2649",217882,"CLEMSON UNIVERSITY                                          ","2003-2004",2,"Basketball",6193268,5178810,1014458,5809869,3602147,2207722,383399,1576663,-1193264,"14","15",617344,312450
"15642",106148,"YAVAPAI COLLEGE                                             ","2003-2004",39,"Total Participants",1558226,552257,1005969,371808,367224,4584,1186418,185033,1001385,"63","33",139911,101211
"13729",106148,"YAVAPAI COLLEGE                                             ","2003-2004",26,"Volleyball",1120255,118870,1001385,0,0,0,1120255,118870,1001385,".","10",0,35991
"6405",161253,"UNIVERSITY OF MAINE                                         ","2003-2004",10,"Ice Hockey",2895258,1894249,1001009,2490855,1352697,1138158,404403,541552,-137149,"28","26",224638,92257
"1972",216597,"VILLANOVA UNIVERSITY                                        ","2003-2004",2,"Basketball",4175306,3217900,957406,4078442,2200600,1877842,96864,1017300,-920436,"14","16",696864,262306
"6484",171128,"MICHIGAN TECHNOLOGICAL UNIVERSITY                           ","2003-2004",10,"Ice Hockey",2076537,1158493,918044,2076537,1158493,918044,0,0,0,"28",".",306716,0
"15550",171128,"MICHIGAN TECHNOLOGICAL UNIVERSITY                           ","2003-2004",39,"Total Participants",2772962,1860460,912502,2168675,1278628,890047,604287,581832,22455,"224","72",563836,179547
"6575",162928,"JOHNS HOPKINS UNIVERSITY                                    ","2003-2004",11,"Lacrosse",1733321,852025,881296,976838,486705,490133,756483,365320,391163,"38","29",97210,86140
"2236",228875,"TEXAS CHRISTIAN UNIVERSITY                                  ","2003-2004",2,"Basketball",3876992,3000250,876742,2427743,1809001,618742,1449249,1191249,258000,"14","14",406272,299695
"8054",122612,"UNIVERSITY OF SAN FRANCISCO                                 ","2003-2004",15,"Soccer",1072255,196199,876056,577488,98353,479135,494767,97846,396921,"32","27",92891,92538
"4819",102368,"TROY STATE UNIVERSITY-MAIN CAMPUS                           ","2003-2004",7,"Football",3915451,3073529,841922,3915451,3073529,841922,0,0,0,"138",".",581757,0
"4381",182290,"UNIVERSITY OF NEVADA-RENO                                   ","2003-2004",7,"Football",4164850,3334135,830715,4164850,3334135,830715,0,0,0,"108",".",475960,0
"6400",170976,"UNIVERSITY OF MICHIGAN-ANN ARBOR                            ","2003-2004",10,"Ice Hockey",2681093,1890879,790214,2681093,1890879,790214,0,0,0,"26",".",436255,0
"4410",221838,"TENNESSEE STATE UNIVERSITY                                  ","2003-2004",7,"Football",2952612,2167271,785341,2952612,2167271,785341,0,0,0,"88",".",207444,0
"15902",219949,"CUMBERLAND UNIVERSITY                                       ","2003-2004",39,"Total Participants",2466931,1709760,757171,1450221,959725,490496,1016710,750035,266675,"161","82",184751,84020
"15803",215062,"UNIVERSITY OF PENNSYLVANIA                                  ","2003-2004",39,"Total Participants",4646132,3900715,745417,2423550,2008838,414712,2222582,1891877,330705,"637","428",1376718,892052
"6449",164988,"BOSTON UNIVERSITY                                           ","2003-2004",10,"Ice Hockey",1903026,1159264,743762,1903026,1159264,743762,0,0,0,"26",".",192494,0
"3041",160755,"TULANE UNIVERSITY OF LOUISIANA                              ","2003-2004",2,"Basketball",2241657,1507000,734657,1612203,864000,748203,629454,643000,-13546,"13","14",227500,200500
"551",227526,"PRAIRIE VIEW A &amp; M UNIVERSITY                               ","2003-2004",1,"Baseball",932671,217012,715659,932671,217012,715659,0,0,0,"28",".",167115,0
"4451",142285,"UNIVERSITY OF IDAHO                                         ","2003-2004",7,"Football",4317590,3603103,714487,4317590,3603103,714487,0,0,0,"106",".",686728,0
"15613",114859,"FULLERTON COLLEGE                                           ","2003-2004",39,"Total Participants",1266730,553684,713046,603445,253636,349809,663285,300048,363237,"245","125",82935,60063
"16369",162928,"JOHNS HOPKINS UNIVERSITY                                    ","2003-2004",39,"Total Participants",2760357,2077500,682857,1599357,1199389,399968,1161000,878111,282889,"359","193",461583,323846
"4660",129020,"UNIVERSITY OF CONNECTICUT                                   ","2003-2004",7,"Football",4846306,4169434,676872,4846306,4169434,676872,0,0,0,"109",".",2566182,0
"13831",122612,"UNIVERSITY OF SAN FRANCISCO                                 ","2003-2004",26,"Volleyball",784967,109695,675272,0,0,0,784967,109695,675272,".","18",0,101336
"4408",157951,"WESTERN KENTUCKY UNIVERSITY                                 ","2003-2004",7,"Football",2549940,1883147,666793,2549940,1883147,666793,0,0,0,"102",".",334723,0
"4403",230728,"UTAH STATE UNIVERSITY                                       ","2003-2004",7,"Football",3362886,2697959,664927,3362886,2697959,664927,0,0,0,"101",".",695158,0
"4344",152363,"SAINT JOSEPHS COLLEGE                                       ","2003-2004",7,"Football",839365,177759,661606,839365,177759,661606,0,0,0,"85",".",65132,0
"17194",207689,"SAINT GREGORYS UNIVERSITY                                   ","2003-2004",39,"Total Participants",1827450,1173049,654401,1155420,595131,560289,672030,577918,94112,"114","69",53866,58520
"1953",235316,"GONZAGA UNIVERSITY                                          ","2003-2004",2,"Basketball",2738272,2085978,652294,1954297,1302728,651569,783975,783250,725,"15","16",351289,227158
"6464",126678,"COLORADO COLLEGE                                            ","2003-2004",10,"Ice Hockey",2136388,1486268,650120,2136388,1486268,650120,0,0,0,"26",".",371302,0
"1982",232557,"LIBERTY UNIVERSITY                                          ","2003-2004",2,"Basketball",1280906,638223,642683,720426,379899,340527,560480,258324,302156,"19","16",229433,176807
"3770",160755,"TULANE UNIVERSITY OF LOUISIANA                              ","2003-2004",3,"All Track Combined",881518,241000,640518,154964,48000,106964,726554,193000,533554,"10","104",22200,88800
"4739",131520,"HOWARD UNIVERSITY                                           ","2003-2004",7,"Football",2699968,2075724,624244,2699968,2075724,624244,0,0,0,"90",".",176576,0
"11280",221999,"VANDERBILT UNIVERSITY                                       ","2003-2004",22,"Tennis",1869926,1262955,606971,945831,623045,322786,924095,639910,284185,"11","9",142085,75367
"2372",230038,"BRIGHAM YOUNG UNIVERSITY                                    ","2003-2004",2,"Basketball",4659506,4056365,603141,3734793,2998188,736605,924713,1058177,-133464,"18","23",455282,275939
"16410",213987,"MERCYHURST COLLEGE                                          ","2003-2004",39,"Total Participants",4344863,3748273,596590,2074485,1717944,356541,2270378,2030329,240049,"329","251",351725,277025
"4396",180489,"THE UNIVERSITY OF MONTANA-MISSOULA                          ","2003-2004",7,"Football",3850470,3256829,593641,3850470,3256829,593641,0,0,0,"102",".",576184,0
"3853",228875,"TEXAS CHRISTIAN UNIVERSITY                                  ","2003-2004",3,"All Track Combined",1272731,691282,581449,548381,355202,193179,724350,336080,388270,"35","23",101021,125540
"1981",146719,"LOYOLA UNIVERSITY CHICAGO                                   ","2003-2004",2,"Basketball",2441113,1869331,571782,1686620,1107171,579449,754493,762160,-7667,"13","13",111469,104516
"15874",232557,"LIBERTY UNIVERSITY                                          ","2003-2004",39,"Total Participants",1217762,646124,571638,686340,345264,341076,531422,300860,230562,"264","121",822862,418849
"4459",100654,"ALABAMA A &amp; M UNIVERSITY                                    ","2003-2004",7,"Football",2475828,1913709,562119,2475828,1913709,562119,0,0,0,"90",".",441384,0
"1600",207971,"UNIVERSITY OF TULSA                                         ","2003-2004",2,"Basketball",3301893,2739857,562036,2862108,1643500,1218608,439785,1096357,-656572,"14","14",240931,163010
"5030",227757,"RICE UNIVERSITY                                             ","2003-2004",7,"Football",6761471,6205278,556193,6761471,6205278,556193,0,0,0,"100",".",837003,0
"4318",232423,"JAMES MADISON UNIVERSITY                                    ","2003-2004",7,"Football",2865066,2322931,542135,2865066,2322931,542135,0,0,0,"119",".",326168,0
"6503",171100,"MICHIGAN STATE UNIVERSITY                                   ","2003-2004",10,"Ice Hockey",2353509,1813360,540149,2353509,1813360,540149,0,0,0,"27",".",204881,0
"4402",219949,"CUMBERLAND UNIVERSITY                                       ","2003-2004",7,"Football",1365126,829179,535947,1365126,829179,535947,0,0,0,"73",".",68893,0
"16761",229179,"TEXAS WOMAN'S UNIVERSITY                                    ","2003-2004",39,"Total Participants",533526,0,533526,0,0,0,533526,606602,-73076,"0","80",0,201278
"16971",169910,"FERRIS STATE UNIVERSITY                                     ","2003-2004",39,"Total Participants",1857590,1330947,526643,985582,825371,160211,872008,505576,366432,"222","141",550019,306423
"2711",209551,"UNIVERSITY OF OREGON                                        ","2003-2004",2,"Basketball",4967440,4441502,525938,4359361,2790433,1568928,608079,1651069,-1042990,"14","18",417589,213105
"15586",218238,"LIMESTONE COLLEGE                                           ","2003-2004",39,"Total Participants",765766,243268,522498,410571,130088,280483,355195,113180,242015,"180","104",138400,121796
"16103",182795,"FRANKLIN PIERCE COLLEGE                                     ","2003-2004",39,"Total Participants",1757985,1253496,504489,965741,653214,312527,792244,600282,191962,"157","142",275416,182689
"435",122612,"UNIVERSITY OF SAN FRANCISCO                                 ","2003-2004",1,"Baseball",713069,208901,504168,713069,208901,504168,0,0,0,"38",".",189236,0
"1631",152363,"SAINT JOSEPHS COLLEGE                                       ","2003-2004",2,"Basketball",662164,158634,503530,325633,81202,244431,336531,77432,259099,"22","13",33897,25939
"364",159391,"LOUISIANA STATE UNIV &amp; AG &amp; MECH &amp; HEBERT LAWS CTR          ","2003-2004",1,"Baseball",2387278,1888890,498388,2387278,1888890,498388,0,0,0,"45",".",845527,0
"10358",228875,"TEXAS CHRISTIAN UNIVERSITY                                  ","2003-2004",18,"Swimming and Diving",1020231,525027,495204,439636,257001,182635,580595,268026,312569,"26","33",69488,81169
"2652",176080,"MISSISSIPPI STATE UNIVERSITY                                ","2003-2004",2,"Basketball",3698156,3205698,492458,3563988,1929603,1634385,134168,1276095,-1141927,"17","14",493758,293386
"17243",161253,"UNIVERSITY OF MAINE                                         ","2003-2004",39,"Total Participants",5450424,4958560,491864,3333837,2324972,1008865,2116587,2633588,-517001,"284","262",803231,621614
"6488",200280,"UNIVERSITY OF NORTH DAKOTA-MAIN CAMPUS                      ","2003-2004",10,"Ice Hockey",3721215,3237775,483440,3577712,2872028,705684,143503,365747,-222244,"27","24",233026,114283
"16591",195809,"ST JOHN'S UNIVERSITY-NEW YORK                               ","2003-2004",39,"Total Participants",5932228,5450499,481729,2376663,2109679,266984,3555565,3340820,214745,"114","205",40346,33612
"1920",179159,"SAINT LOUIS UNIVERSITY-MAIN CAMPUS                          ","2003-2004",2,"Basketball",3201173,2720386,480787,3161137,1803300,1357837,40036,917086,-877050,"14","14",279686,107364
"6426",231174,"UNIVERSITY OF VERMONT AND STATE AGRICULTURAL COLL           ","2003-2004",10,"Ice Hockey",1826630,1358992,467638,1699765,1105455,594310,126865,253537,-126672,"30","21",195258,95674
"2184",215062,"UNIVERSITY OF PENNSYLVANIA                                  ","2003-2004",2,"Basketball",1480049,1020697,459352,1025720,625783,399937,454329,394914,59415,"17","17",189766,154731
"17264",178420,"UNIVERSITY OF MISSOURI-ST LOUIS                             ","2003-2004",39,"Total Participants",665538,214904,450634,292611,110948,181663,372927,103956,268971,"82","71",114345,95424
"16903",121150,"PEPPERDINE UNIVERSITY                                       ","2003-2004",39,"Total Participants",5494288,5047818,446470,2835771,2584941,250830,2658517,2462877,195640,"113","118",603245,405030
"827",110556,"CALIFORNIA STATE UNIVERSITY-FRESNO                          ","2003-2004",1,"Baseball",1313281,872076,441205,1313281,872076,441205,0,0,0,"36",".",302786,0
"1572",160755,"TULANE UNIVERSITY OF LOUISIANA                              ","2003-2004",1,"Baseball",1068203,631000,437203,1068203,631000,437203,0,0,0,"33",".",207000,0
"5103",122612,"UNIVERSITY OF SAN FRANCISCO                                 ","2003-2004",8,"Golf",559569,127444,432125,261216,64205,197011,298353,63239,235114,"10","7",60662,60058
"16921",180595,"ROCKY MOUNTAIN COLLEGE                                      ","2003-2004",39,"Total Participants",677545,257870,419675,138146,70808,67338,539399,187062,352337,"128","64",183082,137346
"2802",212106,"DUQUESNE UNIVERSITY                                         ","2003-2004",2,"Basketball",3036940,2617675,419265,2036680,1660992,375688,1000260,956683,43577,"15","13",251950,174000
"16949",182670,"DARTMOUTH COLLEGE                                           ","2003-2004",39,"Total Participants",5750902,5334296,416606,2823778,2733516,90262,2927124,2600780,326344,"523","497",1171186,869689
"1735",178420,"UNIVERSITY OF MISSOURI-ST LOUIS                             ","2003-2004",2,"Basketball",486378,72284,414094,277021,43039,233982,209357,29245,180112,"14","10",32315,21172
"16712",227526,"PRAIRIE VIEW A &amp; M UNIVERSITY                               ","2003-2004",39,"Total Participants",1313173,908859,404314,1030670,369855,660815,282503,539004,-256501,"160","108",1081045,435006
"17067",190044,"CLARKSON UNIVERSITY                                         ","2003-2004",39,"Total Participants",2774586,2377853,396733,1920863,1527490,393373,853723,850363,3360,"249","136",437134,228120
"1705",180595,"ROCKY MOUNTAIN COLLEGE                                      ","2003-2004",2,"Basketball",555339,158957,396382,301413,81305,220108,253926,77652,176274,"12","11",34293,41467
"17173",433660,"FLORIDA GULF COAST UNIVERSITY                               ","2003-2004",39,"Total Participants",772511,383195,389316,426186,184930,241256,346325,198265,148060,"87","65",147500,148000
"2904",133881,"FLORIDA INSTITUTE OF TECHNOLOGY-MELBOURNE                   ","2003-2004",2,"Basketball",1017223,631809,385414,706616,303899,402717,310607,327910,-17303,"16","16",31578,31696
"4329",133526,"EDWARD WATERS COLLEGE                                       ","2003-2004",7,"Football",589173,207291,381882,589173,207291,381882,0,0,0,"89",".",79291,0
"6441",190044,"CLARKSON UNIVERSITY                                         ","2003-2004",10,"Ice Hockey",2125483,1756768,368715,1510005,1140319,369686,615478,616449,-971,"26","23",224992,100447
"1812",233277,"RADFORD UNIVERSITY                                          ","2003-2004",2,"Basketball",1075303,709924,365379,560256,344622,215634,515047,365302,149745,"13","17",121525,94201
"11675",122612,"UNIVERSITY OF SAN FRANCISCO                                 ","2003-2004",22,"Tennis",450883,87045,363838,238649,45248,193401,212234,41797,170437,"9","11",42249,39086
"4604",114859,"FULLERTON COLLEGE                                           ","2003-2004",7,"Football",560468,203982,356486,560468,203982,356486,0,0,0,"114",".",32923,0
"16455",131469,"GEORGE WASHINGTON UNIVERSITY                                ","2003-2004",39,"Total Participants",5500137,5144900,355237,2125807,2132530,-6723,3374330,3012370,361960,"172","247",711873,625319
"2653",217484,"UNIVERSITY OF RHODE ISLAND                                  ","2003-2004",2,"Basketball",3601836,3251519,350317,2376934,2165946,210988,1224902,1085573,139329,"15","11",475112,219336
"4413",169910,"FERRIS STATE UNIVERSITY                                     ","2003-2004",7,"Football",802958,455070,347888,802958,455070,347888,0,0,0,"117",".",201322,0
"16882",233277,"RADFORD UNIVERSITY                                          ","2003-2004",39,"Total Participants",1829593,1483417,346176,761840,584753,177087,1067753,898664,169089,"151","195",300326,391266
"15632",188429,"ADELPHI UNIVERSITY                                          ","2003-2004",39,"Total Participants",1993615,1650756,342859,1059930,878548,181382,933685,772208,161477,"149","131",230246,192115
"15843",133526,"EDWARD WATERS COLLEGE                                       ","2003-2004",39,"Total Participants",523057,182975,340082,280403,100011,180392,242654,82964,159690,"153","63",213393,102147
"16660",126119,"YUBA COLLEGE                                                ","2003-2004",39,"Total Participants",478800,141552,337248,281200,71960,209240,197600,69592,128008,"134","68",86059,48192
"5764",121150,"PEPPERDINE UNIVERSITY                                       ","2003-2004",8,"Golf",1098304,763411,334893,492077,404157,87920,606227,359254,246973,"9","6",68566,52925
"2612",176017,"UNIVERSITY OF MISSISSIPPI MAIN CAMPUS                       ","2003-2004",2,"Basketball",3563512,3231221,332291,3421766,1799115,1622651,141746,1432106,-1290360,"14","13",551131,423666
"2146",433660,"FLORIDA GULF COAST UNIVERSITY                               ","2003-2004",2,"Basketball",570768,243500,327268,289043,118500,170543,281725,125000,156725,"17","16",65000,65000
"1927",186584,"SETON HALL UNIVERSITY                                       ","2003-2004",2,"Basketball",4655825,4329260,326565,3538279,3205832,332447,1117546,1123428,-5882,"16","14",622189,295493
"4784",215062,"UNIVERSITY OF PENNSYLVANIA                                  ","2003-2004",7,"Football",1665470,1341174,324296,1665470,1341174,324296,0,0,0,"111",".",350371,0
"7863",160755,"TULANE UNIVERSITY OF LOUISIANA                              ","2003-2004",15,"Soccer",530903,215000,315903,0,0,0,530903,215000,315903,".","27",0,116620
"4789",207209,"LANGSTON UNIVERSITY                                         ","2003-2004",7,"Football",459054,147921,311133,459054,147921,311133,0,0,0,"72",".",15215,0
"1956",186131,"PRINCETON UNIVERSITY                                        ","2003-2004",2,"Basketball",1556716,1253869,302847,1111308,787639,323669,445408,466230,-20822,"16","13",297045,125625
"16545",212984,"HOLY FAMILY UNIVERSITY                                      ","2003-2004",39,"Total Participants",862573,561087,301486,315000,198020,116980,547573,363067,184506,"53","64",28223,48286
"11097",188146,"COLLEGE OF SANTA FE                                         ","2003-2004",22,"Tennis",298445,0,298445,298445,298445,0,0,0,0,"7",".",54744,0
"16623",188146,"COLLEGE OF SANTA FE                                         ","2003-2004",39,"Total Participants",298445,0,298445,298445,298445,0,0,0,0,"7","0",54744,0
"16896",235316,"GONZAGA UNIVERSITY                                          ","2003-2004",39,"Total Participants",3383059,3085852,297207,1611367,1462825,148542,1771692,1623027,148665,"140","186",878687,562981
"2712",163462,"MOUNT SAINT MARYS COLLEGE                                   ","2003-2004",2,"Basketball",1685976,1397257,288719,963495,742530,220965,722481,654727,67754,"16","15",137749,97635
"4897",102049,"SAMFORD UNIVERSITY                                          ","2003-2004",7,"Football",2982246,2695784,286462,2982246,2695784,286462,0,0,0,"88",".",246972,0
"4574",180595,"ROCKY MOUNTAIN COLLEGE                                      ","2003-2004",7,"Football",506580,220527,286053,506580,220527,286053,0,0,0,"87",".",102109,0
"1758",102553,"UNIVERSITY OF ALASKA ANCHORAGE                              ","2003-2004",2,"Basketball",1339492,1059311,280181,928486,682298,246188,411006,377013,33993,"16","14",151487,91910
"3735",152363,"SAINT JOSEPHS COLLEGE                                       ","2003-2004",3,"All Track Combined",355122,75801,279321,177561,37900,139661,177561,37901,139660,"30","25",23193,23194
"15829",173045,"AUGSBURG COLLEGE                                            ","2003-2004",39,"Total Participants",1129928,853902,276026,866410,602517,263893,263518,251385,12133,"273","136",291974,147944
"6964",153658,"UNIVERSITY OF IOWA                                          ","2003-2004",13,"Rowing",546300,271103,275197,0,0,0,546300,271103,275197,".","71",0,174698
"2867",104151,"ARIZONA STATE UNIVERSITY-MAIN CAMPUS                        ","2003-2004",2,"Basketball",4786698,4519273,267425,4366962,2894577,1472385,419736,1624696,-1204960,"19","15",565655,388580
"4810",198507,"ELIZABETH CITY STATE UNIVERSITY                             ","2003-2004",7,"Football",521939,254647,267292,521939,254647,267292,0,0,0,"72",".",119448,0
"2177",102049,"SAMFORD UNIVERSITY                                          ","2003-2004",2,"Basketball",2017481,1752579,264902,1294511,1092164,202347,722970,660415,62555,"13","13",167252,69033
"1967",117946,"LOYOLA MARYMOUNT UNIVERSITY                                 ","2003-2004",2,"Basketball",2584949,2321888,263061,1383309,1224939,158370,1201640,1096949,104691,"15","17",176307,196413
"17338",191630,"HOBART WILLIAM SMITH COLLEGES                               ","2003-2004",39,"Total Participants",1825503,1562851,262652,968265,793954,174311,857238,768897,88341,"293","219",188152,114148
"2707",238032,"WEST VIRGINIA UNIVERSITY                                    ","2003-2004",2,"Basketball",3755775,3493554,262221,3659317,2450417,1208900,96458,1043137,-946679,"15","13",540143,237029
"6481",174783,"SAINT CLOUD STATE UNIVERSITY                                ","2003-2004",10,"Ice Hockey",1615725,1353793,261932,1299484,833645,465839,316241,520148,-203907,"28","22",246374,135818
"2617",215284,"UNIVERSITY OF PITTSBURGH-JOHNSTOWN                          ","2003-2004",2,"Basketball",722991,462011,260980,340178,251405,88773,382813,210606,172207,"16","15",29799,34527
"13082",160755,"TULANE UNIVERSITY OF LOUISIANA                              ","2003-2004",26,"Volleyball",474853,214000,260853,0,0,0,474853,214000,260853,".","13",0,96500
"7958",152363,"SAINT JOSEPHS COLLEGE                                       ","2003-2004",15,"Soccer",338355,78086,260269,167959,39495,128464,170396,38591,131805,"21","21",20799,20366
"5637",160755,"TULANE UNIVERSITY OF LOUISIANA                              ","2003-2004",8,"Golf",452191,192000,260191,154964,96000,58964,297227,96000,201227,"10","9",48000,49000
"16396",190099,"COLGATE UNIVERSITY                                          ","2003-2004",39,"Total Participants",6995547,6738805,256742,3085892,2967496,118396,3909655,3771309,138346,"353","286",787605,632192
"4649",190099,"COLGATE UNIVERSITY                                          ","2003-2004",7,"Football",3534011,3277347,256664,3534011,3277347,256664,0,0,0,"99",".",221668,0
"10917",160755,"TULANE UNIVERSITY OF LOUISIANA                              ","2003-2004",22,"Tennis",569896,315000,254896,206619,157000,49619,363277,158000,205277,"10","13",58500,67500
"2665",160649,"SOUTHERN UNIVERSITY AT SHREVEPORT                           ","2003-2004",2,"Basketball",253913,0,253913,253913,123525,130388,0,0,0,"15",".",54018,0
"15097",215062,"UNIVERSITY OF PENNSYLVANIA                                  ","2003-2004",29,"Other Sports",778046,527787,250259,778046,527787,250259,0,0,0,"150",".",238597,0
"4547",141334,"STATE UNIVERSITY OF WEST GEORGIA                            ","2003-2004",7,"Football",686616,436485,250131,686616,436485,250131,0,0,0,"96",".",147241,0
"4631",160612,"SOUTHEASTERN LOUISIANA UNIVERSITY                           ","2003-2004",7,"Football",1988875,1738810,250065,1988875,1738810,250065,0,0,0,"109",".",453103,0
"3384",220862,"UNIVERSITY OF MEMPHIS                                       ","2003-2004",2,"Basketball",5367209,5126415,240794,5257513,3944659,1312854,109696,1181756,-1072060,"16","11",1354415,334683
"17160",198561,"GARDNER-WEBB UNIVERSITY                                     ","2003-2004",39,"Total Participants",3123319,2888909,234410,1452097,1310685,141412,1671222,1578224,92998,"226","135",524862,296869
"15047",173045,"AUGSBURG COLLEGE                                            ","2003-2004",28,"Wrestling",545649,313140,232509,545649,313140,232509,0,0,0,"43",".",74349,0
"4529",100724,"ALABAMA STATE UNIVERSITY                                    ","2003-2004",7,"Football",2025850,1793923,231927,2025850,1793923,231927,0,0,0,"80",".",1198850,0
"3147",161253,"UNIVERSITY OF MAINE                                         ","2003-2004",2,"Basketball",1978027,1749965,228062,888345,823322,65023,1089682,926643,163039,"13","14",137172,170323
"6526",183044,"UNIVERSITY OF NEW HAMPSHIRE-MAIN CAMPUS                     ","2003-2004",10,"Ice Hockey",2801690,2577336,224354,2244206,1727154,517052,557484,850182,-292698,"30","23",252195,127923
"16536",180461,"MONTANA STATE UNIVERSITY-BOZEMAN                            ","2003-2004",39,"Total Participants",2453829,2233161,220668,715834,620193,95641,1737995,1612968,125027,"198","167",738174,446957
"6471",182670,"DARTMOUTH COLLEGE                                           ","2003-2004",10,"Ice Hockey",1059086,839918,219168,680596,494313,186283,378490,345605,32885,"28","21",155849,100192
"2436",207209,"LANGSTON UNIVERSITY                                         ","2003-2004",2,"Basketball",385726,167673,218053,196587,82660,113927,189139,85013,104126,"15","15",2583,2504
"2343",217688,"CHARLESTON SOUTHERN UNIVERSITY                              ","2003-2004",2,"Basketball",1184534,967365,217169,680881,505766,175115,503653,461599,42054,"14","15",110927,108895
"957",219949,"CUMBERLAND UNIVERSITY                                       ","2003-2004",1,"Baseball",627366,411508,215858,627366,411508,215858,0,0,0,"28",".",45415,0
"8460",207689,"SAINT GREGORYS UNIVERSITY                                   ","2003-2004",15,"Soccer",672030,461463,210567,436230,236978,199252,235800,224485,11315,"37","20",11715,12000
"2190",228769,"THE UNIVERSITY OF TEXAS AT ARLINGTON                        ","2003-2004",2,"Basketball",1278633,1068181,210452,744095,561934,182161,534538,506247,28291,"16","18",190864,149679
"1780",169910,"FERRIS STATE UNIVERSITY                                     ","2003-2004",2,"Basketball",521395,313737,207658,250583,154525,96058,270812,159212,111600,"15","13",46698,61311
"4753",232937,"NORFOLK STATE UNIVERSITY                                    ","2003-2004",7,"Football",1618084,1410986,207098,1618084,1410986,207098,0,0,0,"73",".",876307,0
"7409",178420,"UNIVERSITY OF MISSOURI-ST LOUIS                             ","2003-2004",15,"Soccer",275012,68022,206990,123615,29863,93752,151397,38159,113238,"23","22",18897,27720
"1411",207689,"SAINT GREGORYS UNIVERSITY                                   ","2003-2004",1,"Baseball",400860,193876,206984,400860,193876,206984,0,0,0,"34",".",11258,0
"1066",152363,"SAINT JOSEPHS COLLEGE                                       ","2003-2004",1,"Baseball",287738,81012,206726,287738,81012,206726,0,0,0,"50",".",36538,0
"4902",163286,"UNIVERSITY OF MARYLAND-COLLEGE PARK                         ","2003-2004",7,"Football",8941831,8736751,205080,8941831,8736751,205080,0,0,0,"119",".",1366441,0
"6483",213987,"MERCYHURST COLLEGE                                          ","2003-2004",10,"Ice Hockey",1137852,933043,204809,537198,409969,127229,600654,523074,77580,"27","25",73700,64300
"2435",141334,"STATE UNIVERSITY OF WEST GEORGIA                            ","2003-2004",2,"Basketball",480297,275908,204389,267588,149803,117785,212709,126105,86604,"12","10",63964,45120
"14053",228875,"TEXAS CHRISTIAN UNIVERSITY                                  ","2003-2004",26,"Volleyball",687737,484756,202981,0,0,0,687737,484756,202981,".","14",0,170617
"15500",239716,"SAINT NORBERT COLLEGE                                       ","2003-2004",39,"Total Participants",914112,711330,202782,640905,476020,164885,273207,235310,37897,"308","166",375061,152416
"16842",151263,"UNIVERSITY OF INDIANAPOLIS                                  ","2003-2004",39,"Total Participants",2505451,2303416,202035,1304397,1185595,118802,1201054,1117821,83233,"299","178",386057,236615
"4899",192448,"LONG ISLAND UNIVERSITY-C W POST CAMPUS                      ","2003-2004",7,"Football",579983,378786,201197,579983,378786,201197,0,0,0,"92",".",167486,0
"2074",102094,"UNIVERSITY OF SOUTH ALABAMA                                 ","2003-2004",2,"Basketball",2095851,1898006,197845,1120218,1094315,25903,975633,803691,171942,"15","11",188954,140853
"3832",207689,"SAINT GREGORYS UNIVERSITY                                   ","2003-2004",3,"All Track Combined",389070,191372,197698,247590,95552,152038,141480,95820,45660,"21","12",4945,5284
"15758",202763,"THE UNIVERSITY OF FINDLAY                                   ","2003-2004",39,"Total Participants",2807473,2611792,195681,1451158,1425448,25710,1356315,1186344,169971,"358","312",414782,258793
"4458",171128,"MICHIGAN TECHNOLOGICAL UNIVERSITY                           ","2003-2004",7,"Football",1114368,921307,193061,1114368,921307,193061,0,0,0,"90",".",130800,0
"7104",189574,"BRYANT AND STRATTON BUSINESS INST-MAIN SYRACUSE             ","2003-2004",15,"Soccer",392384,2e+05,192384,190795,1e+05,90795,201589,1e+05,101589,"27","22",50000,50000
"16459",189574,"BRYANT AND STRATTON BUSINESS INST-MAIN SYRACUSE             ","2003-2004",39,"Total Participants",392384,2e+05,192384,190795,1e+05,90795,201589,1e+05,101589,"27","22",50000,50000
"3170",121150,"PEPPERDINE UNIVERSITY                                       ","2003-2004",2,"Basketball",2791707,2599994,191713,1611161,1514698,96463,1180546,1085296,95250,"14","15",197892,165145
"4276",186131,"PRINCETON UNIVERSITY                                        ","2003-2004",7,"Football",1813014,1622083,190931,1813014,1622083,190931,0,0,0,"104",".",396760,0
"16107",212577,"FRANKLIN AND MARSHALL COLLEGE                               ","2003-2004",39,"Total Participants",979208,788566,190642,533443,427231,106212,445765,361335,84430,"366","218",268199,147682
"4690",159009,"GRAMBLING STATE UNIVERSITY                                  ","2003-2004",7,"Football",1806471,1618119,188352,1806471,1618119,188352,0,0,0,"120",".",1250352,0
"10717",228875,"TEXAS CHRISTIAN UNIVERSITY                                  ","2003-2004",22,"Tennis",651512,464467,187045,300718,263840,36878,350794,200627,150167,"12","13",70361,43192
"2336",198507,"ELIZABETH CITY STATE UNIVERSITY                             ","2003-2004",2,"Basketball",394447,207807,186640,222682,121026,101656,171765,86781,84984,"15","14",59535,38892
"7403",153658,"UNIVERSITY OF IOWA                                          ","2003-2004",15,"Soccer",445666,259566,186100,0,0,0,445666,259566,186100,".","24",0,73691
"5029",213987,"MERCYHURST COLLEGE                                          ","2003-2004",7,"Football",1122576,937037,185539,1122576,937037,185539,0,0,0,"86",".",71500,0
"2851",169716,"UNIVERSITY OF DETROIT MERCY                                 ","2003-2004",2,"Basketball",1972975,1787730,185245,1292316,1115018,177298,680659,672712,7947,"17","15",147167,104425
"1491",234827,"CENTRAL WASHINGTON UNIVERSITY                               ","2003-2004",1,"Baseball",240338,56120,184218,240338,56120,184218,0,0,0,"28",".",25752,0
"3111",140960,"SAVANNAH STATE UNIVERSITY                                   ","2003-2004",2,"Basketball",544500,361033,183467,535700,211801,323899,8800,149232,-140432,"14","9",104425,77028
"17006",144865,"COLLEGE OF DUPAGE                                           ","2003-2004",39,"Total Participants",521350,339550,181800,279850,152500,127350,241500,187050,54450,"204","97",180350,128100
"17086",155089,"FRIENDS UNIVERSITY                                          ","2003-2004",39,"Total Participants",739114,557942,181172,448282,319174,129108,290832,238768,52064,"229","83",197067,92074
"4395",141574,"UNIVERSITY OF HAWAII AT MANOA                               ","2003-2004",7,"Football",4837475,4657652,179823,4837475,4657652,179823,0,0,0,"124",".",1497192,0
"3050",163338,"UNIVERSITY OF MARYLAND-EASTERN SHORE                        ","2003-2004",2,"Basketball",1036194,858694,177500,547473,398608,148865,488721,460086,28635,"15","18",83963,92479
"2482",133526,"EDWARD WATERS COLLEGE                                       ","2003-2004",2,"Basketball",327169,151274,175895,177144,91091,86053,150025,60183,89842,"15","13",59091,40183
"2403",141006,"SOUTH GEORGIA TECHNICAL COLLEGE                             ","2003-2004",2,"Basketball",175406,0,175406,175406,169454,5952,0,0,0,"15",".",53447,0
"1483",232557,"LIBERTY UNIVERSITY                                          ","2003-2004",1,"Baseball",347239,172973,174266,347239,172973,174266,0,0,0,"40",".",128788,0
"4315",191241,"FORDHAM UNIVERSITY                                          ","2003-2004",7,"Football",3429306,3255639,173667,3429306,3255639,173667,0,0,0,"109",".",248487,0
"4448",213020,"INDIANA UNIVERSITY OF PENNSYLVANIA-MAIN CAMPUS              ","2003-2004",7,"Football",1112927,939338,173589,1112927,939338,173589,0,0,0,"89",".",103256,0
"8935",219949,"CUMBERLAND UNIVERSITY                                       ","2003-2004",16,"Softball",376445,203077,173368,0,0,0,376445,203077,173368,".","24",0,17828
"16931",138354,"THE UNIVERSITY OF WEST FLORIDA                              ","2003-2004",39,"Total Participants",1894655,1723053,171602,821532,779727,41805,1073123,943326,129797,"103","109",212984,247691
"2126",198561,"GARDNER-WEBB UNIVERSITY                                     ","2003-2004",2,"Basketball",1286099,1114686,171413,811893,648932,162961,474206,465754,8452,"12","14",99561,77891
"16305",191199,"FINGER LAKES COMMUNITY COLLEGE                              ","2003-2004",39,"Total Participants",232000,61000,171000,119300,31400,87900,112700,29600,83100,"133","107",4805,4755
"15578",117946,"LOYOLA MARYMOUNT UNIVERSITY                                 ","2003-2004",39,"Total Participants",5992333,5821657,170676,2542119,2441269,100850,3450214,3380388,69826,"142","197",594201,589703
"9191",229179,"TEXAS WOMAN'S UNIVERSITY                                    ","2003-2004",16,"Softball",170401,0,170401,0,0,0,170401,208329,-37928,".","18",0,42430
"16377",194310,"PACE UNIVERSITY-NEW YORK                                    ","2003-2004",39,"Total Participants",1179994,1012790,167204,623332,484165,139167,556662,528625,28037,"172","113",239401,176792
"5083",137351,"UNIVERSITY OF SOUTH FLORIDA                                 ","2003-2004",7,"Football",5189338,5022753,166585,5189338,5022753,166585,0,0,0,"110",".",963901,0
"6828",131469,"GEORGE WASHINGTON UNIVERSITY                                ","2003-2004",11,"Lacrosse",442165,278295,163870,0,0,0,442165,278295,163870,".","30",0,58807
"16880",192448,"LONG ISLAND UNIVERSITY-C W POST CAMPUS                      ","2003-2004",39,"Total Participants",2394229,2231311,162918,938955,906768,32187,1455274,1324543,130731,"269","176",367510,311286
"2694",232423,"JAMES MADISON UNIVERSITY                                    ","2003-2004",2,"Basketball",2167466,2004833,162633,1267931,1150691,117240,899535,854142,45393,"17","13",211151,192281
"5138",228875,"TEXAS CHRISTIAN UNIVERSITY                                  ","2003-2004",8,"Golf",701614,538995,162619,325940,302679,23261,375674,236316,139358,"13","10",70388,77359
"8885",131469,"GEORGE WASHINGTON UNIVERSITY                                ","2003-2004",16,"Softball",399602,237257,162345,0,0,0,399602,237257,162345,".","17",0,27491
"7914",228875,"TEXAS CHRISTIAN UNIVERSITY                                  ","2003-2004",15,"Soccer",514719,352951,161768,0,0,0,514719,352951,161768,".","32",0,99149
"11",228778,"THE UNIVERSITY OF TEXAS AT AUSTIN                           ","2003-2004",1,"Baseball",2719471,2557827,161644,2719471,2557827,161644,0,0,0,"41",".",778589,0
"4354",106704,"UNIVERSITY OF CENTRAL ARKANSAS                              ","2003-2004",7,"Football",936726,775175,161551,936726,775175,161551,0,0,0,"107",".",116548,0
"16756",215743,"SAINT FRANCIS UNIVERSITY                                    ","2003-2004",39,"Total Participants",1878487,1719864,158623,666526,587864,78662,1211961,1132000,79961,"214","179",359036,344465
"16150",102049,"SAMFORD UNIVERSITY                                          ","2003-2004",39,"Total Participants",3221765,3063162,158603,1078140,1010306,67834,2143625,2052856,90769,"186","132",569500,277154
"16616",213349,"KUTZTOWN UNIVERSITY OF PENNSYLVANIA                         ","2003-2004",39,"Total Participants",1532764,1374231,158533,589726,535239,54487,943038,838992,104046,"221","202",270672,186083
"6355",229179,"TEXAS WOMAN'S UNIVERSITY                                    ","2003-2004",9,"Gymnastics",157010,0,157010,0,0,0,157010,147688,9322,".","17",0,39933
"7533",180595,"ROCKY MOUNTAIN COLLEGE                                      ","2003-2004",15,"Soccer",219779,64178,155601,0,0,0,219779,64178,155601,".","22",0,25993
"13237",121150,"PEPPERDINE UNIVERSITY                                       ","2003-2004",26,"Volleyball",1280680,1125452,155228,557895,440772,117123,722785,684680,38105,"17","14",56374,62081
"8711",121071,"PATTEN UNIVERSITY                                           ","2003-2004",16,"Softball",155000,0,155000,0,0,0,155000,40528,114472,".","12",0,40521
"16157",121071,"PATTEN UNIVERSITY                                           ","2003-2004",39,"Total Participants",155000,0,155000,0,0,0,155000,40528,114472,"0","12",0,40521
"2554",171128,"MICHIGAN TECHNOLOGICAL UNIVERSITY                           ","2003-2004",2,"Basketball",921420,767068,154352,478974,375920,103054,442446,391148,51298,"16","16",75349,65676
"12511",163462,"MOUNT SAINT MARYS COLLEGE                                   ","2003-2004",25,"Track and Field, X-Country",581187,427501,153686,294213,229591,64622,286974,197910,89064,"30","26",32634,28456
"2956",110486,"CALIFORNIA STATE UNIVERSITY-BAKERSFIELD                     ","2003-2004",2,"Basketball",810348,657333,153015,535784,406936,128848,274564,250397,24167,"15","15",74360,47140
"17178",230959,"MIDDLEBURY COLLEGE                                          ","2003-2004",39,"Total Participants",2334559,2181681,152878,1160834,1073165,87669,1173725,1108516,65209,"441","405",389686,328389
"11988",180461,"MONTANA STATE UNIVERSITY-BOZEMAN                            ","2003-2004",24,"Track and Field, Outdoor",510445,358565,151880,240164,179814,60350,270281,178751,91530,"40","45",35355,27464
"16782",119216,"MT SAN JACINTO COLLEGE                                      ","2003-2004",39,"Total Participants",291400,139888,151512,115138,59015,56123,176262,80873,95389,"107","63",50579,44385
"14986",215062,"UNIVERSITY OF PENNSYLVANIA                                  ","2003-2004",28,"Wrestling",471174,320448,150726,471174,320448,150726,0,0,0,"46",".",127390,0
"8206",219949,"CUMBERLAND UNIVERSITY                                       ","2003-2004",15,"Soccer",530556,381283,149273,296446,172483,123963,234110,208800,25310,"20","16",12680,11475
"8167",114859,"FULLERTON COLLEGE                                           ","2003-2004",15,"Soccer",220154,71169,148985,121463,37500,83963,98691,33669,65022,"27","18",8608,7912
"1035",182795,"FRANKLIN PIERCE COLLEGE                                     ","2003-2004",1,"Baseball",317576,171055,146521,317576,171055,146521,0,0,0,"33",".",91237,0
"17096",227757,"RICE UNIVERSITY                                             ","2003-2004",39,"Total Participants",6915726,6769523,146203,3139970,3158346,-18376,3775756,3611177,164579,"251","190",1879001,816978
"12090",243151,"UNIVERSITY OF PUERTO RICO-CAYEY UNIVERSITY COLLEGE          ","2003-2004",24,"Track and Field, Outdoor",243450,97996,145454,134330,59801,74529,109120,38195,70925,"6","10",8400,6000
"4456",204185,"MOUNT UNION COLLEGE                                         ","2003-2004",7,"Football",488399,343594,144805,488399,343594,144805,0,0,0,"212",".",127099,0
"15963",175980,"MILLSAPS COLLEGE                                            ","2003-2004",39,"Total Participants",427534,282870,144664,241530,123358,118172,186004,159512,26492,"159","80",205684,89449
"3723",232557,"LIBERTY UNIVERSITY                                          ","2003-2004",3,"All Track Combined",252473,108161,144312,124505,52018,72487,127968,56143,71825,"48","38",43491,38747
"14618",195809,"ST JOHN'S UNIVERSITY-NEW YORK                               ","2003-2004",26,"Volleyball",702200,558852,143348,0,0,0,702200,558852,143348,"0","15",0,3790
"6573",218238,"LIMESTONE COLLEGE                                           ","2003-2004",11,"Lacrosse",215950,72957,142993,130600,50109,80491,85350,22848,62502,"52","24",44080,20280
"931",433660,"FLORIDA GULF COAST UNIVERSITY                               ","2003-2004",1,"Baseball",201965,59780,142185,201965,59780,142185,0,0,0,"39",".",35000,0
"15335",142559,"COLLEGE OF SOUTHERN IDAHO                                   ","2003-2004",35,"Rodeo",195492,54000,141492,97746,27000,70746,97746,27000,70746,"10","11",25000,25000
"1939",229179,"TEXAS WOMAN'S UNIVERSITY                                    ","2003-2004",2,"Basketball",140307,0,140307,0,0,0,140307,216227,-75920,".","13",0,45509
"16666",237312,"UNIVERSITY OF CHARLESTON                                    ","2003-2004",39,"Total Participants",504941,365258,139683,234038,178699,55339,270903,186559,84344,"214","140",236302,108577
"4358",157863,"UNION COLLEGE                                               ","2003-2004",7,"Football",589000,450000,139000,589000,450000,139000,0,0,0,"59",".",50021,0
"2318",230764,"UNIVERSITY OF UTAH                                          ","2003-2004",2,"Basketball",3214661,3075771,138890,3123524,2249895,873629,91137,825876,-734739,"15","11",286016,218917
"16593",125028,"VENTURA COLLEGE                                             ","2003-2004",39,"Total Participants",512449,373951,138498,212110,166304,45806,300339,207647,92692,"212","133",121055,111198
"15979",215284,"UNIVERSITY OF PITTSBURGH-JOHNSTOWN                          ","2003-2004",39,"Total Participants",530195,391920,138275,335791,269315,66476,194404,122605,71799,"120","78",103908,51252
"15712",201645,"CASE WESTERN RESERVE UNIVERSITY                             ","2003-2004",39,"Total Participants",798286,660125,138161,397098,335210,61888,401188,324915,76273,"315","180",317748,247302
"1822",100654,"ALABAMA A &amp; M UNIVERSITY                                    ","2003-2004",2,"Basketball",1230648,1092504,138144,764250,637762,126488,466398,454742,11656,"18","15",150374,110739
"6511",239716,"SAINT NORBERT COLLEGE                                       ","2003-2004",10,"Ice Hockey",446626,309293,137333,446626,309293,137333,0,0,0,"26",".",115527,0
"4553",126119,"YUBA COLLEGE                                                ","2003-2004",7,"Football",174800,37500,137300,174800,37500,137300,0,0,0,"46",".",23000,0
"17199",217484,"UNIVERSITY OF RHODE ISLAND                                  ","2003-2004",39,"Total Participants",5103642,4967419,136223,1544693,1596876,-52183,3558949,3370543,188406,"317","339",1274124,796375
"2445",157447,"NORTHERN KENTUCKY UNIVERSITY                                ","2003-2004",2,"Basketball",1164396,1028559,135837,647087,567249,79838,517309,461310,55999,"14","14",97554,80065
"11835",180461,"MONTANA STATE UNIVERSITY-BOZEMAN                            ","2003-2004",23,"Track and Field, Indoor",441385,306311,135074,164818,123402,41416,276567,182909,93658,"28","46",24264,28102
"15298",188261,"MESALANDS COMMUNITY COLLEGE                                 ","2003-2004",35,"Rodeo",134450,0,134450,134450,133419,1031,0,0,0,"48",".",1521,0
"16265",188261,"MESALANDS COMMUNITY COLLEGE                                 ","2003-2004",39,"Total Participants",134450,0,134450,134450,133419,1031,0,0,0,"48","0",1521,0
"12933",215743,"SAINT FRANCIS UNIVERSITY                                    ","2003-2004",25,"Track and Field, X-Country",633271,498932,134339,310948,245546,65402,322323,253386,68937,"45","39",42342,38807
"4691",218733,"SOUTH CAROLINA STATE UNIVERSITY                             ","2003-2004",7,"Football",1369053,1234884,134169,1369053,1234884,134169,0,0,0,"101",".",180003,0
"4394",207263,"NORTHEASTERN STATE UNIVERSITY                               ","2003-2004",7,"Football",542042,408640,133402,542042,408640,133402,0,0,0,"95",".",89690,0
"17292",166850,"MERRIMACK COLLEGE                                           ","2003-2004",39,"Total Participants",2121557,1988283,133274,1417797,1333915,83882,703760,654368,49392,"218","132",292920,151509
"16432",199209,"NORTH CAROLINA WESLEYAN COLLEGE                             ","2003-2004",39,"Total Participants",257047,124624,132423,142226,77315,64911,114821,47309,67512,"104","57",30548,21077
"10224",160755,"TULANE UNIVERSITY OF LOUISIANA                              ","2003-2004",18,"Swimming and Diving",330252,199000,131252,0,0,0,330252,199000,131252,".","15",0,94000
"16774",125763,"WHITTIER COLLEGE                                            ","2003-2004",39,"Total Participants",535740,404586,131154,270530,220111,50419,265210,184475,80735,"203","145",274337,128909
"3119",212601,"GANNON UNIVERSITY                                           ","2003-2004",2,"Basketball",1043937,912963,130974,605730,484583,121147,438207,428380,9827,"16","14",71872,53054
"6614",182670,"DARTMOUTH COLLEGE                                           ","2003-2004",11,"Lacrosse",660494,530131,130363,279575,260590,18985,380919,269541,111378,"43","28",72228,65267
"2437",192703,"MANHATTAN COLLEGE                                           ","2003-2004",2,"Basketball",1900603,1770414,130189,1205429,1085762,119667,695174,684652,10522,"12","9",213068,104954
"16868",215099,"PHILADELPHIA UNIVERSITY                                     ","2003-2004",39,"Total Participants",1321483,1191509,129974,488002,460885,27117,833481,730624,102857,"83","128",50460,70761
"17290",217688,"CHARLESTON SOUTHERN UNIVERSITY                              ","2003-2004",39,"Total Participants",1757926,1628478,129448,658897,595579,63318,1099029,1032899,66130,"169","97",391041,296249
"14036",180595,"ROCKY MOUNTAIN COLLEGE                                      ","2003-2004",26,"Volleyball",181474,52076,129398,0,0,0,181474,52076,129398,".","14",0,23205
"15467",141334,"STATE UNIVERSITY OF WEST GEORGIA                            ","2003-2004",39,"Total Participants",468373,339517,128856,234474,147198,87276,233899,192319,41580,"160","57",261494,125922
"16942",146339,"JUDSON COLLEGE                                              ","2003-2004",39,"Total Participants",675556,547019,128537,370693,312795,57898,304863,234224,70639,"54","47",60629,77864
"10184",163268,"UNIVERSITY OF MARYLAND-BALTIMORE COUNTY                     ","2003-2004",18,"Swimming and Diving",266103,138106,127997,148447,71298,77149,117656,66808,50848,"25","23",35870,32179
"15473",139764,"GEORGIA SOUTHWESTERN STATE UNIVERSITY                       ","2003-2004",39,"Total Participants",509000,381258,127742,209000,148775,60225,3e+05,232483,67517,"55","49",86352,99428
"12611",114859,"FULLERTON COLLEGE                                           ","2003-2004",25,"Track and Field, X-Country",252612,125367,127245,121834,64730,57104,130778,60637,70141,"22","26",6084,6084
"3472",130226,"QUINNIPIAC UNIVERSITY                                       ","2003-2004",2,"Basketball",2046270,1919303,126967,1144330,1022402,121928,901940,896901,5039,"14","16",256413,233859
"3434",169798,"EASTERN MICHIGAN UNIVERSITY                                 ","2003-2004",2,"Basketball",1781149,1654859,126290,1020628,902139,118489,760521,752720,7801,"15","14",157639,178812
"8471",232557,"LIBERTY UNIVERSITY                                          ","2003-2004",15,"Soccer",215722,89645,126077,116170,44438,71732,99552,45207,54345,"24","24",35042,40454
"17232",106704,"UNIVERSITY OF CENTRAL ARKANSAS                              ","2003-2004",39,"Total Participants",1078103,952206,125897,399863,361898,37965,678240,590308,87932,"207","97",275204,156659
"8512",195809,"ST JOHN'S UNIVERSITY-NEW YORK                               ","2003-2004",15,"Soccer",1323909,1198304,125605,766957,653270,113687,556952,545034,11918,"24","26",3387,2751
"14629",229179,"TEXAS WOMAN'S UNIVERSITY                                    ","2003-2004",26,"Volleyball",125509,0,125509,0,0,0,125509,138418,-12909,".","12",0,34292
"15812",207263,"NORTHEASTERN STATE UNIVERSITY                               ","2003-2004",39,"Total Participants",702340,577051,125289,298651,243110,55541,403689,333941,69748,"191","72",209745,137745
"16948",139630,"EMMANUEL COLLEGE                                            ","2003-2004",39,"Total Participants",544127,419381,124746,221207,217544,3663,322920,201837,121083,"63","49",82721,72650
"14467",152363,"SAINT JOSEPHS COLLEGE                                       ","2003-2004",26,"Volleyball",161181,36492,124689,0,0,0,161181,36492,124689,".","25",0,14960
"2043",198695,"HIGH POINT UNIVERSITY                                       ","2003-2004",2,"Basketball",1257361,1133397,123964,812155,667324,144831,445206,466073,-20867,"15","13",143936,96342
"16388",163268,"UNIVERSITY OF MARYLAND-BALTIMORE COUNTY                     ","2003-2004",39,"Total Participants",1325565,1202290,123275,641583,624365,17218,683982,577925,106057,"229","219",438697,409967
"8504",182795,"FRANKLIN PIERCE COLLEGE                                     ","2003-2004",15,"Soccer",692824,569551,123273,337156,275655,61501,355668,293896,61772,"21","23",50372,51429
"17032",164562,"ASSUMPTION COLLEGE                                          ","2003-2004",39,"Total Participants",554824,431630,123194,288645,215527,73118,266179,216103,50076,"292","251",130238,105308
"672",195809,"ST JOHN'S UNIVERSITY-NEW YORK                               ","2003-2004",1,"Baseball",740898,617924,122974,740898,617924,122974,0,0,0,"33",".",3563,0
"9642",433660,"FLORIDA GULF COAST UNIVERSITY                               ","2003-2004",16,"Softball",169975,47750,122225,0,0,0,169975,47750,122225,".","16",0,30000
"16436",227304,"ODESSA COLLEGE                                              ","2003-2004",39,"Total Participants",701157,579358,121799,494599,405254,89345,206558,174104,32454,"95","31",144955,69449
"7621",235316,"GONZAGA UNIVERSITY                                          ","2003-2004",15,"Soccer",1020296,899300,120996,492549,399694,92855,527747,499606,28141,"30","49",116998,104824
"6406",197036,"UNITED STATES MILITARY ACADEMY                              ","2003-2004",10,"Ice Hockey",751805,630839,120966,751805,630839,120966,0,0,0,"27",".",98030,0
"1774",218238,"LIMESTONE COLLEGE                                           ","2003-2004",2,"Basketball",174520,56024,118496,97420,29593,67827,77100,26431,50669,"14","9",24720,23200
"12621",122612,"UNIVERSITY OF SAN FRANCISCO                                 ","2003-2004",25,"Track and Field, X-Country",161082,42874,118208,82366,21437,60929,78716,21437,57279,"11","9",19054,19054
"16690",169363,"CONCORDIA UNIVERSITY                                        ","2003-2004",39,"Total Participants",911079,792920,118159,455692,409500,46192,455387,383420,71967,"83","86",70000,80000
"17010",199148,"UNIVERSITY OF NORTH CAROLINA AT GREENSBORO                  ","2003-2004",39,"Total Participants",2640067,2521952,118115,1378990,1269501,109489,1261077,1252451,8626,"129","103",339707,275162
"456",194310,"PACE UNIVERSITY-NEW YORK                                    ","2003-2004",1,"Baseball",421666,303658,118008,421666,303658,118008,0,0,0,"39",".",48230,0
"4336",170082,"GRAND VALLEY STATE UNIVERSITY                               ","2003-2004",7,"Football",1722500,1606406,116094,1722500,1606406,116094,0,0,0,"113",".",260292,0
"17222",181394,"UNIVERSITY OF NEBRASKA AT OMAHA                             ","2003-2004",39,"Total Participants",2882830,2767186,115644,2477815,1388748,1089067,405015,1378438,-973423,"222","185",931388,399053
"7510",126119,"YUBA COLLEGE                                                ","2003-2004",15,"Soccer",148200,33040,115160,79800,17220,62580,68400,15820,52580,"21","18",10970,10070
"10050",152363,"SAINT JOSEPHS COLLEGE                                       ","2003-2004",16,"Softball",144642,29556,115086,0,0,0,144642,29556,115086,".","19",0,15822
"16463",147916,"PARKLAND COLLEGE                                            ","2003-2004",39,"Total Participants",272800,157772,115028,155000,84449,70551,117800,73323,44477,"78","62",73460,78755
"10971",139630,"EMMANUEL COLLEGE                                            ","2003-2004",22,"Tennis",176473,61797,114676,31511,30088,1423,144962,31709,113253,"10","7",7993,8827
"17210",120537,"HOPE INTERNATIONAL UNIVERSITY                               ","2003-2004",39,"Total Participants",280118,166480,113638,99516,61710,37806,180602,104770,75832,"40","65",85470,129760
"2310",213987,"MERCYHURST COLLEGE                                          ","2003-2004",2,"Basketball",772489,659114,113375,408005,333464,74541,364484,325650,38834,"14","14",37500,30700
"3611",133526,"EDWARD WATERS COLLEGE                                       ","2003-2004",3,"All Track Combined",162899,49606,113293,81450,24477,56973,81449,25129,56320,"18","18",18477,19129
"16226",220589,"LAMBUTH UNIVERSITY                                          ","2003-2004",39,"Total Participants",656875,544046,112829,404473,339085,65388,252402,204961,47441,"213","89",215935,66276
"1274",114859,"FULLERTON COLLEGE                                           ","2003-2004",1,"Baseball",163905,51215,112690,163905,51215,112690,0,0,0,"34",".",16850,0
"16645",131113,"WILMINGTON COLLEGE                                          ","2003-2004",39,"Total Participants",608986,497025,111961,287284,226405,60879,321702,270620,51082,"70","58",101800,106895
"14484",227757,"RICE UNIVERSITY                                             ","2003-2004",26,"Volleyball",974584,862709,111875,0,0,0,974584,862709,111875,".","18",0,129748
"12821",212984,"HOLY FAMILY UNIVERSITY                                      ","2003-2004",25,"Track and Field, X-Country",150000,38724,111276,75000,20412,54588,75000,18312,56688,"6","6",1412,1312
"3300",221856,"TENNESSEE TEMPLE UNIVERSITY                                 ","2003-2004",2,"Basketball",334786,224006,110780,226875,135154,91721,107911,88852,19059,"15","12",22154,17852
"2121",164562,"ASSUMPTION COLLEGE                                          ","2003-2004",2,"Basketball",980477,870509,109968,483138,442924,40214,497339,427585,69754,"15","15",24850,24650
"4844",198561,"GARDNER-WEBB UNIVERSITY                                     ","2003-2004",7,"Football",1745091,1635497,109594,1745091,1635497,109594,0,0,0,"78",".",211187,0
"16363",225070,"GRAYSON COUNTY COLLEGE                                      ","2003-2004",39,"Total Participants",386178,276589,109589,164896,120470,44426,221282,156119,65163,"42","56",59270,61759
"16884",230737,"UTAH VALLEY STATE COLLEGE                                   ","2003-2004",39,"Total Participants",1327879,1218763,109116,595280,553223,42057,732599,665540,67059,"169","148",242098,158029
"15427",167996,"STONEHILL COLLEGE                                           ","2003-2004",39,"Total Participants",688646,579779,108867,285393,249701,35692,403253,330078,73175,"232","227",216045,219014
"15454",161086,"COLBY COLLEGE                                               ","2003-2004",39,"Total Participants",874697,765897,108800,383201,343919,39282,491496,421978,69518,"372","314",392848,441292
"7328",111434,"CANADA COLLEGE                                              ","2003-2004",15,"Soccer",111000,3420,107580,60000,1800,58200,51000,1620,49380,"20","17",6000,4335
"16604",218645,"UNIVERSITY OF SOUTH CAROLINA-AIKEN                          ","2003-2004",39,"Total Participants",1326958,1221160,105798,704509,650656,53853,622449,570504,51945,"98","86",135467,111583
"7607",218238,"LIMESTONE COLLEGE                                           ","2003-2004",15,"Soccer",144440,38802,105638,78390,20219,58171,66050,18583,47467,"18","14",20160,16880
"3019",204857,"OHIO UNIVERSITY-MAIN CAMPUS                                 ","2003-2004",2,"Basketball",1817401,1713201,104200,1054793,981914,72879,762608,731287,31321,"14","14",140219,96637
"1456",188429,"ADELPHI UNIVERSITY                                          ","2003-2004",1,"Baseball",252237,148206,104031,252237,148206,104031,0,0,0,"33",".",69851,0
"3711",192448,"LONG ISLAND UNIVERSITY-C W POST CAMPUS                      ","2003-2004",3,"All Track Combined",347737,243819,103918,191262,110941,80321,156475,132878,23597,"66","44",20761,20761
"14552",169910,"FERRIS STATE UNIVERSITY                                     ","2003-2004",26,"Volleyball",282231,178516,103715,0,0,0,282231,178516,103715,".","12",0,91092
"4755",234155,"VIRGINIA STATE UNIVERSITY                                   ","2003-2004",7,"Football",672692,569387,103305,672692,569387,103305,0,0,0,"107",".",79132,0
"17198",218441,"NORTH GREENVILLE COLLEGE                                    ","2003-2004",39,"Total Participants",192490,89320,103170,98195,51573,46622,94295,37747,56548,"194","92",141054,51493
"4685",188641,"ALFRED UNIVERSITY                                           ","2003-2004",7,"Football",384856,282054,102802,384856,282054,102802,0,0,0,"75",".",74400,0
"8581",137546,"STETSON UNIVERSITY                                          ","2003-2004",16,"Softball",753452,650847,102605,0,0,0,753452,650847,102605,".","18",0,67371
"7635",215099,"PHILADELPHIA UNIVERSITY                                     ","2003-2004",15,"Soccer",570364,468005,102359,285455,248427,37028,284909,219578,65331,"26","24",16350,16350
"17120",142559,"COLLEGE OF SOUTHERN IDAHO                                   ","2003-2004",39,"Total Participants",398184,296250,101934,195192,157550,37642,202992,138700,64292,"47","37",354800,266700
"16963",204635,"OHIO NORTHERN UNIVERSITY                                    ","2003-2004",39,"Total Participants",743732,642512,101220,393431,333396,60035,350301,309116,41185,"404","243",243435,168100
"16101",171599,"OLIVET COLLEGE                                              ","2003-2004",39,"Total Participants",553067,452202,100865,284407,226336,58071,268660,225866,42794,"358","126",144620,94832
"2734",182795,"FRANKLIN PIERCE COLLEGE                                     ","2003-2004",2,"Basketball",850934,750376,100558,456099,403609,52490,394835,346767,48068,"15","14",43210,35777
"1502",175980,"MILLSAPS COLLEGE                                            ","2003-2004",1,"Baseball",179369,78919,100450,179369,78919,100450,0,0,0,"30",".",30069,0
"17110",147828,"OLIVET NAZARENE UNIVERSITY                                  ","2003-2004",39,"Total Participants",1133728,1033845,99883,511761,492920,18841,621967,540925,81042,"191","105",222616,147937
"15833",102368,"TROY STATE UNIVERSITY-MAIN CAMPUS                           ","2003-2004",39,"Total Participants",2257289,2157731,99558,954792,789163,165629,1302497,1368568,-66071,"260","117",884709,297859
"8178",233277,"RADFORD UNIVERSITY                                          ","2003-2004",15,"Soccer",405105,305675,99430,208422,148207,60215,196683,157468,39215,"24","28",34207,45917
"15935",110592,"CALIFORNIA STATE UNIVERSITY-LOS ANGELES                     ","2003-2004",39,"Total Participants",1399943,1301266,98677,611580,561564,50016,788363,739702,48661,"86","132",100332,123388
"11694",169910,"FERRIS STATE UNIVERSITY                                     ","2003-2004",22,"Tennis",183181,85255,97926,87266,38331,48935,95915,46924,48991,"10","11",17858,21415
"2076",100663,"UNIVERSITY OF ALABAMA AT BIRMINGHAM                         ","2003-2004",2,"Basketball",2710494,2612695,97799,1768134,1615996,152138,942360,996699,-54339,"16","15",295334,152282
"6838",213987,"MERCYHURST COLLEGE                                          ","2003-2004",11,"Lacrosse",457070,359900,97170,291399,233350,58049,165671,126550,39121,"40","25",38100,18450
"15552",101587,"UNIVERSITY OF WEST ALABAMA                                  ","2003-2004",39,"Total Participants",611260,514393,96867,294135,244924,49211,317125,269469,47656,"168","55",217122,69614
"16233",220598,"LANE COLLEGE                                                ","2003-2004",39,"Total Participants",171360,74528,96832,78540,30207,48333,92820,44321,48499,"120","71",133972,48770
"5016",151263,"UNIVERSITY OF INDIANAPOLIS                                  ","2003-2004",7,"Football",1041168,945274,95894,1041168,945274,95894,0,0,0,"70",".",96085,0
"4892",199643,"SHAW UNIVERSITY                                             ","2003-2004",7,"Football",984068,888456,95612,984068,888456,95612,0,0,0,"52",".",146272,0
"7025",180595,"ROCKY MOUNTAIN COLLEGE                                      ","2003-2004",14,"Skiing",180140,85000,95140,90070,42500,47570,90070,42500,47570,"10","6",25872,25873
"14670",114859,"FULLERTON COLLEGE                                           ","2003-2004",27,"Water Polo",179084,84382,94702,89313,45319,43994,89771,39063,50708,"16","16",5118,5310
"4837",219718,"BETHEL COLLEGE                                              ","2003-2004",7,"Football",394664,300039,94625,394664,300039,94625,0,0,0,"52",".",165505,0
"11029",192448,"LONG ISLAND UNIVERSITY-C W POST CAMPUS                      ","2003-2004",22,"Tennis",126037,31838,94199,0,0,0,126037,31838,94199,".","8",0,5734
"9326",215062,"UNIVERSITY OF PENNSYLVANIA                                  ","2003-2004",16,"Softball",223414,129662,93752,0,0,0,223414,129662,93752,".","26",0,53913
"16741",153250,"DORDT COLLEGE                                               ","2003-2004",39,"Total Participants",600122,506622,93500,280570,230570,50000,319552,276052,43500,"119","118",61928,69911
"15256",182670,"DARTMOUTH COLLEGE                                           ","2003-2004",34,"Equestrian",137787,44741,93046,13779,16938,-3159,124008,27803,96205,".","26",1629,12494
"4551",110413,"CALIFORNIA LUTHERAN UNIVERSITY                              ","2003-2004",7,"Football",230791,137747,93044,230791,137747,93044,0,0,0,"75",".",64925,0
"471",163268,"UNIVERSITY OF MARYLAND-BALTIMORE COUNTY                     ","2003-2004",1,"Baseball",182215,89185,93030,182215,89185,93030,0,0,0,"28",".",57321,0
"4083",211158,"BLOOMSBURG UNIVERSITY OF PENNSYLVANIA                       ","2003-2004",6,"Field hocky",413700,320762,92938,0,0,0,413700,320762,92938,".","28",0,19249
"2238",139764,"GEORGIA SOUTHWESTERN STATE UNIVERSITY                       ","2003-2004",2,"Basketball",312100,219973,92127,185100,117631,67469,127000,102342,24658,"16","12",39273,33503
"4594",206048,"TIFFIN UNIVERSITY                                           ","2003-2004",7,"Football",153757,62571,91186,153757,62571,91186,0,0,0,"131",".",57112,0
"4993",152600,"VALPARAISO UNIVERSITY                                       ","2003-2004",7,"Football",583186,492009,91177,583186,492009,91177,0,0,0,"110",".",15192,0
"2838",169363,"CONCORDIA UNIVERSITY                                        ","2003-2004",2,"Basketball",393663,302600,91063,204703,151300,53403,188960,151300,37660,"20","23",21000,21000
"2368",114859,"FULLERTON COLLEGE                                           ","2003-2004",2,"Basketball",189695,98932,90763,95225,43198,52027,94470,55734,38736,"13","10",6647,9930
"1765",227526,"PRAIRIE VIEW A &amp; M UNIVERSITY                               ","2003-2004",2,"Basketball",585040,495046,89994,442438,283684,158754,142602,211362,-68760,"12","14",243185,155145
"719",228723,"TEXAS A &amp; M UNIVERSITY                                      ","2003-2004",1,"Baseball",1423324,1333763,89561,1423324,1333763,89561,0,0,0,"40",".",347404,0
"3069",230807,"WESTMINSTER COLLEGE                                         ","2003-2004",2,"Basketball",253422,163939,89483,149321,97209,52112,104101,66730,37371,"17","12",97206,66732
"4447",176169,"NORTHEAST MISSISSIPPI COMMUNITY COLLEGE                     ","2003-2004",7,"Football",260434,171216,89218,260434,171216,89218,0,0,0,"55",".",27350,0
"1124",179566,"SOUTHWEST MISSOURI STATE UNIVERSITY                         ","2003-2004",1,"Baseball",869379,780199,89180,869379,780199,89180,0,0,0,"31",".",116600,0
"4827",159717,"MCNEESE STATE UNIVERSITY                                    ","2003-2004",7,"Football",1687222,1598319,88903,1687222,1598319,88903,0,0,0,"111",".",320014,0
"2752",131520,"HOWARD UNIVERSITY                                           ","2003-2004",2,"Basketball",1333484,1244768,88716,685430,608696,76734,648054,636072,11982,"13","17",111850,103887
"3246",225070,"GRAYSON COUNTY COLLEGE                                      ","2003-2004",2,"Basketball",257901,169200,88701,127236,84600,42636,130665,84600,46065,"16","16",21500,21500
"15547",207306,"NORTHWESTERN OKLAHOMA STATE UNIVERSITY                      ","2003-2004",39,"Total Participants",286680,199673,87007,119636,78730,40906,167044,120943,46101,"200","88",71023,60650
"3022",207582,"ORAL ROBERTS UNIVERSITY                                     ","2003-2004",2,"Basketball",1985221,1898941,86280,1103042,1019250,83792,882179,879691,2488,"13","14",232294,207439
"923",155089,"FRIENDS UNIVERSITY                                          ","2003-2004",1,"Baseball",194212,107993,86219,194212,107993,86219,0,0,0,"52",".",61272,0
"6497",169910,"FERRIS STATE UNIVERSITY                                     ","2003-2004",10,"Ice Hockey",759066,672854,86212,759066,672854,86212,0,0,0,"28",".",233307,0
"1825",184603,"FAIRLEIGH DICKINSON UNIVERSITY-METROPOLITAN CAMPUS          ","2003-2004",2,"Basketball",1345980,1260119,85861,774511,695214,79297,571469,564905,6564,"15","13",93557,73785
"4985",107983,"SOUTHERN ARKANSAS UNIVERSITY MAIN CAMPUS                    ","2003-2004",7,"Football",312528,227041,85487,312528,227041,85487,0,0,0,"97",".",123158,0
"3032",219976,"DAVID LIPSCOMB UNIVERSITY                                   ","2003-2004",2,"Basketball",1760878,1675820,85058,934884,910311,24573,825994,765509,60485,"15","15",170031,153577
"8430",227757,"RICE UNIVERSITY                                             ","2003-2004",15,"Soccer",745943,661198,84745,0,0,0,745943,661198,84745,".","26",0,158217
"14390",212984,"HOLY FAMILY UNIVERSITY                                      ","2003-2004",26,"Volleyball",142573,57857,84716,0,0,0,142573,57857,84716,".","8",0,9312
"17183",114813,"FRESNO PACIFIC UNIVERSITY                                   ","2003-2004",39,"Total Participants",437566,352874,84692,158200,128458,29742,279366,224416,54950,"50","67",123426,151464
"12797",169910,"FERRIS STATE UNIVERSITY                                     ","2003-2004",25,"Track and Field, X-Country",237600,152924,84676,92976,76462,16514,144624,76462,68162,"38","48",31278,31278
"15682",123563,"SOLANO COUNTY COMMUNITY COLLEGE DISTRICT                    ","2003-2004",39,"Total Participants",223214,138580,84634,91375,51552,39823,131839,87028,44811,"137","70",49050,39092
"4334",177940,"LINCOLN UNIVERSITY                                          ","2003-2004",7,"Football",427608,343100,84508,427608,343100,84508,0,0,0,"90",".",128507,0
"247",141334,"STATE UNIVERSITY OF WEST GEORGIA                            ","2003-2004",1,"Baseball",198456,114180,84276,198456,114180,84276,0,0,0,"39",".",39987,0
"3417",240329,"UNIVERSITY OF WISCONSIN-LA CROSSE                           ","2003-2004",2,"Basketball",173722,89528,84194,82262,32231,50031,91460,57297,34163,"18","17",25519,24745
"4593",240329,"UNIVERSITY OF WISCONSIN-LA CROSSE                           ","2003-2004",7,"Football",216475,132715,83760,216475,132715,83760,0,0,0,"99",".",85231,0
"1667",102368,"TROY STATE UNIVERSITY-MAIN CAMPUS                           ","2003-2004",2,"Basketball",1211080,1127605,83475,690308,650812,39496,520772,476793,43979,"13","13",131388,90600
"14872",215284,"UNIVERSITY OF PITTSBURGH-JOHNSTOWN                          ","2003-2004",28,"Wrestling",237895,154493,83402,237895,154493,83402,0,0,0,"42",".",29284,0
"6553",215062,"UNIVERSITY OF PENNSYLVANIA                                  ","2003-2004",11,"Lacrosse",526630,443391,83239,275254,251873,23381,251376,191518,59858,"39","27",88663,59813
"6818",212577,"FRANKLIN AND MARSHALL COLLEGE                               ","2003-2004",11,"Lacrosse",211501,128321,83180,134349,75838,58511,77152,52483,24669,"43","21",16313,13971
"4914",180461,"MONTANA STATE UNIVERSITY-BOZEMAN                            ","2003-2004",7,"Football",3232050,3150482,81568,3232050,3150482,81568,0,0,0,"89",".",436798,0
"16327",110486,"CALIFORNIA STATE UNIVERSITY-BAKERSFIELD                     ","2003-2004",39,"Total Participants",1708903,1627339,81564,671224,627727,43497,1037679,999612,38067,"123","222",192632,228158
"14786",219949,"CUMBERLAND UNIVERSITY                                       ","2003-2004",28,"Wrestling",267977,186483,81494,267977,186483,81494,0,0,0,"11","0",12773,0
"7734",229179,"TEXAS WOMAN'S UNIVERSITY                                    ","2003-2004",15,"Soccer",80606,0,80606,0,0,0,80606,112167,-31561,".","20",0,39114
"278",102368,"TROY STATE UNIVERSITY-MAIN CAMPUS                           ","2003-2004",1,"Baseball",470830,390278,80552,470830,390278,80552,0,0,0,"43",".",89796,0
"16138",168546,"ALBION COLLEGE                                              ","2003-2004",39,"Total Participants",591131,510615,80516,253779,221000,32779,337352,289615,47737,"318","227",237903,148209
"2381",155089,"FRIENDS UNIVERSITY                                          ","2003-2004",2,"Basketball",290356,209986,80370,168805,121919,46886,121551,88067,33484,"20","14",37575,23121
"6420",190099,"COLGATE UNIVERSITY                                          ","2003-2004",10,"Ice Hockey",1943367,1863653,79714,1206114,1148575,57539,737253,715078,22175,"23","23",170234,101520
"7021",182670,"DARTMOUTH COLLEGE                                           ","2003-2004",14,"Skiing",469461,390379,79082,247824,207166,40658,221637,183213,38424,"18","26",74735,70503
"15377",182670,"DARTMOUTH COLLEGE                                           ","2003-2004",36,"Sailing",251264,173005,78259,125632,84179,41453,125632,88826,36806,".","43",30206,34738
"1613",191241,"FORDHAM UNIVERSITY                                          ","2003-2004",2,"Basketball",2923006,2844772,78234,1583794,1504956,78838,1339212,1339816,-604,"17","16",228479,191120
"16094",146348,"KANKAKEE COMMUNITY COLLEGE                                  ","2003-2004",39,"Total Participants",193000,115103,77897,103000,65659,37341,90000,49444,40556,"50","44",78128,49399
"16836",163912,"ST MARY'S COLLEGE OF MARYLAND                               ","2003-2004",39,"Total Participants",591909,514182,77727,308242,267383,40859,283667,246799,36868,"125","137",80950,88150
"2980",151111,"INDIANA UNIVERSITY-PURDUE UNIVERSITY-INDIANAPOLIS           ","2003-2004",2,"Basketball",161666,84303,77363,134961,55845,79116,26705,28458,-1753,"16","13",42092,20194
"16311",198507,"ELIZABETH CITY STATE UNIVERSITY                             ","2003-2004",39,"Total Participants",207590,130336,77254,89199,51945,37254,118391,78391,40000,"123","63",220741,101364
"16740",237783,"SALEM INTERNATIONAL UNIVERSITY                              ","2003-2004",39,"Total Participants",390086,313201,76885,201751,163838,37913,188335,149363,38972,"118","82",114085,89884
"16748",240189,"UNIVERSITY OF WISCONSIN-WHITEWATER                          ","2003-2004",39,"Total Participants",738424,661890,76534,333371,294866,38505,405053,367024,38029,"348","274",244478,185925
"1011",111434,"CANADA COLLEGE                                              ","2003-2004",1,"Baseball",81000,4500,76500,81000,4500,76500,0,0,0,"27",".",10935,0
"2323",122931,"SANTA CLARA UNIVERSITY                                      ","2003-2004",2,"Basketball",1740924,1665279,75645,1024226,936590,87636,716698,728689,-11991,"14","13",107813,99442
"3015",235097,"EASTERN WASHINGTON UNIVERSITY                               ","2003-2004",2,"Basketball",1220347,1145180,75167,860038,658239,201799,360309,486941,-126632,"13","13",169048,149597
"16886",148496,"DOMINICAN UNIVERSITY                                        ","2003-2004",39,"Total Participants",223656,148752,74904,106023,72828,33195,117633,75924,41709,"82","75",50922,51242
"3183",212984,"HOLY FAMILY UNIVERSITY                                      ","2003-2004",2,"Basketball",401000,326101,74899,200500,163751,36749,200500,162350,38150,"13","11",17209,20614
"16261",207582,"ORAL ROBERTS UNIVERSITY                                     ","2003-2004",39,"Total Participants",3511974,3437080,74894,1727400,1677527,49873,1784574,1759553,25021,"126","106",609202,467445
"3496",233277,"RADFORD UNIVERSITY                                          ","2003-2004",3,"All Track Combined",375207,300611,74596,201180,161114,40066,174027,139497,34530,"67","61",47474,46901
"15508",163462,"MOUNT SAINT MARYS COLLEGE                                   ","2003-2004",39,"Total Participants",1792095,1717544,74551,937300,894711,42589,854795,822833,31962,"170","131",346628,272295
"4880",180106,"CARROLL COLLEGE                                             ","2003-2004",7,"Football",925719,851245,74474,925719,851245,74474,0,0,0,"94",".",217092,0
"10335",202763,"THE UNIVERSITY OF FINDLAY                                   ","2003-2004",18,"Swimming and Diving",157736,83307,74429,73287,42584,30703,84449,40723,43726,"6","17",5903,16276
"4438",220589,"LAMBUTH UNIVERSITY                                          ","2003-2004",7,"Football",493143,418898,74245,493143,418898,74245,0,0,0,"90",".",109227,0
"17299",132657,"LYNN UNIVERSITY                                             ","2003-2004",39,"Total Participants",2093132,2019188,73944,919505,874290,45215,1173627,1144898,28729,"86","84",183574,194121
"7896",157632,"SAINT CATHARINE COLLEGE                                     ","2003-2004",15,"Soccer",94592,21056,73536,59611,10726,48885,34981,10330,24651,"22","13",9000,6000
"16855",122728,"SAN JOSE CHRISTIAN COLLEGE                                  ","2003-2004",39,"Total Participants",171223,97731,73492,121209,59207,62002,50014,38524,11490,"25","17",26820,26820
"16187",230807,"WESTMINSTER COLLEGE                                         ","2003-2004",39,"Total Participants",220516,147323,73193,130986,87595,43391,89530,59728,29802,"55","35",184804,126460
"17129",219976,"DAVID LIPSCOMB UNIVERSITY                                   ","2003-2004",39,"Total Participants",2149851,2076968,72883,1069852,1011008,58844,1079999,1065960,14039,"113","138",426081,411416
"1730",177214,"DRURY UNIVERSITY                                            ","2003-2004",2,"Basketball",566525,494011,72514,233956,207579,26377,332569,286432,46137,"14","12",118512,140546
"5364",152363,"SAINT JOSEPHS COLLEGE                                       ","2003-2004",8,"Golf",90889,18528,72361,45444,9331,36113,45445,9197,36248,"10","7",5843,5644
"4760",239716,"SAINT NORBERT COLLEGE                                       ","2003-2004",7,"Football",331710,259356,72354,331710,259356,72354,0,0,0,"117",".",138369,0
"10011",169910,"FERRIS STATE UNIVERSITY                                     ","2003-2004",16,"Softball",173519,101260,72259,0,0,0,173519,101260,72259,".","22",0,55186
"4316",222178,"ABILENE CHRISTIAN UNIVERSITY                                ","2003-2004",7,"Football",1252786,1180879,71907,1252786,1180879,71907,0,0,0,"98",".",89538,0
"1005",218238,"LIMESTONE COLLEGE                                           ","2003-2004",1,"Baseball",110700,38829,71871,110700,38829,71871,0,0,0,"60",".",32000,0
"11704",152363,"SAINT JOSEPHS COLLEGE                                       ","2003-2004",22,"Tennis",92564,21211,71353,46282,10187,36095,46282,11024,35258,"10","7",3951,4954
"8653",114859,"FULLERTON COLLEGE                                           ","2003-2004",16,"Softball",112146,40801,71345,0,0,0,112146,40801,71345,".","18",0,16553
"4682",152992,"BRIAR CLIFF UNIVERSITY                                      ","2003-2004",7,"Football",591123,519824,71299,591123,519824,71299,0,0,0,"61",".",41805,0
"2421",132657,"LYNN UNIVERSITY                                             ","2003-2004",2,"Basketball",622717,551575,71142,342511,297189,45322,280206,254386,25820,"11","12",30979,31034
"13100",178420,"UNIVERSITY OF MISSOURI-ST LOUIS                             ","2003-2004",26,"Volleyball",88560,17433,71127,0,0,0,88560,17433,71127,".","10",0,11625
"2516",213349,"KUTZTOWN UNIVERSITY OF PENNSYLVANIA                         ","2003-2004",2,"Basketball",535364,464325,71039,245093,215047,30046,290271,249278,40993,"15","15",23340,20286
"16729",189848,"CAZENOVIA COLLEGE                                           ","2003-2004",39,"Total Participants",405005,333991,71014,138612,126120,12492,266393,207871,58522,"90","190",160002,233228
"15697",212115,"EAST STROUDSBURG UNIVERSITY OF PENNSYLVANIA                 ","2003-2004",39,"Total Participants",1176641,1105911,70730,495063,485782,9281,681578,620129,61449,"290","274",204513,129767
"1836",237312,"UNIVERSITY OF CHARLESTON                                    ","2003-2004",2,"Basketball",288079,217648,70431,172268,130534,41734,115811,87114,28697,"17","17",33372,18759
"496",121150,"PEPPERDINE UNIVERSITY                                       ","2003-2004",1,"Baseball",1063644,993252,70392,1063644,993252,70392,0,0,0,"33",".",182448,0
"5693",230038,"BRIGHAM YOUNG UNIVERSITY                                    ","2003-2004",8,"Golf",639966,570190,69776,351421,273198,78223,288545,296992,-8447,"10","11",49721,51680
"7500",213987,"MERCYHURST COLLEGE                                          ","2003-2004",15,"Soccer",591200,521522,69678,293798,256484,37314,297402,265038,32364,"26","26",21000,22500
"5095",153366,"GRACELAND UNIVERSITY-LAMONI                                 ","2003-2004",7,"Football",662057,592438,69619,662057,592438,69619,0,0,0,"83",".",89421,0
"2642",122728,"SAN JOSE CHRISTIAN COLLEGE                                  ","2003-2004",2,"Basketball",177094,107551,69543,116490,60110,56380,60604,47441,13163,"10","10",13410,13410
"7679",194091,"NEW YORK INSTITUTE OF TECHNOLOGY-OLD WESTBURY               ","2003-2004",15,"Soccer",389660,320150,69510,195810,202745,-6935,193850,117405,76445,"24","22",20845,15057
"17180",214175,"MUHLENBERG COLLEGE                                          ","2003-2004",39,"Total Participants",368544,299264,69280,176064,127069,48995,192480,172195,20285,"352","221",212891,168729
"294",133526,"EDWARD WATERS COLLEGE                                       ","2003-2004",1,"Baseball",119102,49931,69171,119102,49931,69171,0,0,0,"26",".",40931,0
"3721",133951,"FLORIDA INTERNATIONAL UNIVERSITY                            ","2003-2004",3,"All Track Combined",452526,383841,68685,171768,158501,13267,280758,225340,55418,"85","67",52146,61087
"2876",154101,"NORTHWESTERN COLLEGE                                        ","2003-2004",2,"Basketball",349445,281097,68348,188786,151672,37114,160659,129425,31234,"25","17",35306,26453
"16733",158431,"BOSSIER PARISH COMMUNITY COLLEGE                            ","2003-2004",39,"Total Participants",280481,212334,68147,124380,89093,35287,156101,123241,32860,"45","32",43555,38338
"6678",182795,"FRANKLIN PIERCE COLLEGE                                     ","2003-2004",11,"Lacrosse",181011,112968,68043,82483,53370,29113,98528,59598,38930,"26","22",20894,23503
"13887",213987,"MERCYHURST COLLEGE                                          ","2003-2004",26,"Volleyball",365088,297190,67898,155611,119127,36484,209477,178063,31414,"16","18",17750,18100
"9674",102049,"SAMFORD UNIVERSITY                                          ","2003-2004",16,"Softball",448021,380477,67544,0,0,0,448021,380477,67544,".","15",0,55218
"6940",235316,"GONZAGA UNIVERSITY                                          ","2003-2004",13,"Rowing",488207,420835,67372,170001,174558,-4557,318206,246277,71929,"29","66",76587,43974
"3940",240329,"UNIVERSITY OF WISCONSIN-LA CROSSE                           ","2003-2004",3,"All Track Combined",209066,141791,67275,118840,78190,40650,90226,63601,26625,"114","125",59832,57428
"3051",147828,"OLIVET NAZARENE UNIVERSITY                                  ","2003-2004",2,"Basketball",507479,440268,67211,290973,261175,29798,216506,179093,37413,"15","16",56759,27037
"16195",183239,"SAINT ANSELM COLLEGE                                        ","2003-2004",39,"Total Participants",598910,533088,65822,387463,346893,40570,211447,186195,25252,"237","127",269561,162869
"7970",117946,"LOYOLA MARYMOUNT UNIVERSITY                                 ","2003-2004",15,"Soccer",1390874,1325171,65703,701962,649853,52109,688912,675318,13594,"29","31",98696,86666
"7208",188429,"ADELPHI UNIVERSITY                                          ","2003-2004",15,"Soccer",519096,453519,65577,270456,255698,14758,248640,197821,50819,"23","29",38450,44181
"4580",178387,"MISSOURI WESTERN STATE COLLEGE                              ","2003-2004",7,"Football",822573,757081,65492,822573,757081,65492,0,0,0,"124",".",80234,0
"16551",152992,"BRIAR CLIFF UNIVERSITY                                      ","2003-2004",39,"Total Participants",1414723,1349353,65370,770002,746382,23620,644721,602971,41750,"205","121",133793,108816
"11197",433660,"FLORIDA GULF COAST UNIVERSITY                               ","2003-2004",22,"Tennis",206812,141515,65297,117562,56050,61512,89250,85465,3785,"11","17",16500,18000
"2905",201548,"CAPITAL UNIVERSITY                                          ","2003-2004",2,"Basketball",248805,183792,65013,139294,90747,48547,109511,93045,16466,"16","18",36491,25016
"16902",107983,"SOUTHERN ARKANSAS UNIVERSITY MAIN CAMPUS                    ","2003-2004",39,"Total Participants",303074,238147,64927,146471,109388,37083,156603,128759,27844,"184","80",237400,130222
"15501",197133,"VASSAR COLLEGE                                              ","2003-2004",39,"Total Participants",1031797,966874,64923,482040,450158,31882,549757,516716,33041,"183","191",158001,188311
"3140",160621,"SOUTHERN UNIVERSITY AND A &amp; M COLLEGE                       ","2003-2004",2,"Basketball",210009,145275,64734,136733,71999,64734,73276,73276,0,"13","13",5538,5234
"17203",243151,"UNIVERSITY OF PUERTO RICO-CAYEY UNIVERSITY COLLEGE          ","2003-2004",39,"Total Participants",316840,253095,63745,167710,145051,22659,149130,108044,41086,"75","62",33575,29335
"6872",122612,"UNIVERSITY OF SAN FRANCISCO                                 ","2003-2004",12,"Rifle",102154,38420,63734,48687,19210,29477,53467,19210,34257,"4","5",17810,17810
"13799",232557,"LIBERTY UNIVERSITY                                          ","2003-2004",26,"Volleyball",160209,96518,63691,0,0,0,160209,96518,63691,".","14",0,74121
"15859",140951,"SAVANNAH COLLEGE OF ART AND DESIGN                          ","2003-2004",39,"Total Participants",2878825,2815234,63591,825699,808609,17090,2053126,2006625,46501,"102","146",365401,601174
"5011",216038,"SLIPPERY ROCK UNIVERSITY OF PENNSYLVANIA                    ","2003-2004",7,"Football",647302,583912,63390,647302,583912,63390,0,0,0,"86",".",77983,0
"2947",140696,"OGLETHORPE UNIVERSITY                                       ","2003-2004",2,"Basketball",126332,63000,63332,64345,31500,32845,61987,31500,30487,"18","15",25844,21341
"4587",175980,"MILLSAPS COLLEGE                                            ","2003-2004",7,"Football",308063,244731,63332,308063,244731,63332,0,0,0,"70",".",121731,0
"233",102049,"SAMFORD UNIVERSITY                                          ","2003-2004",1,"Baseball",527677,464606,63071,527677,464606,63071,0,0,0,"26",".",83629,0
"2984",133650,"FLORIDA AGRICULTURAL AND MECHANICAL UNIVERSITY              ","2003-2004",2,"Basketball",307921,244860,63061,293551,134064,159487,14370,110796,-96426,"18","14",108864,91161
"15674",110574,"CALIFORNIA STATE UNIVERSITY-HAYWARD                         ","2003-2004",39,"Total Participants",944095,881098,62997,331604,305622,25982,612491,575476,37015,"77","104",178467,255296
"13",126119,"YUBA COLLEGE                                                ","2003-2004",1,"Baseball",95000,32180,62820,95000,32180,62820,0,0,0,"25",".",20680,0
"15432",120342,"ORANGE COAST COLLEGE                                        ","2003-2004",39,"Total Participants",633551,570768,62783,326132,307973,18159,307419,262795,44624,"332","179",347134,241374
"11119",235316,"GONZAGA UNIVERSITY                                          ","2003-2004",22,"Tennis",292150,229959,62191,128951,101684,27267,163199,128275,34924,"9","12",41155,28727
"11843",198561,"GARDNER-WEBB UNIVERSITY                                     ","2003-2004",23,"Track and Field, Indoor",212129,150000,62129,85129,42000,43129,127000,108000,19000,"15","19",3641,3330
"7705",122728,"SAN JOSE CHRISTIAN COLLEGE                                  ","2003-2004",15,"Soccer",121209,59207,62002,121209,59207,62002,0,0,0,"15",".",13410,0
"2729",153472,"INDIAN HILLS COMMUNITY COLLEGE                              ","2003-2004",2,"Basketball",276935,215049,61886,276935,215049,61886,0,0,0,"12",".",57996,0
"6491",186131,"PRINCETON UNIVERSITY                                        ","2003-2004",10,"Ice Hockey",996579,934711,61868,589980,515029,74951,406599,419682,-13083,"28","22",203457,182203
"4811",183239,"SAINT ANSELM COLLEGE                                        ","2003-2004",7,"Football",264675,202816,61859,264675,202816,61859,0,0,0,"83",".",63106,0
"15543",150756,"HANOVER COLLEGE                                             ","2003-2004",39,"Total Participants",622071,560280,61791,329332,293372,35960,292739,266908,25831,"205","101",284409,136021
"10524",192448,"LONG ISLAND UNIVERSITY-C W POST CAMPUS                      ","2003-2004",19,"Swimming",202232,140498,61734,0,0,0,202232,140498,61734,".","12",0,29811
"10325",114859,"FULLERTON COLLEGE                                           ","2003-2004",18,"Swimming and Diving",103620,42077,61543,48245,21039,27206,55375,21038,34337,"9","11",3062,3062
"2204",204945,"OWENS COMMUNITY COLLEGE                                     ","2003-2004",2,"Basketball",186939,125499,61440,109078,65529,43549,77861,59970,17891,"17","15",17052,26983
"2730",227429,"PAUL QUINN COLLEGE                                          ","2003-2004",2,"Basketball",132915,71550,61365,81327,41982,39345,51588,29568,22020,"15","15",25632,17094
"3133",126119,"YUBA COLLEGE                                                ","2003-2004",2,"Basketball",114000,52700,61300,53200,30100,23100,60800,22600,38200,"14","16",21600,14100
"10884",163338,"UNIVERSITY OF MARYLAND-EASTERN SHORE                        ","2003-2004",22,"Tennis",97382,36375,61007,49121,20953,28168,48261,15422,32839,"9","8",9617,9198
"17004",136206,"NORTHWOOD UNIVERSITY-FLORIDA EDUCATION CENTER               ","2003-2004",39,"Total Participants",1205029,1144127,60902,584143,573352,10791,620886,570775,50111,"106","68",77480,64382
"568",227757,"RICE UNIVERSITY                                             ","2003-2004",1,"Baseball",1803329,1742471,60858,1803329,1742471,60858,0,0,0,"36",".",403781,0
"13622",219949,"CUMBERLAND UNIVERSITY                                       ","2003-2004",26,"Volleyball",281864,221052,60812,0,0,0,281864,221052,60812,"0","15",0,18002
"6926",215062,"UNIVERSITY OF PENNSYLVANIA                                  ","2003-2004",13,"Rowing",248010,187293,60717,0,0,0,248010,187293,60717,".","45",0,79948
"17241",146393,"KENDALL COLLEGE                                             ","2003-2004",39,"Total Participants",197228,136862,60366,147583,100005,47578,49645,36857,12788,"43","22",37675,30015
"1870",101587,"UNIVERSITY OF WEST ALABAMA                                  ","2003-2004",2,"Basketball",411336,351336,60000,228444,188444,40000,182892,162892,20000,"12","13",43444,34023
"15609",150455,"EARLHAM COLLEGE                                             ","2003-2004",39,"Total Participants",402326,342680,59646,181582,148569,33013,220744,194111,26633,"173","134",93157,55699
"5468",433660,"FLORIDA GULF COAST UNIVERSITY                               ","2003-2004",8,"Golf",175759,116150,59609,97659,60100,37559,78100,56050,22050,"12","7",27000,31000
"6468",230959,"MIDDLEBURY COLLEGE                                          ","2003-2004",10,"Ice Hockey",423205,363834,59371,284874,225619,59255,138331,138215,116,"45","24",82181,57327
"2829",139719,"FORT VALLEY STATE UNIVERSITY                                ","2003-2004",2,"Basketball",325820,266848,58972,164410,121705,42705,161410,145143,16267,"16","15",26106,29144
"8882",133526,"EDWARD WATERS COLLEGE                                       ","2003-2004",16,"Softball",96437,37653,58784,0,0,0,96437,37653,58784,".","17",0,28653
"16236",178217,"MINERAL AREA COLLEGE                                        ","2003-2004",39,"Total Participants",277245,218729,58516,154495,120415,34080,122750,98314,24436,"44","25",52572,39565
"1048",229027,"THE UNIVERSITY OF TEXAS AT SAN ANTONIO                      ","2003-2004",1,"Baseball",513070,454699,58371,513070,454699,58371,0,0,0,"34",".",80426,0
"15857",129941,"UNIVERSITY OF NEW HAVEN                                     ","2003-2004",39,"Total Participants",1599877,1542064,57813,811114,739763,71351,788763,802301,-13538,"222","144",280255,138109
"4004",215062,"UNIVERSITY OF PENNSYLVANIA                                  ","2003-2004",5,"Fencing",209588,151856,57732,100512,70728,29784,109076,81128,27948,"20","18",28775,39126
"17043",171492,"NORTHWOOD UNIVERSITY                                        ","2003-2004",39,"Total Participants",1574080,1516388,57692,640049,606666,33383,934031,909722,24309,"301","126",235011,202066
"12134",126119,"YUBA COLLEGE                                                ","2003-2004",24,"Track and Field, Outdoor",76000,18550,57450,68400,12050,56350,7600,6500,1100,"18","2",6300,750
"6444",202763,"THE UNIVERSITY OF FINDLAY                                   ","2003-2004",10,"Ice Hockey",1098380,1041223,57157,597340,589443,7897,501040,451780,49260,"27","25",122774,54307
"16393",196130,"SUNY COLLEGE AT BUFFALO                                     ","2003-2004",39,"Total Participants",856682,799609,57073,327886,312928,14958,528796,486681,42115,"237","150",266891,240237
"15907",214591,"PENNSYLVANIA STATE UNIV-PENN ST ERIE-BEHREND COLL           ","2003-2004",39,"Total Participants",426102,369044,57058,191752,186020,5732,234350,183024,51326,"181","145",121498,128693
"16933",211431,"CARLOW COLLEGE                                              ","2003-2004",39,"Total Participants",56885,0,56885,0,0,0,56885,188796,-131911,"0","72",0,27400
"4332",207306,"NORTHWESTERN OKLAHOMA STATE UNIVERSITY                      ","2003-2004",7,"Football",320316,263712,56604,320316,263712,56604,0,0,0,"96",".",18399,0
"6466",102553,"UNIVERSITY OF ALASKA ANCHORAGE                              ","2003-2004",10,"Ice Hockey",1104585,1048051,56534,1104585,1048051,56534,0,0,0,"27",".",348142,0
"15961",173665,"HAMLINE UNIVERSITY                                          ","2003-2004",39,"Total Participants",718688,662227,56461,330057,307282,22775,388631,354945,33686,"237","173",218931,128794
"15344",227304,"ODESSA COLLEGE                                              ","2003-2004",35,"Rodeo",209386,153041,56345,159133,116311,42822,50253,36730,13523,"38",".",35017,11058
"15710",216931,"WILKES UNIVERSITY                                           ","2003-2004",39,"Total Participants",395315,339028,56287,134141,114352,19789,261174,224676,36498,"225","117",144546,83330
"4736",202763,"THE UNIVERSITY OF FINDLAY                                   ","2003-2004",7,"Football",1257839,1201595,56244,1257839,1201595,56244,0,0,0,"105",".",84954,0
"16061",229780,"WAYLAND BAPTIST UNIVERSITY                                  ","2003-2004",39,"Total Participants",661600,605400,56200,379300,340800,38500,282300,264600,17700,"75","69",182700,146900
"399",178420,"UNIVERSITY OF MISSOURI-ST LOUIS                             ","2003-2004",1,"Baseball",115773,59781,55992,115773,59781,55992,0,0,0,"28",".",45418,0
"2522",220613,"LEE UNIVERSITY                                              ","2003-2004",2,"Basketball",675643,619654,55989,373147,361646,11501,302496,258008,44488,"13","11",74088,65424
"16500",190567,"CUNY CITY COLLEGE                                           ","2003-2004",39,"Total Participants",163864,108038,55826,73035,48439,24596,90829,59599,31230,"70","72",46874,57006
"16368",179113,"SAINT LOUIS COMMUNITY COLLEGE-MERAMEC                       ","2003-2004",39,"Total Participants",133608,77826,55782,66804,38913,27891,66804,38913,27891,"86","67",11075,11855
"51",139764,"GEORGIA SOUTHWESTERN STATE UNIVERSITY                       ","2003-2004",1,"Baseball",157000,101285,55715,157000,101285,55715,0,0,0,"31",".",33581,0
"12124",113333,"DE ANZA COLLEGE                                             ","2003-2004",24,"Track and Field, Outdoor",76906,21316,55590,38453,9857,28596,38453,11459,26994,"14","10",6097,7699
"6595",194091,"NEW YORK INSTITUTE OF TECHNOLOGY-OLD WESTBURY               ","2003-2004",11,"Lacrosse",309726,254139,55587,309726,254139,55587,0,0,0,"26",".",55911,0
"1932",190099,"COLGATE UNIVERSITY                                          ","2003-2004",2,"Basketball",1690607,1635204,55403,907812,868997,38815,782795,766207,16588,"16","15",100174,111651
"16789",232609,"LYNCHBURG COLLEGE                                           ","2003-2004",39,"Total Participants",773513,718135,55378,338097,293717,44380,435416,424418,10998,"212","202",131107,161744
"5631",199148,"UNIVERSITY OF NORTH CAROLINA AT GREENSBORO                  ","2003-2004",8,"Golf",289000,233711,55289,142293,102388,39905,146707,131323,15384,"8","7",23464,29302
"16033",209065,"LINFIELD COLLEGE                                            ","2003-2004",39,"Total Participants",660366,605121,55245,305375,277136,28239,354991,327985,27006,"371","242",243648,176067
"597",233277,"RADFORD UNIVERSITY                                          ","2003-2004",1,"Baseball",209933,154893,55040,209933,154893,55040,0,0,0,"28",".",63882,0
"4575",155089,"FRIENDS UNIVERSITY                                          ","2003-2004",7,"Football",421630,366706,54924,421630,366706,54924,0,0,0,"94",".",47018,0
"4928",191515,"HAMILTON COLLEGE                                            ","2003-2004",7,"Football",279818,224986,54832,279818,224986,54832,0,0,0,"61",".",45173,0
"16564",153001,"BUENA VISTA UNIVERSITY                                      ","2003-2004",39,"Total Participants",540748,486119,54629,277208,247524,29684,263540,238595,24945,"252","138",136362,106416
"9968",218733,"SOUTH CAROLINA STATE UNIVERSITY                             ","2003-2004",16,"Softball",171766,117186,54580,0,0,0,171766,117186,54580,".","15",0,54477
"2832",207306,"NORTHWESTERN OKLAHOMA STATE UNIVERSITY                      ","2003-2004",2,"Basketball",289538,235039,54499,141312,117421,23891,148226,117618,30608,"19","15",21794,24310
"2377",151263,"UNIVERSITY OF INDIANAPOLIS                                  ","2003-2004",2,"Basketball",833523,779175,54348,405172,376669,28503,428351,402506,25845,"16","13",54651,53762
"5563",133526,"EDWARD WATERS COLLEGE                                       ","2003-2004",8,"Golf",79851,25603,54248,79851,25603,54248,0,0,0,"5",".",15603,0
"6605",190099,"COLGATE UNIVERSITY                                          ","2003-2004",11,"Lacrosse",667132,612927,54205,343968,328130,15838,323164,284797,38367,"34","20",69270,53685
"15959",191649,"HOFSTRA UNIVERSITY                                          ","2003-2004",39,"Total Participants",5705249,5651221,54028,2579335,2530331,49004,3125914,3120890,5024,"247","150",1258509,683468
"16846",198598,"GREENSBORO COLLEGE                                          ","2003-2004",39,"Total Participants",622854,568873,53981,325987,302361,23626,296867,266512,30355,"219","104",184542,112929
"2715",150941,"HUNTINGTON COLLEGE                                          ","2003-2004",2,"Basketball",343616,289699,53917,228224,183831,44393,115392,105868,9524,"13","11",36083,15791
"5656",212984,"HOLY FAMILY UNIVERSITY                                      ","2003-2004",8,"Golf",75000,21090,53910,75000,21090,53910,0,0,0,"7",".",600,0
"4802",174358,"MINNESOTA STATE UNIVERSITY-MOORHEAD                         ","2003-2004",7,"Football",376059,322308,53751,376059,322308,53751,0,0,0,"100",".",74174,0
"17152",157447,"NORTHERN KENTUCKY UNIVERSITY                                ","2003-2004",39,"Total Participants",1241613,1187868,53745,500335,504381,-4046,741278,683487,57791,"121","90",219108,259542
"1229",119216,"MT SAN JACINTO COLLEGE                                      ","2003-2004",1,"Baseball",90527,36821,53706,90527,36821,53706,0,0,0,"28",".",15585,0
"4569",148405,"ROCKFORD COLLEGE                                            ","2003-2004",7,"Football",252772,199276,53496,252772,199276,53496,0,0,0,"65",".",74707,0
"6528",166850,"MERRIMACK COLLEGE                                           ","2003-2004",10,"Ice Hockey",928692,875306,53386,928692,875306,53386,0,0,0,"27",".",127512,0
"17105",244437,"GEORGIA PERIMETER COLLEGE                                   ","2003-2004",39,"Total Participants",535276,482213,53063,267638,260016,7622,267638,222197,45441,"74","58",197414,199822
"16918",160977,"BATES COLLEGE                                               ","2003-2004",39,"Total Participants",1434833,1381839,52994,698391,664172,34219,736442,717667,18775,"371","311",362187,299355
"2519",166513,"UNIVERSITY OF MASSACHUSETTS-LOWELL                          ","2003-2004",2,"Basketball",869707,816752,52955,425318,408939,16379,444389,407813,36576,"14","11",37291,32163
"12835",201645,"CASE WESTERN RESERVE UNIVERSITY                             ","2003-2004",25,"Track and Field, X-Country",198360,145408,52952,104608,79418,25190,93752,65990,27762,"121","84",31911,29339
"16013",220631,"LINCOLN MEMORIAL UNIVERSITY                                 ","2003-2004",39,"Total Participants",1469035,1416084,52951,662234,632083,30151,806801,784001,22800,"86","77",333307,374461
"3511",153366,"GRACELAND UNIVERSITY-LAMONI                                 ","2003-2004",3,"All Track Combined",344717,291825,52892,207529,188434,19095,137188,103391,33797,"74","55",23301,15095
"15541",221096,"MOTLOW STATE COMMUNITY COLLEGE                              ","2003-2004",39,"Total Participants",173659,120873,52786,94134,62841,31293,79525,58032,21493,"64","36",37415,40158
"12049",198561,"GARDNER-WEBB UNIVERSITY                                     ","2003-2004",24,"Track and Field, Outdoor",274128,221361,52767,110000,68353,41647,164128,153008,11120,"18","19",13696,22531
"2084",207263,"NORTHEASTERN STATE UNIVERSITY                               ","2003-2004",2,"Basketball",397914,345195,52719,200319,172455,27864,197595,172740,24855,"15","12",52625,59970
"2358",106704,"UNIVERSITY OF CENTRAL ARKANSAS                              ","2003-2004",2,"Basketball",472392,419773,52619,227256,226170,1086,245136,193603,51533,"21","12",48131,31922
"10902",163453,"MORGAN STATE UNIVERSITY                                     ","2003-2004",22,"Tennis",246338,193832,52506,123169,97907,25262,123169,95925,27244,"7","8",15268,15268
"10889",119216,"MT SAN JACINTO COLLEGE                                      ","2003-2004",22,"Tennis",86308,33868,52440,11996,13126,-1130,74312,20742,53570,"6","10",5841,8615
"476",144865,"COLLEGE OF DUPAGE                                           ","2003-2004",1,"Baseball",93000,40600,52400,93000,40600,52400,0,0,0,"29",".",27500,0
"9062",213783,"MANSFIELD UNIVERSITY OF PENNSYLVANIA                        ","2003-2004",16,"Softball",129456,77173,52283,0,0,0,129456,77173,52283,".","19",0,32183
"15751",243115,"UNIVERSITY OF PUERTO RICO-ARECIBO                           ","2003-2004",39,"Total Participants",146682,94682,52000,82161,51661,30500,64521,43021,21500,"80","60",22381,11747
"2161",178341,"MISSOURI SOUTHERN STATE UNIVERSITY                          ","2003-2004",2,"Basketball",675155,623201,51954,363087,328598,34489,312068,294603,17465,"15","12",47168,40657
"2093",240268,"UNIVERSITY OF WISCONSIN-EAU CLAIRE                          ","2003-2004",2,"Basketball",231751,180015,51736,103405,92797,10608,128346,87218,41128,"18","17",37585,35693
"1877",146339,"JUDSON COLLEGE                                              ","2003-2004",2,"Basketball",302150,250455,51695,151832,134675,17157,150318,115780,34538,"14","13",23104,34095
"4924",198464,"EAST CAROLINA UNIVERSITY                                    ","2003-2004",7,"Football",5891651,5839962,51689,5891651,5839962,51689,0,0,0,"125",".",1238537,0
"2199",234155,"VIRGINIA STATE UNIVERSITY                                   ","2003-2004",2,"Basketball",527102,475488,51614,307940,258743,49197,219162,216745,2417,"16","15",52959,35637
"16859",212656,"GENEVA COLLEGE                                              ","2003-2004",39,"Total Participants",986637,935067,51570,553659,547825,5834,432978,387242,45736,"164","98",251875,100858
"1887",125028,"VENTURA COLLEGE                                             ","2003-2004",2,"Basketball",204958,153407,51551,99532,70416,29116,105426,82991,22435,"13","16",20164,41620
"16797",243106,"UNIVERSITY OF PUERTO RICO-AGUADILLA                         ","2003-2004",39,"Total Participants",97840,46312,51528,53812,25031,28781,44028,21281,22747,"93","76",11377,11573
"2615",167996,"STONEHILL COLLEGE                                           ","2003-2004",2,"Basketball",428742,377242,51500,208362,191795,16567,220380,185447,34933,"13","16",36718,45996
"3670",188641,"ALFRED UNIVERSITY                                           ","2003-2004",3,"All Track Combined",83040,31600,51440,56520,15800,40720,26520,15800,10720,"24","17",10000,7140
"13334",129941,"UNIVERSITY OF NEW HAVEN                                     ","2003-2004",26,"Volleyball",302148,250785,51363,156074,80820,75254,146074,169965,-23891,"12","13",19917,20395
"4695",217688,"CHARLESTON SOUTHERN UNIVERSITY                              ","2003-2004",7,"Football",1377249,1326002,51247,1377249,1326002,51247,0,0,0,"87",".",154660,0
"2307",202763,"THE UNIVERSITY OF FINDLAY                                   ","2003-2004",2,"Basketball",788166,737012,51154,424516,388628,35888,363650,348384,15266,"23","22",36915,32145
"10061",197133,"VASSAR COLLEGE                                              ","2003-2004",17,"Squash",120581,69499,51082,59330,34364,24966,61251,35135,26116,"15","13",10207,10978
"7610",144865,"COLLEGE OF DUPAGE                                           ","2003-2004",15,"Soccer",106875,55800,51075,51875,27600,24275,55000,28200,26800,"32","16",21875,25000
"5741",219949,"CUMBERLAND UNIVERSITY                                       ","2003-2004",8,"Golf",196788,145935,50853,143688,91581,52107,53100,54354,-1254,"8","5",10781,5917
"969",110680,"UNIVERSITY OF CALIFORNIA-SAN DIEGO                          ","2003-2004",1,"Baseball",282155,231754,50401,282155,231754,50401,0,0,0,"37",".",92837,0
"15858",178022,"MAPLE WOODS COMMUNITY COLLEGE                               ","2003-2004",39,"Total Participants",248919,198526,50393,135044,114973,20071,113875,83553,30322,"34","13",48447,43141
"3899",128391,"WESTERN STATE COLLEGE OF COLORADO                           ","2003-2004",3,"All Track Combined",405058,354808,50250,199724,188161,11563,205334,166647,38687,"132","108",41036,39356
"6900",120342,"ORANGE COAST COLLEGE                                        ","2003-2004",13,"Rowing",181720,131484,50236,93894,82216,11678,87826,49268,38558,"60","25",34091,25977
"6517",182795,"FRANKLIN PIERCE COLLEGE                                     ","2003-2004",10,"Ice Hockey",125741,75903,49838,125741,75903,49838,0,0,0,"26",".",46531,0
"11054",114859,"FULLERTON COLLEGE                                           ","2003-2004",22,"Tennis",113708,63899,49809,58685,33833,24852,55023,30066,24957,"10","9",3643,2965
"16072",195003,"ROCHESTER INSTITUTE OF TECHNOLOGY                           ","2003-2004",39,"Total Participants",773901,724097,49804,421311,375772,45539,352590,348325,4265,"249","209",249130,246891
"7091",207263,"NORTHEASTERN STATE UNIVERSITY                               ","2003-2004",15,"Soccer",221034,171258,49776,109546,86188,23358,111488,85070,26418,"26","23",20085,18125
"10571",237783,"SALEM INTERNATIONAL UNIVERSITY                              ","2003-2004",19,"Swimming",95258,45608,49650,47629,22804,24825,47629,22804,24825,"16","12",11055,11055
"16830",216694,"WAYNESBURG COLLEGE                                          ","2003-2004",39,"Total Participants",304415,254781,49634,161628,140731,20897,142787,114050,28737,"210","79",290497,127382
"17013",110680,"UNIVERSITY OF CALIFORNIA-SAN DIEGO                          ","2003-2004",39,"Total Participants",2211365,2161970,49395,1225340,1147529,77811,986025,1014441,-28416,"294","305",520688,490937
"4427",213349,"KUTZTOWN UNIVERSITY OF PENNSYLVANIA                         ","2003-2004",7,"Football",468635,419275,49360,468635,419275,49360,0,0,0,"80",".",71652,0
"2078",107983,"SOUTHERN ARKANSAS UNIVERSITY MAIN CAMPUS                    ","2003-2004",2,"Basketball",217875,168656,49219,112818,81982,30836,105057,86674,18383,"13","17",35882,35137
"840",110565,"CALIFORNIA STATE UNIVERSITY-FULLERTON                       ","2003-2004",1,"Baseball",965141,916068,49073,965141,916068,49073,0,0,0,"39",".",175119,0
"1962",179557,"SOUTHEAST MISSOURI STATE UNIVERSITY                         ","2003-2004",2,"Basketball",1360951,1312071,48880,792845,716374,76471,568106,595697,-27591,"14","12",80168,91344
"17262",127185,"FORT LEWIS COLLEGE                                          ","2003-2004",39,"Total Participants",830048,781305,48743,446992,412416,34576,383056,368889,14167,"144","78",185820,114146
"7818",120537,"HOPE INTERNATIONAL UNIVERSITY                               ","2003-2004",15,"Soccer",110573,61900,48673,51601,29220,22381,58972,32680,26292,"15","17",28720,32180
"14649",117946,"LOYOLA MARYMOUNT UNIVERSITY                                 ","2003-2004",27,"Water Polo",554205,505639,48566,274896,245315,29581,279309,260324,18985,"22","18",40028,38820
"8705",178420,"UNIVERSITY OF MISSOURI-ST LOUIS                             ","2003-2004",16,"Softball",74840,26473,48367,0,0,0,74840,26473,48367,".","15",0,19648
"4264",240268,"UNIVERSITY OF WISCONSIN-EAU CLAIRE                          ","2003-2004",7,"Football",257460,209151,48309,257460,209151,48309,0,0,0,"100",".",47309,0
"7321",146339,"JUDSON COLLEGE                                              ","2003-2004",15,"Soccer",343098,294882,48216,224950,202073,22877,118148,92809,25339,"18","14",18340,12696
"15448",191515,"HAMILTON COLLEGE                                            ","2003-2004",39,"Total Participants",1049629,1001527,48102,558073,533243,24830,491556,468284,23272,"355","277",230660,183395
"11884",191968,"ITHACA COLLEGE                                              ","2003-2004",23,"Track and Field, Indoor",131231,83135,48096,48964,51024,-2060,82267,32111,50156,"45","63",18031,25831
"1742",138354,"THE UNIVERSITY OF WEST FLORIDA                              ","2003-2004",2,"Basketball",642019,593938,48081,299009,287366,11643,343010,306572,36438,"14","12",48767,54219
"7987",215062,"UNIVERSITY OF PENNSYLVANIA                                  ","2003-2004",15,"Soccer",303085,255119,47966,120585,119355,1230,182500,135764,46736,"24","27",40064,35755
"17040",232423,"JAMES MADISON UNIVERSITY                                    ","2003-2004",39,"Total Participants",4641943,4594074,47869,1792168,1659246,132922,2849775,2934828,-85053,"379","373",962236,798496
"10071",182670,"DARTMOUTH COLLEGE                                           ","2003-2004",17,"Squash",186390,138672,47718,89468,69349,20119,96922,69323,27599,"16","13",16847,16768
"4054",212115,"EAST STROUDSBURG UNIVERSITY OF PENNSYLVANIA                 ","2003-2004",6,"Field hocky",165307,117787,47520,0,0,0,165307,117787,47520,".","30",0,17640
"3557",215284,"UNIVERSITY OF PITTSBURGH-JOHNSTOWN                          ","2003-2004",3,"All Track Combined",74492,27120,47372,0,0,0,74492,27120,47372,".","43",0,8772
"1985",143358,"BRADLEY UNIVERSITY                                          ","2003-2004",2,"Basketball",2587474,2540103,47371,1878452,1685526,192926,709022,854577,-145555,"16","15",258396,142834
"9237",138354,"THE UNIVERSITY OF WEST FLORIDA                              ","2003-2004",16,"Softball",273391,226070,47321,0,0,0,273391,226070,47321,".","20",0,51408
"16193",151801,"INDIANA WESLEYAN UNIVERSITY                                 ","2003-2004",39,"Total Participants",396218,349042,47176,172326,146162,26164,223892,202880,21012,"161","182",160708,180594
"4431",100663,"UNIVERSITY OF ALABAMA AT BIRMINGHAM                         ","2003-2004",7,"Football",5163095,5115934,47161,5163095,5115934,47161,0,0,0,"110",".",1076937,0
"1102",137847,"THE UNIVERSITY OF TAMPA                                     ","2003-2004",1,"Baseball",445850,398696,47154,445850,398696,47154,0,0,0,"59",".",93192,0
"16307",139658,"EMORY UNIVERSITY                                            ","2003-2004",39,"Total Participants",1459879,1412813,47066,706240,686474,19766,753639,726339,27300,"197","170",306782,293941
"11562",218645,"UNIVERSITY OF SOUTH CAROLINA-AIKEN                          ","2003-2004",22,"Tennis",185836,138816,47020,83832,71382,12450,102004,67434,34570,"8","7",6544,8695
"15285",189848,"CAZENOVIA COLLEGE                                           ","2003-2004",34,"Equestrian",142789,95859,46930,17896,7996,9900,124893,87863,37030,"4","83",7896,87663
"2620",150163,"BUTLER UNIVERSITY                                           ","2003-2004",2,"Basketball",1952063,1905263,46800,1100772,1053972,46800,851291,851291,0,"14","20",186137,131344
"15528",209056,"LEWIS &amp; CLARK COLLEGE                                       ","2003-2004",39,"Total Participants",790238,743473,46765,296918,288003,8915,493320,455470,37850,"154","190",216877,194494
"4418",237950,"WEST VIRGINIA UNIVERSITY INSTITUTE OF TECHNOLOGY            ","2003-2004",7,"Football",213153,166540,46613,213153,166540,46613,0,0,0,"83",".",62151,0
"875",229780,"WAYLAND BAPTIST UNIVERSITY                                  ","2003-2004",1,"Baseball",215600,169000,46600,215600,169000,46600,0,0,0,"27",".",64700,0
"2603",211440,"CARNEGIE MELLON UNIVERSITY                                  ","2003-2004",2,"Basketball",352768,306199,46569,196767,162567,34200,156001,143632,12369,"20","12",73641,64507
"15338",182564,"WESTERN NEVADA COMMUNITY COLLEGE                            ","2003-2004",35,"Rodeo",46560,0,46560,46560,46560,0,0,0,0,"8",".",30960,0
"17188",182564,"WESTERN NEVADA COMMUNITY COLLEGE                            ","2003-2004",39,"Total Participants",46560,0,46560,46560,46560,0,0,0,0,"8","0",30960,0
"4313",178341,"MISSOURI SOUTHERN STATE UNIVERSITY                          ","2003-2004",7,"Football",891997,845537,46460,891997,845537,46460,0,0,0,"89",".",70355,0
"5321",128106,"COLORADO STATE UNIVERSITY-PUEBLO                            ","2003-2004",8,"Golf",84497,38114,46383,84497,38114,46383,0,0,0,"20",".",17270,0
"5073",227429,"PAUL QUINN COLLEGE                                          ","2003-2004",7,"Football",196327,150152,46175,196327,150152,46175,0,0,0,"70",".",83867,0
"8019",221971,"UNION UNIVERSITY                                            ","2003-2004",15,"Soccer",242025,195862,46163,242025,195862,46163,0,0,0,"23",".",45329,0
"4469",199582,"SAINT AUGUSTINES COLLEGE                                    ","2003-2004",7,"Football",827830,781686,46144,827830,781686,46144,0,0,0,"70",".",123412,0
"16279",143084,"AUGUSTANA COLLEGE                                           ","2003-2004",39,"Total Participants",719046,673253,45793,379840,355233,24607,339206,318020,21186,"359","229",222593,127138
"516",227243,"NORTHWOOD UNIVERSITY                                        ","2003-2004",1,"Baseball",332046,286313,45733,332046,286313,45733,0,0,0,"30",".",51773,0
"16998",213367,"LA SALLE UNIVERSITY                                         ","2003-2004",39,"Total Participants",3461421,3415800,45621,1410446,1394782,15664,2050975,2021018,29957,"240","233",617307,440098
"12623",151263,"UNIVERSITY OF INDIANAPOLIS                                  ","2003-2004",25,"Track and Field, X-Country",485314,439705,45609,273790,250772,23018,211524,188933,22591,"56","58",33063,30990
"17174",148256,"REND LAKE COLLEGE                                           ","2003-2004",39,"Total Participants",468826,423276,45550,278664,243602,35062,190162,179674,10488,"142","60",155509,84855
"14526",232937,"NORFOLK STATE UNIVERSITY                                    ","2003-2004",26,"Volleyball",137268,91867,45401,0,0,0,137268,91867,45401,".","13",0,81640
"15612",194091,"NEW YORK INSTITUTE OF TECHNOLOGY-OLD WESTBURY               ","2003-2004",39,"Total Participants",1646528,1601149,45379,1066592,1091138,-24546,579936,510011,69925,"119","61",207161,86870
"15617",126678,"COLORADO COLLEGE                                            ","2003-2004",39,"Total Participants",3039471,2994099,45372,2442454,1851657,590797,597017,1142442,-545425,"211","190",632515,301715
"6430",195003,"ROCHESTER INSTITUTE OF TECHNOLOGY                           ","2003-2004",10,"Ice Hockey",187586,142320,45266,136967,91701,45266,50619,50619,0,"26","25",52191,39589
"16607",130226,"QUINNIPIAC UNIVERSITY                                       ","2003-2004",39,"Total Participants",5281732,5236471,45261,2456018,2390321,65697,2825714,2846150,-20436,"246","217",824142,766376
"6735",188429,"ADELPHI UNIVERSITY                                          ","2003-2004",11,"Lacrosse",541510,496290,45220,312823,295089,17734,228687,201201,27486,"32","25",34485,25907
"7029",180461,"MONTANA STATE UNIVERSITY-BOZEMAN                            ","2003-2004",14,"Skiing",386574,341592,44982,102586,88675,13911,283988,252917,31071,"8","21",15408,64460
"9798",207689,"SAINT GREGORYS UNIVERSITY                                   ","2003-2004",16,"Softball",235800,190829,44971,0,0,0,235800,190829,44971,".","20",0,12536
"13321",133526,"EDWARD WATERS COLLEGE                                       ","2003-2004",26,"Volleyball",64768,20182,44586,0,0,0,64768,20182,44586,".","15",0,14182
"1946",179326,"SOUTHWEST BAPTIST UNIVERSITY                                ","2003-2004",2,"Basketball",710107,665562,44545,362408,350218,12190,347699,315344,32355,"16","14",46224,48502
"1424",225070,"GRAYSON COUNTY COLLEGE                                      ","2003-2004",1,"Baseball",164896,120470,44426,164896,120470,44426,0,0,0,"26",".",37770,0
"6903",213367,"LA SALLE UNIVERSITY                                         ","2003-2004",13,"Rowing",163253,118967,44286,71412,56356,15056,91841,62611,29230,"12","42",15391,18778
"12685",180461,"MONTANA STATE UNIVERSITY-BOZEMAN                            ","2003-2004",25,"Track and Field, X-Country",147640,103401,44239,65927,49360,16567,81713,54041,27672,"11","13",9705,8303
"9614",169363,"CONCORDIA UNIVERSITY                                        ","2003-2004",16,"Softball",181074,136900,44174,0,0,0,181074,136900,44174,".","23",0,19000
"8700",218238,"LIMESTONE COLLEGE                                           ","2003-2004",16,"Softball",73250,29261,43989,0,0,0,73250,29261,43989,".","16",0,26800
"4777",230959,"MIDDLEBURY COLLEGE                                          ","2003-2004",7,"Football",320565,276674,43891,320565,276674,43891,0,0,0,"75",".",46160,0
"3639",138293,"WEBBER INTERNATIONAL UNIVERSITY                             ","2003-2004",3,"All Track Combined",302401,258797,43604,179467,163771,15696,122934,95026,27908,"44","25",19977,20034
"7073",237312,"UNIVERSITY OF CHARLESTON                                    ","2003-2004",15,"Soccer",117138,73617,43521,70866,50228,20638,46272,23389,22883,"25","20",15573,16269
"10865",178420,"UNIVERSITY OF MISSOURI-ST LOUIS                             ","2003-2004",22,"Tennis",62434,18918,43516,32158,10477,21681,30276,8441,21835,"8","8",6897,5063
"2939",191199,"FINGER LAKES COMMUNITY COLLEGE                              ","2003-2004",2,"Basketball",60300,16800,43500,31100,8600,22500,29200,8200,21000,"15","14",1300,1350
"912",147916,"PARKLAND COLLEGE                                            ","2003-2004",1,"Baseball",93000,49583,43417,93000,49583,43417,0,0,0,"30",".",33056,0
"2541",239743,"SILVER LAKE COLLEGE                                         ","2003-2004",2,"Basketball",43376,0,43376,0,0,0,43376,43377,-1,".","9",0,43376
"6272",195809,"ST JOHN'S UNIVERSITY-NEW YORK                               ","2003-2004",8,"Golf",384703,341513,43190,208708,187108,21600,175995,154405,21590,"8","5",5224,6361
"9021",167996,"STONEHILL COLLEGE                                           ","2003-2004",16,"Softball",79659,36582,43077,0,0,0,79659,36582,43077,".","19",0,25541
"2492",224554,"TEXAS A &amp; M UNIVERSITY-COMMERCE                             ","2003-2004",2,"Basketball",141000,98000,43000,77000,46000,31000,64000,52000,12000,"12","12",42000,39070
"2187",155681,"PITTSBURG STATE UNIVERSITY                                  ","2003-2004",2,"Basketball",559847,516881,42966,343100,294405,48695,216747,222476,-5729,"12","10",43706,29359
"5498",137546,"STETSON UNIVERSITY                                          ","2003-2004",8,"Golf",245761,203036,42725,139837,93299,46538,105924,109737,-3813,"14","6",19358,29084
"8453",169910,"FERRIS STATE UNIVERSITY                                     ","2003-2004",15,"Soccer",112792,70087,42705,0,0,0,112792,70087,42705,".","26",0,25982
"3487",178785,"PENN VALLEY COMMUNITY COLLEGE                               ","2003-2004",2,"Basketball",259770,217345,42425,126298,105085,21213,133472,112260,21212,"16","16",36982,36982
"3336",215929,"UNIVERSITY OF SCRANTON                                      ","2003-2004",2,"Basketball",383997,341605,42392,155144,147827,7317,228853,193778,35075,"22","15",28097,43263
"13598",225070,"GRAYSON COUNTY COLLEGE                                      ","2003-2004",26,"Volleyball",89706,47394,42312,0,0,0,89706,47394,42312,".","14",0,14234
"5899",141565,"UNIVERSITY OF HAWAII AT HILO                                ","2003-2004",8,"Golf",75842,33548,42294,75842,33548,42294,0,0,0,"11",".",26142,0
"7130",131113,"WILMINGTON COLLEGE                                          ","2003-2004",15,"Soccer",192897,150646,42251,99755,77636,22119,93142,73010,20132,"22","14",21436,17116
"7404",127185,"FORT LEWIS COLLEGE                                          ","2003-2004",15,"Soccer",489832,447618,42214,383952,349389,34563,105880,98229,7651,"24","27",45523,27384
"8539",119216,"MT SAN JACINTO COLLEGE                                      ","2003-2004",16,"Softball",70172,27958,42214,0,0,0,70172,27958,42214,".","14",0,12481
"2362",114813,"FRESNO PACIFIC UNIVERSITY                                   ","2003-2004",2,"Basketball",194289,152165,42124,102453,74000,28453,91836,78165,13671,"13","11",59695,42056
"9877",125028,"VENTURA COLLEGE                                             ","2003-2004",16,"Softball",77244,35222,42022,0,0,0,77244,35222,42022,".","12",0,17436
"3788",110592,"CALIFORNIA STATE UNIVERSITY-LOS ANGELES                     ","2003-2004",3,"All Track Combined",425536,383539,41997,188349,166444,21905,237187,217095,20092,"22","63",7084,33779
"8492",147916,"PARKLAND COLLEGE                                            ","2003-2004",15,"Soccer",62000,20031,41969,37200,15639,21561,24800,4392,20408,"24","14",10426,2100
"2215",199209,"NORTH CAROLINA WESLEYAN COLLEGE                             ","2003-2004",2,"Basketball",88495,46640,41855,52140,27640,24500,36355,19000,17355,"20","13",7470,5675
"318",157951,"WESTERN KENTUCKY UNIVERSITY                                 ","2003-2004",1,"Baseball",510401,468621,41780,510401,468621,41780,0,0,0,"35",".",123550,0
"16228",149231,"SOUTHERN ILLINOIS UNIVERSITY-EDWARDSVILLE                   ","2003-2004",39,"Total Participants",1404521,1362947,41574,639920,568150,71770,764601,794797,-30196,"129","115",161908,228754
"4132",230959,"MIDDLEBURY COLLEGE                                          ","2003-2004",6,"Field hocky",157218,115884,41334,0,0,0,157218,115884,41334,".","45",0,32814
"17094",196112,"SUNY INSTITUTE OF TECHNOLOGY AT UTICA-ROME                  ","2003-2004",39,"Total Participants",310265,268935,41330,176844,151515,25329,133421,117420,16001,"86","54",51152,44820
"9074",188429,"ADELPHI UNIVERSITY                                          ","2003-2004",16,"Softball",215512,174342,41170,0,0,0,215512,174342,41170,".","17",0,39871
"4674",198862,"LIVINGSTONE COLLEGE                                         ","2003-2004",7,"Football",685378,644314,41064,685378,644314,41064,0,0,0,"55",".",50930,0
"6943",136215,"NOVA SOUTHEASTERN UNIVERSITY                                ","2003-2004",13,"Rowing",243648,202729,40919,0,0,0,243648,202729,40919,".","11",0,62237
"17329",137546,"STETSON UNIVERSITY                                          ","2003-2004",39,"Total Participants",3584027,3543156,40871,1756101,1803292,-47191,1827926,1739864,88062,"117","120",314424,292875
"15533",139144,"BERRY COLLEGE                                               ","2003-2004",39,"Total Participants",2280293,2239473,40820,1362316,1325411,36905,917977,914062,3915,"117","125",312660,271871
"14644",147828,"OLIVET NAZARENE UNIVERSITY                                  ","2003-2004",26,"Volleyball",195242,154462,40780,0,0,0,195242,154462,40780,".","14",0,47035
"1748",140447,"MERCER UNIVERSITY                                           ","2003-2004",2,"Basketball",528729,487968,40761,331891,291132,40759,196838,196836,2,"17","15",90932,79568
"3219",146348,"KANKAKEE COMMUNITY COLLEGE                                  ","2003-2004",2,"Basketball",91501,50765,40736,47751,34046,13705,43750,16719,27031,"14","13",26940,13204
"15925",218821,"SPARTANBURG METHODIST COLLEGE                               ","2003-2004",39,"Total Participants",586450,545855,40595,339356,318512,20844,247094,227343,19751,"168","94",171724,117508
"7016",190415,"CORNELL UNIVERSITY-ENDOWED COLLEGES                         ","2003-2004",13,"Rowing",609214,568623,40591,455441,452043,3398,153773,116580,37193,"51","34",154159,69768
"5394",106704,"UNIVERSITY OF CENTRAL ARKANSAS                              ","2003-2004",8,"Golf",167153,126622,40531,82357,66482,15875,84796,60140,24656,"11","11",26635,24538
"15853",206048,"TIFFIN UNIVERSITY                                           ","2003-2004",39,"Total Participants",200448,159987,40461,92253,73979,18274,108195,86008,22187,"365","220",124159,65471
"1945",110574,"CALIFORNIA STATE UNIVERSITY-HAYWARD                         ","2003-2004",2,"Basketball",255848,215424,40424,134235,124181,10054,121613,91243,30370,"11","14",40904,23887
"9265",182795,"FRANKLIN PIERCE COLLEGE                                     ","2003-2004",16,"Softball",141445,101031,40414,0,0,0,141445,101031,40414,".","15",0,26060
"15704",167899,"SPRINGFIELD COLLEGE                                         ","2003-2004",39,"Total Participants",390723,350329,40394,218456,197042,21414,172267,153287,18980,"561","369",212837,146329
"16449",212160,"EDINBORO UNIVERSITY OF PENNSYLVANIA                         ","2003-2004",39,"Total Participants",1094052,1053754,40298,459267,460806,-1539,634785,592948,41837,"180","148",231811,216778
"16537",186876,"THE RICHARD STOCKTON COLLEGE OF NEW JERSEY                  ","2003-2004",39,"Total Participants",709273,669062,40211,336001,298026,37975,373272,371036,2236,"144","175",146587,144988
"1894",146393,"KENDALL COLLEGE                                             ","2003-2004",2,"Basketball",165099,124911,40188,103078,72065,31013,62021,52846,9175,"18","13",17622,17430
"13196",139764,"GEORGIA SOUTHWESTERN STATE UNIVERSITY                       ","2003-2004",26,"Volleyball",118000,77902,40098,0,0,0,118000,77902,40098,"0","10",0,24392
"3074",227304,"ODESSA COLLEGE                                              ","2003-2004",2,"Basketball",333502,293435,40067,166550,144843,21707,166952,148592,18360,"12","15",26783,29694
"2112",127918,"REGIS UNIVERSITY                                            ","2003-2004",2,"Basketball",941655,901623,40032,501943,500073,1870,439712,401550,38162,"11","12",46253,31884
"170",101587,"UNIVERSITY OF WEST ALABAMA                                  ","2003-2004",1,"Baseball",195634,155634,40000,195634,155634,40000,0,0,0,"39",".",30400,0
"4420",101587,"UNIVERSITY OF WEST ALABAMA                                  ","2003-2004",7,"Football",618946,578946,40000,618946,578946,40000,0,0,0,"94",".",126293,0
"14399",198507,"ELIZABETH CITY STATE UNIVERSITY                             ","2003-2004",26,"Volleyball",65380,25380,40000,0,0,0,65380,25380,40000,".","11",0,18656
"16444",129695,"MANCHESTER COMMUNITY COLLEGE                                ","2003-2004",39,"Total Participants",40000,0,40000,40000,41900,-1900,0,0,0,"39","0",37085,0
"2672",131113,"WILMINGTON COLLEGE                                          ","2003-2004",2,"Basketball",181574,141578,39996,93034,72887,20147,88540,68691,19849,"14","13",22931,22126
"2346",221096,"MOTLOW STATE COMMUNITY COLLEGE                              ","2003-2004",2,"Basketball",145432,105450,39982,83513,53460,30053,61919,51990,9929,"23","19",19826,20064
"8205",207582,"ORAL ROBERTS UNIVERSITY                                     ","2003-2004",15,"Soccer",699455,659606,39849,320515,291848,28667,378940,367758,11182,"18","20",53197,54758
"11225",163268,"UNIVERSITY OF MARYLAND-BALTIMORE COUNTY                     ","2003-2004",22,"Tennis",116018,76218,39800,58525,36537,21988,57493,39681,17812,"8","10",18415,17898
"4769",154800,"BUTLER COUNTY COMMUNITY COLLEGE                             ","2003-2004",7,"Football",733463,693695,39768,733463,693695,39768,0,0,0,"55",".",80333,0
"2757",140988,"SHORTER COLLEGE                                             ","2003-2004",2,"Basketball",372684,332948,39736,181328,174492,6836,191356,158456,32900,"12","10",30686,21279
"16048",217536,"SALVE REGINA UNIVERSITY                                     ","2003-2004",39,"Total Participants",437957,398337,39620,181228,171812,9416,256729,226525,30204,"205","199",194854,150522
"5548",180595,"ROCKY MOUNTAIN COLLEGE                                      ","2003-2004",8,"Golf",96152,56616,39536,48076,28308,19768,48076,28308,19768,"19","11",20808,20808
"1544",148256,"REND LAKE COLLEGE                                           ","2003-2004",1,"Baseball",131162,91631,39531,131162,91631,39531,0,0,0,"30",".",27360,0
"15608",225371,"HILL COLLEGE                                                ","2003-2004",39,"Total Participants",274527,235034,39493,154168,136347,17821,120359,98687,21672,"73","79",31114,33091
"11158",138354,"THE UNIVERSITY OF WEST FLORIDA                              ","2003-2004",22,"Tennis",298312,258891,39421,141627,127331,14296,156685,131560,25125,"13","10",23869,20091
"1088",199148,"UNIVERSITY OF NORTH CAROLINA AT GREENSBORO                  ","2003-2004",1,"Baseball",381773,342413,39360,381773,342413,39360,0,0,0,"34",".",78927,0
"3353",209065,"LINFIELD COLLEGE                                            ","2003-2004",2,"Basketball",204070,164769,39301,110245,82233,28012,93825,82536,11289,"27","24",33075,33120
"13947",146393,"KENDALL COLLEGE                                             ","2003-2004",26,"Volleyball",108145,68979,39166,58500,32122,26378,49645,36857,12788,"8","9",5362,12585
"5958",169910,"FERRIS STATE UNIVERSITY                                     ","2003-2004",8,"Golf",109201,70051,39150,46274,37724,8550,62927,32327,30600,"14","9",19556,20159
"3746",190567,"CUNY CITY COLLEGE                                           ","2003-2004",3,"All Track Combined",54460,15450,39010,27230,7831,19399,27230,7619,19611,"12","12",4321,4109
"2753",120537,"HOPE INTERNATIONAL UNIVERSITY                               ","2003-2004",2,"Basketball",92144,53250,38894,44229,25760,18469,47915,27490,20425,"12","13",25260,26990
"8954",110680,"UNIVERSITY OF CALIFORNIA-SAN DIEGO                          ","2003-2004",16,"Softball",168451,129562,38889,0,0,0,168451,129562,38889,".","20",0,49258
"13944",114859,"FULLERTON COLLEGE                                           ","2003-2004",26,"Volleyball",76941,38069,38872,0,0,0,76941,38069,38872,".","12",0,5269
"4895",209065,"LINFIELD COLLEGE                                            ","2003-2004",7,"Football",323862,285040,38822,323862,285040,38822,0,0,0,"125",".",85750,0
"7643",191199,"FINGER LAKES COMMUNITY COLLEGE                              ","2003-2004",15,"Soccer",54200,15400,38800,27300,7800,19500,26900,7600,19300,"23","18",850,840
"15745",101693,"UNIVERSITY OF MOBILE                                        ","2003-2004",39,"Total Participants",1329194,1290413,38781,730352,700628,29724,598842,589785,9057,"77","61",177063,125210
"16559",146205,"JOHN A LOGAN COLLEGE                                        ","2003-2004",39,"Total Participants",366861,328110,38751,183852,160443,23409,183009,167667,15342,"45","51",201010,173237
"15781",106342,"LYON COLLEGE                                                ","2003-2004",39,"Total Participants",929699,890967,38732,559959,527396,32563,369740,363571,6169,"106","62",97480,72789
"15800",228042,"SCHREINER UNIVERSITY                                        ","2003-2004",39,"Total Participants",420522,382046,38476,204241,185479,18762,216281,196567,19714,"95","55",79519,83875
"13144",240471,"UNIVERSITY OF WISCONSIN-RIVER FALLS                         ","2003-2004",26,"Volleyball",122746,84360,38386,0,0,0,122746,84360,38386,".","29",0,27059
"11401",232557,"LIBERTY UNIVERSITY                                          ","2003-2004",22,"Tennis",79242,40998,38244,39870,20255,19615,39372,20743,18629,"8","9",17206,17171
"16780",364025,"CHANDLER/GILBERT COMMUNITY COLLEGE                          ","2003-2004",39,"Total Participants",213433,175233,38200,85941,60941,25000,127492,114292,13200,"65","56",41582,51128
"17027",134608,"INDIAN RIVER COMMUNITY COLLEGE                              ","2003-2004",39,"Total Participants",371764,333716,38048,144339,130102,14237,227425,203614,23811,"64","71",18315,28046
"16950",193645,"THE COLLEGE OF NEW ROCHELLE                                 ","2003-2004",39,"Total Participants",38000,0,38000,0,0,0,38000,69378,-31378,"0","64",0,67348
"16993",163426,"MONTGOMERY COLLEGE                                          ","2003-2004",39,"Total Participants",310704,272761,37943,233611,213636,19975,77093,59125,17968,"159","69",158510,39250
"17055",176053,"MISSISSIPPI COLLEGE                                         ","2003-2004",39,"Total Participants",609992,572076,37916,347214,308992,38222,262778,263084,-306,"253","81",323651,168963
"15673",114789,"FRESNO CITY COLLEGE                                         ","2003-2004",39,"Total Participants",219412,181519,37893,129111,102797,26314,90301,78722,11579,"257","147",91433,59198
"6421",173045,"AUGSBURG COLLEGE                                            ","2003-2004",10,"Ice Hockey",194189,156364,37825,137099,106359,30740,57090,50005,7085,"43","27",45831,24247
"12670",131113,"WILMINGTON COLLEGE                                          ","2003-2004",25,"Track and Field, X-Country",85492,47726,37766,42746,23863,18883,42746,23863,18883,"7","7",4372,4372
"2128",220589,"LAMBUTH UNIVERSITY                                          ","2003-2004",2,"Basketball",408063,370336,37727,209025,191813,17212,199038,178523,20515,"14","15",30582,20043
"1643",153250,"DORDT COLLEGE                                               ","2003-2004",2,"Basketball",164508,126808,37700,83415,62815,20600,81093,63993,17100,"24","17",16670,9506
"16529",207209,"LANGSTON UNIVERSITY                                         ","2003-2004",39,"Total Participants",58767,21194,37573,20912,7506,13406,37855,13688,24167,"107","33",19007,5315
"3227",195234,"THE COLLEGE OF SAINT ROSE                                   ","2003-2004",2,"Basketball",814393,776829,37564,450230,416464,33766,364163,360365,3798,"15","12",41524,32713
"3124",200192,"LAKE REGION STATE COLLEGE                                   ","2003-2004",2,"Basketball",106838,69323,37515,47304,28453,18851,59534,40870,18664,"10","10",16294,20961
"1122",198507,"ELIZABETH CITY STATE UNIVERSITY                             ","2003-2004",1,"Baseball",76399,39149,37250,76399,39149,37250,0,0,0,"21",".",28959,0
"3436",174862,"CROWN COLLEGE                                               ","2003-2004",2,"Basketball",75870,38640,37230,40568,20414,20154,35302,18226,17076,"21","13",19902,16084
"6570",191199,"FINGER LAKES COMMUNITY COLLEGE                              ","2003-2004",11,"Lacrosse",52900,15700,37200,28400,8200,20200,24500,7500,17000,"25","25",810,520
"10417",110680,"UNIVERSITY OF CALIFORNIA-SAN DIEGO                          ","2003-2004",18,"Swimming and Diving",194387,157247,37140,94679,77434,17245,99708,79813,19895,"27","38",32667,35224
"1121",199209,"NORTH CAROLINA WESLEYAN COLLEGE                             ","2003-2004",1,"Baseball",74203,37157,37046,74203,37157,37046,0,0,0,"42",".",12900,0
"16333",211440,"CARNEGIE MELLON UNIVERSITY                                  ","2003-2004",39,"Total Participants",887548,850743,36805,438898,425079,13819,448650,425664,22986,"334","143",403696,279947
"6531",196866,"UNION COLLEGE                                               ","2003-2004",10,"Ice Hockey",539461,502718,36743,354295,307603,46692,185166,195115,-9949,"29","21",99000,56543
"3322",177940,"LINCOLN UNIVERSITY                                          ","2003-2004",2,"Basketball",249679,212971,36708,126358,102837,23521,123321,110134,13187,"14","14",24037,28969
"4494",171492,"NORTHWOOD UNIVERSITY                                        ","2003-2004",7,"Football",1013025,976500,36525,1013025,976500,36525,0,0,0,"122",".",85256,0
"4284",173647,"GUSTAVUS ADOLPHUS COLLEGE                                   ","2003-2004",7,"Football",260606,224201,36405,260606,224201,36405,0,0,0,"101",".",42561,0
"8673",182670,"DARTMOUTH COLLEGE                                           ","2003-2004",16,"Softball",196485,160144,36341,0,0,0,196485,160144,36341,".","20",0,42384
"72",199333,"PITT COMMUNITY COLLEGE                                      ","2003-2004",1,"Baseball",95017,58800,36217,95017,58800,36217,0,0,0,"26",".",22873,0
"377",240189,"UNIVERSITY OF WISCONSIN-WHITEWATER                          ","2003-2004",1,"Baseball",114902,78740,36162,114902,78740,36162,0,0,0,"32",".",45712,0
"7575",218645,"UNIVERSITY OF SOUTH CAROLINA-AIKEN                          ","2003-2004",15,"Soccer",349827,313673,36154,173401,156062,17339,176426,157611,18815,"27","23",14706,13441
"2446",141486,"CHAMINADE UNIVERSITY OF HONOLULU                            ","2003-2004",2,"Basketball",106321,70233,36088,106321,70233,36088,0,0,0,"13",".",62480,0
"14967",149231,"SOUTHERN ILLINOIS UNIVERSITY-EDWARDSVILLE                   ","2003-2004",28,"Wrestling",75483,39457,36026,75483,39457,36026,0,0,0,"19",".",10921,0
"1934",240055,"UNIVERSITY OF WISCONSIN COLLEGES                            ","2003-2004",2,"Basketball",177709,141758,35951,96719,76000,20719,80990,65758,15232,"111","84",71236,57782
"4747",176053,"MISSISSIPPI COLLEGE                                         ","2003-2004",7,"Football",357363,321669,35694,357363,321669,35694,0,0,0,"106",".",117724,0
"7032",128391,"WESTERN STATE COLLEGE OF COLORADO                           ","2003-2004",14,"Skiing",145722,110032,35690,71761,52114,19647,73961,57918,16043,"18","8",21698,21220
"4572",207290,"NORTHEASTERN OKLAHOMA AGRICULTURAL AND MECH COLL            ","2003-2004",7,"Football",178616,142934,35682,178616,142934,35682,0,0,0,"81",".",66500,0
"16566",228802,"THE UNIVERSITY OF TEXAS AT TYLER                            ","2003-2004",39,"Total Participants",326671,290997,35674,183622,167716,15906,143049,123281,19768,"104","75",110339,69086
"16856",101028,"CHATTAHOOCHEE VALLEY COMMUNITY COLLEGE                      ","2003-2004",39,"Total Participants",96014,60344,35670,61894,36874,25020,34120,23470,10650,"24","22",25020,10650
"2163",239716,"SAINT NORBERT COLLEGE                                       ","2003-2004",2,"Basketball",208700,173087,35613,103550,86018,17532,105150,87069,18081,"16","18",29400,30525
"8229",125763,"WHITTIER COLLEGE                                            ","2003-2004",15,"Soccer",91160,55570,35590,49890,25480,24410,41270,30090,11180,"17","21",7300,6613
"7695",155089,"FRIENDS UNIVERSITY                                          ","2003-2004",15,"Soccer",126149,90573,35576,64679,44288,20391,61470,46285,15185,"24","18",17065,12638
"594",132657,"LYNN UNIVERSITY                                             ","2003-2004",1,"Baseball",325229,289674,35555,325229,289674,35555,0,0,0,"31",".",46799,0
"16841",128498,"ALBERTUS MAGNUS COLLEGE                                     ","2003-2004",39,"Total Participants",86700,51204,35496,55300,35616,19684,31400,15588,15812,"61","43",46157,26976
"2418",137546,"STETSON UNIVERSITY                                          ","2003-2004",2,"Basketball",1804303,1768915,35388,953351,920094,33257,850952,848821,2131,"12","13",90946,72930
"9204",141334,"STATE UNIVERSITY OF WEST GEORGIA                            ","2003-2004",16,"Softball",113178,77798,35380,0,0,0,113178,77798,35380,".","16",0,37679
"1505",158431,"BOSSIER PARISH COMMUNITY COLLEGE                            ","2003-2004",1,"Baseball",124380,89093,35287,124380,89093,35287,0,0,0,"27",".",21641,0
"3294",123563,"SOLANO COUNTY COMMUNITY COLLEGE DISTRICT                    ","2003-2004",2,"Basketball",90606,55457,35149,37086,27046,10040,53520,28411,25109,"15","13",10198,9175
"12913",190099,"COLGATE UNIVERSITY                                          ","2003-2004",25,"Track and Field, X-Country",1043934,1008834,35100,460009,424968,35041,583925,583866,59,"81","63",71949,75771
"16113",224891,"FRANK PHILLIPS COLLEGE                                      ","2003-2004",39,"Total Participants",581647,546565,35082,336558,313558,23000,245089,233007,12082,"72","42",91190,88810
"16858",206941,"UNIVERSITY OF CENTRAL OKLAHOMA                              ","2003-2004",39,"Total Participants",177998,142967,35031,96521,70367,26154,81477,72600,8877,"231","104",171530,89862
"662",146339,"JUDSON COLLEGE                                              ","2003-2004",1,"Baseball",145743,110722,35021,145743,110722,35021,0,0,0,"22",".",19185,0
"5007",173300,"CONCORDIA COLLEGE AT MOORHEAD                               ","2003-2004",7,"Football",281437,246514,34923,281437,246514,34923,0,0,0,"131",".",5755,0
"9615",106704,"UNIVERSITY OF CENTRAL ARKANSAS                              ","2003-2004",16,"Softball",137221,102301,34920,0,0,0,137221,102301,34920,".","20",0,18853
"15357",111188,"CALIFORNIA MARITIME ACADEMY                                 ","2003-2004",36,"Sailing",72000,37120,34880,72000,37120,34880,0,0,0,"17",".",33474,0
"7727",199209,"NORTH CAROLINA WESLEYAN COLLEGE                             ","2003-2004",15,"Soccer",72715,37848,34867,40839,23777,17062,31876,14071,17805,"26","16",7678,6588
"14361",233277,"RADFORD UNIVERSITY                                          ","2003-2004",26,"Volleyball",184921,150069,34852,0,0,0,184921,150069,34852,".","13",0,32833
"7126",114813,"FRESNO PACIFIC UNIVERSITY                                   ","2003-2004",15,"Soccer",169128,134466,34662,84039,67754,16285,85089,66712,18377,"19","21",43634,35576
"1470",139144,"BERRY COLLEGE                                               ","2003-2004",1,"Baseball",534362,499707,34655,534362,499707,34655,0,0,0,"45",".",105944,0
"10670",218070,"FURMAN UNIVERSITY                                           ","2003-2004",22,"Tennis",570902,536261,34641,221042,231229,-10187,349860,305032,44828,"16","10",21520,23805
"7981",201645,"CASE WESTERN RESERVE UNIVERSITY                             ","2003-2004",15,"Soccer",151118,116508,34610,73016,56148,16868,78102,60360,17742,"31","20",33530,33329
"16145",210304,"WARNER PACIFIC COLLEGE                                      ","2003-2004",39,"Total Participants",122984,88448,34536,68529,42344,26185,54455,46104,8351,"50","50",45822,45137
"17335",147341,"MONMOUTH COLLEGE                                            ","2003-2004",39,"Total Participants",300720,266208,34512,148744,133445,15299,151976,132763,19213,"305","140",169883,114875
"11467",141565,"UNIVERSITY OF HAWAII AT HILO                                ","2003-2004",22,"Tennis",171787,137351,34436,84562,68892,15670,87225,68459,18766,"7","7",24336,24336
"1047",138789,"ARMSTRONG ATLANTIC STATE UNIVERSITY                         ","2003-2004",1,"Baseball",237217,202792,34425,237217,202792,34425,0,0,0,"22",".",109484,0
"913",220589,"LAMBUTH UNIVERSITY                                          ","2003-2004",1,"Baseball",241570,207235,34335,241570,207235,34335,0,0,0,"63",".",51241,0
"4588",173665,"HAMLINE UNIVERSITY                                          ","2003-2004",7,"Football",177656,143322,34334,177656,143322,34334,0,0,0,"78",".",45851,0
"1155",198561,"GARDNER-WEBB UNIVERSITY                                     ","2003-2004",1,"Baseball",432535,398202,34333,432535,398202,34333,0,0,0,"34",".",87615,0
"2862",149231,"SOUTHERN ILLINOIS UNIVERSITY-EDWARDSVILLE                   ","2003-2004",2,"Basketball",648262,614006,34256,341376,320267,21109,306886,293739,13147,"16","15",48751,42291
"6913",217484,"UNIVERSITY OF RHODE ISLAND                                  ","2003-2004",13,"Rowing",411592,377363,34229,0,0,0,411592,377363,34229,".","69",0,84280
"16894",228769,"THE UNIVERSITY OF TEXAS AT ARLINGTON                        ","2003-2004",39,"Total Participants",2090370,2056273,34097,966861,955385,11476,1123509,1100888,22621,"104","86",460417,415277
"1562",178217,"MINERAL AREA COLLEGE                                        ","2003-2004",1,"Baseball",154495,120415,34080,154495,120415,34080,0,0,0,"28",".",23111,0
"7978",199148,"UNIVERSITY OF NORTH CAROLINA AT GREENSBORO                  ","2003-2004",15,"Soccer",697050,663046,34004,357878,340795,17083,339172,322251,16921,"26","26",35739,39520
"12512",176053,"MISSISSIPPI COLLEGE                                         ","2003-2004",25,"Track and Field, X-Country",112591,78600,33991,82313,40217,42096,30278,38383,-8105,"12","10",16180,14346
"15495",226231,"LETOURNEAU UNIVERSITY                                       ","2003-2004",39,"Total Participants",406908,372983,33925,214031,189304,24727,192877,183679,9198,"103","83",117227,102757
"1517",232609,"LYNCHBURG COLLEGE                                           ","2003-2004",1,"Baseball",92982,59107,33875,92982,59107,33875,0,0,0,"30",".",19742,0
"519",217688,"CHARLESTON SOUTHERN UNIVERSITY                              ","2003-2004",1,"Baseball",258022,224246,33776,258022,224246,33776,0,0,0,"29",".",51988,0
"16055",144944,"ELGIN COMMUNITY COLLEGE                                     ","2003-2004",39,"Total Participants",152140,118400,33740,81970,62700,19270,70170,55700,14470,"73","62",59600,61400
"11910",218070,"FURMAN UNIVERSITY                                           ","2003-2004",23,"Track and Field, Indoor",67634,33896,33738,0,0,0,67634,33896,33738,".","31",0,2836
"4240",213349,"KUTZTOWN UNIVERSITY OF PENNSYLVANIA                         ","2003-2004",6,"Field hocky",193975,160294,33681,0,0,0,193975,160294,33681,".","24",0,14629
"3420",176664,"BAPTIST BIBLE COLLEGE AND GRADUATE SCHOOL                   ","2003-2004",2,"Basketball",76149,42500,33649,47380,22500,24880,28769,20000,8769,"10","12",21000,18000
"16191",157632,"SAINT CATHARINE COLLEGE                                     ","2003-2004",39,"Total Participants",386015,352569,33446,257169,234518,22651,128846,118051,10795,"100","48",57200,44600
"5867",219976,"DAVID LIPSCOMB UNIVERSITY                                   ","2003-2004",8,"Golf",212342,178898,33444,122573,95981,26592,89769,82917,6852,"15","6",25531,19068
"1253",207306,"NORTHWESTERN OKLAHOMA STATE UNIVERSITY                      ","2003-2004",1,"Baseball",84677,51367,33310,84677,51367,33310,0,0,0,"37",".",25663,0
"2917",136215,"NOVA SOUTHEASTERN UNIVERSITY                                ","2003-2004",2,"Basketball",485388,452102,33286,240272,224939,15333,245116,227163,17953,"13","13",34655,31940
"17320",226578,"MCLENNAN COMMUNITY COLLEGE                                  ","2003-2004",39,"Total Participants",349887,316670,33217,182909,172238,10671,166978,144432,22546,"55","57",53304,67095
"3767",188429,"ADELPHI UNIVERSITY                                          ","2003-2004",3,"All Track Combined",124435,91243,33192,79733,53915,25818,44702,37328,7374,"23","18",22063,17927
"16152",210331,"WESTERN BAPTIST COLLEGE                                     ","2003-2004",39,"Total Participants",330338,297149,33189,161055,145479,15576,169283,151670,17613,"84","71",85617,85571
"4539",191649,"HOFSTRA UNIVERSITY                                          ","2003-2004",7,"Football",3262557,3229408,33149,3262557,3229408,33149,0,0,0,"83",".",418836,0
"11534",212656,"GENEVA COLLEGE                                              ","2003-2004",22,"Tennis",55727,22692,33035,0,0,0,55727,22692,33035,".","10",0,3365
"13594",120537,"HOPE INTERNATIONAL UNIVERSITY                               ","2003-2004",26,"Volleyball",81087,48060,33027,33172,20570,12602,47915,27490,20425,"9","14",20070,26990
"15685",168263,"WESTFIELD STATE COLLEGE                                     ","2003-2004",39,"Total Participants",238936,206029,32907,108662,92986,15676,130274,113043,17231,"186","162",88755,77607
"5788",218238,"LIMESTONE COLLEGE                                           ","2003-2004",8,"Golf",50120,17269,32851,24500,7149,17351,25620,10120,15500,"12","5",6800,8096
"5511",202763,"THE UNIVERSITY OF FINDLAY                                   ","2003-2004",8,"Golf",133374,100582,32792,67176,56337,10839,66198,44245,21953,"13","7",12558,8274
"2304",217518,"ROGER WILLIAMS UNIVERSITY                                   ","2003-2004",2,"Basketball",153894,121114,32780,75075,62233,12842,78819,58881,19938,"15","12",23854,23519
"8975",212984,"HOLY FAMILY UNIVERSITY                                      ","2003-2004",16,"Softball",165000,132234,32766,0,0,0,165000,132234,32766,".","16",0,6964
"4965",129941,"UNIVERSITY OF NEW HAVEN                                     ","2003-2004",7,"Football",732430,699666,32764,732430,699666,32764,0,0,0,"75",".",140633,0
"5222",110486,"CALIFORNIA STATE UNIVERSITY-BAKERSFIELD                     ","2003-2004",8,"Golf",66074,33322,32752,66074,33322,32752,0,0,0,"9",".",22551,0
"17050",231554,"BLUEFIELD COLLEGE                                           ","2003-2004",39,"Total Participants",450125,417507,32618,273192,245711,27481,176933,171796,5137,"68","56",67313,51386
"16278",190983,"ELMIRA COLLEGE                                              ","2003-2004",39,"Total Participants",831686,799115,32571,325352,315213,10139,506334,483902,22432,"121","161",159491,223646
"7925",220589,"LAMBUTH UNIVERSITY                                          ","2003-2004",15,"Soccer",205398,172877,32521,120004,103584,16420,85394,69293,16101,"23","19",15967,14711
"544",171599,"OLIVET COLLEGE                                              ","2003-2004",1,"Baseball",68316,35834,32482,68316,35834,32482,0,0,0,"36",".",12175,0
"3273",125727,"WESTMONT COLLEGE                                            ","2003-2004",2,"Basketball",328644,296216,32428,199483,167187,32296,129161,129029,132,"14","14",27788,32755
"11131",126119,"YUBA COLLEGE                                                ","2003-2004",22,"Tennis",45600,13200,32400,26600,6850,19750,19000,6350,12650,"7","5",2600,2100
"2723",196079,"SUNY AT BINGHAMTON                                          ","2003-2004",2,"Basketball",2310717,2278319,32398,1373120,1278445,94675,937597,999874,-62277,"16","13",145854,121518
"15676",140818,"PIEDMONT COLLEGE                                            ","2003-2004",39,"Total Participants",408992,376595,32397,190509,170483,20026,218483,206112,12371,"88","75",93730,86066
"16653",119164,"MT SAN ANTONIO COLLEGE                                      ","2003-2004",39,"Total Participants",1260947,1228579,32368,622290,615249,7041,638657,613330,25327,"341","163",94996,69256
"16486",140988,"SHORTER COLLEGE                                             ","2003-2004",39,"Total Participants",1303056,1270819,32237,683725,642361,41364,619331,628458,-9127,"85","81",111658,116719
"2994",170806,"MADONNA UNIVERSITY                                          ","2003-2004",2,"Basketball",215063,182871,32192,116610,96450,20160,98453,86421,12032,"13","11",21320,20701
"16788",214157,"MORAVIAN COLLEGE AND THEOLOGICAL SEMINARY                   ","2003-2004",39,"Total Participants",650601,618419,32182,298763,279711,19052,351838,338708,13130,"212","157",153046,117854
"725",170082,"GRAND VALLEY STATE UNIVERSITY                               ","2003-2004",1,"Baseball",243093,211043,32050,243093,211043,32050,0,0,0,"30",".",60906,0
"7140",213349,"KUTZTOWN UNIVERSITY OF PENNSYLVANIA                         ","2003-2004",15,"Soccer",206204,174189,32015,88141,73380,14761,118063,100809,17254,"23","25",14921,23536
"3523",228769,"THE UNIVERSITY OF TEXAS AT ARLINGTON                        ","2003-2004",3,"All Track Combined",624199,592193,32006,293336,280146,13190,330863,312047,18816,"32","34",57258,57031
"11517",218238,"LIMESTONE COLLEGE                                           ","2003-2004",22,"Tennis",44625,12620,32005,22050,6047,16003,22575,6573,16002,"11","6",4440,4860
"15459",145372,"GREENVILLE COLLEGE                                          ","2003-2004",39,"Total Participants",403987,372044,31943,199337,177593,21744,204650,194451,10199,"189","87",120050,79378
"2692",217615,"AIKEN TECHNICAL COLLEGE                                     ","2003-2004",2,"Basketball",31936,0,31936,31936,37836,-5900,0,0,0,"15",".",31936,0
"16543",153834,"LUTHER COLLEGE                                              ","2003-2004",39,"Total Participants",540447,508527,31920,289137,274035,15102,251310,234492,16818,"310","193",196837,135589
"4119",215099,"PHILADELPHIA UNIVERSITY                                     ","2003-2004",6,"Field hocky",130375,98468,31907,0,0,0,130375,98468,31907,".","24",0,6975
"13115",127918,"REGIS UNIVERSITY                                            ","2003-2004",26,"Volleyball",389028,357308,31720,0,0,0,389028,357308,31720,".","13",0,30984
"4727",211608,"CHEYNEY UNIVERSITY OF PENNSYLVANIA                          ","2003-2004",7,"Football",196714,165149,31565,196714,165149,31565,0,0,0,"43",".",40598,0
"916",212577,"FRANKLIN AND MARSHALL COLLEGE                               ","2003-2004",1,"Baseball",98652,67114,31538,98652,67114,31538,0,0,0,"27",".",22757,0
"2696",110592,"CALIFORNIA STATE UNIVERSITY-LOS ANGELES                     ","2003-2004",2,"Basketball",670061,638743,31318,384807,364912,19895,285254,273831,11423,"12","16",31284,36143
"401",221096,"MOTLOW STATE COMMUNITY COLLEGE                              ","2003-2004",1,"Baseball",94134,62841,31293,94134,62841,31293,0,0,0,"41",".",17589,0
"12491",171599,"OLIVET COLLEGE                                              ","2003-2004",25,"Track and Field, X-Country",99985,68703,31282,49918,34429,15489,50067,34274,15793,"37","10",11290,11290
"4238",215062,"UNIVERSITY OF PENNSYLVANIA                                  ","2003-2004",6,"Field hocky",153708,122550,31158,0,0,0,153708,122550,31158,".","24",0,36793
"8457",232423,"JAMES MADISON UNIVERSITY                                    ","2003-2004",15,"Soccer",835260,804148,31112,410697,391183,19514,424563,412965,11598,"35","26",79141,58600
"15453",177676,"JEFFERSON COLLEGE                                           ","2003-2004",39,"Total Participants",157222,126123,31099,83095,78777,4318,74127,47346,26781,"26","25",33314,55044
"4144",213987,"MERCYHURST COLLEGE                                          ","2003-2004",6,"Field hocky",174971,143900,31071,0,0,0,174971,143900,31071,".","22",0,19900
"16475",216278,"SUSQUEHANNA UNIVERSITY                                      ","2003-2004",39,"Total Participants",514451,483439,31012,235684,213663,22021,278767,269776,8991,"312","178",138770,103021
"8553",198862,"LIVINGSTONE COLLEGE                                         ","2003-2004",16,"Softball",68130,37176,30954,0,0,0,68130,37176,30954,".","13",0,5070
"776",196079,"SUNY AT BINGHAMTON                                          ","2003-2004",1,"Baseball",497258,466397,30861,497258,466397,30861,0,0,0,"26",".",63292,0
"11595",136206,"NORTHWOOD UNIVERSITY-FLORIDA EDUCATION CENTER               ","2003-2004",22,"Tennis",227491,196838,30653,100750,89743,11007,126741,107095,19646,"9","9",6024,8652
"15010",218238,"LIMESTONE COLLEGE                                           ","2003-2004",28,"Wrestling",35331,4786,30545,35331,4786,30545,0,0,0,"3",".",4000,0
"7800",198561,"GARDNER-WEBB UNIVERSITY                                     ","2003-2004",15,"Soccer",623897,593424,30473,305473,285251,20222,318424,308173,10251,"23","16",37156,41400
"10276",215062,"UNIVERSITY OF PENNSYLVANIA                                  ","2003-2004",18,"Swimming and Diving",240844,210403,30441,99161,94327,4834,141683,116076,25607,"33","38",39284,60375
"618",107983,"SOUTHERN ARKANSAS UNIVERSITY MAIN CAMPUS                    ","2003-2004",1,"Baseball",103443,73024,30419,103443,73024,30419,0,0,0,"30",".",52252,0
"9915",178022,"MAPLE WOODS COMMUNITY COLLEGE                               ","2003-2004",16,"Softball",113875,83553,30322,0,0,0,113875,83553,30322,".","13",0,43141
"12788",230737,"UTAH VALLEY STATE COLLEGE                                   ","2003-2004",25,"Track and Field, X-Country",295315,265007,30308,134040,118886,15154,161275,146121,15154,"81","77",23950,23950
"14878",213987,"MERCYHURST COLLEGE                                          ","2003-2004",28,"Wrestling",262034,231750,30284,262034,231750,30284,0,0,0,"40",".",25300,0
"16325",159717,"MCNEESE STATE UNIVERSITY                                    ","2003-2004",39,"Total Participants",1660636,1630405,30231,576862,564391,12471,1083774,1066014,17760,"243","147",593809,355491
"6249",151263,"UNIVERSITY OF INDIANAPOLIS                                  ","2003-2004",8,"Golf",167456,137230,30226,82331,63401,18930,85125,73829,11296,"13","11",13200,12490
"4424",211440,"CARNEGIE MELLON UNIVERSITY                                  ","2003-2004",7,"Football",472370,442161,30209,472370,442161,30209,0,0,0,"107",".",127198,0
"16082",366711,"CALIFORNIA STATE UNIVERSITY-SAN MARCOS                      ","2003-2004",39,"Total Participants",277230,247096,30134,140069,125345,14724,137161,121751,15410,"50","36",37765,34171
"10496",212577,"FRANKLIN AND MARSHALL COLLEGE                               ","2003-2004",19,"Swimming",110951,80842,30109,54277,40421,13856,56674,40421,16253,"16","22",13256,13256
"2218",171492,"NORTHWOOD UNIVERSITY                                        ","2003-2004",2,"Basketball",734979,704949,30030,377237,358239,18998,357742,346710,11032,"18","14",35191,42493
"2549",117751,"THE MASTER'S COLLEGE AND SEMINARY                           ","2003-2004",2,"Basketball",688596,658573,30023,408161,380513,27648,280435,278060,2375,"12","10",63812,46401
"8997",101587,"UNIVERSITY OF WEST ALABAMA                                  ","2003-2004",16,"Softball",163730,133730,30000,0,0,0,163730,133730,30000,".","15",0,15590
"2181",143084,"AUGUSTANA COLLEGE                                           ","2003-2004",2,"Basketball",267796,237824,29972,181489,155023,26466,86307,82801,3506,"21","26",35570,22837
"14441",169798,"EASTERN MICHIGAN UNIVERSITY                                 ","2003-2004",26,"Volleyball",429084,399114,29970,0,0,0,429084,399114,29970,".","14",0,63268
"9324",139366,"COLUMBUS STATE UNIVERSITY                                   ","2003-2004",16,"Softball",165442,135512,29930,0,0,0,165442,135512,29930,".","12",0,34505
"2743",172051,"SAGINAW VALLEY STATE UNIVERSITY                             ","2003-2004",2,"Basketball",491235,461313,29922,244638,233075,11563,246597,228238,18359,"16","14",41874,53201
"15441",191968,"ITHACA COLLEGE                                              ","2003-2004",39,"Total Participants",1600993,1571378,29615,704056,742772,-38716,896937,828606,68331,"412","392",538651,419661
"17314",146481,"LAKE FOREST COLLEGE                                         ","2003-2004",39,"Total Participants",451952,422455,29497,205916,198729,7187,246036,223726,22310,"162","117",138420,107292
"2056",140164,"KENNESAW STATE UNIVERSITY                                   ","2003-2004",2,"Basketball",1059897,1030452,29445,571736,557033,14703,488161,473419,14742,"14","12",103371,51299
"6897",160977,"BATES COLLEGE                                               ","2003-2004",13,"Rowing",196041,166613,29428,92504,77984,14520,103537,88629,14908,"29","41",41854,52887
"15637",125462,"WEST HILLS COMMUNITY COLLEGE                                ","2003-2004",39,"Total Participants",104828,75408,29420,39782,37309,2473,65046,38099,26947,"108","26",31758,11650
"205",140988,"SHORTER COLLEGE                                             ","2003-2004",1,"Baseball",285008,255712,29296,285008,255712,29296,0,0,0,"33",".",27143,0
"8122",186876,"THE RICHARD STOCKTON COLLEGE OF NEW JERSEY                  ","2003-2004",15,"Soccer",243803,214553,29250,137367,110315,27052,106436,104238,2198,"25","27",29979,19895
"9570",123563,"SOLANO COUNTY COMMUNITY COLLEGE DISTRICT                    ","2003-2004",16,"Softball",53723,24475,29248,0,0,0,53723,24475,29248,".","12",0,7318
"16787",204200,"COLLEGE OF MOUNT SAINT JOSEPH                               ","2003-2004",39,"Total Participants",405223,376045,29178,191791,182394,9397,213432,193651,19781,"191","110",205460,102223
"4622",144351,"CONCORDIA UNIVERSITY                                        ","2003-2004",7,"Football",75639,46507,29132,75639,46507,29132,0,0,0,"66",".",33922,0
"3379",191621,"HILBERT COLLEGE                                             ","2003-2004",2,"Basketball",202171,173056,29115,104874,90859,14015,97297,82197,15100,"14","16",15484,15069
"12186",213987,"MERCYHURST COLLEGE                                          ","2003-2004",25,"Track and Field, X-Country",173865,144799,29066,96657,69824,26833,77208,74975,2233,"14","19",9675,9675
"2553",237181,"BETHANY COLLEGE                                             ","2003-2004",2,"Basketball",133397,104385,29012,91237,52587,38650,42160,51798,-9638,"22","16",19118,18976
"5065",216807,"WESTMINSTER COLLEGE                                         ","2003-2004",7,"Football",300876,271888,28988,300876,271888,28988,0,0,0,"80",".",43940,0
"2782",210304,"WARNER PACIFIC COLLEGE                                      ","2003-2004",2,"Basketball",96950,68013,28937,54100,35229,18871,42850,32784,10066,"12","14",23228,20784
"1928",196130,"SUNY COLLEGE AT BUFFALO                                     ","2003-2004",2,"Basketball",245139,216216,28923,140015,123141,16874,105124,93075,12049,"16","15",37653,34053
"2716",240480,"UNIVERSITY OF WISCONSIN-STEVENS POINT                       ","2003-2004",2,"Basketball",448123,419233,28890,335032,306770,28262,113091,112463,628,"20","17",54491,29490
"2972",219046,"BLACK HILLS STATE UNIVERSITY                                ","2003-2004",2,"Basketball",284634,255850,28784,145871,129400,16471,138763,126450,12313,"12","17",30000,30000
"4581",216010,"SHIPPENSBURG UNIVERSITY OF PENNSYLVANIA                     ","2003-2004",7,"Football",556892,528108,28784,556892,528108,28784,0,0,0,"90",".",79462,0
"3061",212115,"EAST STROUDSBURG UNIVERSITY OF PENNSYLVANIA                 ","2003-2004",2,"Basketball",351239,322593,28646,185565,161310,24255,165674,161283,4391,"15","17",22866,25231
"15122",191199,"FINGER LAKES COMMUNITY COLLEGE                              ","2003-2004",29,"Other Sports",37000,8400,28600,18500,4200,14300,18500,4200,14300,"35","20",340,510
"10406",151263,"UNIVERSITY OF INDIANAPOLIS                                  ","2003-2004",18,"Swimming and Diving",307916,279326,28590,152195,139897,12298,155721,139429,16292,"15","19",21641,23614
"17267",213251,"JUNIATA COLLEGE                                             ","2003-2004",39,"Total Participants",515018,486443,28575,202624,202386,238,312394,284057,28337,"218","189",233772,165290
"10047",126119,"YUBA COLLEGE                                                ","2003-2004",16,"Softball",45600,17100,28500,0,0,0,45600,17100,28500,".","12",0,8600
"11817",166683,"MASSACHUSETTS INSTITUTE OF TECHNOLOGY                       ","2003-2004",23,"Track and Field, Indoor",93783,65341,28442,34444,35995,-1551,59339,29346,29993,"43","44",15665,12194
"16976",167260,"NICHOLS COLLEGE                                             ","2003-2004",39,"Total Participants",275058,246844,28214,156005,152385,3620,119053,94459,24594,"225","76",208212,84490
"1034",134945,"JACKSONVILLE UNIVERSITY                                     ","2003-2004",1,"Baseball",520693,492520,28173,520693,492520,28173,0,0,0,"39",".",92469,0
"2420",110671,"UNIVERSITY OF CALIFORNIA-RIVERSIDE                          ","2003-2004",2,"Basketball",1330201,1302049,28152,905892,756879,149013,424309,545170,-120861,"15","15",97273,57742
"477",106342,"LYON COLLEGE                                                ","2003-2004",1,"Baseball",326855,298879,27976,326855,298879,27976,0,0,0,"45",".",37934,0
"3304",152992,"BRIAR CLIFF UNIVERSITY                                      ","2003-2004",2,"Basketball",357972,330032,27940,190884,178297,12587,167088,151735,15353,"32","21",21962,17604
"14746",125028,"VENTURA COLLEGE                                             ","2003-2004",27,"Water Polo",60386,32456,27930,24192,13650,10542,36194,18806,17388,"14","24",7613,9229
"3811",173665,"HAMLINE UNIVERSITY                                          ","2003-2004",3,"All Track Combined",187555,159667,27888,89634,77292,12342,97921,82375,15546,"41","24",22185,20081
"2433",107877,"WILLIAMS BAPTIST COLLEGE                                    ","2003-2004",2,"Basketball",285137,257329,27808,146238,122251,23987,138899,135078,3821,"11","12",21526,23053
"8645",221485,"SOUTHWEST TENNESSEE COMMUNITY COLLEGE                       ","2003-2004",16,"Softball",91077,63287,27790,0,0,0,91077,63287,27790,".","14",0,28327
"16090",221485,"SOUTHWEST TENNESSEE COMMUNITY COLLEGE                       ","2003-2004",39,"Total Participants",317015,289225,27790,225938,225938,0,91077,63287,27790,"60","30",101532,59449
"3820",138354,"THE UNIVERSITY OF WEST FLORIDA                              ","2003-2004",3,"All Track Combined",174810,147055,27755,81600,74660,6940,93210,72395,20815,"11","22",16528,12934
"16905",198862,"LIVINGSTONE COLLEGE                                         ","2003-2004",39,"Total Participants",345979,318300,27679,83815,83165,650,262164,235135,27029,"87","58",87217,60176
"2133",163912,"ST MARY'S COLLEGE OF MARYLAND                               ","2003-2004",2,"Basketball",165361,137690,27671,77922,61158,16764,87439,76532,10907,"10","12",17800,17800
"16125",172264,"SIENA HEIGHTS UNIVERSITY                                    ","2003-2004",39,"Total Participants",191179,163543,27636,96762,84648,12114,94417,78895,15522,"137","115",66910,69769
"4635",168546,"ALBION COLLEGE                                              ","2003-2004",7,"Football",291529,263897,27632,291529,263897,27632,0,0,0,"142",".",98345,0
"4484",165529,"CURRY COLLEGE                                               ","2003-2004",7,"Football",131760,104145,27615,131760,104145,27615,0,0,0,"82",".",45708,0
"12454",191199,"FINGER LAKES COMMUNITY COLLEGE                              ","2003-2004",25,"Track and Field, X-Country",32000,4400,27600,16000,2200,13800,16000,2200,13800,"10","8",680,810
"9106",199209,"NORTH CAROLINA WESLEYAN COLLEGE                             ","2003-2004",16,"Softball",41189,13614,27575,0,0,0,41189,13614,27575,".","13",0,4165
"4717",219046,"BLACK HILLS STATE UNIVERSITY                                ","2003-2004",7,"Football",284944,257372,27572,284944,257372,27572,0,0,0,"64",".",50000,0
"8284",218441,"NORTH GREENVILLE COLLEGE                                    ","2003-2004",15,"Soccer",43358,15811,27547,21679,7733,13946,21679,8078,13601,"22","19",7665,7967
"14394",117946,"LOYOLA MARYMOUNT UNIVERSITY                                 ","2003-2004",26,"Volleyball",765099,737630,27469,0,0,0,765099,737630,27469,".","19",0,98473
"8803",213349,"KUTZTOWN UNIVERSITY OF PENNSYLVANIA                         ","2003-2004",16,"Softball",187382,159972,27410,0,0,0,187382,159972,27410,".","26",0,36006
"15970",212197,"ELIZABETHTOWN COLLEGE                                       ","2003-2004",39,"Total Participants",423499,396097,27402,234429,219330,15099,189070,176767,12303,"242","225",104576,95563
"4981",172051,"SAGINAW VALLEY STATE UNIVERSITY                             ","2003-2004",7,"Football",947330,919959,27371,947330,919959,27371,0,0,0,"124",".",183805,0
"2479",166850,"MERRIMACK COLLEGE                                           ","2003-2004",2,"Basketball",820140,792897,27243,387067,361242,25825,433073,431655,1418,"16","12",36812,47781
"6490",165529,"CURRY COLLEGE                                               ","2003-2004",10,"Ice Hockey",70687,43462,27225,70687,43462,27225,0,0,0,"29",".",31591,0
"4596",164562,"ASSUMPTION COLLEGE                                          ","2003-2004",7,"Football",207968,180746,27222,207968,180746,27222,0,0,0,"73",".",22050,0
"3063",205203,"UNIVERSITY OF RIO GRANDE                                    ","2003-2004",2,"Basketball",248306,221096,27210,119085,115668,3417,129221,105428,23793,"35","23",21002,17444
"859",123563,"SOLANO COUNTY COMMUNITY COLLEGE DISTRICT                    ","2003-2004",1,"Baseball",44618,17431,27187,44618,17431,27187,0,0,0,"28",".",5903,0
"11580",244437,"GEORGIA PERIMETER COLLEGE                                   ","2003-2004",22,"Tennis",95226,68075,27151,47613,33694,13919,47613,34381,13232,"6","8",27748,27748
"7366",230959,"MIDDLEBURY COLLEGE                                          ","2003-2004",15,"Soccer",202489,175383,27106,120043,93744,26299,82446,81639,807,"46","46",18632,13120
"5880",139366,"COLUMBUS STATE UNIVERSITY                                   ","2003-2004",8,"Golf",115612,88508,27104,115612,88508,27104,0,0,0,"10",".",27800,0
"4286",175883,"JONES COUNTY JUNIOR COLLEGE                                 ","2003-2004",7,"Football",362600,335537,27063,362600,335537,27063,0,0,0,"55",".",79453,0
"7714",244437,"GEORGIA PERIMETER COLLEGE                                   ","2003-2004",15,"Soccer",212944,185882,27062,106472,93780,12692,106472,92102,14370,"31","22",48663,49097
"8488",163912,"ST MARY'S COLLEGE OF MARYLAND                               ","2003-2004",15,"Soccer",156008,128955,27053,85674,70418,15256,70334,58537,11797,"24","24",10800,10800
"17082",153144,"COE COLLEGE                                                 ","2003-2004",39,"Total Participants",531467,504428,27039,283573,267734,15839,247894,236694,11200,"322","198",184699,117966
"14037",218238,"LIMESTONE COLLEGE                                           ","2003-2004",26,"Volleyball",42750,15739,27011,0,0,0,42750,15739,27011,".","12",0,14200
"16067",221014,"MILLIGAN COLLEGE                                            ","2003-2004",39,"Total Participants",1358490,1331490,27000,680206,663706,16500,678284,667784,10500,"99","86",88625,86300
"16429",153366,"GRACELAND UNIVERSITY-LAMONI                                 ","2003-2004",39,"Total Participants",1434675,1407707,26968,785577,802564,-16987,649098,605143,43955,"310","191",271310,147024
"4917",147828,"OLIVET NAZARENE UNIVERSITY                                  ","2003-2004",7,"Football",426275,399311,26964,426275,399311,26964,0,0,0,"84",".",73216,0
"1566",163462,"MOUNT SAINT MARYS COLLEGE                                   ","2003-2004",1,"Baseball",195195,168269,26926,195195,168269,26926,0,0,0,"30",".",62345,0
"967",230737,"UTAH VALLEY STATE COLLEGE                                   ","2003-2004",1,"Baseball",205466,178563,26903,205466,178563,26903,0,0,0,"33",".",33928,0
"4116",192448,"LONG ISLAND UNIVERSITY-C W POST CAMPUS                      ","2003-2004",6,"Field hocky",171961,145093,26868,0,0,0,171961,145093,26868,".","22",0,39259
"16430",227243,"NORTHWOOD UNIVERSITY                                        ","2003-2004",39,"Total Participants",1135779,1108934,26845,661124,630311,30813,474655,478623,-3968,"70","45",103286,81354
"2176",148405,"ROCKFORD COLLEGE                                            ","2003-2004",2,"Basketball",133421,106587,26834,59998,54663,5335,73423,51924,21499,"13","10",30982,25483
"8618",157447,"NORTHERN KENTUCKY UNIVERSITY                                ","2003-2004",16,"Softball",217647,190822,26825,0,0,0,217647,190822,26825,".","24",0,54388
"16705",154688,"BAKER UNIVERSITY COLLEGE OF ARTS AND SCIENCES               ","2003-2004",39,"Total Participants",745519,718695,26824,367659,361774,5885,377860,356921,20939,"235","100",222182,132471
"17161",157863,"UNION COLLEGE                                               ","2003-2004",39,"Total Participants",908285,881500,26785,467635,460500,7135,440650,421000,19650,"143","65",111431,62119
"13180",177676,"JEFFERSON COLLEGE                                           ","2003-2004",26,"Volleyball",74127,47346,26781,0,0,0,74127,47346,26781,".","13",0,30038
"16840",172051,"SAGINAW VALLEY STATE UNIVERSITY                             ","2003-2004",39,"Total Participants",729638,702884,26754,358182,357462,720,371456,345422,26034,"303","115",415215,201819
"7062",231174,"UNIVERSITY OF VERMONT AND STATE AGRICULTURAL COLL           ","2003-2004",14,"Skiing",579864,553145,26719,289932,269442,20490,289932,283703,6229,"15","14",50562,50562
"15827",168290,"WHEELOCK COLLEGE                                            ","2003-2004",39,"Total Participants",26655,0,26655,0,0,0,26655,59540,-32885,"0","60",0,30000
"7490",148496,"DOMINICAN UNIVERSITY                                        ","2003-2004",15,"Soccer",76490,49861,26629,47023,30844,16179,29467,19017,10450,"30","17",17821,10549
"14565",192448,"LONG ISLAND UNIVERSITY-C W POST CAMPUS                      ","2003-2004",26,"Volleyball",165868,139243,26625,0,0,0,165868,139243,26625,".","10",0,25859
"7100",172440,"FINLANDIA UNIVERSITY                                        ","2003-2004",15,"Soccer",67892,41279,26613,33946,21803,12143,33946,19476,14470,"19","20",17003,11946
"14474",217484,"UNIVERSITY OF RHODE ISLAND                                  ","2003-2004",26,"Volleyball",558265,531663,26602,0,0,0,558265,531663,26602,".","15",0,71161
"4627",149514,"TRINITY INTERNATIONAL UNIVERSITY                            ","2003-2004",7,"Football",790831,764307,26524,790831,764307,26524,0,0,0,"55",".",110711,0
"4292",121901,"RIVERSIDE COMMUNITY COLLEGE                                 ","2003-2004",7,"Football",54000,27500,26500,54000,27500,26500,0,0,0,"90",".",23500,0
"6445",173665,"HAMLINE UNIVERSITY                                          ","2003-2004",10,"Ice Hockey",162766,136284,26482,91197,91138,59,71569,45146,26423,"27","17",56636,34260
"6810",212054,"DREXEL UNIVERSITY                                           ","2003-2004",11,"Lacrosse",813950,787504,26446,520284,489560,30724,293666,297944,-4278,"34","24",60784,30818
"16965",113236,"CYPRESS COLLEGE                                             ","2003-2004",39,"Total Participants",378297,351911,26386,186288,174331,11957,192009,177580,14429,"81","89",103600,94680
"9192",230737,"UTAH VALLEY STATE COLLEGE                                   ","2003-2004",16,"Softball",125918,99548,26370,0,0,0,125918,99548,26370,".","16",0,12902
"13796",102368,"TROY STATE UNIVERSITY-MAIN CAMPUS                           ","2003-2004",26,"Volleyball",282812,256446,26366,0,0,0,282812,256446,26366,".","11",0,32533
"16416",176318,"RUST COLLEGE                                                ","2003-2004",39,"Total Participants",80347,54056,26291,42114,29206,12908,38233,24850,13383,"72","63",31607,24563
"4415",201645,"CASE WESTERN RESERVE UNIVERSITY                             ","2003-2004",7,"Football",244633,218343,26290,244633,218343,26290,0,0,0,"78",".",76294,0
"886",227304,"ODESSA COLLEGE                                              ","2003-2004",1,"Baseball",213768,187510,26258,213768,187510,26258,0,0,0,"28",".",47524,0
"15056",151263,"UNIVERSITY OF INDIANAPOLIS                                  ","2003-2004",28,"Wrestling",179826,153595,26231,179826,153595,26231,0,0,0,"33","0",59552,0
"13265",142285,"UNIVERSITY OF IDAHO                                         ","2003-2004",26,"Volleyball",566531,540337,26194,0,0,0,566531,540337,26194,".","14",0,99767
"4619",212601,"GANNON UNIVERSITY                                           ","2003-2004",7,"Football",1033948,1007818,26130,1033948,1007818,26130,0,0,0,"74",".",88642,0
"3462",228802,"THE UNIVERSITY OF TEXAS AT TYLER                            ","2003-2004",2,"Basketball",176912,150783,26129,79051,65589,13462,97861,85194,12667,"19","17",28645,24088
"4328",122889,"SANTA BARBARA CITY COLLEGE                                  ","2003-2004",7,"Football",133534,107417,26117,133534,107417,26117,0,0,0,"58",".",39113,0
"16767",170082,"GRAND VALLEY STATE UNIVERSITY                               ","2003-2004",39,"Total Participants",2398842,2372741,26101,788988,771128,17860,1609854,1601613,8241,"287","213",516128,407671
"3921",149231,"SOUTHERN ILLINOIS UNIVERSITY-EDWARDSVILLE                   ","2003-2004",3,"All Track Combined",286855,260786,26069,140893,122334,18559,145962,138452,7510,"34","31",22789,29967
"8071",113333,"DE ANZA COLLEGE                                             ","2003-2004",15,"Soccer",86371,60351,26020,48598,24422,24176,37773,35929,1844,"27","23",21203,24422
"5545",217688,"CHARLESTON SOUTHERN UNIVERSITY                              ","2003-2004",8,"Golf",241179,215165,26014,121876,108869,13007,119303,106296,13007,"12","6",21690,21690
"15096",157863,"UNION COLLEGE                                               ","2003-2004",29,"Other Sports",81000,55000,26000,45000,40000,5000,36000,15000,21000,"12",".",4000,4000
"16166",155201,"INDEPENDENCE COMMUNITY COLLEGE                              ","2003-2004",39,"Total Participants",224841,198919,25922,111352,90860,20492,113489,108059,5430,"123","59",109828,56382
"10293",217484,"UNIVERSITY OF RHODE ISLAND                                  ","2003-2004",18,"Swimming and Diving",335826,309928,25898,132586,128424,4162,203240,181504,21736,"30","32",41539,42550
"12092",144865,"COLLEGE OF DUPAGE                                           ","2003-2004",24,"Track and Field, Outdoor",84475,58600,25875,44800,28700,16100,39675,29900,9775,"29","14",20800,14675
"6665",166850,"MERRIMACK COLLEGE                                           ","2003-2004",11,"Lacrosse",177620,151780,25840,95970,82446,13524,81650,69334,12316,"26","18",17959,10190
"651",169363,"CONCORDIA UNIVERSITY                                        ","2003-2004",1,"Baseball",281083,255300,25783,281083,255300,25783,0,0,0,"34",".",29000,0
"8499",204635,"OHIO NORTHERN UNIVERSITY                                    ","2003-2004",15,"Soccer",105244,79488,25756,61891,46176,15715,43353,33312,10041,"32","22",31622,23830
"3823",114813,"FRESNO PACIFIC UNIVERSITY                                   ","2003-2004",3,"All Track Combined",163543,137963,25580,74161,60704,13457,89382,77259,12123,"18","21",20097,30296
"7289",230737,"UTAH VALLEY STATE COLLEGE                                   ","2003-2004",15,"Soccer",220029,194494,25535,0,0,0,220029,194494,25535,".","26",0,19894
"7178",110486,"CALIFORNIA STATE UNIVERSITY-BAKERSFIELD                     ","2003-2004",15,"Soccer",342820,317297,25523,183764,166563,17201,159056,150734,8322,"22","28",17565,18078
"11463",219949,"CUMBERLAND UNIVERSITY                                       ","2003-2004",22,"Tennis",185935,160422,25513,114744,97670,17074,71191,62752,8439,"7","6",6014,3894
"7330",157951,"WESTERN KENTUCKY UNIVERSITY                                 ","2003-2004",15,"Soccer",722315,696872,25443,294363,274780,19583,427952,422092,5860,"23","26",44728,95304
"13904",237312,"UNIVERSITY OF CHARLESTON                                    ","2003-2004",26,"Volleyball",84019,58645,25374,0,0,0,84019,58645,25374,".","22",0,19401
"5020",125028,"VENTURA COLLEGE                                             ","2003-2004",7,"Football",179529,154173,25356,179529,154173,25356,0,0,0,"71",".",26439,0
"3690",235316,"GONZAGA UNIVERSITY                                          ","2003-2004",3,"All Track Combined",79124,53794,25330,39562,26897,12665,39562,26897,12665,"12","13",14023,14023
"15885",181783,"WAYNE STATE COLLEGE                                         ","2003-2004",39,"Total Participants",656275,630958,25317,214305,201214,13091,441970,429744,12226,"161","84",189344,140581
"3371",190983,"ELMIRA COLLEGE                                              ","2003-2004",2,"Basketball",179354,154179,25175,96189,74924,21265,83165,79255,3910,"14","12",29393,25189
"2688",176318,"RUST COLLEGE                                                ","2003-2004",2,"Basketball",78118,53079,25039,39279,26340,12939,38839,26739,12100,"18","15",19294,14268
"89",101028,"CHATTAHOOCHEE VALLEY COMMUNITY COLLEGE                      ","2003-2004",1,"Baseball",61894,36874,25020,61894,36874,25020,0,0,0,"24",".",25020,0
"7013",131469,"GEORGE WASHINGTON UNIVERSITY                                ","2003-2004",13,"Rowing",368223,343283,24940,166075,156852,9223,202148,186431,15717,"29","59",35865,37388
"3341",171599,"OLIVET COLLEGE                                              ","2003-2004",2,"Basketball",141975,117055,24920,75301,53507,21794,66674,63548,3126,"38","16",14463,14588
"14602",146339,"JUDSON COLLEGE                                              ","2003-2004",26,"Volleyball",98804,73912,24892,0,0,0,98804,73912,24892,".","8",0,13697
"851",110574,"CALIFORNIA STATE UNIVERSITY-HAYWARD                         ","2003-2004",1,"Baseball",162071,137226,24845,162071,137226,24845,0,0,0,"27",".",69602,0
"8290",209056,"LEWIS &amp; CLARK COLLEGE                                       ","2003-2004",15,"Soccer",88039,63211,24828,0,0,0,88039,63211,24828,".","26",0,17294
"2462",183239,"SAINT ANSELM COLLEGE                                        ","2003-2004",2,"Basketball",965995,941180,24815,498515,474862,23653,467480,466318,1162,"13","14",30063,37846
"14733",191241,"FORDHAM UNIVERSITY                                          ","2003-2004",27,"Water Polo",58333,33537,24796,58333,33537,24796,0,0,0,"13","0",11041,0
"12373",167996,"STONEHILL COLLEGE                                           ","2003-2004",25,"Track and Field, X-Country",66806,42022,24784,34909,20976,13933,31897,21046,10851,"15","21",9772,9863
"1626",107044,"HARDING UNIVERSITY                                          ","2003-2004",2,"Basketball",106498,81747,24751,55119,41678,13441,51379,40069,11310,"13","12",34133,32614
"3077",131450,"GALLAUDET UNIVERSITY                                        ","2003-2004",2,"Basketball",102026,77339,24687,65312,40625,24687,36714,36714,0,"14","11",34125,26054
"9677",233277,"RADFORD UNIVERSITY                                          ","2003-2004",16,"Softball",161554,136886,24668,0,0,0,161554,136886,24668,".","16",0,59667
"5177",178420,"UNIVERSITY OF MISSOURI-ST LOUIS                             ","2003-2004",8,"Golf",48919,24277,24642,21065,10827,10238,27854,13450,14404,"9","6",10818,10196
"9393",220598,"LANE COLLEGE                                                ","2003-2004",16,"Softball",38080,13449,24631,0,0,0,38080,13449,24631,".","14",0,6686
"1410",220598,"LANE COLLEGE                                                ","2003-2004",1,"Baseball",42840,18229,24611,42840,18229,24611,0,0,0,"15",".",7510,0
"10834",182670,"DARTMOUTH COLLEGE                                           ","2003-2004",22,"Tennis",267408,242830,24578,132549,119937,12612,134859,122893,11966,"18","12",36858,35149
"8040",164562,"ASSUMPTION COLLEGE                                          ","2003-2004",15,"Soccer",100604,76069,24535,48825,32194,16631,51779,43875,7904,"17","23",11500,12000
"4542",217536,"SALVE REGINA UNIVERSITY                                     ","2003-2004",7,"Football",82914,58422,24492,82914,58422,24492,0,0,0,"70",".",45422,0
"3843",214591,"PENNSYLVANIA STATE UNIV-PENN ST ERIE-BEHREND COLL           ","2003-2004",3,"All Track Combined",64419,39930,24489,32209,19965,12244,32210,19965,12245,"63","40",17144,17144
"6901",190099,"COLGATE UNIVERSITY                                          ","2003-2004",13,"Rowing",453515,429039,24476,176816,182252,-5436,276699,246787,29912,"23","52",38719,43124
"13011",137847,"THE UNIVERSITY OF TAMPA                                     ","2003-2004",26,"Volleyball",274492,250037,24455,0,0,0,274492,250037,24455,".","15",0,43740
"13003",114813,"FRESNO PACIFIC UNIVERSITY                                   ","2003-2004",26,"Volleyball",104895,80445,24450,0,0,0,104895,80445,24450,".","14",0,43536
"16286",197221,"WEBB INSTITUTE                                              ","2003-2004",39,"Total Participants",24450,0,24450,24450,24450,0,0,0,0,"83","0",15949,0
"13146",178217,"MINERAL AREA COLLEGE                                        ","2003-2004",26,"Volleyball",122750,98314,24436,0,0,0,122750,98314,24436,".","12",0,18558
"14347",215284,"UNIVERSITY OF PITTSBURGH-JOHNSTOWN                          ","2003-2004",26,"Volleyball",119912,95485,24427,0,0,0,119912,95485,24427,".","20",0,7953
"15999",150941,"HUNTINGTON COLLEGE                                          ","2003-2004",39,"Total Participants",582866,558439,24427,299348,286630,12718,283518,271809,11709,"98","83",94157,71098
"16697",231581,"BRIDGEWATER COLLEGE                                         ","2003-2004",39,"Total Participants",559121,534694,24427,246239,234131,12108,312882,300563,12319,"347","194",260062,153539
"698",110246,"BUTTE COLLEGE                                               ","2003-2004",1,"Baseball",58436,34037,24399,58436,34037,24399,0,0,0,"29",".",27807,0
"10675",170532,"KALAMAZOO COLLEGE                                           ","2003-2004",22,"Tennis",65112,40730,24382,53078,27361,25717,12034,13369,-1335,"15","14",8141,7825
"15784",148405,"ROCKFORD COLLEGE                                            ","2003-2004",39,"Total Participants",230045,205690,24355,123326,112767,10559,106719,92923,13796,"123","55",147855,60062
"9665",239716,"SAINT NORBERT COLLEGE                                       ","2003-2004",16,"Softball",69921,45621,24300,0,0,0,69921,45621,24300,".","16",0,34371
"2005",134945,"JACKSONVILLE UNIVERSITY                                     ","2003-2004",2,"Basketball",1343706,1319413,24293,763799,740178,23621,579907,579235,672,"12","16",105181,80561
"12573",196158,"SUNY COLLEGE AT FREDONIA                                    ","2003-2004",25,"Track and Field, X-Country",193036,168764,24272,92682,79856,12826,100354,88908,11446,"48","63",29701,36009
"1112",207263,"NORTHEASTERN STATE UNIVERSITY                               ","2003-2004",1,"Baseball",116706,92464,24242,116706,92464,24242,0,0,0,"41",".",25695,0
"11050",166850,"MERRIMACK COLLEGE                                           ","2003-2004",22,"Tennis",53754,29534,24220,15418,9767,5651,38336,19767,18569,"8","9",3907,3907
"16568",191302,"FULTON-MONTGOMERY COMMUNITY COLLEGE                         ","2003-2004",39,"Total Participants",64163,39949,24214,39358,19634,19724,24805,20315,4490,"56","40",20890,20880
"8626",131113,"WILMINGTON COLLEGE                                          ","2003-2004",16,"Softball",114164,90036,24128,0,0,0,114164,90036,24128,".","13",0,38005
"3614",147828,"OLIVET NAZARENE UNIVERSITY                                  ","2003-2004",3,"All Track Combined",174284,150172,24112,87142,75086,12056,87142,75086,12056,"26","22",20166,20166
"7779",138354,"THE UNIVERSITY OF WEST FLORIDA                              ","2003-2004",15,"Soccer",402800,378692,24108,175928,180158,-4230,226872,198534,28338,"25","24",30008,39145
"2536",225371,"HILL COLLEGE                                                ","2003-2004",2,"Basketball",116065,91976,24089,55057,41760,13297,61008,50216,10792,"11","18",13296,10791
"6523",130226,"QUINNIPIAC UNIVERSITY                                       ","2003-2004",10,"Ice Hockey",1588205,1564143,24062,815513,762673,52840,772692,801470,-28778,"28","23",240479,194070
"3160",188429,"ADELPHI UNIVERSITY                                          ","2003-2004",2,"Basketball",408935,384874,24061,235519,224257,11262,173416,160617,12799,"13","11",42641,28811
"13763",125763,"WHITTIER COLLEGE                                            ","2003-2004",26,"Volleyball",47890,23876,24014,0,0,0,47890,23876,24014,".","15",0,13905
"191",101693,"UNIVERSITY OF MOBILE                                        ","2003-2004",1,"Baseball",249902,226022,23880,249902,226022,23880,0,0,0,"25",".",27885,0
"5691",198561,"GARDNER-WEBB UNIVERSITY                                     ","2003-2004",8,"Golf",253584,229771,23813,126692,119700,6992,126892,110071,16821,"11","7",19915,15340
"5645",100663,"UNIVERSITY OF ALABAMA AT BIRMINGHAM                         ","2003-2004",8,"Golf",324204,300463,23741,165222,141481,23741,158982,158982,0,"11","8",31798,38412
"4845",167996,"STONEHILL COLLEGE                                           ","2003-2004",7,"Football",288964,265335,23629,288964,265335,23629,0,0,0,"60",".",44603,0
"2809",210429,"WESTERN OREGON UNIVERSITY                                   ","2003-2004",2,"Basketball",267866,244248,23618,151791,132705,19086,116075,111543,4532,"16","14",56189,47807
"16219",177995,"LONGVIEW COMMUNITY COLLEGE                                  ","2003-2004",39,"Total Participants",201778,178192,23586,115647,97906,17741,86131,80286,5845,"32","15",39723,25177
"15927",184612,"FELICIAN COLLEGE                                            ","2003-2004",39,"Total Participants",854135,830574,23561,508629,503353,5276,345506,327221,18285,"76","53",180245,113428
"15716",179326,"SOUTHWEST BAPTIST UNIVERSITY                                ","2003-2004",39,"Total Participants",1135930,1112377,23553,410425,398185,12240,725505,714192,11313,"156","90",172059,142089
"2143",167260,"NICHOLS COLLEGE                                             ","2003-2004",2,"Basketball",87415,63903,23512,39784,30626,9158,47631,33277,14354,"12","14",22626,25277
"16834",128391,"WESTERN STATE COLLEGE OF COLORADO                           ","2003-2004",39,"Total Participants",965198,941688,23510,590600,640532,-49932,374598,301156,73442,"334","140",207097,109448
"10491",218238,"LIMESTONE COLLEGE                                           ","2003-2004",19,"Swimming",30600,7107,23493,0,0,0,30600,7107,23493,".","12",0,5280
"342",239716,"SAINT NORBERT COLLEGE                                       ","2003-2004",1,"Baseball",70283,46792,23491,70283,46792,23491,0,0,0,"32",".",35682,0
"16719",138789,"ARMSTRONG ATLANTIC STATE UNIVERSITY                         ","2003-2004",39,"Total Participants",822820,799401,23419,361173,330422,30751,461647,468979,-7332,"52","51",311429,402271
"3449",216807,"WESTMINSTER COLLEGE                                         ","2003-2004",2,"Basketball",179638,156283,23355,123447,90644,32803,56191,65639,-9448,"15","14",24674,21601
"11507",207263,"NORTHEASTERN STATE UNIVERSITY                               ","2003-2004",22,"Tennis",117530,94193,23337,0,0,0,117530,94193,23337,".","8",0,18575
"17038",148007,"PRAIRIE STATE COLLEGE                                       ","2003-2004",39,"Total Participants",112500,89175,23325,60500,48875,11625,52000,40300,11700,"64","54",60700,55550
"17111",204945,"OWENS COMMUNITY COLLEGE                                     ","2003-2004",39,"Total Participants",195488,172219,23269,94132,86143,7989,101356,86076,15280,"57","42",34157,52093
"16045",122889,"SANTA BARBARA CITY COLLEGE                                  ","2003-2004",39,"Total Participants",337017,313755,23262,182685,169588,13097,154332,144167,10165,"165","90",142954,56221
"10310",125763,"WHITTIER COLLEGE                                            ","2003-2004",18,"Swimming and Diving",54800,31635,23165,28800,15060,13740,26000,16575,9425,"14","17",4000,5204
"7651",183239,"SAINT ANSELM COLLEGE                                        ","2003-2004",15,"Soccer",89403,66284,23119,50878,34454,16424,38525,31830,6695,"25","24",21522,20665
"2569",143215,"SOUTHWESTERN ILLINOIS COLLEGE                               ","2003-2004",2,"Basketball",281157,258062,23095,174865,155687,19178,106292,102375,3917,"17","12",20039,15293
"11715",102049,"SAMFORD UNIVERSITY                                          ","2003-2004",22,"Tennis",384393,361322,23071,167817,171551,-3734,216576,189771,26805,"9","9",15252,18252
"14509",240329,"UNIVERSITY OF WISCONSIN-LA CROSSE                           ","2003-2004",26,"Volleyball",174961,151892,23069,0,0,0,174961,151892,23069,".","18",0,35654
"2963",146296,"JOLIET JUNIOR COLLEGE                                       ","2003-2004",2,"Basketball",66000,43000,23000,37500,23000,14500,28500,20000,8500,"15","15",6000,6000
"3081",176460,"WESLEY COLLEGE                                              ","2003-2004",2,"Basketball",23000,0,23000,23000,23000,0,0,0,0,"13",".",12000,0
"4421",206817,"BACONE COLLEGE                                              ","2003-2004",7,"Football",720000,697000,23000,720000,697000,23000,0,0,0,"60",".",112021,0
"17053",183655,"ATLANTIC CAPE COMMUNITY COLLEGE                             ","2003-2004",39,"Total Participants",35000,12000,23000,25000,7000,18000,10000,5000,5000,"25","21",17000,4000
"237",219976,"DAVID LIPSCOMB UNIVERSITY                                   ","2003-2004",1,"Baseball",500789,477837,22952,500789,477837,22952,0,0,0,"41",".",116423,0
"16292",141486,"CHAMINADE UNIVERSITY OF HONOLULU                            ","2003-2004",39,"Total Participants",143314,120372,22942,37038,35478,1560,106276,84894,21382,"35","40",92670,75117
"7232",110592,"CALIFORNIA STATE UNIVERSITY-LOS ANGELES                     ","2003-2004",15,"Soccer",275384,252460,22924,129285,114457,14828,146099,138003,8096,"24","24",18436,21736
"1793",226578,"MCLENNAN COMMUNITY COLLEGE                                  ","2003-2004",2,"Basketball",221635,198736,22899,107890,97699,10191,113745,101037,12708,"15","17",18712,25500
"13956",155089,"FRIENDS UNIVERSITY                                          ","2003-2004",26,"Volleyball",63195,40306,22889,0,0,0,63195,40306,22889,".","12",0,18477
"5722",142328,"LEWIS-CLARK STATE COLLEGE                                   ","2003-2004",8,"Golf",51180,28320,22860,25590,12852,12738,25590,15468,10122,"12","7",6755,6740
"15649",177542,"HANNIBAL-LAGRANGE COLLEGE                                   ","2003-2004",39,"Total Participants",631063,608207,22856,297486,301185,-3699,333577,307022,26555,"74","85",55429,49210
"10136",121150,"PEPPERDINE UNIVERSITY                                       ","2003-2004",18,"Swimming and Diving",273570,250717,22853,0,0,0,273570,250717,22853,".","32",0,23921
"9646",225070,"GRAYSON COUNTY COLLEGE                                      ","2003-2004",16,"Softball",131576,108725,22851,0,0,0,131576,108725,22851,".","26",0,26025
"4549",181783,"WAYNE STATE COLLEGE                                         ","2003-2004",7,"Football",426557,403727,22830,426557,403727,22830,0,0,0,"72",".",74227,0
"8057",151263,"UNIVERSITY OF INDIANAPOLIS                                  ","2003-2004",15,"Soccer",395968,373154,22814,186355,172948,13407,209613,200206,9407,"30","22",20986,29477
"9719",217688,"CHARLESTON SOUTHERN UNIVERSITY                              ","2003-2004",16,"Softball",257186,234394,22792,0,0,0,257186,234394,22792,".","18",0,41565
"1619",144962,"ELMHURST COLLEGE                                            ","2003-2004",2,"Basketball",179406,156732,22674,105374,91527,13847,74032,65205,8827,"27","14",31726,22115
"17187",439145,"PIERCE COLLEGE AT PUYALLUP                                  ","2003-2004",39,"Total Participants",135727,113097,22630,74138,61182,12956,61589,51915,9674,"47","30",29410,28271
"6929",161086,"COLBY COLLEGE                                               ","2003-2004",13,"Rowing",117837,95210,22627,20309,20157,152,97528,75053,22475,"24","38",15941,68459
"4044",182795,"FRANKLIN PIERCE COLLEGE                                     ","2003-2004",6,"Field hocky",64484,41938,22546,0,0,0,64484,41938,22546,".","23",0,19320
"5622",230807,"WESTMINSTER COLLEGE                                         ","2003-2004",8,"Golf",39666,17120,22546,19833,8560,11273,19833,8560,11273,"8","7",8560,8561
"6588",186131,"PRINCETON UNIVERSITY                                        ","2003-2004",11,"Lacrosse",796259,773732,22527,511934,478965,32969,284325,294767,-10442,"46","27",181974,63223
"9936",176053,"MISSISSIPPI COLLEGE                                         ","2003-2004",16,"Softball",96236,73723,22513,0,0,0,96236,73723,22513,".","17",0,29079
"7345",153250,"DORDT COLLEGE                                               ","2003-2004",15,"Soccer",120639,98139,22500,61844,50344,11500,58795,47795,11000,"19","20",7739,8876
"16460",227429,"PAUL QUINN COLLEGE                                          ","2003-2004",39,"Total Participants",137437,114940,22497,79719,77423,2296,57718,37517,20201,"125","55",155324,40528
"2183",133951,"FLORIDA INTERNATIONAL UNIVERSITY                            ","2003-2004",2,"Basketball",1908056,1885583,22473,1092871,1075616,17255,815185,809967,5218,"17","15",213388,159982
"15220",163453,"MORGAN STATE UNIVERSITY                                     ","2003-2004",33,"Bowling",99235,76783,22452,0,0,0,99235,76783,22452,".","5",0,15831
"11124",215062,"UNIVERSITY OF PENNSYLVANIA                                  ","2003-2004",22,"Tennis",257103,234661,22442,130352,113851,16501,126751,120810,5941,"15","14",41258,47965
"3154",210331,"WESTERN BAPTIST COLLEGE                                     ","2003-2004",2,"Basketball",116194,93757,22437,64750,49997,14753,51444,43760,7684,"14","13",25584,19347
"4544",118976,"MODESTO JUNIOR COLLEGE                                      ","2003-2004",7,"Football",158898,136469,22429,158898,136469,22429,0,0,0,"69",".",27406,0
"3018",150455,"EARLHAM COLLEGE                                             ","2003-2004",2,"Basketball",129855,107436,22419,68761,57359,11402,61094,50077,11017,"16","13",20122,15783
"9278",120537,"HOPE INTERNATIONAL UNIVERSITY                               ","2003-2004",16,"Softball",51601,29220,22381,0,0,0,51601,29220,22381,".","15",0,28720
"2595",191302,"FULTON-MONTGOMERY COMMUNITY COLLEGE                         ","2003-2004",2,"Basketball",40890,18518,22372,19865,8975,10890,21025,9543,11482,"11","8",7432,8544
"8307",167260,"NICHOLS COLLEGE                                             ","2003-2004",15,"Soccer",77145,54806,22339,25518,24515,1003,51627,30291,21336,"24","15",18515,17876
"5074",144892,"EASTERN ILLINOIS UNIVERSITY                                 ","2003-2004",7,"Football",1270314,1248011,22303,1270314,1248011,22303,0,0,0,"88",".",241739,0
"3386",158431,"BOSSIER PARISH COMMUNITY COLLEGE                            ","2003-2004",2,"Basketball",84557,62259,22298,84557,62259,22298,0,0,0,"18",".",21914,0
"10378",144865,"COLLEGE OF DUPAGE                                           ","2003-2004",18,"Swimming and Diving",39550,17300,22250,10950,5200,5750,28600,12100,16500,"9","15",4950,8600
"2704",207290,"NORTHEASTERN OKLAHOMA AGRICULTURAL AND MECH COLL            ","2003-2004",2,"Basketball",133162,110917,22245,67844,60902,6942,65318,50015,15303,"12","14",26600,24050
"3104",211608,"CHEYNEY UNIVERSITY OF PENNSYLVANIA                          ","2003-2004",2,"Basketball",318109,295869,22240,152053,136229,15824,166056,159640,6416,"12","13",37865,56719
"4697",143084,"AUGUSTANA COLLEGE                                           ","2003-2004",7,"Football",407014,384780,22234,407014,384780,22234,0,0,0,"130",".",46092,0
"15213",232937,"NORFOLK STATE UNIVERSITY                                    ","2003-2004",33,"Bowling",39826,17631,22195,0,0,0,39826,17631,22195,".","5",0,12631
"2546",199148,"UNIVERSITY OF NORTH CAROLINA AT GREENSBORO                  ","2003-2004",2,"Basketball",1280807,1258620,22187,674381,658374,16007,606426,600246,6180,"16","16",132773,90361
"14029",199209,"NORTH CAROLINA WESLEYAN COLLEGE                             ","2003-2004",26,"Volleyball",41256,19076,22180,0,0,0,41256,19076,22180,".","14",0,4149
"409",215266,"UNIVERSITY OF PITTSBURGH-BRADFORD                           ","2003-2004",1,"Baseball",89351,67245,22106,89351,67245,22106,0,0,0,"27",".",23474,0
"16431",144962,"ELMHURST COLLEGE                                            ","2003-2004",39,"Total Participants",498850,476761,22089,200162,205891,-5729,298688,270870,27818,"217","121",153204,137063
"12157",220598,"LANE COLLEGE                                                ","2003-2004",24,"Track and Field, Outdoor",28560,6472,22088,14280,3495,10785,14280,2977,11303,"16","15",1914,1631
"12885",220598,"LANE COLLEGE                                                ","2003-2004",25,"Track and Field, X-Country",28560,6472,22088,14280,3495,10785,14280,2977,11303,"10","7",1914,1631
"9603",232557,"LIBERTY UNIVERSITY                                          ","2003-2004",16,"Softball",104321,82249,22072,0,0,0,104321,82249,22072,".","20",0,71549
"12624",216278,"SUSQUEHANNA UNIVERSITY                                      ","2003-2004",25,"Track and Field, X-Country",90240,68184,22056,49070,36779,12291,41170,31405,9765,"60","32",19001,16024
"5032",191083,"ERIE COMMUNITY COLLEGE                                      ","2003-2004",7,"Football",127807,105759,22048,127807,105759,22048,0,0,0,"87",".",36526,0
"5556",366711,"CALIFORNIA STATE UNIVERSITY-SAN MARCOS                      ","2003-2004",8,"Golf",141634,119614,22020,72271,61604,10667,69363,58010,11353,"10","7",19394,15800
"16208",243133,"UNIVERSITY OF PUERTO RICO-BAYAMON                           ","2003-2004",39,"Total Participants",122000,100006,21994,74500,57854,16646,47500,42152,5348,"152","69",20759,17567
"13450",126119,"YUBA COLLEGE                                                ","2003-2004",26,"Volleyball",41800,19860,21940,0,0,0,41800,19860,21940,".","11",0,11360
"11540",218441,"NORTH GREENVILLE COLLEGE                                    ","2003-2004",22,"Tennis",31158,9265,21893,15579,4478,11101,15579,4787,10792,"12","11",4432,4200
"2054",200253,"MINOT STATE UNIVERSITY                                      ","2003-2004",2,"Basketball",93076,71226,21850,44180,31726,12454,48896,39500,9396,"14","15",24587,27314
"2033",181783,"WAYNE STATE COLLEGE                                         ","2003-2004",2,"Basketball",478998,457216,21782,246927,242992,3935,232071,214224,17847,"18","12",36569,33227
"15799",113333,"DE ANZA COLLEGE                                             ","2003-2004",39,"Total Participants",299078,277383,21695,137631,154917,-17286,161447,122466,38981,"183","103",104154,72185
"8535",163268,"UNIVERSITY OF MARYLAND-BALTIMORE COUNTY                     ","2003-2004",16,"Softball",100047,78353,21694,0,0,0,100047,78353,21694,".","19",0,42255
"7481",148405,"ROCKFORD COLLEGE                                            ","2003-2004",15,"Soccer",53212,31520,21692,27248,16026,11222,25964,15494,10470,"15","16",7091,5959
"3159",201645,"CASE WESTERN RESERVE UNIVERSITY                             ","2003-2004",2,"Basketball",254187,232601,21586,119179,97694,21485,135008,134907,101,"15","15",55600,67832
"14738",213987,"MERCYHURST COLLEGE                                          ","2003-2004",27,"Water Polo",151469,129900,21569,44373,47200,-2827,107096,82700,24396,"10","15",8200,9200
"10360",233277,"RADFORD UNIVERSITY                                          ","2003-2004",18,"Swimming and Diving",86198,64652,21546,0,0,0,86198,64652,21546,".","22",0,34841
"1217",213987,"MERCYHURST COLLEGE                                          ","2003-2004",1,"Baseball",270423,248900,21523,270423,248900,21523,0,0,0,"34",".",37300,0
"8132",230807,"WESTMINSTER COLLEGE                                         ","2003-2004",15,"Soccer",95843,74327,21516,95843,74327,21516,0,0,0,"24",".",74328,0
"9114",221096,"MOTLOW STATE COMMUNITY COLLEGE                              ","2003-2004",16,"Softball",79525,58032,21493,0,0,0,79525,58032,21493,".","17",0,20094
"16218",137032,"SAINT LEO UNIVERSITY                                        ","2003-2004",39,"Total Participants",602078,580585,21493,294025,280527,13498,308053,300058,7995,"94","82",176191,149893
"16987",143215,"SOUTHWESTERN ILLINOIS COLLEGE                               ","2003-2004",39,"Total Participants",435203,413728,21475,207730,201784,5946,227473,211944,15529,"80","65",53133,49273
"1849",178411,"UNIVERSITY OF MISSOURI-ROLLA                                ","2003-2004",2,"Basketball",575257,553786,21471,291909,270911,20998,283348,282875,473,"12","17",43126,41244
"3171",151306,"UNIVERSITY OF SOUTHERN INDIANA                              ","2003-2004",2,"Basketball",655107,633646,21461,406952,355479,51473,248155,278167,-30012,"17","14",110783,73204
"9273",172051,"SAGINAW VALLEY STATE UNIVERSITY                             ","2003-2004",16,"Softball",114096,92642,21454,0,0,0,114096,92642,21454,".","21",0,43264
"17176",121363,"PORTERVILLE COLLEGE                                         ","2003-2004",39,"Total Participants",89400,68000,21400,37200,30000,7200,52200,38000,14200,"75","46",3285,6204
"9076",216931,"WILKES UNIVERSITY                                           ","2003-2004",16,"Softball",74832,53443,21389,0,0,0,74832,53443,21389,".","14",0,10619
"9966",190099,"COLGATE UNIVERSITY                                          ","2003-2004",16,"Softball",633308,611921,21387,0,0,0,633308,611921,21387,".","17",0,50405
"1460",228802,"THE UNIVERSITY OF TEXAS AT TYLER                            ","2003-2004",1,"Baseball",93442,72087,21355,93442,72087,21355,0,0,0,"38",".",37595,0
"10385",214591,"PENNSYLVANIA STATE UNIV-PENN ST ERIE-BEHREND COLL           ","2003-2004",18,"Swimming and Diving",40525,19178,21347,20263,9589,10674,20262,9589,10673,"14","10",8870,8870
"3101",129941,"UNIVERSITY OF NEW HAVEN                                     ","2003-2004",2,"Basketball",798589,777256,21333,416427,416115,312,382162,361141,21021,"14","14",27525,27228
"16982",110246,"BUTTE COLLEGE                                               ","2003-2004",39,"Total Participants",219080,197774,21306,94774,81614,13160,124306,116160,8146,"190","84",190489,120248
"7359",196130,"SUNY COLLEGE AT BUFFALO                                     ","2003-2004",15,"Soccer",165070,143860,21210,85893,68939,16954,79177,74921,4256,"24","22",16898,21098
"8256",146393,"KENDALL COLLEGE                                             ","2003-2004",15,"Soccer",89083,67883,21200,89083,67883,21200,0,0,0,"17","0",14691,0
"8262",190099,"COLGATE UNIVERSITY                                          ","2003-2004",15,"Soccer",609591,588410,21181,352893,355486,-2593,256698,232924,23774,"23","22",33548,58844
"4950",181446,"NEBRASKA WESLEYAN UNIVERSITY                                ","2003-2004",7,"Football",130108,109022,21086,130108,109022,21086,0,0,0,"106",".",31952,0
"5001",212656,"GENEVA COLLEGE                                              ","2003-2004",7,"Football",720456,699380,21076,720456,699380,21076,0,0,0,"73",".",127258,0
"14802",191649,"HOFSTRA UNIVERSITY                                          ","2003-2004",28,"Wrestling",494832,473768,21064,494832,473768,21064,0,0,0,"26",".",105028,0
"5197",218070,"FURMAN UNIVERSITY                                           ","2003-2004",8,"Golf",605313,584283,21030,228162,259570,-31408,377151,324713,52438,"16","8",45123,31999
"17037",107044,"HARDING UNIVERSITY                                          ","2003-2004",39,"Total Participants",197574,176559,21015,105957,96086,9871,91617,80473,11144,"229","80",209502,105367
"3514",153250,"DORDT COLLEGE                                               ","2003-2004",3,"All Track Combined",167742,146742,21000,83871,73371,10500,83871,73371,10500,"32","31",12146,12146
"9909",171599,"OLIVET COLLEGE                                              ","2003-2004",16,"Softball",62315,41365,20950,0,0,0,62315,41365,20950,".","24",0,13313
"11094",158802,"DILLARD UNIVERSITY                                          ","2003-2004",22,"Tennis",161039,140100,20939,90989,70050,20939,70050,70050,0,"1","6",15000,11675
"11987",168546,"ALBION COLLEGE                                              ","2003-2004",24,"Track and Field, Outdoor",117854,96925,20929,65207,51779,13428,52647,45146,7501,"43","39",29040,26009
"11950",125028,"VENTURA COLLEGE                                             ","2003-2004",24,"Track and Field, Outdoor",63873,42945,20928,31619,19313,12306,32254,23632,8622,"22","7",6240,4187
"12959",199582,"SAINT AUGUSTINES COLLEGE                                    ","2003-2004",25,"Track and Field, X-Country",74485,53607,20878,28702,24429,4273,45783,29178,16605,"6","7",2894,4125
"9477",171492,"NORTHWOOD UNIVERSITY                                        ","2003-2004",16,"Softball",205429,184588,20841,0,0,0,205429,184588,20841,".","15",0,40606
"16668",215929,"UNIVERSITY OF SCRANTON                                      ","2003-2004",39,"Total Participants",654596,633787,20809,322474,300360,22114,332122,333427,-1305,"200","164",150406,161602
"2095",221014,"MILLIGAN COLLEGE                                            ","2003-2004",2,"Basketball",337944,317148,20796,190196,170400,19796,147748,146748,1000,"14","13",19500,19000
"14470",240189,"UNIVERSITY OF WISCONSIN-WHITEWATER                          ","2003-2004",26,"Volleyball",83932,63151,20781,0,0,0,83932,63151,20781,".","19",0,18748
"767",231554,"BLUEFIELD COLLEGE                                           ","2003-2004",1,"Baseball",146070,125313,20757,146070,125313,20757,0,0,0,"20",".",28484,0
"8449",146348,"KANKAKEE COMMUNITY COLLEGE                                  ","2003-2004",15,"Soccer",38000,17251,20749,38000,17251,20749,0,0,0,"12",".",9651,0
"9380",222178,"ABILENE CHRISTIAN UNIVERSITY                                ","2003-2004",16,"Softball",274054,253357,20697,0,0,0,274054,253357,20697,".","16",0,38310
"2805",186876,"THE RICHARD STOCKTON COLLEGE OF NEW JERSEY                  ","2003-2004",2,"Basketball",229600,208934,20666,120394,106888,13506,109206,102046,7160,"16","15",24392,23434
"10485",211158,"BLOOMSBURG UNIVERSITY OF PENNSYLVANIA                       ","2003-2004",19,"Swimming",142810,122220,20590,91273,59886,31387,51537,62334,-10797,"24","21",11486,12075
"2981",157076,"KENTUCKY WESLEYAN COLLEGE                                   ","2003-2004",2,"Basketball",587149,566571,20578,333671,315267,18404,253478,251304,2174,"14","13",45441,35618
"1192",220631,"LINCOLN MEMORIAL UNIVERSITY                                 ","2003-2004",1,"Baseball",277834,257303,20531,277834,257303,20531,0,0,0,"26",".",115945,0
"7776",207306,"NORTHWESTERN OKLAHOMA STATE UNIVERSITY                      ","2003-2004",15,"Soccer",68417,47894,20523,0,0,0,68417,47894,20523,".","23",0,15857
"16691",215266,"UNIVERSITY OF PITTSBURGH-BRADFORD                           ","2003-2004",39,"Total Participants",255189,234667,20522,137080,116477,20603,118109,118190,-81,"82","66",72736,69020
"5226",146719,"LOYOLA UNIVERSITY CHICAGO                                   ","2003-2004",8,"Golf",242478,221968,20510,133883,113648,20235,108595,108320,275,"9","7",22846,23108
"7086",210304,"WARNER PACIFIC COLLEGE                                      ","2003-2004",15,"Soccer",59343,38901,20442,43063,24815,18248,16280,14086,2194,"16","13",12815,7086
"9617",146339,"JUDSON COLLEGE                                              ","2003-2004",16,"Softball",87911,67503,20408,0,0,0,87911,67503,20408,".","12",0,17376
"2414",231059,"SAINT MICHAELS COLLEGE                                      ","2003-2004",2,"Basketball",1147839,1127532,20307,575369,570162,5207,572470,557370,15100,"13","14",33511,36266
"13816",146348,"KANKAKEE COMMUNITY COLLEGE                                  ","2003-2004",26,"Volleyball",45000,24694,20306,0,0,0,45000,24694,20306,".","15",0,18890
"2636",176053,"MISSISSIPPI COLLEGE                                         ","2003-2004",2,"Basketball",328692,308425,20267,179354,172706,6648,149338,135719,13619,"33","15",66246,42338
"5914",227304,"ODESSA COLLEGE                                              ","2003-2004",8,"Golf",121698,101433,20265,121698,101433,20265,0,0,0,"17",".",35631,0
"9908",146348,"KANKAKEE COMMUNITY COLLEGE                                  ","2003-2004",16,"Softball",45000,24750,20250,0,0,0,45000,24750,20250,".","16",0,17305
"7386",110413,"CALIFORNIA LUTHERAN UNIVERSITY                              ","2003-2004",15,"Soccer",124882,104648,20234,62866,35360,27506,62016,69288,-7272,"30","23",22187,22252
"4272",107044,"HARDING UNIVERSITY                                          ","2003-2004",7,"Football",126595,106369,20226,126595,106369,20226,0,0,0,"109",".",84616,0
"16801",235750,"LOWER COLUMBIA COLLEGE                                      ","2003-2004",39,"Total Participants",106089,85887,20202,48457,42777,5680,57632,43110,14522,"42","53",38306,34740
"14516",152992,"BRIAR CLIFF UNIVERSITY                                      ","2003-2004",26,"Volleyball",176496,156297,20199,0,0,0,176496,156297,20199,".","24",0,40385
"11243",171128,"MICHIGAN TECHNOLOGICAL UNIVERSITY                           ","2003-2004",22,"Tennis",185375,165192,20183,37488,40090,-2602,147887,125102,22785,"12","9",14292,15328
"6875",157386,"MOREHEAD STATE UNIVERSITY                                   ","2003-2004",12,"Rifle",69032,48885,20147,31745,19023,12722,37287,29862,7425,"5","9",4301,7647
"2748",148131,"QUINCY UNIVERSITY                                           ","2003-2004",2,"Basketball",726920,706792,20128,357553,349565,7988,369367,357227,12140,"16","15",35487,48446
"4099",233277,"RADFORD UNIVERSITY                                          ","2003-2004",6,"Field hocky",134442,114327,20115,0,0,0,134442,114327,20115,".","20",0,47159
"22",191199,"FINGER LAKES COMMUNITY COLLEGE                              ","2003-2004",1,"Baseball",29100,9000,20100,29100,9000,20100,0,0,0,"25",".",825,0
"8755",213987,"MERCYHURST COLLEGE                                          ","2003-2004",16,"Softball",196574,176475,20099,0,0,0,196574,176475,20099,".","32",0,21300
"4520",150455,"EARLHAM COLLEGE                                             ","2003-2004",7,"Football",140588,120509,20079,140588,120509,20079,0,0,0,"45",".",34732,0
"676",178022,"MAPLE WOODS COMMUNITY COLLEGE                               ","2003-2004",1,"Baseball",135044,114973,20071,135044,114973,20071,0,0,0,"34",".",48447,0
"9378",140951,"SAVANNAH COLLEGE OF ART AND DESIGN                          ","2003-2004",16,"Softball",204730,184662,20068,0,0,0,204730,184662,20068,".","10",0,61156
"4752",147341,"MONMOUTH COLLEGE                                            ","2003-2004",7,"Football",119483,99433,20050,119483,99433,20050,0,0,0,"120",".",61678,0
"7836",168546,"ALBION COLLEGE                                              ","2003-2004",15,"Soccer",111134,91085,20049,40775,35720,5055,70359,55365,14994,"23","35",16852,21592
"17150",196015,"SUNY COLLEGE OF TECHNOLOGY AT CANTON                        ","2003-2004",39,"Total Participants",213194,193145,20049,127772,116222,11550,85422,76923,8499,"139","49",128326,44147
"2373",153524,"IOWA CENTRAL COMMUNITY COLLEGE                              ","2003-2004",2,"Basketball",126722,106685,20037,73426,55459,17967,53296,51226,2070,"15","13",15637,18778
"3900",195809,"ST JOHN'S UNIVERSITY-NEW YORK                               ","2003-2004",3,"All Track Combined",784097,764061,20036,0,0,0,784097,764061,20036,"0","92",0,704
"10507",198561,"GARDNER-WEBB UNIVERSITY                                     ","2003-2004",19,"Swimming",246828,226823,20005,0,0,0,246828,226823,20005,".","18",0,35934
"10046",212577,"FRANKLIN AND MARSHALL COLLEGE                               ","2003-2004",16,"Softball",37900,17899,20001,0,0,0,37900,17899,20001,".","13",0,8593
"685",224891,"FRANK PHILLIPS COLLEGE                                      ","2003-2004",1,"Baseball",190150,170150,20000,190150,170150,20000,0,0,0,"29",".",43050,0
"867",364025,"CHANDLER/GILBERT COMMUNITY COLLEGE                          ","2003-2004",1,"Baseball",56310,36310,20000,56310,36310,20000,0,0,0,"31",".",18108,0
"890",136516,"POLK COMMUNITY COLLEGE                                      ","2003-2004",1,"Baseball",135972,115972,20000,135972,115972,20000,0,0,0,"24",".",68416,0
"1262",129695,"MANCHESTER COMMUNITY COLLEGE                                ","2003-2004",1,"Baseball",20000,0,20000,20000,21000,-1000,0,0,0,"19",".",18961,0
"2880",138901,"ATLANTA METROPOLITAN COLLEGE                                ","2003-2004",2,"Basketball",250000,230000,20000,125000,115000,10000,125000,115000,10000,"12","12",80000,80000
"7912",129695,"MANCHESTER COMMUNITY COLLEGE                                ","2003-2004",15,"Soccer",20000,0,20000,20000,20900,-900,0,0,0,"20",".",18124,0
"12656",198561,"GARDNER-WEBB UNIVERSITY                                     ","2003-2004",25,"Track and Field, X-Country",36000,16000,20000,18000,8000,10000,18000,8000,10000,"7","9",3787,3875
"2556",139366,"COLUMBUS STATE UNIVERSITY                                   ","2003-2004",2,"Basketball",422158,402168,19990,199393,189896,9497,222765,212272,10493,"15","12",54420,50760
"14301",227429,"PAUL QUINN COLLEGE                                          ","2003-2004",26,"Volleyball",39476,19560,19916,0,0,0,39476,19560,19916,"0","15",0,9104
"1214",131113,"WILMINGTON COLLEGE                                          ","2003-2004",1,"Baseball",144783,124906,19877,144783,124906,19877,0,0,0,"27",".",53061,0
"5573",222178,"ABILENE CHRISTIAN UNIVERSITY                                ","2003-2004",8,"Golf",174235,154385,19850,174235,154385,19850,0,0,0,"13",".",36605,0
"5437",213385,"LAFAYETTE COLLEGE                                           ","2003-2004",8,"Golf",71715,51893,19822,38009,27503,10506,33706,24390,9316,"9","8",7702,6847
"2962",155335,"NEWMAN UNIVERSITY                                           ","2003-2004",2,"Basketball",152135,132319,19816,76943,67035,9908,75192,65284,9908,"20","16",33875,33250
"1930",199643,"SHAW UNIVERSITY                                             ","2003-2004",2,"Basketball",614235,594421,19814,308547,306210,2337,305688,288211,17477,"14","9",41296,40128
"2007",409698,"CALIFORNIA STATE UNIVERSITY-MONTEREY BAY                    ","2003-2004",2,"Basketball",106759,86961,19798,61674,53599,8075,45085,33362,11723,"24","16",28195,31622
"9588",153366,"GRACELAND UNIVERSITY-LAMONI                                 ","2003-2004",16,"Softball",98054,78338,19716,0,0,0,98054,78338,19716,".","18",0,14704
"35",153001,"BUENA VISTA UNIVERSITY                                      ","2003-2004",1,"Baseball",65830,46132,19698,65830,46132,19698,0,0,0,"37",".",17263,0
"1695",198598,"GREENSBORO COLLEGE                                          ","2003-2004",2,"Basketball",151248,131556,19692,93383,81073,12310,57865,50483,7382,"15","13",30254,19641
"6409",166513,"UNIVERSITY OF MASSACHUSETTS-LOWELL                          ","2003-2004",10,"Ice Hockey",955091,935417,19674,955091,935417,19674,0,0,0,"30",".",131639,0
"1883",147916,"PARKLAND COLLEGE                                            ","2003-2004",2,"Basketball",93000,73345,19655,46500,29786,16714,46500,43559,2941,"14","12",19728,28245
"13650",141486,"CHAMINADE UNIVERSITY OF HONOLULU                            ","2003-2004",26,"Volleyball",62575,42972,19603,0,0,0,62575,42972,19603,".","13",0,37668
"3392",128391,"WESTERN STATE COLLEGE OF COLORADO                           ","2003-2004",2,"Basketball",296496,276915,19581,151056,145538,5518,145440,131377,14063,"19","13",26439,27780
"3096",214157,"MORAVIAN COLLEGE AND THEOLOGICAL SEMINARY                   ","2003-2004",2,"Basketball",186954,167377,19577,99174,95147,4027,87780,72230,15550,"25","16",19727,17093
"153",150756,"HANOVER COLLEGE                                             ","2003-2004",1,"Baseball",159078,139538,19540,159078,139538,19540,0,0,0,"27",".",27447,0
"6399",173300,"CONCORDIA COLLEGE AT MOORHEAD                               ","2003-2004",10,"Ice Hockey",155694,136167,19527,86683,72445,14238,69011,63722,5289,"25","23",8291,8560
"4348",211981,"DELAWARE VALLEY COLLEGE                                     ","2003-2004",7,"Football",175600,156100,19500,175600,156100,19500,0,0,0,"142",".",46000,0
"15892",158802,"DILLARD UNIVERSITY                                          ","2003-2004",39,"Total Participants",405263,385786,19477,118514,97575,20939,286749,288211,-1462,"22","43",43221,48386
"13883",110574,"CALIFORNIA STATE UNIVERSITY-HAYWARD                         ","2003-2004",26,"Volleyball",167076,147651,19425,0,0,0,167076,147651,19425,".","16",0,68313
"7977",117751,"THE MASTER'S COLLEGE AND SEMINARY                           ","2003-2004",15,"Soccer",376645,357242,19403,218469,202265,16204,158176,154977,3199,"22","18",37890,22676
"1507",206941,"UNIVERSITY OF CENTRAL OKLAHOMA                              ","2003-2004",1,"Baseball",39685,20300,19385,39685,20300,19385,0,0,0,"38",".",12800,0
"10697",198561,"GARDNER-WEBB UNIVERSITY                                     ","2003-2004",22,"Tennis",249591,230243,19348,119770,120040,-270,129821,110203,19618,"9","7",14004,15258
"920",151263,"UNIVERSITY OF INDIANAPOLIS                                  ","2003-2004",1,"Baseball",362836,343541,19295,362836,343541,19295,0,0,0,"59",".",72536,0
"4945",114789,"FRESNO CITY COLLEGE                                         ","2003-2004",7,"Football",87966,68677,19289,87966,68677,19289,0,0,0,"83",".",20551,0
"17060",146825,"MACMURRAY COLLEGE                                           ","2003-2004",39,"Total Participants",232446,213203,19243,141016,125601,15415,91430,87602,3828,"188","81",112860,52433
"7837",220631,"LINCOLN MEMORIAL UNIVERSITY                                 ","2003-2004",15,"Soccer",383972,364732,19240,191986,182366,9620,191986,182366,9620,"23","19",58225,58225
"15143",232423,"JAMES MADISON UNIVERSITY                                    ","2003-2004",30,"Archery",53838,34604,19234,26919,17302,9617,26919,17302,9617,"8","9",12280,12280
"8367",212115,"EAST STROUDSBURG UNIVERSITY OF PENNSYLVANIA                 ","2003-2004",15,"Soccer",283990,264762,19228,162093,149687,12406,121897,115075,6822,"28","32",24674,15065
"15536",186584,"SETON HALL UNIVERSITY                                       ","2003-2004",39,"Total Participants",4839054,4819857,19197,2124338,1978666,145672,2714716,2841191,-126475,"161","148",991439,692621
"3055",155210,"JOHNSON COUNTY COMMUNITY COLLEGE                            ","2003-2004",2,"Basketball",221550,202432,19118,118438,111527,6911,103112,90905,12207,"14","10",27047,32058
"14719",110653,"UNIVERSITY OF CALIFORNIA-IRVINE                             ","2003-2004",27,"Water Polo",298219,279101,19118,110705,110739,-34,187514,168362,19152,"21","23",37307,49868
"3057",165866,"FRAMINGHAM STATE COLLEGE                                    ","2003-2004",2,"Basketball",64904,45790,19114,36400,25350,11050,28504,20440,8064,"14","13",13170,10063
"6529",190983,"ELMIRA COLLEGE                                              ","2003-2004",10,"Ice Hockey",255314,236218,19096,142566,132121,10445,112748,104097,8651,"32","24",62276,54470
"3580",150756,"HANOVER COLLEGE                                             ","2003-2004",3,"All Track Combined",138551,119533,19018,70510,59483,11027,68041,60050,7991,"24","17",21638,21638
"16843",187912,"NEW MEXICO MILITARY INSTITUTE                               ","2003-2004",39,"Total Participants",561816,542807,19009,381018,359681,21337,180798,183126,-2328,"133","10",186811,42315
"6955",122931,"SANTA CLARA UNIVERSITY                                      ","2003-2004",13,"Rowing",134954,115948,19006,86914,58224,28690,48040,57724,-9684,"21","26",18288,21434
"49",228875,"TEXAS CHRISTIAN UNIVERSITY                                  ","2003-2004",1,"Baseball",848679,829676,19003,848679,829676,19003,0,0,0,"36",".",224537,0
"12809",126119,"YUBA COLLEGE                                                ","2003-2004",25,"Track and Field, X-Country",26600,7622,18978,11400,3660,7740,15200,3962,11238,"3","4",909,1212
"11891",204635,"OHIO NORTHERN UNIVERSITY                                    ","2003-2004",23,"Track and Field, Indoor",103019,84073,18946,58341,47365,10976,44678,36708,7970,"55","40",7931,7407
"15729",165866,"FRAMINGHAM STATE COLLEGE                                    ","2003-2004",39,"Total Participants",208424,189480,18944,124761,109461,15300,83663,80019,3644,"120","74",78639,36720
"3000",170967,"ROCHESTER COLLEGE                                           ","2003-2004",2,"Basketball",183139,164205,18934,129597,114748,14849,53542,49457,4085,"15","15",38375,15174
"8661",227304,"ODESSA COLLEGE                                              ","2003-2004",16,"Softball",156305,137374,18931,0,0,0,156305,137374,18931,".","16",0,28697
"13801",159717,"MCNEESE STATE UNIVERSITY                                    ","2003-2004",26,"Volleyball",210478,191564,18914,0,0,0,210478,191564,18914,"0","14",0,48596
"9364",175980,"MILLSAPS COLLEGE                                            ","2003-2004",16,"Softball",68735,49843,18892,0,0,0,68735,49843,18892,".","15",0,15243
"14608",212106,"DUQUESNE UNIVERSITY                                         ","2003-2004",26,"Volleyball",468307,449418,18889,0,0,0,468307,449418,18889,".","12",0,41130
"16312",188641,"ALFRED UNIVERSITY                                           ","2003-2004",39,"Total Participants",536661,517778,18883,264272,236934,27338,272389,280844,-8455,"208","149",164160,110110
"9675",214591,"PENNSYLVANIA STATE UNIV-PENN ST ERIE-BEHREND COLL           ","2003-2004",16,"Softball",60094,41254,18840,0,0,0,60094,41254,18840,".","16",0,13330
"11236",190099,"COLGATE UNIVERSITY                                          ","2003-2004",22,"Tennis",266275,247446,18829,144585,132462,12123,121690,114984,6706,"13","11",27807,31481
"10254",204635,"OHIO NORTHERN UNIVERSITY                                    ","2003-2004",18,"Swimming and Diving",85831,67010,18821,33645,26400,7245,52186,40610,11576,"25","45",9502,10539
"7274",212984,"HOLY FAMILY UNIVERSITY                                      ","2003-2004",15,"Soccer",330000,311182,18818,165000,156518,8482,165000,154664,10336,"27","23",9002,10084
"15212",100724,"ALABAMA STATE UNIVERSITY                                    ","2003-2004",33,"Bowling",59450,40639,18811,0,0,0,59450,40639,18811,".","8",0,34474
"3364",196112,"SUNY INSTITUTE OF TECHNOLOGY AT UTICA-ROME                  ","2003-2004",2,"Basketball",125913,107114,18799,69424,59970,9454,56489,47144,9345,"14","12",15596,17868
"13826",128391,"WESTERN STATE COLLEGE OF COLORADO                           ","2003-2004",26,"Volleyball",95303,76591,18712,0,0,0,95303,76591,18712,".","11",0,21092
"9749",191199,"FINGER LAKES COMMUNITY COLLEGE                              ","2003-2004",16,"Softball",26800,8100,18700,0,0,0,26800,8100,18700,".","22",0,725
"8644",224527,"EAST TEXAS BAPTIST UNIVERSITY                               ","2003-2004",16,"Softball",94914,76215,18699,0,0,0,94914,76215,18699,".","18",0,33830
"1768",101693,"UNIVERSITY OF MOBILE                                        ","2003-2004",2,"Basketball",609065,590389,18676,332252,319736,12516,276813,270653,6160,"14","11",62966,41086
"2217",214041,"MILLERSVILLE UNIVERSITY OF PENNSYLVANIA                     ","2003-2004",2,"Basketball",424413,405765,18648,207042,190375,16667,217371,215390,1981,"16","16",22366,22729
"91",237783,"SALEM INTERNATIONAL UNIVERSITY                              ","2003-2004",1,"Baseball",62019,43374,18645,62019,43374,18645,0,0,0,"27",".",21524,0
"9930",211431,"CARLOW COLLEGE                                              ","2003-2004",16,"Softball",18600,0,18600,0,0,0,18600,35465,-16865,".","15",0,680
"2275",179113,"SAINT LOUIS COMMUNITY COLLEGE-MERAMEC                       ","2003-2004",2,"Basketball",44536,25942,18594,22268,12971,9297,22268,12971,9297,"14","13",4030,3720
"7459",179113,"SAINT LOUIS COMMUNITY COLLEGE-MERAMEC                       ","2003-2004",15,"Soccer",44536,25942,18594,22268,12971,9297,22268,12971,9297,"22","19",2745,3050
"12725",106704,"UNIVERSITY OF CENTRAL ARKANSAS                              ","2003-2004",25,"Track and Field, X-Country",98219,79645,18574,0,0,0,98219,79645,18574,".","7",0,10254
"15283",194310,"PACE UNIVERSITY-NEW YORK                                    ","2003-2004",34,"Equestrian",75820,57247,18573,0,0,0,75820,57247,18573,".","12",0,29247
"7861",216931,"WILKES UNIVERSITY                                           ","2003-2004",15,"Soccer",94900,76342,18558,38226,30854,7372,56674,45488,11186,"25","26",15118,14453
"5379",164465,"AMHERST COLLEGE                                             ","2003-2004",8,"Golf",178988,160454,18534,87019,78191,8828,91969,82263,9706,"7","6",10917,7836
"9855",158431,"BOSSIER PARISH COMMUNITY COLLEGE                            ","2003-2004",16,"Softball",92916,74448,18468,0,0,0,92916,74448,18468,".","17",0,21510
"2023",214175,"MUHLENBERG COLLEGE                                          ","2003-2004",2,"Basketball",111280,92846,18434,50430,46192,4238,60850,46654,14196,"23","18",36940,40092
"858",155201,"INDEPENDENCE COMMUNITY COLLEGE                              ","2003-2004",1,"Baseball",71425,53010,18415,71425,53010,18415,0,0,0,"32",".",16658,0
"1270",128106,"COLORADO STATE UNIVERSITY-PUEBLO                            ","2003-2004",1,"Baseball",205565,187151,18414,205565,187151,18414,0,0,0,"43",".",53900,0
"12372",107044,"HARDING UNIVERSITY                                          ","2003-2004",25,"Track and Field, X-Country",53306,34938,18368,26653,17469,9184,26653,17469,9184,"34","26",16866,16866
"2468",196866,"UNION COLLEGE                                               ","2003-2004",2,"Basketball",266520,248167,18353,152659,138973,13686,113861,109194,4667,"15","15",19054,19221
"15686",101435,"HUNTINGDON COLLEGE                                          ","2003-2004",39,"Total Participants",575131,556803,18328,312943,310623,2320,262188,246180,16008,"157","67",322865,125523
"16910",210739,"DESALES UNIVERSITY                                          ","2003-2004",39,"Total Participants",402864,384544,18320,270520,252760,17760,132344,131784,560,"144","91",145818,102192
"8319",172264,"SIENA HEIGHTS UNIVERSITY                                    ","2003-2004",15,"Soccer",49725,31422,18303,26427,16035,10392,23298,15387,7911,"23","23",12507,12507
"2130",199069,"MOUNT OLIVE COLLEGE                                         ","2003-2004",2,"Basketball",352907,334627,18280,202985,185654,17331,149922,148973,949,"33","14",33884,31399
"11963",230807,"WESTMINSTER COLLEGE                                         ","2003-2004",24,"Track and Field, Outdoor",27677,9400,18277,15310,4708,10602,12367,4692,7675,"6","3",4710,4692
"4775",174862,"CROWN COLLEGE                                               ","2003-2004",7,"Football",81482,63248,18234,81482,63248,18234,0,0,0,"47",".",45545,0
"12462",151801,"INDIANA WESLEYAN UNIVERSITY                                 ","2003-2004",25,"Track and Field, X-Country",120545,102314,18231,59333,41184,18149,61212,61130,82,"72","98",40464,41552
"8749",153001,"BUENA VISTA UNIVERSITY                                      ","2003-2004",16,"Softball",82121,63896,18225,0,0,0,82121,63896,18225,".","21",0,18288
"14028",139658,"EMORY UNIVERSITY                                            ","2003-2004",26,"Volleyball",181253,163033,18220,0,0,0,181253,163033,18220,".","15",0,45954
"8275",169363,"CONCORDIA UNIVERSITY                                        ","2003-2004",15,"Soccer",184913,166700,18213,94071,83350,10721,90842,83350,7492,"16","19",9500,9500
"13393",188429,"ADELPHI UNIVERSITY                                          ","2003-2004",26,"Volleyball",104377,86174,18203,0,0,0,104377,86174,18203,".","12",0,19121
"2577",193900,"NEW YORK UNIVERSITY                                         ","2003-2004",2,"Basketball",711089,692921,18168,328897,319813,9084,382192,373108,9084,"24","20",142961,170399
"11198",179955,"WILLIAM JEWELL COLLEGE                                      ","2003-2004",22,"Tennis",34500,16355,18145,17250,8177,9073,17250,8178,9072,"8","11",1427,1428
"1193",150455,"EARLHAM COLLEGE                                             ","2003-2004",1,"Baseball",63639,45532,18107,63639,45532,18107,0,0,0,"17",".",16408,0
"11916",212160,"EDINBORO UNIVERSITY OF PENNSYLVANIA                         ","2003-2004",23,"Track and Field, Indoor",23328,5231,18097,0,0,0,23328,5231,18097,".","26",0,4231
"5689",219718,"BETHEL COLLEGE                                              ","2003-2004",8,"Golf",60881,42787,18094,38110,27356,10754,22771,15431,7340,"7","8",13493,9293
"5403",207263,"NORTHEASTERN STATE UNIVERSITY                               ","2003-2004",8,"Golf",149921,131841,18080,72399,64458,7941,77522,67383,10139,"14","7",21650,24575
"5092",215743,"SAINT FRANCIS UNIVERSITY                                    ","2003-2004",7,"Football",611991,593942,18049,611991,593942,18049,0,0,0,"91",".",106918,0
"15555",149781,"WHEATON COLLEGE                                             ","2003-2004",39,"Total Participants",802843,784794,18049,396311,380837,15474,406532,403957,2575,"299","204",278724,172407
"3579",157447,"NORTHERN KENTUCKY UNIVERSITY                                ","2003-2004",3,"All Track Combined",64631,46587,18044,26426,27328,-902,38205,19259,18946,"15","5",7495,8171
"15145",183655,"ATLANTIC CAPE COMMUNITY COLLEGE                             ","2003-2004",30,"Archery",25000,7000,18000,25000,7000,18000,0,0,0,"10",".",4000,0
"3215",229887,"WILEY COLLEGE                                               ","2003-2004",2,"Basketball",145484,127495,17989,58423,50528,7895,87061,76967,10094,"11","19",26780,31528
"9357",207306,"NORTHWESTERN OKLAHOMA STATE UNIVERSITY                      ","2003-2004",16,"Softball",63668,45686,17982,0,0,0,63668,45686,17982,".","15",0,15316
"16865",210234,"TREASURE VALLEY COMMUNITY COLLEGE                           ","2003-2004",39,"Total Participants",298499,280528,17971,139403,133207,6196,159096,147321,11775,"138","105",108000,99000
"3308",139144,"BERRY COLLEGE                                               ","2003-2004",2,"Basketball",804454,786520,17934,395147,385879,9268,409307,400641,8666,"12","12",74766,74766
"17215",161767,"ANNE ARUNDEL COMMUNITY COLLEGE                              ","2003-2004",39,"Total Participants",112493,94601,17892,62112,55405,6707,50381,39196,11185,"95","71",40112,33838
"7438",409698,"CALIFORNIA STATE UNIVERSITY-MONTEREY BAY                    ","2003-2004",15,"Soccer",47843,29976,17867,29936,18124,11812,17907,11852,6055,"30","17",15541,9082
"16370",178244,"MISSOURI BAPTIST UNIVERSITY                                 ","2003-2004",39,"Total Participants",2162797,2144946,17851,1482052,1474735,7317,680745,670211,10534,"188","95",175784,78699
"2961",211431,"CARLOW COLLEGE                                              ","2003-2004",2,"Basketball",17850,0,17850,0,0,0,17850,84163,-66313,".","16",0,18384
"15135",238263,"MADISON AREA TECHNICAL COLLEGE                              ","2003-2004",29,"Other Sports",21998,4152,17846,0,0,0,21998,4152,17846,".","14",0,3365
"10004",244437,"GEORGIA PERIMETER COLLEGE                                   ","2003-2004",16,"Softball",113553,95714,17839,0,0,0,113553,95714,17839,".","13",0,58880
"6866",197036,"UNITED STATES MILITARY ACADEMY                              ","2003-2004",12,"Rifle",42038,24205,17833,42038,24205,17833,0,0,0,"9",".",250,0
"6029",216764,"WEST CHESTER UNIVERSITY OF PENNSYLVANIA                     ","2003-2004",8,"Golf",29657,11852,17805,16779,10971,5808,12878,881,11997,"10","2",9881,791
"8029",211431,"CARLOW COLLEGE                                              ","2003-2004",15,"Soccer",17800,0,17800,0,0,0,17800,62645,-44845,".","15",0,2715
"11964",204635,"OHIO NORTHERN UNIVERSITY                                    ","2003-2004",24,"Track and Field, Outdoor",96892,79100,17792,53965,43814,10151,42927,35286,7641,"50","38",7931,7407
"2727",140872,"REINHARDT COLLEGE                                           ","2003-2004",2,"Basketball",341226,323446,17780,191626,180166,11460,149600,143280,6320,"15","12",2350,1480
"1402",177995,"LONGVIEW COMMUNITY COLLEGE                                  ","2003-2004",1,"Baseball",115647,97906,17741,115647,97906,17741,0,0,0,"32",".",39723,0
"7316",167996,"STONEHILL COLLEGE                                           ","2003-2004",15,"Soccer",78438,60709,17729,36073,28458,7615,42365,32251,10114,"25","24",11787,20320
"346",142461,"NORTHWEST NAZARENE UNIVERSITY                               ","2003-2004",1,"Baseball",252698,234987,17711,252698,234987,17711,0,0,0,"20",".",54459,0
"9182",217484,"UNIVERSITY OF RHODE ISLAND                                  ","2003-2004",16,"Softball",373552,355852,17700,0,0,0,373552,355852,17700,".","22",0,68886
"6745",196079,"SUNY AT BINGHAMTON                                          ","2003-2004",11,"Lacrosse",551067,533393,17674,284563,272476,12087,266504,260917,5587,"31","25",28999,29601
"6478",217536,"SALVE REGINA UNIVERSITY                                     ","2003-2004",10,"Ice Hockey",136772,119123,17649,68475,64841,3634,68297,54282,14015,"28","20",54841,44282
"6608",206525,"WITTENBERG UNIVERSITY                                       ","2003-2004",11,"Lacrosse",124049,106426,17623,79017,61014,18003,45032,45412,-380,"38","15",17149,8637
"4360",212115,"EAST STROUDSBURG UNIVERSITY OF PENNSYLVANIA                 ","2003-2004",7,"Football",430721,413109,17612,430721,413109,17612,0,0,0,"84",".",82382,0
"1256",114789,"FRESNO CITY COLLEGE                                         ","2003-2004",1,"Baseball",70545,52957,17588,70545,52957,17588,0,0,0,"38",".",18547,0
"7336",127918,"REGIS UNIVERSITY                                            ","2003-2004",15,"Soccer",497253,479689,17564,240312,248588,-8276,256941,231101,25840,"21","19",29662,31780
"4350",153834,"LUTHER COLLEGE                                              ","2003-2004",7,"Football",186150,168605,17545,186150,168605,17545,0,0,0,"90",".",51543,0
"7674",206048,"TIFFIN UNIVERSITY                                           ","2003-2004",15,"Soccer",42874,25343,17531,20698,13138,7560,22176,12205,9971,"31","32",11960,9972
"2243",206048,"TIFFIN UNIVERSITY                                           ","2003-2004",2,"Basketball",57777,40261,17516,35064,21302,13762,22713,18959,3754,"34","24",19168,11104
"15598",111939,"CHAFFEY COLLEGE                                             ","2003-2004",39,"Total Participants",103893,86379,17514,42325,33805,8520,61568,52574,8994,"197","104",26009,27520
"11011",178402,"UNIVERSITY OF MISSOURI-KANSAS CITY                          ","2003-2004",22,"Tennis",260872,243377,17495,128528,126831,1697,132344,116546,15798,"13","11",13411,15960
"4509",175272,"WINONA STATE UNIVERSITY                                     ","2003-2004",7,"Football",388626,371134,17492,388626,371134,17492,0,0,0,"115",".",99666,0
"14517",144962,"ELMHURST COLLEGE                                            ","2003-2004",26,"Volleyball",87099,69672,17427,0,0,0,87099,69672,17427,"0","29",0,36975
"2721",148991,"SPOON RIVER COLLEGE                                         ","2003-2004",2,"Basketball",80884,63476,17408,47408,34288,13120,33476,29188,4288,"11","10",26163,25587
"8672",139764,"GEORGIA SOUTHWESTERN STATE UNIVERSITY                       ","2003-2004",16,"Softball",118000,100597,17403,0,0,0,118000,100597,17403,".","20",0,28556
"17207",219824,"CHATTANOOGA STATE TECHNICAL COMMUNITY COLLEGE               ","2003-2004",39,"Total Participants",129209,111817,17392,66786,61980,4806,62423,49837,12586,"41","36",22555,24373
"11387",126678,"COLORADO COLLEGE                                            ","2003-2004",22,"Tennis",48291,30907,17384,31262,16669,14593,17029,14238,2791,"13","17",10142,10367
"16081",123013,"SANTA ROSA JUNIOR COLLEGE                                   ","2003-2004",39,"Total Participants",500990,483622,17368,267473,259296,8177,233517,224326,9191,"269","125",150265,84692
"5674",138354,"THE UNIVERSITY OF WEST FLORIDA                              ","2003-2004",8,"Golf",304268,286946,17322,172541,146552,25989,131727,140394,-8667,"10","10",38193,36140
"11365",136215,"NOVA SOUTHEASTERN UNIVERSITY                                ","2003-2004",22,"Tennis",111419,94123,17296,0,0,0,111419,94123,17296,".","5",0,12988
"7942",121886,"RIO HONDO COLLEGE                                           ","2003-2004",15,"Soccer",58061,40784,17277,34226,20884,13342,23835,19900,3935,"30","20",6509,9087
"12408",218441,"NORTH GREENVILLE COLLEGE                                    ","2003-2004",25,"Track and Field, X-Country",27758,10505,17253,13879,5283,8596,13879,5222,8657,"15","13",4783,4722
"12778",161086,"COLBY COLLEGE                                               ","2003-2004",25,"Track and Field, X-Country",128956,111736,17220,61351,55648,5703,67605,56088,11517,"81","81",49689,55795
"2682",145725,"ILLINOIS INSTITUTE OF TECHNOLOGY                            ","2003-2004",2,"Basketball",173918,156755,17163,90084,80137,9947,83834,76618,7216,"16","8",12303,15034
"9451",184612,"FELICIAN COLLEGE                                            ","2003-2004",16,"Softball",130517,113384,17133,0,0,0,130517,113384,17133,".","14",0,38792
"7085",215929,"UNIVERSITY OF SCRANTON                                      ","2003-2004",15,"Soccer",168391,151266,17125,63270,63270,0,105121,87996,17125,"27","26",17949,29890
"11162",125763,"WHITTIER COLLEGE                                            ","2003-2004",22,"Tennis",38600,21490,17110,19900,10400,9500,18700,11090,7610,"7","9",3429,4335
"16538",210429,"WESTERN OREGON UNIVERSITY                                   ","2003-2004",39,"Total Participants",601246,584161,17085,204721,188312,16409,396525,395849,676,"291","134",287063,193423
"2194",218821,"SPARTANBURG METHODIST COLLEGE                               ","2003-2004",2,"Basketball",184763,167741,17022,110233,95748,14485,74530,71993,2537,"19","15",47916,32909
"6682",163912,"ST MARY'S COLLEGE OF MARYLAND                               ","2003-2004",11,"Lacrosse",168770,151753,17017,98621,85623,12998,70149,66130,4019,"33","22",18500,17500
"8174",149231,"SOUTHERN ILLINOIS UNIVERSITY-EDWARDSVILLE                   ","2003-2004",15,"Soccer",364688,347686,17002,187514,177991,9523,177174,169695,7479,"25","24",33696,28130
"5",139366,"COLUMBUS STATE UNIVERSITY                                   ","2003-2004",1,"Baseball",181000,164006,16994,181000,164006,16994,0,0,0,"36",".",50860,0
"7511",157447,"NORTHERN KENTUCKY UNIVERSITY                                ","2003-2004",15,"Soccer",327227,310239,16988,135322,128577,6745,191905,181662,10243,"28","18",19966,41608
"14407",228802,"THE UNIVERSITY OF TEXAS AT TYLER                            ","2003-2004",26,"Volleyball",53494,36525,16969,0,0,0,53494,36525,16969,".","12",0,13113
"8302",192448,"LONG ISLAND UNIVERSITY-C W POST CAMPUS                      ","2003-2004",15,"Soccer",384020,367067,16953,206870,178471,28399,177150,188596,-11446,"25","22",36927,39195
"2428",148496,"DOMINICAN UNIVERSITY                                        ","2003-2004",2,"Basketball",55162,38234,16928,27662,19780,7882,27500,18454,9046,"11","17",11117,9953
"7296",196079,"SUNY AT BINGHAMTON                                          ","2003-2004",15,"Soccer",835525,818624,16901,456055,443785,12270,379470,374839,4631,"26","24",60609,49049
"1157",210739,"DESALES UNIVERSITY                                          ","2003-2004",1,"Baseball",78064,61164,16900,78064,61164,16900,0,0,0,"25",".",26740,0
"13919",138354,"THE UNIVERSITY OF WEST FLORIDA                              ","2003-2004",26,"Volleyball",191238,174373,16865,0,0,0,191238,174373,16865,".","11",0,33754
"536",106704,"UNIVERSITY OF CENTRAL ARKANSAS                              ","2003-2004",1,"Baseball",171753,154925,16828,171753,154925,16828,0,0,0,"38",".",40527,0
"3303",216694,"WAYNESBURG COLLEGE                                          ","2003-2004",2,"Basketball",84660,67850,16810,45437,38682,6755,39223,29168,10055,"18","14",34548,26304
"663",164562,"ASSUMPTION COLLEGE                                          ","2003-2004",1,"Baseball",77131,60345,16786,77131,60345,16786,0,0,0,"27",".",11125,0
"12708",217688,"CHARLESTON SOUTHERN UNIVERSITY                              ","2003-2004",25,"Track and Field, X-Country",373597,356815,16782,170721,161289,9432,202876,195526,7350,"19","20",37742,40887
"7773",217688,"CHARLESTON SOUTHERN UNIVERSITY                              ","2003-2004",15,"Soccer",235973,219202,16771,0,0,0,235973,219202,16771,".","19",0,35953
"2998",189848,"CAZENOVIA COLLEGE                                           ","2003-2004",2,"Basketball",81569,64869,16700,44382,36482,7900,37187,28387,8800,"15","15",36382,28187
"16445",148991,"SPOON RIVER COLLEGE                                         ","2003-2004",39,"Total Participants",53808,37120,16688,25433,18215,7218,28375,18905,9470,"31","23",37054,34155
"12693",204200,"COLLEGE OF MOUNT SAINT JOSEPH                               ","2003-2004",25,"Track and Field, X-Country",73611,56955,16656,36782,28226,8556,36829,28729,8100,"27","33",11542,11857
"2810",153834,"LUTHER COLLEGE                                              ","2003-2004",2,"Basketball",141412,124769,16643,74865,62230,12635,66547,62539,4008,"25","19",21720,21560
"16792",191719,"HUDSON VALLEY COMMUNITY COLLEGE                             ","2003-2004",39,"Total Participants",169249,152626,16623,109218,95459,13759,60031,57167,2864,"188","62",164558,49484
"16447",155335,"NEWMAN UNIVERSITY                                           ","2003-2004",39,"Total Participants",598137,581541,16596,323970,312876,11094,274167,268665,5502,"124","111",195392,174431
"668",146348,"KANKAKEE COMMUNITY COLLEGE                                  ","2003-2004",1,"Baseball",65000,48408,16592,65000,48408,16592,0,0,0,"24",".",41537,0
"5010",154101,"NORTHWESTERN COLLEGE                                        ","2003-2004",7,"Football",306923,290354,16569,306923,290354,16569,0,0,0,"73",".",59264,0
"13641",202763,"THE UNIVERSITY OF FINDLAY                                   ","2003-2004",26,"Volleyball",286091,269537,16554,118191,113453,4738,167900,156084,11816,"19","25",17812,27078
"10567",213251,"JUNIATA COLLEGE                                             ","2003-2004",19,"Swimming",46299,29764,16535,0,0,0,46299,29764,16535,".","18",0,22564
"2725",179867,"WASHINGTON UNIVERSITY IN ST LOUIS                           ","2003-2004",2,"Basketball",474175,457641,16534,239655,221076,18579,234520,236565,-2045,"21","23",67796,82483
"2207",193645,"THE COLLEGE OF NEW ROCHELLE                                 ","2003-2004",2,"Basketball",16500,0,16500,0,0,0,16500,26970,-10470,".","13",0,20470
"5298",100724,"ALABAMA STATE UNIVERSITY                                    ","2003-2004",8,"Golf",118442,101943,16499,59998,52499,7499,58444,49444,9000,"6","6",29222,29222
"10474",195809,"ST JOHN'S UNIVERSITY-NEW YORK                               ","2003-2004",19,"Swimming",700045,683599,16446,277173,268950,8223,422872,414649,8223,"12","18",1746,1298
"6384",217484,"UNIVERSITY OF RHODE ISLAND                                  ","2003-2004",9,"Gymnastics",453043,436600,16443,0,0,0,453043,436600,16443,".","12",0,50084
"4782",175786,"HINDS COMMUNITY COLLEGE                                     ","2003-2004",7,"Football",330569,314129,16440,330569,314129,16440,0,0,0,"55",".",87439,0
"2260",162779,"HOWARD COMMUNITY COLLEGE                                    ","2003-2004",2,"Basketball",42193,25761,16432,22472,12985,9487,19721,12776,6945,"17","8",11076,10866
"4826",156745,"GEORGETOWN COLLEGE                                          ","2003-2004",7,"Football",563779,547349,16430,563779,547349,16430,0,0,0,"97",".",60540,0
"3552",171492,"NORTHWOOD UNIVERSITY                                        ","2003-2004",3,"All Track Combined",249242,232814,16428,124968,125780,-812,124274,107034,17240,"83","42",16194,16329
"3085",230898,"GREEN MOUNTAIN COLLEGE                                      ","2003-2004",2,"Basketball",191002,174642,16360,113574,103514,10060,77428,71128,6300,"13","10",17997,15594
"7470",190044,"CLARKSON UNIVERSITY                                         ","2003-2004",15,"Soccer",115009,98659,16350,63375,48485,14890,51634,50174,1460,"31","23",18597,20908
"9377",147916,"PARKLAND COLLEGE                                            ","2003-2004",16,"Softball",55800,39469,16331,0,0,0,55800,39469,16331,".","22",0,26313
"13130",222178,"ABILENE CHRISTIAN UNIVERSITY                                ","2003-2004",26,"Volleyball",283060,266730,16330,0,0,0,283060,266730,16330,".","16",0,36751
"388",117946,"LOYOLA MARYMOUNT UNIVERSITY                                 ","2003-2004",1,"Baseball",816861,800567,16294,816861,800567,16294,0,0,0,"33",".",141870,0
"14001",201645,"CASE WESTERN RESERVE UNIVERSITY                             ","2003-2004",26,"Volleyball",73377,57086,16291,0,0,0,73377,57086,16291,".","12",0,32142
"2109",145372,"GREENVILLE COLLEGE                                          ","2003-2004",2,"Basketball",133448,117169,16279,77634,69515,8119,55814,47654,8160,"21","11",12542,13923
"17234",161518,"SAINT JOSEPHS COLLEGE                                       ","2003-2004",39,"Total Participants",153686,137411,16275,84496,72296,12200,69190,65115,4075,"89","85",43979,56056
"3323",181446,"NEBRASKA WESLEYAN UNIVERSITY                                ","2003-2004",2,"Basketball",116945,100728,16217,77311,62028,15283,39634,38700,934,"35","18",35686,16995
"16204",146296,"JOLIET JUNIOR COLLEGE                                       ","2003-2004",39,"Total Participants",125200,109000,16200,54000,43500,10500,71200,65500,5700,"166","58",73500,36500
"12648",198695,"HIGH POINT UNIVERSITY                                       ","2003-2004",25,"Track and Field, X-Country",532577,516387,16190,303611,281818,21793,228966,234569,-5603,"83","55",26847,30385
"5160",226578,"MCLENNAN COMMUNITY COLLEGE                                  ","2003-2004",8,"Golf",97372,81185,16187,44568,40549,4019,52804,40636,12168,"10","8",12688,16504
"15909",174862,"CROWN COLLEGE                                               ","2003-2004",39,"Total Participants",124371,108217,16154,61211,55672,5539,63160,52545,10615,"115","60",100026,58619
"4989",111939,"CHAFFEY COLLEGE                                             ","2003-2004",7,"Football",47078,30928,16150,47078,30928,16150,0,0,0,"81",".",4514,0
"14693",125763,"WHITTIER COLLEGE                                            ","2003-2004",27,"Water Polo",54350,38210,16140,29800,19780,10020,24550,18430,6120,"16","13",14141,10646
"3272",243106,"UNIVERSITY OF PUERTO RICO-AGUADILLA                         ","2003-2004",2,"Basketball",20267,4137,16130,11182,2275,8907,9085,1862,7223,"16","13",1107,906
"7269",211440,"CARNEGIE MELLON UNIVERSITY                                  ","2003-2004",15,"Soccer",263059,247003,16056,148790,140427,8363,114269,106576,7693,"32","23",50591,51984
"558",168430,"WORCESTER STATE COLLEGE                                     ","2003-2004",1,"Baseball",91058,75028,16030,91058,75028,16030,0,0,0,"34",".",60932,0
"6831",161086,"COLBY COLLEGE                                               ","2003-2004",11,"Lacrosse",117438,101412,16026,62921,57934,4987,54517,43478,11039,"37","26",52324,42115
"2680",133979,"FLORIDA MEMORIAL COLLEGE                                    ","2003-2004",2,"Basketball",170500,154500,16000,98500,79800,18700,72000,74700,-2700,"9","12",24000,21700
"5625",132693,"BREVARD COMMUNITY COLLEGE-COCOA CAMPUS                      ","2003-2004",8,"Golf",50500,34500,16000,50500,34500,16000,0,0,0,"10",".",8300,0
"11579",153250,"DORDT COLLEGE                                               ","2003-2004",22,"Tennis",50399,34399,16000,29878,18378,11500,20521,16021,4500,"9","11",2325,3562
"12019",243115,"UNIVERSITY OF PUERTO RICO-ARECIBO                           ","2003-2004",24,"Track and Field, Outdoor",30620,14620,16000,13770,5770,8000,16850,8850,8000,"8","14",880,1540
"16519",132693,"BREVARD COMMUNITY COLLEGE-COCOA CAMPUS                      ","2003-2004",39,"Total Participants",223425,207425,16000,113500,97500,16000,109925,109925,0,"45","39",31400,33875
"9189",262013,"NEW YORK INSTITUTE OF TECHNOLOGY-CENTRAL ISLIP              ","2003-2004",16,"Softball",15975,0,15975,0,0,0,15975,240111,-224136,".","13",0,240110
"16888",262013,"NEW YORK INSTITUTE OF TECHNOLOGY-CENTRAL ISLIP              ","2003-2004",39,"Total Participants",15975,0,15975,0,0,0,15975,240111,-224136,"0","13",0,240110
"6519",215929,"UNIVERSITY OF SCRANTON                                      ","2003-2004",10,"Ice Hockey",75112,59149,15963,75112,59149,15963,0,0,0,"23",".",32905,0
"622",210429,"WESTERN OREGON UNIVERSITY                                   ","2003-2004",1,"Baseball",117723,101806,15917,117723,101806,15917,0,0,0,"52",".",49152,0
"1549",137032,"SAINT LEO UNIVERSITY                                        ","2003-2004",1,"Baseball",155952,140052,15900,155952,140052,15900,0,0,0,"32",".",61068,0
"406",159717,"MCNEESE STATE UNIVERSITY                                    ","2003-2004",1,"Baseball",321249,305375,15874,321249,305375,15874,0,0,0,"41",".",78015,0
"2745",196200,"SUNY-POTSDAM                                                ","2003-2004",2,"Basketball",258688,242832,15856,168695,149147,19548,89993,93685,-3692,"13","10",40236,37922
"843",217518,"ROGER WILLIAMS UNIVERSITY                                   ","2003-2004",1,"Baseball",76572,60740,15832,76572,60740,15832,0,0,0,"23",".",35908,0
"16810",165024,"BRIDGEWATER STATE COLLEGE                                   ","2003-2004",39,"Total Participants",161679,145898,15781,70269,63001,7268,91410,82897,8513,"212","161",102014,91025
"2837",121363,"PORTERVILLE COLLEGE                                         ","2003-2004",2,"Basketball",57700,41920,15780,32700,22800,9900,25000,19120,5880,"14","14",2035,1707
"3703",237312,"UNIVERSITY OF CHARLESTON                                    ","2003-2004",3,"All Track Combined",78215,62507,15708,37201,31754,5447,41014,30753,10261,"30","43",19810,23748
"1602",127185,"FORT LEWIS COLLEGE                                          ","2003-2004",2,"Basketball",433638,417941,15697,233534,230775,2759,200104,187166,12938,"17","12",46241,23335
"1683",165671,"EMMANUEL COLLEGE                                            ","2003-2004",2,"Basketball",134471,118775,15696,50353,50002,351,84118,68773,15345,"18","17",17969,26712
"6253",146205,"JOHN A LOGAN COLLEGE                                        ","2003-2004",8,"Golf",96097,80414,15683,34769,24839,9930,61328,55575,5753,"8","7",19683,21209
"4296",130776,"WESTERN CONNECTICUT STATE UNIVERSITY                        ","2003-2004",7,"Football",242387,226712,15675,242387,226712,15675,0,0,0,"90",".",40470,0
"9291",194310,"PACE UNIVERSITY-NEW YORK                                    ","2003-2004",16,"Softball",101999,86363,15636,0,0,0,101999,86363,15636,".","15",0,22664
"16134",161235,"UNIVERSITY OF MAINE AT FORT KENT                            ","2003-2004",39,"Total Participants",89736,74100,15636,55161,43877,11284,34575,30223,4352,"35","26",75078,70583
"309",157863,"UNION COLLEGE                                               ","2003-2004",1,"Baseball",245135,229500,15635,245135,229500,15635,0,0,0,"23",".",22635,0
"3317",159656,"LOYOLA UNIVERSITY NEW ORLEANS                               ","2003-2004",2,"Basketball",195286,179676,15610,122257,111538,10719,73029,68138,4891,"12","10",43858,18413
"11510",167899,"SPRINGFIELD COLLEGE                                         ","2003-2004",22,"Tennis",21838,6238,15600,11464,3364,8100,10374,2874,7500,"12","11",2530,1392
"16093",139861,"GEORGIA COLLEGE AND STATE UNIVERSITY                        ","2003-2004",39,"Total Participants",568177,552599,15578,285213,276921,8292,282964,275678,7286,"89","75",133728,162760
"4898",115393,"HARTNELL COLLEGE                                            ","2003-2004",7,"Football",61533,45985,15548,61533,45985,15548,0,0,0,"51",".",23500,0
"1280",226231,"LETOURNEAU UNIVERSITY                                       ","2003-2004",1,"Baseball",80896,65361,15535,80896,65361,15535,0,0,0,"36",".",30474,0
"1223",235316,"GONZAGA UNIVERSITY                                          ","2003-2004",1,"Baseball",660929,645400,15529,660929,645400,15529,0,0,0,"34",".",225134,0
"2865",206862,"SOUTHERN NAZARENE UNIVERSITY                                ","2003-2004",2,"Basketball",773505,757997,15508,413063,405309,7754,360442,352688,7754,"16","14",76363,56082
"2893",197133,"VASSAR COLLEGE                                              ","2003-2004",2,"Basketball",109322,93822,15500,62319,46819,15500,47003,47003,0,"15","10",16693,18102
"17058",143613,"CARL SANDBURG COLLEGE                                       ","2003-2004",39,"Total Participants",57217,41749,15468,14420,12885,1535,42797,28864,13933,"30","34",30478,47868
"8230",191649,"HOFSTRA UNIVERSITY                                          ","2003-2004",15,"Soccer",974073,958610,15463,479096,469192,9904,494977,489418,5559,"27","25",94811,76457
"2045",245953,"MID-AMERICA CHRISTIAN UNIVERSITY                            ","2003-2004",2,"Basketball",78879,63450,15429,54861,34539,20322,24018,28911,-4893,"16","13",14913,11742
"4906",172644,"WAYNE STATE UNIVERSITY                                      ","2003-2004",7,"Football",850263,834841,15422,850263,834841,15422,0,0,0,"88",".",90852,0
"16174",155210,"JOHNSON COUNTY COMMUNITY COLLEGE                            ","2003-2004",39,"Total Participants",761302,745965,15337,366681,360554,6127,394621,385411,9210,"146","97",134401,138619
"8098",217518,"ROGER WILLIAMS UNIVERSITY                                   ","2003-2004",15,"Soccer",90704,75380,15324,56542,44713,11829,34162,30667,3495,"27","26",17054,13614
"16570",228343,"SOUTHWESTERN UNIVERSITY                                     ","2003-2004",39,"Total Participants",844015,828712,15303,445718,434618,11100,398297,394094,4203,"119","93",262164,244165
"9310",136206,"NORTHWOOD UNIVERSITY-FLORIDA EDUCATION CENTER               ","2003-2004",16,"Softball",133741,118479,15262,0,0,0,133741,118479,15262,".","17",0,14582
"15727",216524,"URSINUS COLLEGE                                             ","2003-2004",39,"Total Participants",531662,516401,15261,219887,221722,-1835,311775,294679,17096,"251","174",240171,207573
"6259",216694,"WAYNESBURG COLLEGE                                          ","2003-2004",8,"Golf",23700,8464,15236,12150,4734,7416,11550,3730,7820,"14","2",3991,3453
"284",117140,"UNIVERSITY OF LA VERNE                                      ","2003-2004",1,"Baseball",91262,76039,15223,91262,76039,15223,0,0,0,"29",".",23478,0
"13938",171599,"OLIVET COLLEGE                                              ","2003-2004",26,"Volleyball",55862,40639,15223,0,0,0,55862,40639,15223,".","14",0,10384
"12120",219718,"BETHEL COLLEGE                                              ","2003-2004",24,"Track and Field, Outdoor",32238,17066,15172,16119,8533,7586,16119,8533,7586,"8","8",5792,5792
"7127",177214,"DRURY UNIVERSITY                                            ","2003-2004",15,"Soccer",107835,92686,15149,55501,48015,7486,52334,44671,7663,"24","21",39441,40650
"4990",201371,"BLUFFTON COLLEGE                                            ","2003-2004",7,"Football",166163,151016,15147,166163,151016,15147,0,0,0,"70",".",42320,0
"3442",413723,"CASCADE COLLEGE                                             ","2003-2004",2,"Basketball",48600,33454,15146,29343,20632,8711,19257,12822,6435,"21","11",13654,7587
"11793",147828,"OLIVET NAZARENE UNIVERSITY                                  ","2003-2004",22,"Tennis",128031,112889,15142,72807,72057,750,55224,40832,14392,"12","12",14737,13139
"6125",213987,"MERCYHURST COLLEGE                                          ","2003-2004",8,"Golf",114565,99440,15125,68827,54890,13937,45738,44550,1188,"13","9",5400,5400
"4666",177339,"EVANGEL UNIVERSITY                                          ","2003-2004",7,"Football",740405,725289,15116,740405,725289,15116,0,0,0,"79",".",72100,0
"4766",204857,"OHIO UNIVERSITY-MAIN CAMPUS                                 ","2003-2004",7,"Football",3336423,3321350,15073,3336423,3321350,15073,0,0,0,"105",".",305060,0
"11696",184348,"DREW UNIVERSITY                                             ","2003-2004",22,"Tennis",81721,66662,15059,41636,32532,9104,40085,34130,5955,"12","12",5977,3955
"9128",196079,"SUNY AT BINGHAMTON                                          ","2003-2004",16,"Softball",424283,409229,15054,0,0,0,424283,409229,15054,".","22",0,55158
"4474",154688,"BAKER UNIVERSITY COLLEGE OF ARTS AND SCIENCES               ","2003-2004",7,"Football",364715,349669,15046,364715,349669,15046,0,0,0,"110",".",89566,0
"15319",207306,"NORTHWESTERN OKLAHOMA STATE UNIVERSITY                      ","2003-2004",35,"Rodeo",57280,42238,15042,28640,21119,7521,28640,21119,7521,"45","30",4500,4500
"7825",150400,"DEPAUW UNIVERSITY                                           ","2003-2004",15,"Soccer",172659,157673,14986,110672,102162,8510,61987,55511,6476,"31","27",22373,27487
"2438",154907,"CLOUD COUNTY COMMUNITY COLLEGE                              ","2003-2004",2,"Basketball",186949,171966,14983,99976,91449,8527,86973,80517,6456,"15","14",887,1118
"15042",171599,"OLIVET COLLEGE                                              ","2003-2004",28,"Wrestling",67456,52473,14983,67456,52473,14983,0,0,0,"40","0",20979,0
"10475",188429,"ADELPHI UNIVERSITY                                          ","2003-2004",19,"Swimming",93307,78346,14961,39248,36493,2755,54059,41853,12206,"5","9",6470,11645
"7429",240329,"UNIVERSITY OF WISCONSIN-LA CROSSE                           ","2003-2004",15,"Soccer",36602,21658,14944,0,0,0,36602,21658,14944,".","25",0,16097
"6465",165866,"FRAMINGHAM STATE COLLEGE                                    ","2003-2004",10,"Ice Hockey",57450,42514,14936,57450,42514,14936,0,0,0,"28",".",20944,0
"16493",197045,"UTICA COLLEGE                                               ","2003-2004",39,"Total Participants",744225,729300,14925,361650,340525,21125,382575,388775,-6200,"234","167",183850,158200
"11297",164562,"ASSUMPTION COLLEGE                                          ","2003-2004",22,"Tennis",36397,21502,14895,26881,12958,13923,9516,8544,972,"7","12",3850,2350
"8622",110486,"CALIFORNIA STATE UNIVERSITY-BAKERSFIELD                     ","2003-2004",16,"Softball",190211,175331,14880,0,0,0,190211,175331,14880,".","18",0,34396
"1658",239512,"NORTHLAND COLLEGE                                           ","2003-2004",2,"Basketball",115036,100235,14801,58450,49684,8766,56586,50551,6035,"22","10",28713,28774
"8011",227243,"NORTHWOOD UNIVERSITY                                        ","2003-2004",15,"Soccer",295092,280291,14801,149885,141882,8003,145207,138409,6798,"21","18",19733,23401
"8508",125028,"VENTURA COLLEGE                                             ","2003-2004",15,"Soccer",42932,28141,14791,0,0,0,42932,28141,14791,".","20",0,9989
"11495",176318,"RUST COLLEGE                                                ","2003-2004",22,"Tennis",31078,16312,14766,15539,8156,7383,15539,8156,7383,"6","7",850,850
"16967",239512,"NORTHLAND COLLEGE                                           ","2003-2004",39,"Total Participants",353933,339175,14758,195951,184962,10989,157982,154213,3769,"99","64",151294,111885
"3473",184612,"FELICIAN COLLEGE                                            ","2003-2004",2,"Basketball",429657,415042,14615,256961,243084,13877,172696,171958,738,"24","17",49615,31746
"2197",104708,"GLENDALE COMMUNITY COLLEGE                                  ","2003-2004",2,"Basketball",58655,44048,14607,29066,21916,7150,29589,22132,7457,"15","12",6843,6096
"6453",197045,"UTICA COLLEGE                                               ","2003-2004",10,"Ice Hockey",279100,264500,14600,152300,138000,14300,126800,126500,300,"26","25",51400,45500
"2027",165644,"EASTERN NAZARENE COLLEGE                                    ","2003-2004",2,"Basketball",138367,123840,14527,60575,61079,-504,77792,62761,15031,"14","12",16998,16323
"10797",139764,"GEORGIA SOUTHWESTERN STATE UNIVERSITY                       ","2003-2004",22,"Tennis",116000,101474,14526,52000,47490,4510,64000,53984,10016,"8","7",13498,12977
"2227",130776,"WESTERN CONNECTICUT STATE UNIVERSITY                        ","2003-2004",2,"Basketball",225833,211317,14516,119740,114877,4863,106093,96440,9653,"13","10",28172,24865
"2384",128498,"ALBERTUS MAGNUS COLLEGE                                     ","2003-2004",2,"Basketball",35400,20899,14501,18300,10549,7751,17100,10350,6750,"10","11",10550,11385
"7597",236595,"SEATTLE UNIVERSITY                                          ","2003-2004",15,"Soccer",537587,523097,14490,314514,279184,35330,223073,243913,-20840,"29","24",66817,43101
"8217",209065,"LINFIELD COLLEGE                                            ","2003-2004",15,"Soccer",99600,85120,14480,45721,38481,7240,53879,46639,7240,"25","48",15950,21552
"15964",206011,"TERRA STATE COMMUNITY COLLEGE                               ","2003-2004",39,"Total Participants",66067,51598,14469,24067,17096,6971,42000,34502,7498,"6","9",11033,12480
"10296",125028,"VENTURA COLLEGE                                             ","2003-2004",18,"Swimming and Diving",73326,58868,14458,36663,29434,7229,36663,29434,7229,"16","22",11214,11214
"3285",157401,"MURRAY STATE UNIVERSITY                                     ","2003-2004",2,"Basketball",1925706,1911256,14450,1329506,1330182,-676,596200,581074,15126,"15","14",276866,113023
"1868",143118,"AURORA UNIVERSITY                                           ","2003-2004",2,"Basketball",105101,90656,14445,62454,54582,7872,42647,36074,6573,"21","16",13884,11089
"8271",181446,"NEBRASKA WESLEYAN UNIVERSITY                                ","2003-2004",15,"Soccer",61270,46833,14437,33788,23696,10092,27482,23137,4345,"16","23",12407,13638
"16290",122339,"SAN DIEGO CITY COLLEGE                                      ","2003-2004",39,"Total Participants",194385,179966,14419,91693,87656,4037,102692,92310,10382,"79","61",30286,25108
"13391",148496,"DOMINICAN UNIVERSITY                                        ","2003-2004",26,"Volleyball",33000,18592,14408,0,0,0,33000,18592,14408,".","12",0,11592
"44",191302,"FULTON-MONTGOMERY COMMUNITY COLLEGE                         ","2003-2004",1,"Baseball",26828,12424,14404,26828,12424,14404,0,0,0,"24",".",9040,0
"16909",196158,"SUNY COLLEGE AT FREDONIA                                    ","2003-2004",39,"Total Participants",783935,769540,14395,420322,409651,10671,363613,359889,3724,"174","190",206128,206416
"8193",158431,"BOSSIER PARISH COMMUNITY COLLEGE                            ","2003-2004",15,"Soccer",63185,48793,14392,0,0,0,63185,48793,14392,".","15",0,16828
"9643",131520,"HOWARD UNIVERSITY                                           ","2003-2004",16,"Softball",306362,291971,14391,0,0,0,306362,291971,14391,".","22",0,63754
"15309",180373,"MILES COMMUNITY COLLEGE                                     ","2003-2004",35,"Rodeo",141467,127110,14357,87710,78808,8902,53757,48302,5455,"18","11",41727,25575
"11359",148496,"DOMINICAN UNIVERSITY                                        ","2003-2004",22,"Tennis",30500,16188,14312,16500,8228,8272,14000,7960,6040,"7","8",3728,3459
"3056",215099,"PHILADELPHIA UNIVERSITY                                     ","2003-2004",2,"Basketball",512227,497919,14308,255775,240638,15137,256452,257281,-829,"12","13",15150,15150
"4679",191719,"HUDSON VALLEY COMMUNITY COLLEGE                             ","2003-2004",7,"Football",152685,138381,14304,152685,138381,14304,0,0,0,"80",".",86560,0
"14669",122384,"SAN DIEGO MIRAMAR COLLEGE                                   ","2003-2004",27,"Water Polo",14250,0,14250,14250,14250,0,0,0,0,"8",".",11250,0
"15491",122384,"SAN DIEGO MIRAMAR COLLEGE                                   ","2003-2004",39,"Total Participants",14250,0,14250,14250,14250,0,0,0,0,"8","0",11250,0
"3453",207847,"SOUTHEASTERN OKLAHOMA STATE UNIVERSITY                      ","2003-2004",2,"Basketball",291305,277071,14234,154013,139779,14234,137292,137292,0,"18","15",26454,24174
"10252",195234,"THE COLLEGE OF SAINT ROSE                                   ","2003-2004",18,"Swimming and Diving",176475,162244,14231,70741,63272,7469,105734,98972,6762,"10","21",11383,11383
"11277",102368,"TROY STATE UNIVERSITY-MAIN CAMPUS                           ","2003-2004",22,"Tennis",251151,236932,14219,125575,96378,29197,125576,140554,-14978,"8","8",22348,22348
"11087",213349,"KUTZTOWN UNIVERSITY OF PENNSYLVANIA                         ","2003-2004",22,"Tennis",94123,79909,14214,49912,42548,7364,44211,37361,6850,"7","9",13366,7887
"16738",211981,"DELAWARE VALLEY COLLEGE                                     ","2003-2004",39,"Total Participants",261396,247196,14200,148850,141750,7100,112546,105446,7100,"294","101",106900,46281
"583",168546,"ALBION COLLEGE                                              ","2003-2004",1,"Baseball",63299,49135,14164,63299,49135,14164,0,0,0,"26",".",25293,0
"12901",167394,"COLLEGE OF OUR LADY OF THE ELMS                             ","2003-2004",25,"Track and Field, X-Country",23168,9026,14142,11584,4513,7071,11584,4513,7071,"5","3",1163,1163
"4537",214175,"MUHLENBERG COLLEGE                                          ","2003-2004",7,"Football",138640,124515,14125,138640,124515,14125,0,0,0,"95",".",84757,0
"4643",211158,"BLOOMSBURG UNIVERSITY OF PENNSYLVANIA                       ","2003-2004",7,"Football",622618,608494,14124,622618,608494,14124,0,0,0,"92",".",49238,0
"1526",204635,"OHIO NORTHERN UNIVERSITY                                    ","2003-2004",1,"Baseball",71756,57651,14105,71756,57651,14105,0,0,0,"40",".",36513,0
"5936",182795,"FRANKLIN PIERCE COLLEGE                                     ","2003-2004",8,"Golf",36233,22135,14098,26643,15233,11410,9590,6902,2688,"7","5",10165,2688
"5175",154688,"BAKER UNIVERSITY COLLEGE OF ARTS AND SCIENCES               ","2003-2004",8,"Golf",105234,91176,14058,45160,45812,-652,60074,45364,14710,"15","6",11036,12236
"961",148405,"ROCKFORD COLLEGE                                            ","2003-2004",1,"Baseball",67225,53171,14054,67225,53171,14054,0,0,0,"18",".",27500,0
"2769",180106,"CARROLL COLLEGE                                             ","2003-2004",2,"Basketball",625706,611661,14045,316591,305541,11050,309115,306120,2995,"17","16",56816,56636
"4645",107512,"OUACHITA BAPTIST UNIVERSITY                                 ","2003-2004",7,"Football",1230300,1216278,14022,1230300,1216278,14022,0,0,0,"72",".",115118,0
"1359",152992,"BRIAR CLIFF UNIVERSITY                                      ","2003-2004",1,"Baseball",288589,274578,14011,288589,274578,14011,0,0,0,"38",".",32035,0
"8366",101435,"HUNTINGDON COLLEGE                                          ","2003-2004",15,"Soccer",120295,106351,13944,57320,55264,2056,62975,51087,11888,"19","15",27924,27574
"12282",136215,"NOVA SOUTHEASTERN UNIVERSITY                                ","2003-2004",25,"Track and Field, X-Country",90430,76516,13914,39200,32932,6268,51230,43584,7646,"4","6",3744,3769
"9494",134608,"INDIAN RIVER COMMUNITY COLLEGE                              ","2003-2004",16,"Softball",101428,87520,13908,0,0,0,101428,87520,13908,".","25",0,13908
"3652",155715,"PRATT COMMUNITY COLLEGE                                     ","2003-2004",3,"All Track Combined",86670,72769,13901,43335,36384,6951,43335,36385,6950,"18","3",2500,2500
"2145",218645,"UNIVERSITY OF SOUTH CAROLINA-AIKEN                          ","2003-2004",2,"Basketball",537504,523609,13895,259941,257263,2678,277563,266346,11217,"14","13",32790,32823
"6902",191241,"FORDHAM UNIVERSITY                                          ","2003-2004",13,"Rowing",320197,306310,13887,0,0,0,320197,306310,13887,"0","36",0,26867
"16349",240338,"WISCONSIN LUTHERAN COLLEGE                                  ","2003-2004",39,"Total Participants",285705,271842,13863,114499,118471,-3972,171206,153371,17835,"141","112",182435,87438
"16526",107877,"WILLIAMS BAPTIST COLLEGE                                    ","2003-2004",39,"Total Participants",328762,314901,13861,204623,190182,14441,124139,124719,-580,"58","38",62868,57263
"10375",131520,"HOWARD UNIVERSITY                                           ","2003-2004",18,"Swimming and Diving",272531,258674,13857,121995,129337,-7342,150536,129337,21199,"28",".",9540,18520
"15",237312,"UNIVERSITY OF CHARLESTON                                    ","2003-2004",1,"Baseball",66111,52256,13855,66111,52256,13855,0,0,0,"32",".",12670,0
"2008",200022,"BISMARCK STATE COLLEGE                                      ","2003-2004",2,"Basketball",52866,39014,13852,28411,20865,7546,24455,18149,6306,"13","10",20865,18150
"9328",107983,"SOUTHERN ARKANSAS UNIVERSITY MAIN CAMPUS                    ","2003-2004",16,"Softball",66124,52292,13832,0,0,0,66124,52292,13832,".","18",0,41750
"13670",151801,"INDIANA WESLEYAN UNIVERSITY                                 ","2003-2004",26,"Volleyball",47385,33602,13783,0,0,0,47385,33602,13783,"0","13",0,24063
"11304",190567,"CUNY CITY COLLEGE                                           ","2003-2004",22,"Tennis",27230,13454,13776,13615,6680,6935,13615,6774,6841,"9","9",3086,4080
"2399",219833,"CHRISTIAN BROTHERS UNIVERSITY                               ","2003-2004",2,"Basketball",65396,51627,13769,34622,25390,9232,30774,26237,4537,"15","13",22600,23837
"9202",110574,"CALIFORNIA STATE UNIVERSITY-HAYWARD                         ","2003-2004",16,"Softball",127206,113438,13768,0,0,0,127206,113438,13768,".","14",0,43834
"1521",209065,"LINFIELD COLLEGE                                            ","2003-2004",1,"Baseball",119229,105476,13753,119229,105476,13753,0,0,0,"43",".",53320,0
"2341",186201,"RAMAPO COLLEGE OF NEW JERSEY                                ","2003-2004",2,"Basketball",180302,166549,13753,133832,118591,15241,46470,47958,-1488,"19","14",41309,27997
"16375",217475,"COMMUNITY COLLEGE OF RHODE ISLAND                           ","2003-2004",39,"Total Participants",118500,104750,13750,61500,53550,7950,57000,51200,5800,"105","85",66150,65450
"10942",212577,"FRANKLIN AND MARSHALL COLLEGE                               ","2003-2004",22,"Tennis",51303,37566,13737,19163,13058,6105,32140,24508,7632,"14","7",4736,4352
"2389",157100,"KENTUCKY CHRISTIAN COLLEGE                                  ","2003-2004",2,"Basketball",95692,81971,13721,54054,44284,9770,41638,37687,3951,"10","10",34524,26087
"6884",110680,"UNIVERSITY OF CALIFORNIA-SAN DIEGO                          ","2003-2004",13,"Rowing",293186,279489,13697,130871,130579,292,162315,148910,13405,"48","65",63676,66043
"15728",198695,"HIGH POINT UNIVERSITY                                       ","2003-2004",39,"Total Participants",2105788,2092091,13697,1134956,1104223,30733,970832,987868,-17036,"181","119",289520,228589
"17284",129774,"MITCHELL COLLEGE                                            ","2003-2004",39,"Total Participants",445203,431510,13693,258139,246446,11693,187064,185064,2000,"90","58",67955,68138
"10407",236595,"SEATTLE UNIVERSITY                                          ","2003-2004",18,"Swimming and Diving",297421,283737,13684,157423,150581,6842,139998,133156,6842,"15","17",41072,41072
"5269",136215,"NOVA SOUTHEASTERN UNIVERSITY                                ","2003-2004",8,"Golf",337474,323820,13654,148737,146440,2297,188737,177380,11357,"7","6",57483,45760
"16820",140872,"REINHARDT COLLEGE                                           ","2003-2004",39,"Total Participants",374573,360923,13650,216521,202871,13650,158052,158052,0,"72","49",5798,6094
"8233",236708,"SPOKANE FALLS COMMUNITY COLLEGE                             ","2003-2004",15,"Soccer",77350,63715,13635,34062,23275,10787,43288,40440,2848,"24","21",19745,30746
"15998",211927,"DELAWARE COUNTY COMMUNITY COLLEGE                           ","2003-2004",39,"Total Participants",35800,22200,13600,21500,12500,9000,14300,9700,4600,"49","29",16280,9170
"1235",163426,"MONTGOMERY COLLEGE                                          ","2003-2004",1,"Baseball",133164,119577,13587,133164,119577,13587,0,0,0,"36",".",93844,0
"4124",217484,"UNIVERSITY OF RHODE ISLAND                                  ","2003-2004",6,"Field hocky",345283,331755,13528,0,0,0,345283,331755,13528,".","23",0,53517
"3245",117690,"LOS ANGELES HARBOR COLLEGE                                  ","2003-2004",2,"Basketball",148012,134504,13508,82012,72333,9679,66000,62171,3829,"13","13",17153,15241
"642",146205,"JOHN A LOGAN COLLEGE                                        ","2003-2004",1,"Baseball",149083,135604,13479,149083,135604,13479,0,0,0,"23",".",76434,0
"4357",174738,"ROCHESTER COMMUNITY AND TECHNICAL COLLEGE                   ","2003-2004",7,"Football",61977,48504,13473,61977,48504,13473,0,0,0,"65",".",39462,0
"2279",237783,"SALEM INTERNATIONAL UNIVERSITY                              ","2003-2004",2,"Basketball",122326,108870,13456,76802,65882,10920,45524,42988,2536,"15","13",33883,21608
"16091",219046,"BLACK HILLS STATE UNIVERSITY                                ","2003-2004",39,"Total Participants",334481,321045,13436,114675,111117,3558,219806,209928,9878,"142","81",125225,105225
"16170",164270,"MCDANIEL COLLEGE                                            ","2003-2004",39,"Total Participants",624911,611479,13432,309777,301885,7892,315134,309594,5540,"311","213",234507,176206
"7664",175980,"MILLSAPS COLLEGE                                            ","2003-2004",15,"Soccer",86895,73472,13423,39256,28936,10320,47639,44536,3103,"29","20",16936,16936
"14597",215743,"SAINT FRANCIS UNIVERSITY                                    ","2003-2004",26,"Volleyball",209858,196438,13420,80070,71741,8329,129788,124697,5091,"24","14",11983,27947
"12966",153144,"COE COLLEGE                                                 ","2003-2004",25,"Track and Field, X-Country",146232,132822,13410,70926,65221,5705,75306,67601,7705,"61","60",18228,20608
"7531",204468,"NOTRE DAME COLLEGE                                          ","2003-2004",15,"Soccer",103095,89705,13390,55710,42320,13390,47385,47385,0,"23","16",28620,21575
"14044",211431,"CARLOW COLLEGE                                              ","2003-2004",26,"Volleyball",13385,0,13385,0,0,0,13385,78356,-64971,".","17",0,4845
"8064",189848,"CAZENOVIA COLLEGE                                           ","2003-2004",15,"Soccer",54826,41443,13383,20994,19956,1038,33832,21487,12345,"13","16",19856,20487
"6322",215062,"UNIVERSITY OF PENNSYLVANIA                                  ","2003-2004",9,"Gymnastics",170661,157306,13355,0,0,0,170661,157306,13355,".","22",0,56816
"16328",170620,"LAKE MICHIGAN COLLEGE                                       ","2003-2004",39,"Total Participants",126896,113542,13354,43736,39012,4724,83160,74530,8630,"36","38",25400,41124
"10469",137847,"THE UNIVERSITY OF TAMPA                                     ","2003-2004",19,"Swimming",179044,165710,13334,81772,72605,9167,97272,93105,4167,"20","23",19406,19406
"3084",175980,"MILLSAPS COLLEGE                                            ","2003-2004",2,"Basketball",176710,163383,13327,90221,84945,5276,86489,78438,8051,"13","13",27945,29638
"7654",171492,"NORTHWOOD UNIVERSITY                                        ","2003-2004",15,"Soccer",250322,237025,13297,111151,95485,15666,139171,141540,-2369,"24","23",13674,19530
"15499",195234,"THE COLLEGE OF SAINT ROSE                                   ","2003-2004",39,"Total Participants",1321241,1307953,13288,671000,663119,7881,650241,644834,5407,"123","98",148105,119761
"871",110592,"CALIFORNIA STATE UNIVERSITY-LOS ANGELES                     ","2003-2004",1,"Baseball",293946,280663,13283,293946,280663,13283,0,0,0,"28",".",43528,0
"1816",138789,"ARMSTRONG ATLANTIC STATE UNIVERSITY                         ","2003-2004",2,"Basketball",503961,490694,13267,263252,256944,6308,240709,233750,6959,"13","12",145160,128709
"14640",132657,"LYNN UNIVERSITY                                             ","2003-2004",26,"Volleyball",251081,237821,13260,0,0,0,251081,237821,13260,".","14",0,22520
"3835",202763,"THE UNIVERSITY OF FINDLAY                                   ","2003-2004",3,"All Track Combined",460628,447374,13254,228883,221525,7358,231745,225849,5896,"44","34",54234,49112
"17092",153162,"CORNELL COLLEGE                                             ","2003-2004",39,"Total Participants",442204,428958,13246,235800,229790,6010,206404,199168,7236,"240","164",188266,107552
"16802",240471,"UNIVERSITY OF WISCONSIN-RIVER FALLS                         ","2003-2004",39,"Total Participants",569049,555811,13238,181863,180724,1139,387186,375087,12099,"263","213",145051,171644
"13093",140951,"SAVANNAH COLLEGE OF ART AND DESIGN                          ","2003-2004",26,"Volleyball",136318,123089,13229,0,0,0,136318,123089,13229,".","13",0,58822
"8976",212115,"EAST STROUDSBURG UNIVERSITY OF PENNSYLVANIA                 ","2003-2004",16,"Softball",100830,87609,13221,0,0,0,100830,87609,13221,".","20",0,10963
"2424",230737,"UTAH VALLEY STATE COLLEGE                                   ","2003-2004",2,"Basketball",731072,717855,13217,474343,474343,0,256729,243512,13217,"17","15",133902,60391
"13451",194091,"NEW YORK INSTITUTE OF TECHNOLOGY-OLD WESTBURY               ","2003-2004",26,"Volleyball",187393,174186,13207,0,0,0,187393,174186,13207,".","8",0,22467
"10502",211440,"CARNEGIE MELLON UNIVERSITY                                  ","2003-2004",19,"Swimming",201387,188185,13202,100460,96094,4366,100927,92091,8836,"24","19",59145,55142
"16466",203535,"KENYON COLLEGE                                              ","2003-2004",39,"Total Participants",950904,937702,13202,461612,459360,2252,489292,478342,10950,"224","211",268253,204611
"3857",213349,"KUTZTOWN UNIVERSITY OF PENNSYLVANIA                         ","2003-2004",3,"All Track Combined",267347,254162,13185,132519,123721,8798,134828,130441,4387,"36","52",34466,33983
"10819",182795,"FRANKLIN PIERCE COLLEGE                                     ","2003-2004",22,"Tennis",72870,59690,13180,51019,44272,6747,21851,15418,6433,"9","8",6502,5783
"10728",213987,"MERCYHURST COLLEGE                                          ","2003-2004",22,"Tennis",122160,109000,13160,54165,46450,7715,67995,62550,5445,"9","9",6300,6500
"2894",220631,"LINCOLN MEMORIAL UNIVERSITY                                 ","2003-2004",2,"Basketball",614582,601449,13133,302902,290819,12083,311680,310630,1050,"15","15",130005,137191
"3749",213367,"LA SALLE UNIVERSITY                                         ","2003-2004",3,"All Track Combined",675153,662033,13120,371722,364412,7310,303431,297621,5810,"44","42",55382,50049
"12761",207209,"LANGSTON UNIVERSITY                                         ","2003-2004",25,"Track and Field, X-Country",16943,3880,13063,0,0,0,16943,3880,13063,".","4",0,1602
"13218",163912,"ST MARY'S COLLEGE OF MARYLAND                               ","2003-2004",26,"Volleyball",35613,22581,13032,0,0,0,35613,22581,13032,".","12",0,16000
"9945",218441,"NORTH GREENVILLE COLLEGE                                    ","2003-2004",16,"Softball",23379,10348,13031,0,0,0,23379,10348,13031,".","19",0,9465
"915",125028,"VENTURA COLLEGE                                             ","2003-2004",1,"Baseball",52116,39112,13004,52116,39112,13004,0,0,0,"40",".",25712,0
"8270",159717,"MCNEESE STATE UNIVERSITY                                    ","2003-2004",15,"Soccer",201763,188761,13002,0,0,0,201763,188761,13002,"0","25",0,46386
"15509",123554,"SAINT MARYS COLLEGE OF CALIFORNIA                           ","2003-2004",39,"Total Participants",3076978,3063996,12982,1320770,1318049,2721,1756208,1745947,10261,"194","129",623754,384276
"3075",154998,"DODGE CITY COMMUNITY COLLEGE                                ","2003-2004",2,"Basketball",198801,185820,12981,100181,93719,6462,98620,92101,6519,"13","15",26626,23219
"11232",144865,"COLLEGE OF DUPAGE                                           ","2003-2004",22,"Tennis",36630,23650,12980,16850,10600,6250,19780,13050,6730,"10","7",9850,8780
"7352",177542,"HANNIBAL-LAGRANGE COLLEGE                                   ","2003-2004",15,"Soccer",194247,181269,12978,98413,94778,3635,95834,86491,9343,"21","20",11848,11590
"2347",140720,"PAINE COLLEGE                                               ","2003-2004",2,"Basketball",327325,314357,12968,166027,159543,6484,161298,154814,6484,"15","15",66361,64577
"3799",144962,"ELMHURST COLLEGE                                            ","2003-2004",3,"All Track Combined",107179,94250,12929,50489,45205,5284,56690,49045,7645,"34","14",12245,12245
"17044",217156,"BROWN UNIVERSITY                                            ","2003-2004",39,"Total Participants",5233098,5220169,12929,2494933,2488959,5974,2738165,2731210,6955,"470","545",993586,916505
"166",140818,"PIEDMONT COLLEGE                                            ","2003-2004",1,"Baseball",109986,97064,12922,109986,97064,12922,0,0,0,"31",".",37780,0
"14148",229780,"WAYLAND BAPTIST UNIVERSITY                                  ","2003-2004",26,"Volleyball",86000,73100,12900,0,0,0,86000,73100,12900,".","16",0,29500
"4167",212577,"FRANKLIN AND MARSHALL COLLEGE                               ","2003-2004",6,"Field hocky",78668,65772,12896,0,0,0,78668,65772,12896,".","20",0,20241
"4300",145372,"GREENVILLE COLLEGE                                          ","2003-2004",7,"Football",229956,217062,12894,229956,217062,12894,0,0,0,"65",".",41131,0
"14981",214175,"MUHLENBERG COLLEGE                                          ","2003-2004",28,"Wrestling",33165,20301,12864,33165,20301,12864,0,0,0,"15",".",16969,0
"15052",213349,"KUTZTOWN UNIVERSITY OF PENNSYLVANIA                         ","2003-2004",28,"Wrestling",79077,66219,12858,79077,66219,12858,0,0,0,"21",".",18653,0
"9255",164562,"ASSUMPTION COLLEGE                                          ","2003-2004",16,"Softball",69664,56850,12814,0,0,0,69664,56850,12814,".","17",0,12500
"5438",131469,"GEORGE WASHINGTON UNIVERSITY                                ","2003-2004",8,"Golf",169759,156947,12812,169759,156947,12812,0,0,0,"10",".",27755,0
"1607",106148,"YAVAPAI COLLEGE                                             ","2003-2004",2,"Basketball",337580,324770,12810,168790,164994,3796,168790,159776,9014,"13","13",47799,47597
"8345",212054,"DREXEL UNIVERSITY                                           ","2003-2004",15,"Soccer",838675,825894,12781,377005,457270,-80265,461670,368624,93046,"32","25",47980,45382
"7662",173665,"HAMLINE UNIVERSITY                                          ","2003-2004",15,"Soccer",91548,78785,12763,45316,38945,6371,46232,39840,6392,"22","26",10300,11055
"4881",115296,"GROSSMONT COLLEGE                                           ","2003-2004",7,"Football",131840,119081,12759,131840,119081,12759,0,0,0,"86",".",58747,0
"6179",235097,"EASTERN WASHINGTON UNIVERSITY                               ","2003-2004",8,"Golf",132733,119991,12742,0,0,0,132733,119991,12742,".","8",0,24036
"6194",102049,"SAMFORD UNIVERSITY                                          ","2003-2004",8,"Golf",308353,295616,12737,125812,129955,-4143,182541,165661,16880,"7","7",30463,28635
"16374",240374,"UNIVERSITY OF WISCONSIN-PARKSIDE                            ","2003-2004",39,"Total Participants",1332851,1320132,12719,770569,763794,6775,562282,556338,5944,"108","74",131682,141752
"10336",196130,"SUNY COLLEGE AT BUFFALO                                     ","2003-2004",18,"Swimming and Diving",101178,88460,12718,50589,39807,10782,50589,48653,1936,"9","11",22707,27753
"4770",196130,"SUNY COLLEGE AT BUFFALO                                     ","2003-2004",7,"Football",232878,220161,12717,232878,220161,12717,0,0,0,"95",".",82827,0
"13355",146427,"KNOX COLLEGE                                                ","2003-2004",26,"Volleyball",34283,21568,12715,0,0,0,34283,21568,12715,".","17",0,17839
"8834",228042,"SCHREINER UNIVERSITY                                        ","2003-2004",16,"Softball",67780,55071,12709,0,0,0,67780,55071,12709,".","14",0,20000
"9383",129941,"UNIVERSITY OF NEW HAVEN                                     ","2003-2004",16,"Softball",134895,122193,12702,0,0,0,134895,122193,12702,".","22",0,19989
"16002",165644,"EASTERN NAZARENE COLLEGE                                    ","2003-2004",39,"Total Participants",171289,158612,12677,98334,81407,16927,72955,77205,-4250,"72","74",63429,53661
"17341",157216,"LINDSEY WILSON COLLEGE                                      ","2003-2004",39,"Total Participants",2007611,1994937,12674,1001175,995237,5938,1006436,999700,6736,"88","93",118214,98943
"4973",206862,"SOUTHERN NAZARENE UNIVERSITY                                ","2003-2004",7,"Football",635608,622986,12622,635608,622986,12622,0,0,0,"78",".",138735,0
"1908",179715,"NORTH CENTRAL MISSOURI COLLEGE                              ","2003-2004",2,"Basketball",97728,85122,12606,45452,39149,6303,52276,45973,6303,"14","12",14286,17082
"14626",182795,"FRANKLIN PIERCE COLLEGE                                     ","2003-2004",26,"Volleyball",79852,67251,12601,0,0,0,79852,67251,12601,".","13",0,11551
"1093",125763,"WHITTIER COLLEGE                                            ","2003-2004",1,"Baseball",38090,25490,12600,38090,25490,12600,0,0,0,"30",".",14400,0
"11547",240329,"UNIVERSITY OF WISCONSIN-LA CROSSE                           ","2003-2004",22,"Tennis",51610,39022,12588,25413,16591,8822,26197,22431,3766,"12","11",3861,9701
"4920",203085,"HEIDELBERG COLLEGE                                          ","2003-2004",7,"Football",198823,186236,12587,198823,186236,12587,0,0,0,"97",".",69728,0
"8708",219824,"CHATTANOOGA STATE TECHNICAL COMMUNITY COLLEGE               ","2003-2004",16,"Softball",62423,49837,12586,0,0,0,62423,49837,12586,".","21",0,13333
"16703",128106,"COLORADO STATE UNIVERSITY-PUEBLO                            ","2003-2004",39,"Total Participants",758458,745872,12586,375558,333026,42532,382900,412846,-29946,"121","81",163360,167020
"3682",102368,"TROY STATE UNIVERSITY-MAIN CAMPUS                           ","2003-2004",3,"All Track Combined",501424,488930,12494,250712,202533,48179,250712,286397,-35685,"46","34",36997,36997
"8142",198598,"GREENSBORO COLLEGE                                          ","2003-2004",15,"Soccer",136950,124463,12487,71344,65683,5661,65606,58780,6826,"24","22",24168,26192
"3618",191515,"HAMILTON COLLEGE                                            ","2003-2004",3,"All Track Combined",145746,133267,12479,89752,84278,5474,55994,48989,7005,"63","58",20811,21196
"7924",129941,"UNIVERSITY OF NEW HAVEN                                     ","2003-2004",15,"Soccer",411634,399167,12467,222577,215665,6912,189057,183502,5555,"23","21",17754,16283
"2895",173300,"CONCORDIA COLLEGE AT MOORHEAD                               ","2003-2004",2,"Basketball",160510,148075,12435,87823,79659,8164,72687,68416,4271,"16","21",5240,4860
"16339",234669,"BELLEVUE COMMUNITY COLLEGE                                  ","2003-2004",39,"Total Participants",202080,189650,12430,141600,133500,8100,60480,56150,4330,"68","69",30210,35050
"8961",218821,"SPARTANBURG METHODIST COLLEGE                               ","2003-2004",16,"Softball",81958,69536,12422,0,0,0,81958,69536,12422,".","22",0,30740
"13181",173647,"GUSTAVUS ADOLPHUS COLLEGE                                   ","2003-2004",26,"Volleyball",99275,86859,12416,0,0,0,99275,86859,12416,".","19",0,23618
"2101",157632,"SAINT CATHARINE COLLEGE                                     ","2003-2004",2,"Basketball",236195,223797,12398,136144,129985,6159,100051,93812,6239,"16","16",19200,19200
"2042",439145,"PIERCE COLLEGE AT PUYALLUP                                  ","2003-2004",2,"Basketball",92028,79638,12390,45955,41503,4452,46073,38135,7938,"11","10",11548,12884
"3233",168430,"WORCESTER STATE COLLEGE                                     ","2003-2004",2,"Basketball",86543,74156,12387,29425,29950,-525,57118,44206,12912,"10","12",28950,42226
"14287",130776,"WESTERN CONNECTICUT STATE UNIVERSITY                        ","2003-2004",26,"Volleyball",62266,49888,12378,0,0,0,62266,49888,12378,".","17",0,25803
"1065",240374,"UNIVERSITY OF WISCONSIN-PARKSIDE                            ","2003-2004",1,"Baseball",197806,185472,12334,197806,185472,12334,0,0,0,"23",".",42100,0
"2124",218441,"NORTH GREENVILLE COLLEGE                                    ","2003-2004",2,"Basketball",51358,39057,12301,25679,22074,3605,25679,16983,8696,"14","15",18947,16424
"3172",239220,"MID-STATE TECHNICAL COLLEGE                                 ","2003-2004",2,"Basketball",74512,62237,12275,44077,35299,8778,30435,26938,3497,"13","8",19255,14694
"5389",188429,"ADELPHI UNIVERSITY                                          ","2003-2004",8,"Golf",51327,39070,12257,51327,39070,12257,0,0,0,"10",".",12257,0
"11860",207209,"LANGSTON UNIVERSITY                                         ","2003-2004",23,"Track and Field, Indoor",20912,8657,12255,10456,3753,6703,10456,4904,5552,"6","7",573,573
"11931",207209,"LANGSTON UNIVERSITY                                         ","2003-2004",24,"Track and Field, Outdoor",20912,8657,12255,10456,3753,6703,10456,4904,5552,"14","7",636,636
"13325",224527,"EAST TEXAS BAPTIST UNIVERSITY                               ","2003-2004",26,"Volleyball",97942,85691,12251,0,0,0,97942,85691,12251,"0","13",0,47735
"11545",110592,"CALIFORNIA STATE UNIVERSITY-LOS ANGELES                     ","2003-2004",22,"Tennis",165641,153398,12243,0,0,0,165641,153398,12243,".","14",0,6726
"13949",240338,"WISCONSIN LUTHERAN COLLEGE                                  ","2003-2004",26,"Volleyball",47104,34862,12242,0,0,0,47104,34862,12242,".","18",0,12494
"2141",161688,"ALLEGANY COLLEGE OF MARYLAND                                ","2003-2004",2,"Basketball",104411,92171,12240,68771,53255,15516,35640,38916,-3276,"12","12",12225,7070
"2150",111939,"CHAFFEY COLLEGE                                             ","2003-2004",2,"Basketball",47077,34841,12236,22050,17268,4782,25027,17573,7454,"13","12",4782,8373
"8603",218070,"FURMAN UNIVERSITY                                           ","2003-2004",16,"Softball",321750,309542,12208,0,0,0,321750,309542,12208,".","17",0,54022
"1227",168263,"WESTFIELD STATE COLLEGE                                     ","2003-2004",1,"Baseball",60173,47976,12197,60173,47976,12197,0,0,0,"27",".",23556,0
"15420",165529,"CURRY COLLEGE                                               ","2003-2004",39,"Total Participants",241477,229286,12191,155154,136112,19042,86323,93174,-6851,"203","80",149902,65057
"15903",140164,"KENNESAW STATE UNIVERSITY                                   ","2003-2004",39,"Total Participants",1952419,1940243,12176,738798,749403,-10605,1213621,1190840,22781,"98","93",225456,247573
"10250",161086,"COLBY COLLEGE                                               ","2003-2004",18,"Swimming and Diving",99781,87610,12171,48310,39942,8368,51471,47668,3803,"15","23",38649,45735
"9636",151263,"UNIVERSITY OF INDIANAPOLIS                                  ","2003-2004",16,"Softball",225588,213431,12157,0,0,0,225588,213431,12157,".","30",0,33714
"8725",204945,"OWENS COMMUNITY COLLEGE                                     ","2003-2004",16,"Softball",53223,41089,12134,0,0,0,53223,41089,12134,".","13",0,7866
"12911",218238,"LIMESTONE COLLEGE                                           ","2003-2004",25,"Track and Field, X-Country",18000,5898,12102,9000,2949,6051,9000,2949,6051,"10","6",2200,2200
"15249",196051,"MORRISVILLE STATE COLLEGE                                   ","2003-2004",34,"Equestrian",30692,18618,12074,15346,9309,6037,15346,9309,6037,"13","49",8410,8410
"10869",155089,"FRIENDS UNIVERSITY                                          ","2003-2004",22,"Tennis",42994,30921,12073,22272,14923,7349,20722,15998,4724,"7","7",6259,4724
"1453",175157,"VERMILION COMMUNITY COLLEGE                                 ","2003-2004",1,"Baseball",40338,28279,12059,40338,28279,12059,0,0,0,"18",".",15366,0
"15457",175157,"VERMILION COMMUNITY COLLEGE                                 ","2003-2004",39,"Total Participants",85101,73042,12059,41643,29584,12059,43458,43458,0,"95","31",29939,10007
"1867",174491,"NORTHWESTERN COLLEGE                                        ","2003-2004",2,"Basketball",72779,60724,12055,33089,25013,8076,39690,35711,3979,"19","19",14841,22545
"5589",218645,"UNIVERSITY OF SOUTH CAROLINA-AIKEN                          ","2003-2004",8,"Golf",143019,130970,12049,143019,130970,12049,0,0,0,"8",".",27945,0
"4497",123013,"SANTA ROSA JUNIOR COLLEGE                                   ","2003-2004",7,"Football",106432,94386,12046,106432,94386,12046,0,0,0,"80",".",39346,0
"17046",186201,"RAMAPO COLLEGE OF NEW JERSEY                                ","2003-2004",39,"Total Participants",485359,473316,12043,286612,272129,14483,198747,201187,-2440,"169","121",177302,170481
"14581",166513,"UNIVERSITY OF MASSACHUSETTS-LOWELL                          ","2003-2004",26,"Volleyball",149953,137926,12027,0,0,0,149953,137926,12027,".","12",0,22659
"16655",139393,"COVENANT COLLEGE                                            ","2003-2004",39,"Total Participants",679302,667279,12023,266751,260878,5873,412551,406401,6150,"57","69",64383,90762
"930",218645,"UNIVERSITY OF SOUTH CAROLINA-AIKEN                          ","2003-2004",1,"Baseball",304257,292242,12015,304257,292242,12015,0,0,0,"41",".",53482,0
"9957",204635,"OHIO NORTHERN UNIVERSITY                                    ","2003-2004",16,"Softball",43903,31897,12006,0,0,0,43903,31897,12006,".","18",0,25868
"4776",168430,"WORCESTER STATE COLLEGE                                     ","2003-2004",7,"Football",67864,55859,12005,67864,55859,12005,0,0,0,"73",".",49168,0
"3325",236072,"SEATTLE COMMUNITY COLLEGE-NORTH CAMPUS                      ","2003-2004",2,"Basketball",60000,48000,12000,30000,24000,6000,30000,24000,6000,"14","14",545,545
"7645",221014,"MILLIGAN COLLEGE                                            ","2003-2004",15,"Soccer",519275,507275,12000,230850,224850,6000,288425,282425,6000,"20","18",21850,24425
"13353",101587,"UNIVERSITY OF WEST ALABAMA                                  ","2003-2004",26,"Volleyball",98586,86586,12000,0,0,0,98586,86586,12000,".","15",0,11288
"13533",193645,"THE COLLEGE OF NEW ROCHELLE                                 ","2003-2004",26,"Volleyball",12000,0,12000,0,0,0,12000,17688,-5688,".","10",0,13188
"3234",214591,"PENNSYLVANIA STATE UNIV-PENN ST ERIE-BEHREND COLL           ","2003-2004",2,"Basketball",192880,180905,11975,85855,97479,-11624,107025,83426,23599,"18","14",32296,30676
"6639",194310,"PACE UNIVERSITY-NEW YORK                                    ","2003-2004",11,"Lacrosse",81325,69365,11960,81325,69365,11960,0,0,0,"44",".",39535,0
"9073",170082,"GRAND VALLEY STATE UNIVERSITY                               ","2003-2004",16,"Softball",215141,203182,11959,0,0,0,215141,203182,11959,".","21",0,36435
"16887",117751,"THE MASTER'S COLLEGE AND SEMINARY                           ","2003-2004",39,"Total Participants",896514,884571,11943,532240,522271,9969,364274,362300,1974,"75","56",185708,103233
"8502",214175,"MUHLENBERG COLLEGE                                          ","2003-2004",15,"Soccer",57414,45493,11921,30076,23134,6942,27338,22359,4979,"28","27",12883,16943
"15306",225371,"HILL COLLEGE                                                ","2003-2004",35,"Rodeo",73349,61446,11903,55012,46085,8927,18337,15361,2976,"37","12",8925,2975
"12084",110486,"CALIFORNIA STATE UNIVERSITY-BAKERSFIELD                     ","2003-2004",24,"Track and Field, Outdoor",218309,206409,11900,105713,99467,6246,112596,106942,5654,"16","18",5767,10062
"14610",226383,"LUBBOCK CHRISTIAN UNIVERSITY                                ","2003-2004",26,"Volleyball",287783,275895,11888,0,0,0,287783,275895,11888,".","13",0,70260
"77",113236,"CYPRESS COLLEGE                                             ","2003-2004",1,"Baseball",116986,105139,11847,116986,105139,11847,0,0,0,"28",".",72164,0
"4243",164562,"ASSUMPTION COLLEGE                                          ","2003-2004",6,"Field hocky",46360,34557,11803,0,0,0,46360,34557,11803,".","25",0,16700
"641",151801,"INDIANA WESLEYAN UNIVERSITY                                 ","2003-2004",1,"Baseball",46050,34297,11753,46050,34297,11753,0,0,0,"23",".",25898,0
"16692",117140,"UNIVERSITY OF LA VERNE                                      ","2003-2004",39,"Total Participants",608411,596675,11736,328427,307179,21248,279984,289496,-9512,"230","134",134762,111753
"293",129774,"MITCHELL COLLEGE                                            ","2003-2004",1,"Baseball",106599,94906,11693,106599,94906,11693,0,0,0,"26",".",15408,0
"11273",217688,"CHARLESTON SOUTHERN UNIVERSITY                              ","2003-2004",22,"Tennis",193830,182137,11693,108278,101175,7103,85552,80962,4590,"8","6",14034,14034
"9218",163426,"MONTGOMERY COLLEGE                                          ","2003-2004",16,"Softball",29394,17718,11676,0,0,0,29394,17718,11676,".","10",0,9823
"15689",237792,"SHEPHERD COLLEGE                                            ","2003-2004",39,"Total Participants",503316,491691,11625,239230,230823,8407,264086,260868,3218,"190","74",248991,120806
"16161",136215,"NOVA SOUTHEASTERN UNIVERSITY                                ","2003-2004",39,"Total Participants",2009197,1997613,11584,735942,775440,-39498,1273255,1222173,51082,"72","88",245743,302022
"9309",140164,"KENNESAW STATE UNIVERSITY                                   ","2003-2004",16,"Softball",472940,461365,11575,0,0,0,472940,461365,11575,".","20",0,72427
"11137",237312,"UNIVERSITY OF CHARLESTON                                    ","2003-2004",22,"Tennis",41094,29534,11560,19875,14574,5301,21219,14960,6259,"7","8",6512,6770
"5304",190415,"CORNELL UNIVERSITY-ENDOWED COLLEGES                         ","2003-2004",8,"Golf",33411,21855,11556,33411,21855,11556,0,0,0,"6",".",9561,0
"8660",100724,"ALABAMA STATE UNIVERSITY                                    ","2003-2004",16,"Softball",146215,134663,11552,0,0,0,146215,134663,11552,".","12",0,99420
"4468",213251,"JUNIATA COLLEGE                                             ","2003-2004",7,"Football",240486,228943,11543,240486,228943,11543,0,0,0,"78",".",83307,0
"13508",190099,"COLGATE UNIVERSITY                                          ","2003-2004",26,"Volleyball",273161,261622,11539,0,0,0,273161,261622,11539,".","11",0,28255
"4879",196015,"SUNY COLLEGE OF TECHNOLOGY AT CANTON                        ","2003-2004",7,"Football",119556,108018,11538,119556,108018,11538,0,0,0,"59",".",37479,0
"3412",208035,"WESTERN OKLAHOMA STATE COLLEGE                              ","2003-2004",2,"Basketball",174544,163020,11524,85380,84927,453,89164,78093,11071,"21","16",31981,30037
"96",153250,"DORDT COLLEGE                                               ","2003-2004",1,"Baseball",81482,69982,11500,81482,69982,11500,0,0,0,"23",".",20197,0
"2523",154235,"SAINT AMBROSE UNIVERSITY                                    ","2003-2004",2,"Basketball",338855,327355,11500,212872,203872,9000,125983,123483,2500,"42","25",22443,25873
"14333",122728,"SAN JOSE CHRISTIAN COLLEGE                                  ","2003-2004",26,"Volleyball",50014,38524,11490,0,0,0,50014,38524,11490,".","7",0,13410
"4787",130590,"TRINITY COLLEGE                                             ","2003-2004",7,"Football",331350,319862,11488,331350,319862,11488,0,0,0,"75",".",52425,0
"3758",243106,"UNIVERSITY OF PUERTO RICO-AGUADILLA                         ","2003-2004",3,"All Track Combined",36342,24855,11487,23762,16156,7606,12580,8699,3881,"34","18",4824,2598
"2650",202514,"DEFIANCE COLLEGE                                            ","2003-2004",2,"Basketball",186535,175052,11483,102817,97757,5060,83718,77295,6423,"24","13",31080,30843
"4457",179326,"SOUTHWEST BAPTIST UNIVERSITY                                ","2003-2004",7,"Football",871647,860172,11475,871647,860172,11475,0,0,0,"79",".",58147,0
"9501",216694,"WAYNESBURG COLLEGE                                          ","2003-2004",16,"Softball",28988,17525,11463,0,0,0,28988,17525,11463,".","15",0,16031
"9641",155089,"FRIENDS UNIVERSITY                                          ","2003-2004",16,"Softball",64096,52663,11433,0,0,0,64096,52663,11433,".","17",0,21939
"2360",213251,"JUNIATA COLLEGE                                             ","2003-2004",2,"Basketball",135241,123819,11422,78911,72720,6191,56330,51099,5231,"16","11",37502,21049
"15204",234164,"VIRGINIA UNION UNIVERSITY                                   ","2003-2004",33,"Bowling",16148,4777,11371,0,0,0,16148,4777,11371,".","5",0,934
"11325",125462,"WEST HILLS COMMUNITY COLLEGE                                ","2003-2004",22,"Tennis",14750,3382,11368,0,0,0,14750,3382,11368,".","7",0,2633
"14124",170082,"GRAND VALLEY STATE UNIVERSITY                               ","2003-2004",26,"Volleyball",372031,360671,11360,0,0,0,372031,360671,11360,".","18",0,67120
"11433",151263,"UNIVERSITY OF INDIANAPOLIS                                  ","2003-2004",22,"Tennis",160644,149289,11355,67064,61441,5623,93580,87848,5732,"7","8",14343,11689
"3847",143084,"AUGUSTANA COLLEGE                                           ","2003-2004",3,"All Track Combined",243933,232586,11347,134893,127118,7775,109040,105468,3572,"83","73",38973,35795
"1785",237950,"WEST VIRGINIA UNIVERSITY INSTITUTE OF TECHNOLOGY            ","2003-2004",2,"Basketball",87813,76471,11342,42171,32137,10034,45642,44334,1308,"16","12",22753,30966
"4730",144962,"ELMHURST COLLEGE                                            ","2003-2004",7,"Football",172366,161029,11337,172366,161029,11337,0,0,0,"78",".",42300,0
"11355",199148,"UNIVERSITY OF NORTH CAROLINA AT GREENSBORO                  ","2003-2004",22,"Tennis",298774,287437,11337,148625,133440,15185,150149,153997,-3848,"9","7",23491,23491
"2113",143613,"CARL SANDBURG COLLEGE                                       ","2003-2004",2,"Basketball",49906,38612,11294,25875,19605,6270,24031,19007,5024,"14","13",17598,19006
"3659",164562,"ASSUMPTION COLLEGE                                          ","2003-2004",3,"All Track Combined",34338,23060,11278,15576,11560,4016,18762,11500,7262,"88","106",6713,8086
"965",214591,"PENNSYLVANIA STATE UNIV-PENN ST ERIE-BEHREND COLL           ","2003-2004",1,"Baseball",77143,65868,11275,77143,65868,11275,0,0,0,"28",".",23056,0
"710",154350,"SIMPSON COLLEGE                                             ","2003-2004",1,"Baseball",75685,64412,11273,75685,64412,11273,0,0,0,"33",".",34269,0
"1364",224572,"EASTFIELD COLLEGE                                           ","2003-2004",1,"Baseball",101664,90416,11248,101664,90416,11248,0,0,0,"29",".",19900,0
"16114",152318,"ROSE-HULMAN INSTITUTE OF TECHNOLOGY                         ","2003-2004",39,"Total Participants",693048,681800,11248,373985,367800,6185,319063,314000,5063,"270","76",311882,184145
"14780",218821,"SPARTANBURG METHODIST COLLEGE                               ","2003-2004",28,"Wrestling",79137,67892,11245,79137,67892,11245,0,0,0,"41",".",35325,0
"8094",140164,"KENNESAW STATE UNIVERSITY                                   ","2003-2004",15,"Soccer",433886,422680,11206,0,0,0,433886,422680,11206,".","25",0,77085
"3471",216038,"SLIPPERY ROCK UNIVERSITY OF PENNSYLVANIA                    ","2003-2004",2,"Basketball",448227,437022,11205,196717,190164,6553,251510,246858,4652,"13","19",25188,38886
"16348",221519,"SEWANEE-THE UNIVERSITY OF THE SOUTH                         ","2003-2004",39,"Total Participants",988557,977388,11169,400288,400101,187,588269,577287,10982,"199","165",337204,221965
"6978",217156,"BROWN UNIVERSITY                                            ","2003-2004",13,"Rowing",771076,759908,11168,330263,324289,5974,440813,435619,5194,"44","55",124874,196353
"11353",233277,"RADFORD UNIVERSITY                                          ","2003-2004",22,"Tennis",165887,154746,11141,79689,77784,1905,86198,76962,9236,"8","10",17584,14788
"9916",125763,"WHITTIER COLLEGE                                            ","2003-2004",16,"Softball",31010,19876,11134,0,0,0,31010,19876,11134,".","14",0,11736
"13602",240727,"UNIVERSITY OF WYOMING                                       ","2003-2004",26,"Volleyball",557957,546827,11130,0,0,0,557957,546827,11130,".","15",0,161254
"8599",237783,"SALEM INTERNATIONAL UNIVERSITY                              ","2003-2004",16,"Softball",43386,32263,11123,0,0,0,43386,32263,11123,".","12",0,15155
"1839",192749,"MANHATTANVILLE COLLEGE                                      ","2003-2004",2,"Basketball",134468,123358,11110,70327,59544,10783,64141,63814,327,"11","11",10305,7954
"3102",210739,"DESALES UNIVERSITY                                          ","2003-2004",2,"Basketball",129477,118377,11100,84883,77683,7200,44594,40694,3900,"17","13",30466,26491
"2997",153162,"CORNELL COLLEGE                                             ","2003-2004",2,"Basketball",136284,125203,11081,80989,70259,10730,55295,54944,351,"16","13",26777,14300
"6439",161086,"COLBY COLLEGE                                               ","2003-2004",10,"Ice Hockey",86441,75371,11070,46003,39798,6205,40438,35573,4865,"26","23",36578,34127
"2927",134079,"FLORIDA SOUTHERN COLLEGE                                    ","2003-2004",2,"Basketball",411182,400113,11069,257618,248183,9435,153564,151930,1634,"17","15",79916,43163
"8894",220589,"LAMBUTH UNIVERSITY                                          ","2003-2004",16,"Softball",81736,70694,11042,0,0,0,81736,70694,11042,".","21",0,8663
"3489",156745,"GEORGETOWN COLLEGE                                          ","2003-2004",2,"Basketball",699691,688655,11036,439969,431389,8580,259722,257266,2456,"13","14",62195,27471
"13350",198598,"GREENSBORO COLLEGE                                          ","2003-2004",26,"Volleyball",59904,48869,11035,0,0,0,59904,48869,11035,"0","13",0,18840
"16916",224572,"EASTFIELD COLLEGE                                           ","2003-2004",39,"Total Participants",165578,154543,11035,114654,103476,11178,50924,51067,-143,"49","27",59434,10991
"15329",101587,"UNIVERSITY OF WEST ALABAMA                                  ","2003-2004",35,"Rodeo",99310,88305,11005,71501,64221,7280,27809,24084,3725,"16","6",13236,4964
"4125",185572,"MONMOUTH UNIVERSITY                                         ","2003-2004",6,"Field hocky",194692,183689,11003,0,0,0,194692,183689,11003,".","25",0,38864
"7072",234669,"BELLEVUE COMMUNITY COLLEGE                                  ","2003-2004",15,"Soccer",31000,20000,11000,18000,12000,6000,13000,8000,5000,"18","18",4000,4000
"13854",153250,"DORDT COLLEGE                                               ","2003-2004",26,"Volleyball",96838,85838,11000,0,0,0,96838,85838,11000,"0","21",0,23203
"11683",140988,"SHORTER COLLEGE                                             ","2003-2004",22,"Tennis",194250,183264,10986,113528,106451,7077,80722,76813,3909,"12","11",12633,12503
"2509",228501,"SUL ROSS STATE UNIVERSITY                                   ","2003-2004",2,"Basketball",131998,121038,10960,79731,71972,7759,52267,49066,3201,"21","15",37200,24870
"14009",155715,"PRATT COMMUNITY COLLEGE                                     ","2003-2004",26,"Volleyball",50326,39375,10951,0,0,0,50326,39375,10951,".","12",0,6800
"1487",243106,"UNIVERSITY OF PUERTO RICO-AGUADILLA                         ","2003-2004",1,"Baseball",13977,3057,10920,13977,3057,10920,0,0,0,"20",".",2175,0
"2789",207050,"EASTERN OKLAHOMA STATE COLLEGE                              ","2003-2004",2,"Basketball",192350,181450,10900,96100,87200,8900,96250,94250,2000,"18","13",82750,88250
"2144",237057,"WHITMAN COLLEGE                                             ","2003-2004",2,"Basketball",155712,144826,10886,77381,80098,-2717,78331,64728,13603,"14","14",46276,35014
"16847",166391,"LASELL COLLEGE                                              ","2003-2004",39,"Total Participants",196288,185402,10886,74982,63995,10987,121306,121407,-101,"74","102",54082,83751
"5232",187912,"NEW MEXICO MILITARY INSTITUTE                               ","2003-2004",8,"Golf",112002,101120,10882,112002,101120,10882,0,0,0,"8",".",14500,0
"9460",237312,"UNIVERSITY OF CHARLESTON                                    ","2003-2004",16,"Softball",39694,28813,10881,0,0,0,39694,28813,10881,".","16",0,13626
"2954",153001,"BUENA VISTA UNIVERSITY                                      ","2003-2004",2,"Basketball",171270,160416,10854,90232,83779,6453,81038,76637,4401,"23","20",27173,24667
"13667",230807,"WESTMINSTER COLLEGE                                         ","2003-2004",26,"Volleyball",57330,46476,10854,0,0,0,57330,46476,10854,".","13",0,46475
"1247",161518,"SAINT JOSEPHS COLLEGE                                       ","2003-2004",1,"Baseball",56068,45218,10850,56068,45218,10850,0,0,0,"24",".",19537,0
"16192",148821,"SHAWNEE COMMUNITY COLLEGE                                   ","2003-2004",39,"Total Participants",146010,135161,10849,58446,56201,2245,87564,78960,8604,"39","48",60399,66379
"6508",168254,"WESTERN NEW ENGLAND COLLEGE                                 ","2003-2004",10,"Ice Hockey",49900,39065,10835,49900,39065,10835,0,0,0,"23",".",31230,0
"17080",192022,"JEFFERSON COMMUNITY COLLEGE                                 ","2003-2004",39,"Total Participants",87105,76272,10833,53476,50652,2824,33629,25620,8009,"84","63",41912,26990
"9070",143084,"AUGUSTANA COLLEGE                                           ","2003-2004",16,"Softball",79727,68903,10824,0,0,0,79727,68903,10824,".","32",0,15200
"15478",150400,"DEPAUW UNIVERSITY                                           ","2003-2004",39,"Total Participants",859016,848201,10815,390048,385547,4501,468968,462654,6314,"299","180",326656,243162
"727",201645,"CASE WESTERN RESERVE UNIVERSITY                             ","2003-2004",1,"Baseball",82000,71201,10799,82000,71201,10799,0,0,0,"18",".",44161,0
"16343",211608,"CHEYNEY UNIVERSITY OF PENNSYLVANIA                          ","2003-2004",39,"Total Participants",47657,36860,10797,10593,10092,501,37064,26768,10296,"79","36",83780,69578
"2559",148584,"UNIVERSITY OF ST FRANCIS                                    ","2003-2004",2,"Basketball",443887,433096,10791,261474,251837,9637,182413,181259,1154,"18","15",15409,16030
"13886",123563,"SOLANO COUNTY COMMUNITY COLLEGE DISTRICT                    ","2003-2004",26,"Volleyball",33177,22386,10791,0,0,0,33177,22386,10791,".","10",0,7911
"7822",196112,"SUNY INSTITUTE OF TECHNOLOGY AT UTICA-ROME                  ","2003-2004",15,"Soccer",77901,67118,10783,40430,34608,5822,37471,32510,4961,"17","14",7242,8302
"3722",214175,"MUHLENBERG COLLEGE                                          ","2003-2004",3,"All Track Combined",40990,30214,10776,20495,15107,5388,20495,15107,5388,"109","71",11791,11791
"8295",148007,"PRAIRIE STATE COLLEGE                                       ","2003-2004",15,"Soccer",50000,39225,10775,25000,19075,5925,25000,20150,4850,"14","16",15800,17900
"4530",176178,"NORTHWEST MISSISSIPPI COMMUNITY COLLEGE                     ","2003-2004",7,"Football",497925,487165,10760,497925,487165,10760,0,0,0,"55",".",112048,0
"4411",150066,"ANDERSON UNIVERSITY                                         ","2003-2004",7,"Football",195920,185163,10757,195920,185163,10757,0,0,0,"113",".",89073,0
"5318",196079,"SUNY AT BINGHAMTON                                          ","2003-2004",8,"Golf",153961,143212,10749,153961,143212,10749,0,0,0,"10",".",24567,0
"1207",206525,"WITTENBERG UNIVERSITY                                       ","2003-2004",1,"Baseball",52144,41413,10731,52144,41413,10731,0,0,0,"44",".",14881,0
"7600",239716,"SAINT NORBERT COLLEGE                                       ","2003-2004",15,"Soccer",63955,53234,10721,36108,28813,7295,27847,24421,3426,"32","22",23226,20010
"16443",213233,"JOHNSON COLLEGE                                             ","2003-2004",39,"Total Participants",10700,0,10700,10700,10418,282,0,0,0,"41","0",1521,0
"11544",163426,"MONTGOMERY COLLEGE                                          ","2003-2004",22,"Tennis",34446,23753,10693,17542,12415,5127,16904,11338,5566,"17","13",3847,1697
"1757",200846,"UNIVERSITY OF AKRON-WAYNE COLLEGE                           ","2003-2004",2,"Basketball",40000,29332,10668,20000,16786,3214,20000,12546,7454,"14","9",16686,11809
"5220",155089,"FRIENDS UNIVERSITY                                          ","2003-2004",8,"Golf",26115,15452,10663,26115,15452,10663,0,0,0,"6",".",8508,0
"9647",101028,"CHATTAHOOCHEE VALLEY COMMUNITY COLLEGE                      ","2003-2004",16,"Softball",34120,23470,10650,0,0,0,34120,23470,10650,".","22",0,10650
"6402",183239,"SAINT ANSELM COLLEGE                                        ","2003-2004",10,"Ice Hockey",185688,175040,10648,185688,175040,10648,0,0,0,"31",".",54642,0
"4723",121691,"UNIVERSITY OF REDLANDS                                      ","2003-2004",7,"Football",348725,338080,10645,348725,338080,10645,0,0,0,"115",".",74780,0
"14049",169363,"CONCORDIA UNIVERSITY                                        ","2003-2004",26,"Volleyball",102933,92320,10613,0,0,0,102933,92320,10613,".","11",0,20000
"7872",144944,"ELGIN COMMUNITY COLLEGE                                     ","2003-2004",15,"Soccer",39000,28400,10600,19500,14200,5300,19500,14200,5300,"15","15",10100,10100
"10237",134608,"INDIAN RIVER COMMUNITY COLLEGE                              ","2003-2004",18,"Swimming and Diving",138440,127850,10590,71197,65902,5295,67243,61948,5295,"24","19",5295,5295
"1398",222178,"ABILENE CHRISTIAN UNIVERSITY                                ","2003-2004",1,"Baseball",384422,373840,10582,384422,373840,10582,0,0,0,"31",".",71543,0
"543",161086,"COLBY COLLEGE                                               ","2003-2004",1,"Baseball",48235,37658,10577,48235,37658,10577,0,0,0,"22",".",33276,0
"182",140951,"SAVANNAH COLLEGE OF ART AND DESIGN                          ","2003-2004",1,"Baseball",326694,316139,10555,326694,316139,10555,0,0,0,"26",".",111936,0
"13505",102049,"SAMFORD UNIVERSITY                                          ","2003-2004",26,"Volleyball",466711,456196,10515,0,0,0,466711,456196,10515,".","14",0,27002
"15462",155177,"HESSTON COLLEGE                                             ","2003-2004",39,"Total Participants",133846,123346,10500,78294,70594,7700,55552,52752,2800,"66","39",60055,43064
"4592",179867,"WASHINGTON UNIVERSITY IN ST LOUIS                           ","2003-2004",7,"Football",387230,376739,10491,387230,376739,10491,0,0,0,"101",".",151196,0
"13697",218441,"NORTH GREENVILLE COLLEGE                                    ","2003-2004",26,"Volleyball",19779,9312,10467,0,0,0,19779,9312,10467,".","15",0,8715
"16899",192703,"MANHATTAN COLLEGE                                           ","2003-2004",39,"Total Participants",2946348,2935886,10462,1487298,1479080,8218,1459050,1456806,2244,"214","194",596526,392939
"7209",231554,"BLUEFIELD COLLEGE                                           ","2003-2004",15,"Soccer",174823,164364,10459,103011,96468,6543,71812,67896,3916,"23","19",13686,9772
"7528",136206,"NORTHWOOD UNIVERSITY-FLORIDA EDUCATION CENTER               ","2003-2004",15,"Soccer",277114,266675,10439,147983,148703,-720,129131,117972,11159,"31","18",19512,15279
"2448",204200,"COLLEGE OF MOUNT SAINT JOSEPH                               ","2003-2004",2,"Basketball",195974,185547,10427,113072,108188,4884,82902,77359,5543,"21","14",40727,23726
"4440",176354,"SOUTHWEST MISSISSIPPI COMMUNITY COLLEGE                     ","2003-2004",7,"Football",461165,450741,10424,461165,450741,10424,0,0,0,"52",".",62049,0
"8164",157076,"KENTUCKY WESLEYAN COLLEGE                                   ","2003-2004",15,"Soccer",156145,145722,10423,75674,73798,1876,80471,71924,8547,"21","17",20951,17612
"6339",216524,"URSINUS COLLEGE                                             ","2003-2004",9,"Gymnastics",56030,45627,10403,0,0,0,56030,45627,10403,".","12",0,29030
"4951",166850,"MERRIMACK COLLEGE                                           ","2003-2004",7,"Football",447200,436811,10389,447200,436811,10389,0,0,0,"66",".",60840,0
"855",122889,"SANTA BARBARA CITY COLLEGE                                  ","2003-2004",1,"Baseball",65558,55173,10385,65558,55173,10385,0,0,0,"26",".",40511,0
"9813",196866,"UNION COLLEGE                                               ","2003-2004",16,"Softball",85687,75307,10380,0,0,0,85687,75307,10380,".","14",0,6046
"6603",164562,"ASSUMPTION COLLEGE                                          ","2003-2004",11,"Lacrosse",49125,38750,10375,25865,19210,6655,23260,19540,3720,"21","20",9050,6350
"4301",240471,"UNIVERSITY OF WISCONSIN-RIVER FALLS                         ","2003-2004",7,"Football",287653,277289,10364,287653,277289,10364,0,0,0,"98",".",47021,0
"12729",139861,"GEORGIA COLLEGE AND STATE UNIVERSITY                        ","2003-2004",25,"Track and Field, X-Country",58484,48143,10341,29242,21649,7593,29242,26494,2748,"7","13",8425,8310
"8374",212577,"FRANKLIN AND MARSHALL COLLEGE                               ","2003-2004",15,"Soccer",62727,52399,10328,32446,24462,7984,30281,27937,2344,"26","25",14149,16707
"121",191649,"HOFSTRA UNIVERSITY                                          ","2003-2004",1,"Baseball",601652,591337,10315,601652,591337,10315,0,0,0,"33",".",158898,0
"273",183239,"SAINT ANSELM COLLEGE                                        ","2003-2004",1,"Baseball",68428,58120,10308,68428,58120,10308,0,0,0,"28",".",45059,0
"12442",107983,"SOUTHERN ARKANSAS UNIVERSITY MAIN CAMPUS                    ","2003-2004",25,"Track and Field, X-Country",66466,56172,10294,33233,28086,5147,33233,28086,5147,"34","26",19781,19780
"17311",218414,"NEWBERRY COLLEGE                                            ","2003-2004",39,"Total Participants",206588,196298,10290,106728,102238,4490,99860,94060,5800,"207","70",253086,97687
"3429",216931,"WILKES UNIVERSITY                                           ","2003-2004",2,"Basketball",162342,152069,10273,101703,92775,8928,60639,59294,1345,"16","18",18349,17787
"7855",210331,"WESTERN BAPTIST COLLEGE                                     ","2003-2004",15,"Soccer",105376,95109,10267,51692,48123,3569,53684,46986,6698,"25","23",23710,22573
"3885",240727,"UNIVERSITY OF WYOMING                                       ","2003-2004",3,"All Track Combined",749880,739618,10262,317532,337343,-19811,432348,402275,30073,"29","55",55284,92245
"10162",186584,"SETON HALL UNIVERSITY                                       ","2003-2004",18,"Swimming and Diving",493673,483417,10256,264144,230499,33645,229529,252918,-23389,"14","16",32599,32488
"5877",119164,"MT SAN ANTONIO COLLEGE                                      ","2003-2004",8,"Golf",157631,147376,10255,67166,67166,0,90465,80210,10255,"12","8",6811,7111
"323",130226,"QUINNIPIAC UNIVERSITY                                       ","2003-2004",1,"Baseball",543011,532769,10242,543011,532769,10242,0,0,0,"30",".",125027,0
"5665",138293,"WEBBER INTERNATIONAL UNIVERSITY                             ","2003-2004",8,"Golf",124378,114138,10240,79524,80893,-1369,44854,33245,11609,"15","6",15628,8300
"795",234711,"BIG BEND COMMUNITY COLLEGE                                  ","2003-2004",1,"Baseball",80237,70010,10227,80237,70010,10227,0,0,0,"29",".",29000,0
"6525",196130,"SUNY COLLEGE AT BUFFALO                                     ","2003-2004",10,"Ice Hockey",223783,213563,10220,117457,115636,1821,106326,97927,8399,"29","20",60876,46005
"17205",110529,"CALIFORNIA STATE POLYTECHNIC UNIVERSITY-POMONA              ","2003-2004",39,"Total Participants",900369,890175,10194,460504,453551,6953,439865,436624,3241,"119","91",114971,118706
"6710",196015,"SUNY COLLEGE OF TECHNOLOGY AT CANTON                        ","2003-2004",11,"Lacrosse",42537,32356,10181,22349,16617,5732,20188,15739,4449,"15","11",10568,10511
"9315",148496,"DOMINICAN UNIVERSITY                                        ","2003-2004",16,"Softball",31166,20985,10181,0,0,0,31166,20985,10181,".","15",0,13819
"3830",217484,"UNIVERSITY OF RHODE ISLAND                                  ","2003-2004",3,"All Track Combined",985296,975127,10169,309079,343372,-34293,676217,631755,44462,"104","113",105170,89901
"16737",229072,"TEXAS SOUTHMOST COLLEGE                                     ","2003-2004",39,"Total Participants",421245,411084,10161,268632,259469,9163,152613,151615,998,"57","18",164903,96100
"15668",207069,"REDLANDS COMMUNITY COLLEGE                                  ","2003-2004",39,"Total Participants",128942,118791,10151,59618,54595,5023,69324,64196,5128,"55","38",38265,73165
"2257",153144,"COE COLLEGE                                                 ","2003-2004",2,"Basketball",145867,135717,10150,82951,77007,5944,62916,58710,4206,"25","14",26977,21395
"2340",161518,"SAINT JOSEPHS COLLEGE                                       ","2003-2004",2,"Basketball",49644,39494,10150,23933,17203,6730,25711,22291,3420,"15","10",8338,13309
"16572",111461,"COLLEGE OF THE CANYONS                                      ","2003-2004",39,"Total Participants",176453,166316,10137,75407,72828,2579,101046,93488,7558,"172","112",97897,89065
"14447",178244,"MISSOURI BAPTIST UNIVERSITY                                 ","2003-2004",26,"Volleyball",492874,482800,10074,240947,238317,2630,251927,244483,7444,"22","23",25223,13705
"12232",214157,"MORAVIAN COLLEGE AND THEOLOGICAL SEMINARY                   ","2003-2004",25,"Track and Field, X-Country",136924,126866,10058,68462,63433,5029,68462,63433,5029,"33","42",17295,17295
"532",145372,"GREENVILLE COLLEGE                                          ","2003-2004",1,"Baseball",59353,49323,10030,59353,49323,10030,0,0,0,"22",".",18284,0
"16513",172440,"FINLANDIA UNIVERSITY                                        ","2003-2004",39,"Total Participants",242807,232802,10005,151723,142087,9636,91084,90715,369,"81","63",135260,83125
"3375",236708,"SPOKANE FALLS COMMUNITY COLLEGE                             ","2003-2004",2,"Basketball",86977,76976,10001,49369,42502,6867,37608,34474,3134,"13","10",26951,24822
"2835",243115,"UNIVERSITY OF PUERTO RICO-ARECIBO                           ","2003-2004",2,"Basketball",43939,33939,10000,26240,21240,5000,17699,12699,5000,"15","9",8370,4329
"4833",146296,"JOLIET JUNIOR COLLEGE                                       ","2003-2004",7,"Football",137500,127500,10000,137500,127500,10000,0,0,0,"85",".",42500,0
"7183",140872,"REINHARDT COLLEGE                                           ","2003-2004",15,"Soccer",216134,206134,10000,135584,125584,10000,80550,80550,0,"33","18",719,788
"7995",364025,"CHANDLER/GILBERT COMMUNITY COLLEGE                          ","2003-2004",15,"Soccer",57935,47935,10000,29631,24631,5000,28304,23304,5000,"24","16",9898,9024
"3532",159656,"LOYOLA UNIVERSITY NEW ORLEANS                               ","2003-2004",3,"All Track Combined",33968,24000,9968,16984,12000,4984,16984,12000,4984,"7","10",5522,5522
"17280",170806,"MADONNA UNIVERSITY                                          ","2003-2004",39,"Total Participants",599740,589783,9957,250038,244367,5671,349702,345416,4286,"73","57",68568,76537
"9296",168546,"ALBION COLLEGE                                              ","2003-2004",16,"Softball",63709,53756,9953,0,0,0,63709,53756,9953,".","18",0,14737
"4804",187134,"THE COLLEGE OF NEW JERSEY                                   ","2003-2004",7,"Football",221031,211079,9952,221031,211079,9952,0,0,0,"72",".",62034,0
"2099",146205,"JOHN A LOGAN COLLEGE                                        ","2003-2004",2,"Basketball",284949,275006,9943,156949,154667,2282,128000,120339,7661,"14","12",104893,78447
"12225",212160,"EDINBORO UNIVERSITY OF PENNSYLVANIA                         ","2003-2004",25,"Track and Field, X-Country",200276,190334,9942,100098,101354,-1256,100178,88980,11198,"28","26",37356,35030
"7721",150455,"EARLHAM COLLEGE                                             ","2003-2004",15,"Soccer",99031,89091,9940,51900,44998,6902,47131,44093,3038,"22","26",13080,16168
"12498",220589,"LAMBUTH UNIVERSITY                                          ","2003-2004",25,"Track and Field, X-Country",20378,10440,9938,9064,2673,6391,11314,7767,3547,"5","5",1542,3504
"13312",110680,"UNIVERSITY OF CALIFORNIA-SAN DIEGO                          ","2003-2004",26,"Volleyball",322621,312690,9931,180475,131572,48903,142146,181118,-38972,"20","16",48591,64242
"13862",150455,"EARLHAM COLLEGE                                             ","2003-2004",26,"Volleyball",46878,36947,9931,0,0,0,46878,36947,9931,"0","14",0,6897
"7235",215743,"SAINT FRANCIS UNIVERSITY                                    ","2003-2004",15,"Soccer",383588,373665,9923,171414,168029,3385,212174,205636,6538,"18","28",35706,22796
"6593",191515,"HAMILTON COLLEGE                                            ","2003-2004",11,"Lacrosse",115892,105979,9913,80560,73889,6671,35332,32090,3242,"45","22",16113,12141
"6103",171599,"OLIVET COLLEGE                                              ","2003-2004",8,"Golf",33700,23801,9899,25175,14265,10910,8525,9536,-1011,"14","7",10516,8649
"16153",107558,"UNIVERSITY OF THE OZARKS                                    ","2003-2004",39,"Total Participants",301549,291650,9899,182412,175475,6937,119137,116175,2962,"117","71",66400,61250
"10261",170082,"GRAND VALLEY STATE UNIVERSITY                               ","2003-2004",18,"Swimming and Diving",286530,276636,9894,126389,121443,4946,160141,155193,4948,"20","28",21119,21119
"6578",230959,"MIDDLEBURY COLLEGE                                          ","2003-2004",11,"Lacrosse",295959,286066,9893,141182,136720,4462,154777,149346,5431,"40","38",44018,36179
"8849",207263,"NORTHEASTERN STATE UNIVERSITY                               ","2003-2004",16,"Softball",97149,87295,9854,0,0,0,97149,87295,9854,".","22",0,16500
"90",181783,"WAYNE STATE COLLEGE                                         ","2003-2004",1,"Baseball",121330,111506,9824,121330,111506,9824,0,0,0,"36",".",47319,0
"6865",157401,"MURRAY STATE UNIVERSITY                                     ","2003-2004",12,"Rifle",97959,88150,9809,61224,55092,6132,36735,33058,3677,"5","3",10479,6287
"16382",191621,"HILBERT COLLEGE                                             ","2003-2004",39,"Total Participants",133937,124129,9808,65408,63645,1763,68529,60484,8045,"91","78",41212,42493
"11428",125028,"VENTURA COLLEGE                                             ","2003-2004",22,"Tennis",47211,37423,9788,26938,21064,5874,20273,16359,3914,"12","7",12594,6290
"6395",173647,"GUSTAVUS ADOLPHUS COLLEGE                                   ","2003-2004",10,"Ice Hockey",266434,256647,9787,161083,153730,7353,105351,102917,2434,"58","22",39806,41822
"6477",191083,"ERIE COMMUNITY COLLEGE                                      ","2003-2004",10,"Ice Hockey",45703,35920,9783,45703,35920,9783,0,0,0,"21",".",22800,0
"11239",201645,"CASE WESTERN RESERVE UNIVERSITY                             ","2003-2004",22,"Tennis",45077,35311,9766,22416,17946,4470,22661,17365,5296,"14","11",6438,5857
"5257",199209,"NORTH CAROLINA WESLEYAN COLLEGE                             ","2003-2004",8,"Golf",20136,10381,9755,20136,10381,9755,0,0,0,"6",".",1500,0
"3091",211981,"DELAWARE VALLEY COLLEGE                                     ","2003-2004",2,"Basketball",100100,90350,9750,47950,42900,5050,52150,47450,4700,"15","10",11300,12250
"4602",157076,"KENTUCKY WESLEYAN COLLEGE                                   ","2003-2004",7,"Football",266191,256441,9750,266191,256441,9750,0,0,0,"71",".",69238,0
"12013",215929,"UNIVERSITY OF SCRANTON                                      ","2003-2004",24,"Track and Field, Outdoor",30786,21086,9700,20206,10015,10191,10580,11071,-491,"16","15",4183,4434
"359",143084,"AUGUSTANA COLLEGE                                           ","2003-2004",1,"Baseball",93456,83767,9689,93456,83767,9689,0,0,0,"40",".",40781,0
"5796",169363,"CONCORDIA UNIVERSITY                                        ","2003-2004",8,"Golf",81488,71800,9688,40744,35900,4844,40744,35900,4844,"8","4",6500,6500
"12556",169363,"CONCORDIA UNIVERSITY                                        ","2003-2004",25,"Track and Field, X-Country",79588,69900,9688,39794,34950,4844,39794,34950,4844,"5","6",4000,4000
"13731",110246,"BUTTE COLLEGE                                               ","2003-2004",26,"Volleyball",32252,22567,9685,0,0,0,32252,22567,9685,".","13",0,20001
"13532",143215,"SOUTHWESTERN ILLINOIS COLLEGE                               ","2003-2004",26,"Volleyball",93933,84253,9680,0,0,0,93933,84253,9680,".","14",0,13181
"235",238661,"EDGEWOOD COLLEGE                                            ","2003-2004",1,"Baseball",56433,46798,9635,56433,46798,9635,0,0,0,"29",".",27256,0
"12535",210304,"WARNER PACIFIC COLLEGE                                      ","2003-2004",25,"Track and Field, X-Country",23668,14036,9632,12544,7207,5337,11124,6829,4295,"7","6",3332,2954
"2764",161226,"UNIVERSITY OF MAINE AT FARMINGTON                           ","2003-2004",2,"Basketball",50423,40792,9631,22458,20990,1468,27965,19802,8163,"18","14",12266,10788
"4915",117690,"LOS ANGELES HARBOR COLLEGE                                  ","2003-2004",7,"Football",110096,100510,9586,110096,100510,9586,0,0,0,"80",".",24816,0
"3819",232423,"JAMES MADISON UNIVERSITY                                    ","2003-2004",3,"All Track Combined",630667,621090,9577,313911,284118,29793,316756,336972,-20216,"79","139",91162,103777
"5832",214175,"MUHLENBERG COLLEGE                                          ","2003-2004",8,"Golf",24266,14703,9563,21159,11619,9540,3107,3084,23,"12","9",8404,1631
"11441",120537,"HOPE INTERNATIONAL UNIVERSITY                               ","2003-2004",22,"Tennis",36857,27300,9557,14743,11920,2823,22114,15380,6734,"4","6",11420,14880
"1766",212577,"FRANKLIN AND MARSHALL COLLEGE                               ","2003-2004",2,"Basketball",195473,185946,9527,107919,105034,2885,87554,80912,6642,"17","13",29797,16704
"6550",217536,"SALVE REGINA UNIVERSITY                                     ","2003-2004",11,"Lacrosse",51154,41637,9517,28872,22032,6840,22282,19605,2677,"24","19",13782,11355
"6147",150941,"HUNTINGTON COLLEGE                                          ","2003-2004",8,"Golf",41114,31610,9504,41114,31610,9504,0,0,0,"8",".",10360,0
"654",146296,"JOLIET JUNIOR COLLEGE                                       ","2003-2004",1,"Baseball",30000,20500,9500,30000,20500,9500,0,0,0,"30",".",13500,0
"12696",190691,"CUNY YORK COLLEGE                                           ","2003-2004",25,"Track and Field, X-Country",15424,5924,9500,7712,2962,4750,7712,2962,4750,"5","7",1878,1878
"10574",212160,"EDINBORO UNIVERSITY OF PENNSYLVANIA                         ","2003-2004",19,"Swimming",95904,86411,9493,37147,37430,-283,58757,48981,9776,"14","15",11571,17094
"13725",213349,"KUTZTOWN UNIVERSITY OF PENNSYLVANIA                         ","2003-2004",26,"Volleyball",137280,127794,9486,0,0,0,137280,127794,9486,".","15",0,17646
"17272",162779,"HOWARD COMMUNITY COLLEGE                                    ","2003-2004",39,"Total Participants",80108,70623,9485,51065,41490,9575,29043,29133,-90,"87","36",44852,32697
"7515",184694,"FAIRLEIGH DICKINSON UNIVERSITY-COLLEGE AT FLORHAM           ","2003-2004",15,"Soccer",79424,69945,9479,37045,28989,8056,42379,40956,1423,"27","20",18027,15713
"1319",207582,"ORAL ROBERTS UNIVERSITY                                     ","2003-2004",1,"Baseball",675773,666300,9473,675773,666300,9473,0,0,0,"34",".",203560,0
"9613",148991,"SPOON RIVER COLLEGE                                         ","2003-2004",16,"Softball",28375,18905,9470,0,0,0,28375,18905,9470,".","13",0,8568
"8354",184603,"FAIRLEIGH DICKINSON UNIVERSITY-METROPOLITAN CAMPUS          ","2003-2004",15,"Soccer",691549,682095,9454,420834,417975,2859,270715,264120,6595,"30","18",70612,41186
"102",237792,"SHEPHERD COLLEGE                                            ","2003-2004",1,"Baseball",132395,122948,9447,132395,122948,9447,0,0,0,"31",".",55797,0
"16772",229267,"TRINITY UNIVERSITY                                          ","2003-2004",39,"Total Participants",1060699,1051252,9447,491940,496531,-4591,568759,554721,14038,"269","151",450312,296813
"612",107877,"WILLIAMS BAPTIST COLLEGE                                    ","2003-2004",1,"Baseball",130729,121286,9443,130729,121286,9443,0,0,0,"27",".",23864,0
"8395",228802,"THE UNIVERSITY OF TEXAS AT TYLER                            ","2003-2004",15,"Soccer",114813,105414,9399,57719,55578,2141,57094,49836,7258,"25","26",24214,16982
"13714",157951,"WESTERN KENTUCKY UNIVERSITY                                 ","2003-2004",26,"Volleyball",280951,271558,9393,0,0,0,280951,271558,9393,".","12",0,64365
"5526",237312,"UNIVERSITY OF CHARLESTON                                    ","2003-2004",8,"Golf",34324,24944,9380,34324,24944,9380,0,0,0,"12",".",14770,0
"13541",243106,"UNIVERSITY OF PUERTO RICO-AGUADILLA                         ","2003-2004",26,"Volleyball",12579,3200,9379,5591,1408,4183,6988,1792,5196,"8","10",1039,1039
"15912",162210,"COLUMBIA UNION COLLEGE                                      ","2003-2004",39,"Total Participants",274641,265285,9356,147151,143201,3950,127490,122084,5406,"74","35",58417,61445
"2701",108807,"ALLAN HANCOCK COLLEGE                                       ","2003-2004",2,"Basketball",90421,81068,9353,44917,30535,14382,45504,50533,-5029,"16","14",16570,15921
"9721",213020,"INDIANA UNIVERSITY OF PENNSYLVANIA-MAIN CAMPUS              ","2003-2004",16,"Softball",168132,158783,9349,0,0,0,168132,158783,9349,".","21",0,49256
"2432",238980,"LAKELAND COLLEGE                                            ","2003-2004",2,"Basketball",105800,96454,9346,48135,44494,3641,57665,51960,5705,"16","16",21106,23012
"64",167996,"STONEHILL COLLEGE                                           ","2003-2004",1,"Baseball",99491,90186,9305,99491,90186,9305,0,0,0,"27",".",58213,0
"17014",184603,"FAIRLEIGH DICKINSON UNIVERSITY-METROPOLITAN CAMPUS          ","2003-2004",39,"Total Participants",2273804,2264500,9304,1023221,1013348,9873,1250583,1251152,-569,"131","136",306990,270125
"6455",146481,"LAKE FOREST COLLEGE                                         ","2003-2004",10,"Ice Hockey",187029,177729,9300,127805,122255,5550,59224,55474,3750,"26","20",49280,30099
"13066",121363,"PORTERVILLE COLLEGE                                         ","2003-2004",26,"Volleyball",26500,17200,9300,0,0,0,26500,17200,9300,"0","10",0,2150
"1564",179113,"SAINT LOUIS COMMUNITY COLLEGE-MERAMEC                       ","2003-2004",1,"Baseball",22268,12971,9297,22268,12971,9297,0,0,0,"29",".",2380,0
"4621",175573,"COPIAH-LINCOLN COMMUNITY COLLEGE                            ","2003-2004",7,"Football",303804,294507,9297,303804,294507,9297,0,0,0,"49",".",34206,0
"9528",179113,"SAINT LOUIS COMMUNITY COLLEGE-MERAMEC                       ","2003-2004",16,"Softball",22268,12971,9297,0,0,0,22268,12971,9297,".","23",0,2560
"13844",179113,"SAINT LOUIS COMMUNITY COLLEGE-MERAMEC                       ","2003-2004",26,"Volleyball",22268,12971,9297,0,0,0,22268,12971,9297,".","12",0,2525
"14818",179113,"SAINT LOUIS COMMUNITY COLLEGE-MERAMEC                       ","2003-2004",28,"Wrestling",22268,12971,9297,22268,12971,9297,0,0,0,"21",".",1920,0
"6414",164562,"ASSUMPTION COLLEGE                                          ","2003-2004",10,"Ice Hockey",73237,63943,9294,73237,63943,9294,0,0,0,"27",".",34000,0
"10931",207582,"ORAL ROBERTS UNIVERSITY                                     ","2003-2004",22,"Tennis",362723,353455,9268,145614,141023,4591,217109,212432,4677,"7","6",20820,18438
"1181",150400,"DEPAUW UNIVERSITY                                           ","2003-2004",1,"Baseball",76425,67196,9229,76425,67196,9229,0,0,0,"35",".",29320,0
"5780",139658,"EMORY UNIVERSITY                                            ","2003-2004",8,"Golf",121829,112605,9224,121829,112605,9224,0,0,0,"12",".",26107,0
"14346",177542,"HANNIBAL-LAGRANGE COLLEGE                                   ","2003-2004",26,"Volleyball",86995,77771,9224,0,0,0,86995,77771,9224,".","15",0,8258
"2673",119164,"MT SAN ANTONIO COLLEGE                                      ","2003-2004",2,"Basketball",171739,162518,9221,72064,70674,1390,99675,91844,7831,"14","13",10494,11789
"2940",139658,"EMORY UNIVERSITY                                            ","2003-2004",2,"Basketball",332948,323731,9217,174561,171990,2571,158387,151741,6646,"16","12",64740,45834
"16168",238980,"LAKELAND COLLEGE                                            ","2003-2004",39,"Total Participants",207292,198085,9207,115722,116023,-301,91570,82062,9508,"200","80",107380,56956
"975",228042,"SCHREINER UNIVERSITY                                        ","2003-2004",1,"Baseball",94858,85654,9204,94858,85654,9204,0,0,0,"33",".",28244,0
"11602",133951,"FLORIDA INTERNATIONAL UNIVERSITY                            ","2003-2004",22,"Tennis",238559,229356,9203,0,0,0,238559,229356,9203,".","8",0,30390
"17279",226383,"LUBBOCK CHRISTIAN UNIVERSITY                                ","2003-2004",39,"Total Participants",619522,610329,9193,331739,334434,-2695,287783,275895,11888,"32","27",154008,143421
"5098",238980,"LAKELAND COLLEGE                                            ","2003-2004",7,"Football",129116,119927,9189,129116,119927,9189,0,0,0,"86",".",38232,0
"1213",202763,"THE UNIVERSITY OF FINDLAY                                   ","2003-2004",1,"Baseball",141647,132485,9162,141647,132485,9162,0,0,0,"38",".",29201,0
"12149",150941,"HUNTINGTON COLLEGE                                          ","2003-2004",24,"Track and Field, Outdoor",125097,115939,9158,69277,67877,1400,55820,48062,7758,"20","11",10051,9929
"1594",209056,"LEWIS &amp; CLARK COLLEGE                                       ","2003-2004",2,"Basketball",237826,228670,9156,123070,121070,2000,114756,107600,7156,"14","16",28856,34745
"3377",203085,"HEIDELBERG COLLEGE                                          ","2003-2004",2,"Basketball",109482,100355,9127,54478,48971,5507,55004,51384,3620,"23","23",20055,20010
"13793",159656,"LOYOLA UNIVERSITY NEW ORLEANS                               ","2003-2004",26,"Volleyball",57748,48629,9119,0,0,0,57748,48629,9119,".","12",0,14344
"8944",150756,"HANOVER COLLEGE                                             ","2003-2004",16,"Softball",66834,57720,9114,0,0,0,66834,57720,9114,".","19",0,17233
"4757",181020,"DOANE COLLEGE                                               ","2003-2004",7,"Football",405011,395898,9113,405011,395898,9113,0,0,0,"96",".",42515,0
"12588",191241,"FORDHAM UNIVERSITY                                          ","2003-2004",25,"Track and Field, X-Country",593344,584239,9105,299764,290459,9305,293580,293780,-200,"106","91",40004,35690
"7065",161235,"UNIVERSITY OF MAINE AT FORT KENT                            ","2003-2004",14,"Skiing",16650,7581,9069,16650,7581,9069,0,0,0,"4",".",3798,0
"12951",204635,"OHIO NORTHERN UNIVERSITY                                    ","2003-2004",25,"Track and Field, X-Country",67397,58331,9066,33876,29521,4355,33521,28810,4711,"23","22",11475,12003
"7615",170082,"GRAND VALLEY STATE UNIVERSITY                               ","2003-2004",15,"Soccer",241796,232738,9058,0,0,0,241796,232738,9058,".","28",0,59013
"11872",231174,"UNIVERSITY OF VERMONT AND STATE AGRICULTURAL COLL           ","2003-2004",23,"Track and Field, Indoor",98367,89316,9051,0,0,0,98367,89316,9051,".","35",0,18055
"12119",231174,"UNIVERSITY OF VERMONT AND STATE AGRICULTURAL COLL           ","2003-2004",24,"Track and Field, Outdoor",98367,89316,9051,0,0,0,98367,89316,9051,".","35",0,18055
"2486",230913,"JOHNSON STATE COLLEGE                                       ","2003-2004",2,"Basketball",62425,53391,9034,29833,25621,4212,32592,27770,4822,"17","12",19260,21534
"16036",217518,"ROGER WILLIAMS UNIVERSITY                                   ","2003-2004",39,"Total Participants",649460,640437,9023,418879,407052,11827,230581,233385,-2804,"174","160",275787,141586
"1832",167729,"SALEM STATE COLLEGE                                         ","2003-2004",2,"Basketball",114318,105314,9004,48288,43366,4922,66030,61948,4082,"13","14",19301,20379
"2082",364025,"CHANDLER/GILBERT COMMUNITY COLLEGE                          ","2003-2004",2,"Basketball",75066,66066,9000,31372,28372,3000,43694,37694,6000,"10","12",13576,15274
"14039",243115,"UNIVERSITY OF PUERTO RICO-ARECIBO                           ","2003-2004",26,"Volleyball",32689,23689,9000,12380,7880,4500,20309,15809,4500,"14","13",2450,2639
"15888",183974,"CENTENARY COLLEGE                                           ","2003-2004",39,"Total Participants",409437,400455,8982,221626,216815,4811,187811,183640,4171,"129","81",118188,89593
"16046",140447,"MERCER UNIVERSITY                                           ","2003-2004",39,"Total Participants",727599,718627,8972,414432,414430,2,313167,304197,8970,"109","85",227606,223069
"3338",137032,"SAINT LEO UNIVERSITY                                        ","2003-2004",2,"Basketball",227613,218661,8952,122102,113537,8565,105511,105124,387,"14","11",43284,32785
"4693",139719,"FORT VALLEY STATE UNIVERSITY                                ","2003-2004",7,"Football",606546,597600,8946,606546,597600,8946,0,0,0,"78",".",85269,0
"1149",134608,"INDIAN RIVER COMMUNITY COLLEGE                              ","2003-2004",1,"Baseball",73142,64200,8942,73142,64200,8942,0,0,0,"27",".",8942,0
"8945",209065,"LINFIELD COLLEGE                                            ","2003-2004",16,"Softball",77832,68894,8938,0,0,0,77832,68894,8938,".","22",0,25014
"9833",195809,"ST JOHN'S UNIVERSITY-NEW YORK                               ","2003-2004",16,"Softball",547681,538751,8930,0,0,0,547681,538751,8930,".","17",0,5237
"6976",130943,"UNIVERSITY OF DELAWARE                                      ","2003-2004",13,"Rowing",367416,358493,8923,0,0,0,367416,358493,8923,".","46",0,69551
"9982",213367,"LA SALLE UNIVERSITY                                         ","2003-2004",16,"Softball",258471,249561,8910,0,0,0,258471,249561,8910,".","20",0,47760
"10462",168546,"ALBION COLLEGE                                              ","2003-2004",18,"Swimming and Diving",51457,42559,8898,23234,21354,1880,28223,21205,7018,"19","36",8749,8277
"14332",125462,"WEST HILLS COMMUNITY COLLEGE                                ","2003-2004",26,"Volleyball",23689,14791,8898,0,0,0,23689,14791,8898,".","6",0,3800
"4786",164270,"MCDANIEL COLLEGE                                            ","2003-2004",7,"Football",260775,251880,8895,260775,251880,8895,0,0,0,"93",".",70526,0
"712",225371,"HILL COLLEGE                                                ","2003-2004",1,"Baseball",99156,90262,8894,99156,90262,8894,0,0,0,"25",".",8893,0
"10932",107044,"HARDING UNIVERSITY                                          ","2003-2004",22,"Tennis",23798,14908,8890,11899,7454,4445,11899,7454,4445,"8","6",7232,7232
"7348",196015,"SUNY COLLEGE OF TECHNOLOGY AT CANTON                        ","2003-2004",15,"Soccer",40147,31266,8881,22037,15682,6355,18110,15584,2526,"22","19",10064,9311
"3011",196158,"SUNY COLLEGE AT FREDONIA                                    ","2003-2004",2,"Basketball",180428,171555,8873,99770,95955,3815,80658,75600,5058,"17","16",30002,29333
"518",186201,"RAMAPO COLLEGE OF NEW JERSEY                                ","2003-2004",1,"Baseball",118915,110050,8865,118915,110050,8865,0,0,0,"38",".",51230,0
"8696",146481,"LAKE FOREST COLLEGE                                         ","2003-2004",16,"Softball",45821,36971,8850,0,0,0,45821,36971,8850,".","16",0,9421
"9541",165671,"EMMANUEL COLLEGE                                            ","2003-2004",16,"Softball",42216,33379,8837,0,0,0,42216,33379,8837,".","13",0,17393
"15654",165671,"EMMANUEL COLLEGE                                            ","2003-2004",39,"Total Participants",248090,239253,8837,91085,91085,0,157005,148168,8837,"83","124",50016,76076
"7083",154688,"BAKER UNIVERSITY COLLEGE OF ARTS AND SCIENCES               ","2003-2004",15,"Soccer",160589,151765,8824,100938,99368,1570,59651,52397,7254,"33","17",28249,21900
"2671",207069,"REDLANDS COMMUNITY COLLEGE                                  ","2003-2004",2,"Basketball",178954,170140,8814,144933,139530,5403,34021,30610,3411,"16","13",18135,20291
"4916",123563,"SOLANO COUNTY COMMUNITY COLLEGE DISTRICT                    ","2003-2004",7,"Football",75529,66734,8795,75529,66734,8795,0,0,0,"69",".",24116,0
"13308",213020,"INDIANA UNIVERSITY OF PENNSYLVANIA-MAIN CAMPUS              ","2003-2004",26,"Volleyball",91670,82900,8770,0,0,0,91670,82900,8770,".","18",0,17437
"6586",191649,"HOFSTRA UNIVERSITY                                          ","2003-2004",11,"Lacrosse",1106557,1097795,8762,606684,600216,6468,499873,497579,2294,"39","26",156904,91573
"4608",150756,"HANOVER COLLEGE                                             ","2003-2004",7,"Football",381533,372780,8753,381533,372780,8753,0,0,0,"98",".",141626,0
"14778",149781,"WHEATON COLLEGE                                             ","2003-2004",28,"Wrestling",44315,35571,8744,44315,35571,8744,0,0,0,"10",".",9219,0
"6841",196112,"SUNY INSTITUTE OF TECHNOLOGY AT UTICA-ROME                  ","2003-2004",11,"Lacrosse",47148,38416,8732,47148,38416,8732,0,0,0,"18",".",11124,0
"2821",211352,"CABRINI COLLEGE                                             ","2003-2004",2,"Basketball",75804,67077,8727,58404,50404,8000,17400,16673,727,"30","13",44114,14014
"8338",191241,"FORDHAM UNIVERSITY                                          ","2003-2004",15,"Soccer",826997,818274,8723,331531,324188,7343,495466,494086,1380,"27","21",29135,50045
"8321",168263,"WESTFIELD STATE COLLEGE                                     ","2003-2004",15,"Soccer",43935,35225,8710,22407,19424,2983,21528,15801,5727,"26","20",10415,7557
"2635",211927,"DELAWARE COUNTY COMMUNITY COLLEGE                           ","2003-2004",2,"Basketball",15700,7000,8700,8500,3500,5000,7200,3500,3700,"11","7",4950,3570
"2474",102377,"TUSKEGEE UNIVERSITY                                         ","2003-2004",2,"Basketball",669602,660932,8670,297030,292221,4809,372572,368711,3861,"14","15",37124,36937
"7458",176053,"MISSISSIPPI COLLEGE                                         ","2003-2004",15,"Soccer",132479,123821,8658,56332,59430,-3098,76147,64391,11756,"31","21",25137,29866
"4955",237932,"WEST LIBERTY STATE COLLEGE                                  ","2003-2004",7,"Football",315288,306638,8650,315288,306638,8650,0,0,0,"79",".",36173,0
"11502",234164,"VIRGINIA UNION UNIVERSITY                                   ","2003-2004",22,"Tennis",36592,27970,8622,18296,13985,4311,18296,13985,4311,"5","6",1593,1593
"1597",206491,"WILBERFORCE UNIVERSITY                                      ","2003-2004",2,"Basketball",191704,183090,8614,101341,97034,4307,90363,86056,4307,"15","10",31978,32743
"14453",200192,"LAKE REGION STATE COLLEGE                                   ","2003-2004",26,"Volleyball",38997,30387,8610,0,0,0,38997,30387,8610,".","13",0,21889
"16850",200192,"LAKE REGION STATE COLLEGE                                   ","2003-2004",39,"Total Participants",41572,32962,8610,2575,2575,0,38997,30387,8610,"17","23",17069,42850
"6857",212106,"DUQUESNE UNIVERSITY                                         ","2003-2004",12,"Rifle",53774,45170,8604,53774,45170,8604,0,0,0,"7",".",11610,0
"5025",216931,"WILKES UNIVERSITY                                           ","2003-2004",7,"Football",219084,210482,8602,219084,210482,8602,0,0,0,"105",".",74745,0
"5577",214157,"MORAVIAN COLLEGE AND THEOLOGICAL SEMINARY                   ","2003-2004",8,"Golf",23144,14542,8602,23144,14542,8602,0,0,0,"9",".",5829,0
"1960",144944,"ELGIN COMMUNITY COLLEGE                                     ","2003-2004",2,"Basketball",64000,55400,8600,32000,28200,3800,32000,27200,4800,"12","12",18200,19100
"4510",155104,"GARDEN CITY COMMUNITY COLLEGE                               ","2003-2004",7,"Football",54779,46180,8599,54779,46180,8599,0,0,0,"55",".",36937,0
"4566",217156,"BROWN UNIVERSITY                                            ","2003-2004",7,"Football",1168338,1159740,8598,1168338,1159740,8598,0,0,0,"84",".",184994,0
"811",196112,"SUNY INSTITUTE OF TECHNOLOGY AT UTICA-ROME                  ","2003-2004",1,"Baseball",59986,51412,8574,59986,51412,8574,0,0,0,"24",".",13872,0
"4839",120342,"ORANGE COAST COLLEGE                                        ","2003-2004",7,"Football",113529,104958,8571,113529,104958,8571,0,0,0,"74",".",84703,0
"10193",201645,"CASE WESTERN RESERVE UNIVERSITY                             ","2003-2004",18,"Swimming and Diving",114356,105786,8570,57178,52893,4285,57178,52893,4285,"22","24",33991,33991
"12488",177542,"HANNIBAL-LAGRANGE COLLEGE                                   ","2003-2004",25,"Track and Field, X-Country",1e+05,91437,8563,50000,41859,8141,50000,49578,422,"6","9",1859,1578
"7900",123013,"SANTA ROSA JUNIOR COLLEGE                                   ","2003-2004",15,"Soccer",94167,85607,8560,45229,42634,2595,48938,42973,5965,"32","24",13761,13174
"6962",209056,"LEWIS &amp; CLARK COLLEGE                                       ","2003-2004",13,"Rowing",143747,135201,8546,56027,55332,695,87720,79869,7851,"26","48",24903,44273
"6387",167996,"STONEHILL COLLEGE                                           ","2003-2004",10,"Ice Hockey",59638,51100,8538,59638,51100,8538,0,0,0,"26",".",28000,0
"11738",218733,"SOUTH CAROLINA STATE UNIVERSITY                             ","2003-2004",22,"Tennis",204081,195547,8534,99785,96401,3384,104296,99146,5150,"9","6",22550,22632
"964",174862,"CROWN COLLEGE                                               ","2003-2004",1,"Baseball",37920,29393,8527,37920,29393,8527,0,0,0,"19",".",14123,0
"14645",166850,"MERRIMACK COLLEGE                                           ","2003-2004",26,"Volleyball",119978,111464,8514,0,0,0,119978,111464,8514,".","10",0,15065
"11012",141486,"CHAMINADE UNIVERSITY OF HONOLULU                            ","2003-2004",22,"Tennis",15588,7082,8506,7794,3541,4253,7794,3541,4253,"5","6",3524,3524
"95",229072,"TEXAS SOUTHMOST COLLEGE                                     ","2003-2004",1,"Baseball",214903,206400,8503,214903,206400,8503,0,0,0,"49",".",122706,0
"7220",197045,"UTICA COLLEGE                                               ","2003-2004",15,"Soccer",108400,99900,8500,60700,51450,9250,47700,48450,-750,"22","20",10700,11800
"16799",111188,"CALIFORNIA MARITIME ACADEMY                                 ","2003-2004",39,"Total Participants",222000,213502,8498,195100,185965,9135,26900,27537,-637,"133","20",98894,13412
"4184",191968,"ITHACA COLLEGE                                              ","2003-2004",6,"Field hocky",86812,78361,8451,0,0,0,86812,78361,8451,".","20",0,27388
"3805",170082,"GRAND VALLEY STATE UNIVERSITY                               ","2003-2004",3,"All Track Combined",517864,509414,8450,233058,228833,4225,284806,280581,4225,"76","83",69082,69083
"1401",211158,"BLOOMSBURG UNIVERSITY OF PENNSYLVANIA                       ","2003-2004",1,"Baseball",89908,81483,8425,89908,81483,8425,0,0,0,"29",".",15212,0
"14696",123563,"SOLANO COUNTY COMMUNITY COLLEGE DISTRICT                    ","2003-2004",27,"Water Polo",31562,23137,8425,31562,23137,8425,0,0,0,"14",".",6345,0
"10206",123563,"SOLANO COUNTY COMMUNITY COLLEGE DISTRICT                    ","2003-2004",18,"Swimming and Diving",30390,21968,8422,15195,10984,4211,15195,10984,4211,"11","15",2488,2488
"17168",197911,"BARTON COLLEGE                                              ","2003-2004",39,"Total Participants",713461,705040,8421,389855,382783,7072,323606,322257,1349,"107","71",105140,81398
"4714",123217,"COLLEGE OF THE SEQUOIAS                                     ","2003-2004",7,"Football",57518,49100,8418,57518,49100,8418,0,0,0,"73",".",17000,0
"13695",214157,"MORAVIAN COLLEGE AND THEOLOGICAL SEMINARY                   ","2003-2004",26,"Volleyball",36418,28001,8417,0,0,0,36418,28001,8417,".","11",0,15380
"1405",163912,"ST MARY'S COLLEGE OF MARYLAND                               ","2003-2004",1,"Baseball",72523,64122,8401,72523,64122,8401,0,0,0,"25",".",17300,0
"2811",148627,"SAINT XAVIER UNIVERSITY                                     ","2003-2004",2,"Basketball",256880,248480,8400,126950,120950,6000,129930,127530,2400,"23","16",44950,36530
"3026",156356,"BRESCIA UNIVERSITY                                          ","2003-2004",2,"Basketball",49700,41300,8400,25050,20650,4400,24650,20650,4000,"17","19",20600,20600
"9901",212656,"GENEVA COLLEGE                                              ","2003-2004",16,"Softball",67693,59313,8380,0,0,0,67693,59313,8380,".","14",0,12350
"1622",191083,"ERIE COMMUNITY COLLEGE                                      ","2003-2004",2,"Basketball",69695,61320,8375,37074,38919,-1845,32621,22401,10220,"15","16",33439,16795
"16225",234711,"BIG BEND COMMUNITY COLLEGE                                  ","2003-2004",39,"Total Participants",124364,115993,8371,80237,70010,10227,44127,45983,-1856,"43","31",48500,58800
"9873",139658,"EMORY UNIVERSITY                                            ","2003-2004",16,"Softball",112337,103968,8369,0,0,0,112337,103968,8369,".","16",0,28536
"8195",157216,"LINDSEY WILSON COLLEGE                                      ","2003-2004",15,"Soccer",763872,755523,8349,392364,388878,3486,371508,366645,4863,"20","20",38562,24179
"1866",101569,"LAWSON STATE COMMUNITY COLLEGE                              ","2003-2004",2,"Basketball",85450,77125,8325,49296,44568,4728,36154,32557,3597,"18","15",39775,27993
"13406",104708,"GLENDALE COMMUNITY COLLEGE                                  ","2003-2004",26,"Volleyball",28684,20362,8322,0,0,0,28684,20362,8322,".","12",0,6229
"7579",140988,"SHORTER COLLEGE                                             ","2003-2004",15,"Soccer",484673,476353,8320,216819,212321,4498,267854,264032,3822,"18","25",27063,26143
"17107",234155,"VIRGINIA STATE UNIVERSITY                                   ","2003-2004",39,"Total Participants",451947,443629,8318,171943,164913,7030,280004,278716,1288,"201","90",193975,112538
"7744",179326,"SOUTHWEST BAPTIST UNIVERSITY                                ","2003-2004",15,"Soccer",210905,202590,8315,0,0,0,210905,202590,8315,".","20",0,31854
"3094",134608,"INDIAN RIVER COMMUNITY COLLEGE                              ","2003-2004",2,"Basketball",141284,132971,8313,71106,67028,4078,70178,65943,4235,"13","15",4078,4235
"1422",213349,"KUTZTOWN UNIVERSITY OF PENNSYLVANIA                         ","2003-2004",1,"Baseball",152075,143775,8300,152075,143775,8300,0,0,0,"24",".",73421,0
"6827",166391,"LASELL COLLEGE                                              ","2003-2004",11,"Lacrosse",39136,30843,8293,22285,17302,4983,16851,13541,3310,"22","15",9302,5173
"4935",173045,"AUGSBURG COLLEGE                                            ","2003-2004",7,"Football",146444,138162,8282,146444,138162,8282,0,0,0,"59",".",48839,0
"1857",165024,"BRIDGEWATER STATE COLLEGE                                   ","2003-2004",2,"Basketball",31380,23116,8264,15940,11748,4192,15440,11368,4072,"13","12",11690,11190
"5344",198598,"GREENSBORO COLLEGE                                          ","2003-2004",8,"Golf",59939,51687,8252,59939,51687,8252,0,0,0,"10","0",21776,0
"3177",209287,"MULTNOMAH BIBLE COLLEGE AND BIBLICAL SEMINARY               ","2003-2004",2,"Basketball",52872,44621,8251,52872,44621,8251,0,0,0,"10",".",2000,0
"10997",188429,"ADELPHI UNIVERSITY                                          ","2003-2004",22,"Tennis",91814,83566,8248,54106,50077,4029,37708,33489,4219,"10","10",4029,4652
"13198",181783,"WAYNE STATE COLLEGE                                         ","2003-2004",26,"Volleyball",196106,187867,8239,0,0,0,196106,187867,8239,".","9",0,29565
"908",214157,"MORAVIAN COLLEGE AND THEOLOGICAL SEMINARY                   ","2003-2004",1,"Baseball",78256,70021,8235,78256,70021,8235,0,0,0,"23",".",14864,0
"13412",110592,"CALIFORNIA STATE UNIVERSITY-LOS ANGELES                     ","2003-2004",26,"Volleyball",239436,231206,8230,0,0,0,239436,231206,8230,".","15",0,25004
"4926",160977,"BATES COLLEGE                                               ","2003-2004",7,"Football",231639,223419,8220,231639,223419,8220,0,0,0,"55",".",55764,0
"4793",225548,"HOWARD PAYNE UNIVERSITY                                     ","2003-2004",7,"Football",349924,341731,8193,349924,341731,8193,0,0,0,"103",".",80700,0
"11486",229267,"TRINITY UNIVERSITY                                          ","2003-2004",22,"Tennis",187025,178839,8186,93201,89328,3873,93824,89511,4313,"12","12",26833,27017
"517",171492,"NORTHWOOD UNIVERSITY                                        ","2003-2004",1,"Baseball",200917,192738,8179,200917,192738,8179,0,0,0,"32",".",54584,0
"6522",239512,"NORTHLAND COLLEGE                                           ","2003-2004",10,"Ice Hockey",74851,66675,8176,74851,66675,8176,0,0,0,"24",".",46024,0
"16340",240329,"UNIVERSITY OF WISCONSIN-LA CROSSE                           ","2003-2004",39,"Total Participants",823257,815082,8175,296202,330105,-33903,527055,484977,42078,"327","274",251521,227196
"7123",186584,"SETON HALL UNIVERSITY                                       ","2003-2004",15,"Soccer",925128,916962,8166,450898,436525,14373,474230,480437,-6207,"24","24",63292,78638
"2563",139393,"COVENANT COLLEGE                                            ","2003-2004",2,"Basketball",316251,308086,8165,150097,143309,6788,166154,164777,1377,"13","12",27082,29636
"14312",220589,"LAMBUTH UNIVERSITY                                          ","2003-2004",26,"Volleyball",33221,25086,8135,0,0,0,33221,25086,8135,"0","11",0,8826
"4101",213251,"JUNIATA COLLEGE                                             ","2003-2004",6,"Field hocky",66360,58228,8132,0,0,0,66360,58228,8132,".","24",0,26569
"11434",187912,"NEW MEXICO MILITARY INSTITUTE                               ","2003-2004",22,"Tennis",104760,96641,8119,104760,96641,8119,0,0,0,"9",".",14500,0
"9699",186876,"THE RICHARD STOCKTON COLLEGE OF NEW JERSEY                  ","2003-2004",16,"Softball",68301,60184,8117,0,0,0,68301,60184,8117,".","21",0,38059
"606",148496,"DOMINICAN UNIVERSITY                                        ","2003-2004",1,"Baseball",32500,24386,8114,32500,24386,8114,0,0,0,"28",".",16386,0
"2630",240365,"UNIVERSITY OF WISCONSIN-OSHKOSH                             ","2003-2004",2,"Basketball",185345,177253,8092,99885,95216,4669,85460,82037,3423,"15","14",36614,45827
"7548",147828,"OLIVET NAZARENE UNIVERSITY                                  ","2003-2004",15,"Soccer",242420,234364,8056,118665,118921,-256,123755,115443,8312,"22","23",16358,14074
"2861",181491,"NORTHEAST COMMUNITY COLLEGE                                 ","2003-2004",2,"Basketball",242003,233949,8054,118157,111354,6803,123846,122595,1251,"15","15",21333,18919
"8234",197221,"WEBB INSTITUTE                                              ","2003-2004",15,"Soccer",8050,0,8050,8050,8050,0,0,0,0,"24",".",3550,0
"4389",194310,"PACE UNIVERSITY-NEW YORK                                    ","2003-2004",7,"Football",481116,473074,8042,481116,473074,8042,0,0,0,"51",".",66593,0
"2350",114789,"FRESNO CITY COLLEGE                                         ","2003-2004",2,"Basketball",88804,80764,8040,70512,62875,7637,18292,17889,403,"12","17",17481,13324
"13574",206048,"TIFFIN UNIVERSITY                                           ","2003-2004",26,"Volleyball",18928,10893,8035,0,0,0,18928,10893,8035,".","25",0,8915
"9430",238661,"EDGEWOOD COLLEGE                                            ","2003-2004",16,"Softball",49382,41350,8032,0,0,0,49382,41350,8032,".","17",0,18390
"17025",203085,"HEIDELBERG COLLEGE                                          ","2003-2004",39,"Total Participants",384041,376016,8025,235550,229839,5711,148491,146177,2314,"255","128",160707,66453
"10753",220701,"MARTIN METHODIST COLLEGE                                    ","2003-2004",22,"Tennis",165898,157881,8017,82998,78981,4017,82900,78900,4000,"6","6",4004,4136
"9715",227243,"NORTHWOOD UNIVERSITY                                        ","2003-2004",16,"Softball",162629,154616,8013,0,0,0,162629,154616,8013,".","16",0,27578
"1952",155715,"PRATT COMMUNITY COLLEGE                                     ","2003-2004",2,"Basketball",190453,182441,8012,99168,98186,982,91285,84255,7030,"12","13",14275,14275
"3202",117140,"UNIVERSITY OF LA VERNE                                      ","2003-2004",2,"Basketball",131049,123038,8011,63707,56813,6894,67342,66225,1117,"12","9",12401,16183
"5392",125763,"WHITTIER COLLEGE                                            ","2003-2004",8,"Golf",12800,4790,8010,12800,4790,8010,0,0,0,"7",".",4500,0
"2698",127732,"NORTHEASTERN JUNIOR COLLEGE                                 ","2003-2004",2,"Basketball",47500,39500,8000,25000,21000,4000,22500,18500,4000,"15","12",16000,13500
"2779",155177,"HESSTON COLLEGE                                             ","2003-2004",2,"Basketball",81573,73573,8000,43261,38761,4500,38312,34812,3500,"15","12",22261,18312
"9821",193645,"THE COLLEGE OF NEW ROCHELLE                                 ","2003-2004",16,"Softball",8000,0,8000,0,0,0,8000,15362,-7362,".","17",0,10362
"10584",193645,"THE COLLEGE OF NEW ROCHELLE                                 ","2003-2004",19,"Swimming",8000,0,8000,0,0,0,8000,16894,-8894,".","10",0,11394
"15408",243115,"UNIVERSITY OF PUERTO RICO-ARECIBO                           ","2003-2004",38,"Weight Lifting",13217,5217,8000,6008,2008,4000,7209,3209,4000,"2","4",598,1196
"13875",144865,"COLLEGE OF DUPAGE                                           ","2003-2004",26,"Volleyball",38795,30800,7995,0,0,0,38795,30800,7995,"0","9",0,17795
"2142",224891,"FRANK PHILLIPS COLLEGE                                      ","2003-2004",2,"Basketball",280574,272587,7987,139369,135874,3495,141205,136713,4492,"14","13",26000,25050
"5980",207582,"ORAL ROBERTS UNIVERSITY                                     ","2003-2004",8,"Golf",411421,403440,7981,191626,185575,6051,219795,217865,1930,"9","6",39086,31082
"292",166850,"MERRIMACK COLLEGE                                           ","2003-2004",1,"Baseball",133325,125350,7975,133325,125350,7975,0,0,0,"28",".",18917,0
"2375",236258,"PENINSULA COLLEGE                                           ","2003-2004",2,"Basketball",79849,71876,7973,40083,36954,3129,39766,34922,4844,"14","10",20277,16237
"17190",167729,"SALEM STATE COLLEGE                                         ","2003-2004",39,"Total Participants",251500,243536,7964,152741,145997,6744,98759,97539,1220,"127","105",105544,72113
"12503",110468,"ALLIANT INTERNATIONAL UNIVERSITY-SAN DIEGO                  ","2003-2004",25,"Track and Field, X-Country",110000,102038,7962,55000,51039,3961,55000,50999,4001,"19","14",8610,8570
"5918",159717,"MCNEESE STATE UNIVERSITY                                    ","2003-2004",8,"Golf",196649,188690,7959,92345,87156,5189,104304,101534,2770,"14","8",23632,29578
"7414",123554,"SAINT MARYS COLLEGE OF CALIFORNIA                           ","2003-2004",15,"Soccer",954442,946485,7957,412020,409299,2721,542422,537186,5236,"29","23",58580,57837
"3025",154800,"BUTLER COUNTY COMMUNITY COLLEGE                             ","2003-2004",2,"Basketball",335120,327172,7948,191407,186638,4769,143713,140534,3179,"12","12",35301,26180
"3818",234155,"VIRGINIA STATE UNIVERSITY                                   ","2003-2004",3,"All Track Combined",132210,124268,7942,58852,51822,7030,73358,72446,912,"44","30",20917,11771
"3646",145372,"GREENVILLE COLLEGE                                          ","2003-2004",3,"All Track Combined",170365,162429,7936,86483,81214,5269,83882,81215,2667,"53","27",32933,32935
"11230",209065,"LINFIELD COLLEGE                                            ","2003-2004",22,"Tennis",79647,71727,7920,39747,35742,4005,39900,35985,3915,"14","10",15820,15820
"8990",148821,"SHAWNEE COMMUNITY COLLEGE                                   ","2003-2004",16,"Softball",48377,40462,7915,0,0,0,48377,40462,7915,".","18",0,20388
"1503",231581,"BRIDGEWATER COLLEGE                                         ","2003-2004",1,"Baseball",77150,69255,7895,77150,69255,7895,0,0,0,"39",".",35761,0
"2786",115393,"HARTNELL COLLEGE                                            ","2003-2004",2,"Basketball",71464,63576,7888,42139,34986,7153,29325,28590,735,"14","11",13386,9381
"7226",194310,"PACE UNIVERSITY-NEW YORK                                    ","2003-2004",15,"Soccer",138949,131061,7888,0,0,0,138949,131061,7888,".","21",0,17359
"4293",209056,"LEWIS &amp; CLARK COLLEGE                                       ","2003-2004",7,"Football",252800,244916,7884,252800,244916,7884,0,0,0,"44",".",76331,0
"7682",226231,"LETOURNEAU UNIVERSITY                                       ","2003-2004",15,"Soccer",125196,117317,7879,79308,72760,6548,45888,44557,1331,"22","18",25146,16359
"7986",122889,"SANTA BARBARA CITY COLLEGE                                  ","2003-2004",15,"Soccer",39871,32010,7861,19023,14753,4270,20848,17257,3591,"24","25",5180,4356
"10817",167996,"STONEHILL COLLEGE                                           ","2003-2004",22,"Tennis",41139,33280,7859,23324,20091,3233,17815,13189,4626,"11","10",13090,4667
"5938",114859,"FULLERTON COLLEGE                                           ","2003-2004",8,"Golf",44560,36705,7855,0,0,0,44560,36705,7855,".","5",0,2978
"14779",122597,"SAN FRANCISCO STATE UNIVERSITY                              ","2003-2004",28,"Wrestling",202032,194195,7837,202032,194195,7837,0,0,0,"22",".",41006,0
"3376",123554,"SAINT MARYS COLLEGE OF CALIFORNIA                           ","2003-2004",2,"Basketball",1780122,1772297,7825,936513,933126,3387,843609,839171,4438,"16","15",148413,118575
"8065",165644,"EASTERN NAZARENE COLLEGE                                    ","2003-2004",15,"Soccer",53429,45605,7824,31603,23686,7917,21826,21919,-93,"21","23",13707,10658
"4799",119216,"MT SAN JACINTO COLLEGE                                      ","2003-2004",7,"Football",70312,62495,7817,70312,62495,7817,0,0,0,"54",".",16244,0
"5008",214157,"MORAVIAN COLLEGE AND THEOLOGICAL SEMINARY                   ","2003-2004",7,"Football",221957,214154,7803,221957,214154,7803,0,0,0,"80",".",45425,0
"12827",167899,"SPRINGFIELD COLLEGE                                         ","2003-2004",25,"Track and Field, X-Country",19466,11666,7800,5385,5085,300,14081,6581,7500,"23","12",4969,6397
"7212",161767,"ANNE ARUNDEL COMMUNITY COLLEGE                              ","2003-2004",15,"Soccer",28389,20592,7797,12552,10209,2343,15837,10383,5454,"18","23",6200,8238
"15468",154907,"CLOUD COUNTY COMMUNITY COLLEGE                              ","2003-2004",39,"Total Participants",467445,459675,7770,224449,228336,-3887,242996,231339,11657,"92","77",2172,3276
"11677",195243,"SAINT THOMAS AQUINAS COLLEGE                                ","2003-2004",22,"Tennis",28277,20520,7757,19091,13863,5228,9186,6657,2529,"8","6",4863,2157
"3306",123013,"SANTA ROSA JUNIOR COLLEGE                                   ","2003-2004",2,"Basketball",97302,89560,7742,51729,47513,4216,45573,42047,3526,"14","15",14334,15311
"11037",150941,"HUNTINGTON COLLEGE                                          ","2003-2004",22,"Tennis",71693,63952,7741,36460,31960,4500,35233,31992,3241,"8","9",6341,6373
"14545",147916,"PARKLAND COLLEGE                                            ","2003-2004",26,"Volleyball",37200,29462,7738,0,0,0,37200,29462,7738,".","14",0,22097
"124",150604,"FRANKLIN COLLEGE                                            ","2003-2004",1,"Baseball",110583,102856,7727,110583,102856,7727,0,0,0,"35",".",63356,0
"5327",204200,"COLLEGE OF MOUNT SAINT JOSEPH                               ","2003-2004",8,"Golf",25937,18220,7717,12738,12774,-36,13199,5446,7753,"5","5",6956,1861
"85",165644,"EASTERN NAZARENE COLLEGE                                    ","2003-2004",1,"Baseball",55416,47712,7704,55416,47712,7704,0,0,0,"18",".",27538,0
"4670",143118,"AURORA UNIVERSITY                                           ","2003-2004",7,"Football",188192,180491,7701,188192,180491,7701,0,0,0,"100",".",44778,0
"7488",128498,"ALBERTUS MAGNUS COLLEGE                                     ","2003-2004",15,"Soccer",25100,17407,7693,25100,17407,7693,0,0,0,"19",".",17404,0
"7542",145372,"GREENVILLE COLLEGE                                          ","2003-2004",15,"Soccer",74131,66448,7683,39773,33284,6489,34358,33164,1194,"22","19",8914,9094
"12807",151777,"MANCHESTER COLLEGE                                          ","2003-2004",25,"Track and Field, X-Country",44252,36578,7674,22126,18289,3837,22126,18289,3837,"62","55",11150,11150
"4070",167899,"SPRINGFIELD COLLEGE                                         ","2003-2004",6,"Field hocky",24426,16761,7665,0,0,0,24426,16761,7665,".","42",0,13695
"12321",209506,"OREGON INSTITUTE OF TECHNOLOGY                              ","2003-2004",25,"Track and Field, X-Country",71081,63442,7639,33974,35894,-1920,37107,27548,9559,"38","28",27021,18675
"13376",225371,"HILL COLLEGE                                                ","2003-2004",26,"Volleyball",32737,25109,7628,0,0,0,32737,25109,7628,"0","12",0,7262
"4746",146427,"KNOX COLLEGE                                                ","2003-2004",7,"Football",133211,125595,7616,133211,125595,7616,0,0,0,"66",".",49098,0
"14113",218733,"SOUTH CAROLINA STATE UNIVERSITY                             ","2003-2004",26,"Volleyball",287109,279501,7608,0,0,0,287109,279501,7608,".","16",0,52056
"2394",148256,"REND LAKE COLLEGE                                           ","2003-2004",2,"Basketball",128439,120833,7606,56628,58553,-1925,71811,62280,9531,"17","13",25534,17771
"3290",214643,"PENNSYLVANIA STATE UNIVERSITY-PENN STATE WILKES-BA          ","2003-2004",2,"Basketball",14000,6400,7600,14000,6400,7600,0,0,0,"16",".",3100,0
"7177",110671,"UNIVERSITY OF CALIFORNIA-RIVERSIDE                          ","2003-2004",15,"Soccer",512401,504809,7592,207338,217306,-9968,305063,287503,17560,"25","34",8353,6380
"12796",120865,"PACIFIC UNION COLLEGE                                       ","2003-2004",25,"Track and Field, X-Country",15000,7418,7582,7500,4022,3478,7500,3396,4104,"8","10",2078,3102
"7840",198303,"CHOWAN COLLEGE                                              ","2003-2004",15,"Soccer",85303,77722,7581,36972,32977,3995,48331,44745,3586,"19","14",17761,16186
"8606",177542,"HANNIBAL-LAGRANGE COLLEGE                                   ","2003-2004",16,"Softball",100748,93182,7566,0,0,0,100748,93182,7566,".","26",0,11532
"2465",151801,"INDIANA WESLEYAN UNIVERSITY                                 ","2003-2004",2,"Basketball",138223,130678,7545,69214,68543,671,69009,62135,6874,"17","13",43537,36504
"29",221014,"MILLIGAN COLLEGE                                            ","2003-2004",1,"Baseball",275021,267521,7500,275021,267521,7500,0,0,0,"30",".",27400,0
"503",144944,"ELGIN COMMUNITY COLLEGE                                     ","2003-2004",1,"Baseball",41000,33500,7500,41000,33500,7500,0,0,0,"28",".",21200,0
"2108",213233,"JOHNSON COLLEGE                                             ","2003-2004",2,"Basketball",7500,0,7500,7500,7112,388,0,0,0,"12",".",593,0
"2681",197221,"WEBB INSTITUTE                                              ","2003-2004",2,"Basketball",7500,0,7500,7500,7500,0,0,0,0,"15",".",3200,0
"3222",101648,"MARION MILITARY INSTITUTE                                   ","2003-2004",2,"Basketball",7500,0,7500,7500,117600,-110100,0,0,0,"9",".",15500,0
"4554",148627,"SAINT XAVIER UNIVERSITY                                     ","2003-2004",7,"Football",260470,252970,7500,260470,252970,7500,0,0,0,"94",".",86015,0
"13443",206011,"TERRA STATE COMMUNITY COLLEGE                               ","2003-2004",26,"Volleyball",42000,34502,7498,0,0,0,42000,34502,7498,".","9",0,12480
"6977",182795,"FRANKLIN PIERCE COLLEGE                                     ","2003-2004",13,"Rowing",24485,16992,7493,12783,8681,4102,11702,8311,3391,"7","8",3210,3391
"7185",139861,"GEORGIA COLLEGE AND STATE UNIVERSITY                        ","2003-2004",15,"Soccer",86321,78835,7486,0,0,0,86321,78835,7486,".","24",0,60000
"5085",180984,"CONCORDIA UNIVERSITY                                        ","2003-2004",7,"Football",258069,250588,7481,258069,250588,7481,0,0,0,"85",".",46155,0
"12702",117946,"LOYOLA MARYMOUNT UNIVERSITY                                 ","2003-2004",25,"Track and Field, X-Country",304798,297345,7453,145128,142422,2706,159670,154923,4747,"10","15",15475,11014
"5515",235316,"GONZAGA UNIVERSITY                                          ","2003-2004",8,"Golf",290203,282755,7448,119375,114592,4783,170828,168163,2665,"11","11",53501,45735
"12274",121150,"PEPPERDINE UNIVERSITY                                       ","2003-2004",25,"Track and Field, X-Country",67804,60373,7431,26436,22667,3769,41368,37706,3662,"13","21",8879,14488
"14100",155520,"MIDAMERICA NAZARENE UNIVERSITY                              ","2003-2004",26,"Volleyball",106152,98721,7431,0,0,0,106152,98721,7431,".","10",0,26070
"9417",220631,"LINCOLN MEMORIAL UNIVERSITY                                 ","2003-2004",16,"Softball",207447,200022,7425,0,0,0,207447,200022,7425,".","14",0,92236
"3813",191083,"ERIE COMMUNITY COLLEGE                                      ","2003-2004",3,"All Track Combined",37653,30233,7420,23145,19724,3421,14508,10509,3999,"27","11",16849,7634
"9472",168290,"WHEELOCK COLLEGE                                            ","2003-2004",16,"Softball",7400,0,7400,0,0,0,7400,14700,-7300,".","14",0,6000
"15200",213233,"JOHNSON COLLEGE                                             ","2003-2004",33,"Bowling",7400,0,7400,7400,7391,9,0,0,0,"20",".",370,0
"9346",243106,"UNIVERSITY OF PUERTO RICO-AGUADILLA                         ","2003-2004",16,"Softball",10483,3087,7396,0,0,0,10483,3087,7396,".","15",0,1797
"6715",203535,"KENYON COLLEGE                                              ","2003-2004",11,"Lacrosse",141285,133899,7386,86484,85484,1000,54801,48415,6386,"30","25",36084,22780
"14616",106704,"UNIVERSITY OF CENTRAL ARKANSAS                              ","2003-2004",26,"Volleyball",148149,140764,7385,0,0,0,148149,140764,7385,".","11",0,21824
"5702",224226,"DALLAS BAPTIST UNIVERSITY                                   ","2003-2004",8,"Golf",19894,12518,7376,19894,12518,7376,0,0,0,"8","0",9975,0
"6930",237312,"UNIVERSITY OF CHARLESTON                                    ","2003-2004",13,"Rowing",31787,24419,7368,0,0,0,31787,24419,7368,".","11",0,8296
"42",173665,"HAMLINE UNIVERSITY                                          ","2003-2004",1,"Baseball",73425,66065,7360,73425,66065,7360,0,0,0,"25",".",36399,0
"11823",190691,"CUNY YORK COLLEGE                                           ","2003-2004",23,"Track and Field, Indoor",19178,11848,7330,9589,5924,3665,9589,5924,3665,"12","10",3756,3756
"12145",190691,"CUNY YORK COLLEGE                                           ","2003-2004",24,"Track and Field, Outdoor",19178,11848,7330,9589,5924,3665,9589,5924,3665,"12","12",3756,3756
"3669",212115,"EAST STROUDSBURG UNIVERSITY OF PENNSYLVANIA                 ","2003-2004",3,"All Track Combined",199181,191852,7329,97230,94039,3191,101951,97813,4138,"94","104",21848,21593
"7179",213251,"JUNIATA COLLEGE                                             ","2003-2004",15,"Soccer",88070,80749,7321,43798,40816,2982,44272,39933,4339,"23","26",16087,16084
"11567",216287,"SWARTHMORE COLLEGE                                          ","2003-2004",22,"Tennis",47720,40408,7312,19235,16132,3103,28485,24276,4209,"14","18",15011,23831
"15568",173300,"CONCORDIA COLLEGE AT MOORHEAD                               ","2003-2004",39,"Total Participants",699745,692433,7312,348406,351549,-3143,351339,340884,10455,"350","250",29179,23410
"15050",204635,"OHIO NORTHERN UNIVERSITY                                    ","2003-2004",28,"Wrestling",39974,32663,7311,39974,32663,7311,0,0,0,"13",".",26305,0
"7",218821,"SPARTANBURG METHODIST COLLEGE                               ","2003-2004",1,"Baseball",114928,107619,7309,114928,107619,7309,0,0,0,"40",".",42496,0
"980",181312,"MID PLAINS COMMUNITY COLLEGE AREA                           ","2003-2004",1,"Baseball",65809,58503,7306,65809,58503,7306,0,0,0,"26",".",23521,0
"8246",152992,"BRIAR CLIFF UNIVERSITY                                      ","2003-2004",15,"Soccer",312303,305001,7302,174051,177501,-3450,138252,127500,10752,"22","19",13589,12606
"649",121363,"PORTERVILLE COLLEGE                                         ","2003-2004",1,"Baseball",36500,29200,7300,36500,29200,7300,0,0,0,"53",".",688,0
"17074",146366,"KASKASKIA COLLEGE                                           ","2003-2004",39,"Total Participants",225117,217836,7281,121963,116977,4986,103154,100859,2295,"46","46",79004,89801
"14209",165644,"EASTERN NAZARENE COLLEGE                                    ","2003-2004",26,"Volleyball",26751,19481,7270,0,0,0,26751,19481,7270,".","13",0,10482
"1169",128498,"ALBERTUS MAGNUS COLLEGE                                     ","2003-2004",1,"Baseball",22900,15635,7265,22900,15635,7265,0,0,0,"15",".",15630,0
"1889",234711,"BIG BEND COMMUNITY COLLEGE                                  ","2003-2004",2,"Basketball",60264,53000,7264,34334,26052,8282,25930,26948,-1018,"14","10",19500,19500
"3301",160977,"BATES COLLEGE                                               ","2003-2004",2,"Basketball",163270,156009,7261,98644,93260,5384,64626,62749,1877,"15","16",35149,21019
"7686",130697,"WESLEYAN UNIVERSITY                                         ","2003-2004",15,"Soccer",111192,103959,7233,72964,64515,8449,38228,39444,-1216,"28","23",16328,10682
"1632",123217,"COLLEGE OF THE SEQUOIAS                                     ","2003-2004",2,"Basketball",42562,35336,7226,23911,17973,5938,18651,17363,1288,"11","14",6923,6923
"1019",148991,"SPOON RIVER COLLEGE                                         ","2003-2004",1,"Baseball",25433,18215,7218,25433,18215,7218,0,0,0,"20",".",10891,0
"15273",231581,"BRIDGEWATER COLLEGE                                         ","2003-2004",34,"Equestrian",23996,16779,7217,0,0,0,23996,16779,7217,"0","28",0,8421
"675",149231,"SOUTHERN ILLINOIS UNIVERSITY-EDWARDSVILLE                   ","2003-2004",1,"Baseball",184356,177146,7210,184356,177146,7210,0,0,0,"26",".",37352,0
"8018",173045,"AUGSBURG COLLEGE                                            ","2003-2004",15,"Soccer",78575,71365,7210,43034,36774,6260,35541,34591,950,"24","26",19877,19877
"9261",214157,"MORAVIAN COLLEGE AND THEOLOGICAL SEMINARY                   ","2003-2004",16,"Softball",84225,77024,7201,0,0,0,84225,77024,7201,".","18",0,17406
"6674",166948,"MOUNT IDA COLLEGE                                           ","2003-2004",11,"Lacrosse",38039,30839,7200,38039,30839,7200,0,0,0,"25",".",23839,0
"16897",214643,"PENNSYLVANIA STATE UNIVERSITY-PENN STATE WILKES-BA          ","2003-2004",39,"Total Participants",31800,24600,7200,26800,21100,5700,5000,3500,1500,"82","8",13200,1500
"7733",143084,"AUGUSTANA COLLEGE                                           ","2003-2004",15,"Soccer",96817,89619,7198,47704,44071,3633,49113,45548,3565,"25","23",17996,18845
"12016",236708,"SPOKANE FALLS COMMUNITY COLLEGE                             ","2003-2004",24,"Track and Field, Outdoor",69773,62586,7187,42427,37978,4449,27346,24608,2738,"29","18",33695,20652
"2564",225548,"HOWARD PAYNE UNIVERSITY                                     ","2003-2004",2,"Basketball",188053,180898,7155,97797,86669,11128,90256,94229,-3973,"24","19",30500,29600
"14590",201548,"CAPITAL UNIVERSITY                                          ","2003-2004",26,"Volleyball",60584,53430,7154,0,0,0,60584,53430,7154,".","16",0,19715
"4531",214041,"MILLERSVILLE UNIVERSITY OF PENNSYLVANIA                     ","2003-2004",7,"Football",542250,535105,7145,542250,535105,7145,0,0,0,"89",".",58803,0
"821",190044,"CLARKSON UNIVERSITY                                         ","2003-2004",1,"Baseball",68295,61153,7142,68295,61153,7142,0,0,0,"31",".",19763,0
"1383",228343,"SOUTHWESTERN UNIVERSITY                                     ","2003-2004",1,"Baseball",149585,142447,7138,149585,142447,7138,0,0,0,"35",".",60170,0
"3244",178244,"MISSOURI BAPTIST UNIVERSITY                                 ","2003-2004",2,"Basketball",710748,703617,7131,382665,381199,1466,328083,322418,5665,"28","28",36870,23403
"5431",176479,"WILLIAM CAREY COLLEGE                                       ","2003-2004",8,"Golf",36295,29167,7128,36295,29167,7128,0,0,0,"8",".",4644,0
"5451",153524,"IOWA CENTRAL COMMUNITY COLLEGE                              ","2003-2004",8,"Golf",20663,13542,7121,9846,5286,4560,10817,8256,2561,"13","5",1436,7055
"1322",184348,"DREW UNIVERSITY                                             ","2003-2004",1,"Baseball",88039,80930,7109,88039,80930,7109,0,0,0,"28",".",15847,0
"13193",143613,"CARL SANDBURG COLLEGE                                       ","2003-2004",26,"Volleyball",24291,17185,7106,0,0,0,24291,17185,7106,".","10",0,17180
"11527",211431,"CARLOW COLLEGE                                              ","2003-2004",22,"Tennis",7100,0,7100,0,0,0,7100,12330,-5230,".","9",0,776
"7001",132657,"LYNN UNIVERSITY                                             ","2003-2004",13,"Rowing",20579,13494,7085,0,0,0,20579,13494,7085,".","5",0,12994
"1634",157818,"TRANSYLVANIA UNIVERSITY                                     ","2003-2004",2,"Basketball",259596,252516,7080,140963,137423,3540,118633,115093,3540,"22","15",49874,35749
"5088",203535,"KENYON COLLEGE                                              ","2003-2004",7,"Football",204896,197818,7078,204896,197818,7078,0,0,0,"48",".",52364,0
"1840",221892,"TREVECCA NAZARENE UNIVERSITY                                ","2003-2004",2,"Basketball",552101,545025,7076,269614,278790,-9176,282487,266235,16252,"13","14",33931,33923
"14016",210429,"WESTERN OREGON UNIVERSITY                                   ","2003-2004",26,"Volleyball",154284,147214,7070,0,0,0,154284,147214,7070,".","15",0,40598
"14376",143118,"AURORA UNIVERSITY                                           ","2003-2004",26,"Volleyball",47864,40795,7069,0,0,0,47864,40795,7069,".","12",0,14890
"17233",167394,"COLLEGE OF OUR LADY OF THE ELMS                             ","2003-2004",39,"Total Participants",244683,237615,7068,77680,76496,1184,167003,161119,5884,"65","92",31773,53790
"15493",153524,"IOWA CENTRAL COMMUNITY COLLEGE                              ","2003-2004",39,"Total Participants",331611,324545,7066,189854,183293,6561,141757,141252,505,"230","72",138939,70932
"6358",131469,"GEORGE WASHINGTON UNIVERSITY                                ","2003-2004",9,"Gymnastics",441710,434656,7054,0,0,0,441710,434656,7054,".","14",0,31137
"6895",137847,"THE UNIVERSITY OF TAMPA                                     ","2003-2004",13,"Rowing",56911,49877,7034,0,0,0,56911,49877,7034,".","30",0,16860
"7864",238980,"LAKELAND COLLEGE                                            ","2003-2004",15,"Soccer",51061,44048,7013,22759,22247,512,28302,21801,6501,"21","13",7605,7740
"7444",186201,"RAMAPO COLLEGE OF NEW JERSEY                                ","2003-2004",15,"Soccer",132530,125521,7009,89005,83160,5845,43525,42361,1164,"39","24",35917,29334
"3504",217475,"COMMUNITY COLLEGE OF RHODE ISLAND                           ","2003-2004",3,"All Track Combined",17500,10500,7000,8750,5250,3500,8750,5250,3500,"37","21",4450,4450
"3692",141334,"STATE UNIVERSITY OF WEST GEORGIA                            ","2003-2004",3,"All Track Combined",62644,55644,7000,36018,33018,3000,26626,22626,4000,"13","11",10302,6203
"13825",157863,"UNION COLLEGE                                               ","2003-2004",26,"Volleyball",107000,1e+05,7000,0,0,0,107000,1e+05,7000,".","11",0,10025
"8829",202763,"THE UNIVERSITY OF FINDLAY                                   ","2003-2004",16,"Softball",123774,116781,6993,0,0,0,123774,116781,6993,".","31",0,27509
"11155",171492,"NORTHWOOD UNIVERSITY                                        ","2003-2004",22,"Tennis",266539,259546,6993,137414,132071,5343,129125,127475,1650,"7","7",15849,12716
"14382",107983,"SOUTHERN ARKANSAS UNIVERSITY MAIN CAMPUS                    ","2003-2004",26,"Volleyball",45129,38140,6989,0,0,0,45129,38140,6989,".","13",0,26435
"4817",153278,"UNIVERSITY OF DUBUQUE                                       ","2003-2004",7,"Football",327560,320576,6984,327560,320576,6984,0,0,0,"139",".",89534,0
"12608",206048,"TIFFIN UNIVERSITY                                           ","2003-2004",25,"Track and Field, X-Country",59484,52503,6981,24459,17478,6981,35025,35025,0,"95","82",16882,22497
"4919",168263,"WESTFIELD STATE COLLEGE                                     ","2003-2004",7,"Football",63252,56278,6974,63252,56278,6974,0,0,0,"60",".",25193,0
"12949",211440,"CARNEGIE MELLON UNIVERSITY                                  ","2003-2004",25,"Track and Field, X-Country",217075,210103,6972,110957,108345,2612,106118,101758,4360,"132","67",45434,38847
"5235",206011,"TERRA STATE COMMUNITY COLLEGE                               ","2003-2004",8,"Golf",24067,17096,6971,24067,17096,6971,0,0,0,"6",".",11033,0
"3028",219295,"PRESENTATION COLLEGE                                        ","2003-2004",2,"Basketball",188171,181212,6959,106611,103132,3479,81560,78080,3480,"14","13",29818,22846
"11852",147341,"MONMOUTH COLLEGE                                            ","2003-2004",23,"Track and Field, Indoor",35190,28232,6958,17595,14116,3479,17595,14116,3479,"32","29",13595,13595
"12072",147341,"MONMOUTH COLLEGE                                            ","2003-2004",24,"Track and Field, Outdoor",35190,28232,6958,17595,14116,3479,17595,14116,3479,"31","17",13595,13595
"7308",106704,"UNIVERSITY OF CENTRAL ARKANSAS                              ","2003-2004",15,"Soccer",282847,275918,6929,145753,140491,5262,137094,135427,1667,"30","23",43363,40433
"6196",218441,"NORTH GREENVILLE COLLEGE                                    ","2003-2004",8,"Golf",19379,12455,6924,19379,12455,6924,0,0,0,"15",".",12448,0
"7196",199069,"MOUNT OLIVE COLLEGE                                         ","2003-2004",15,"Soccer",146627,139715,6912,89029,82116,6913,57598,57599,-1,"24","14",19888,18331
"4927",165866,"FRAMINGHAM STATE COLLEGE                                    ","2003-2004",7,"Football",62936,56035,6901,62936,56035,6901,0,0,0,"35",".",19845,0
"14121",190983,"ELMIRA COLLEGE                                              ","2003-2004",26,"Volleyball",62167,55266,6901,0,0,0,62167,55266,6901,"0","11",0,29115
"812",211927,"DELAWARE COUNTY COMMUNITY COLLEGE                           ","2003-2004",1,"Baseball",12400,5500,6900,12400,5500,6900,0,0,0,"16",".",7200,0
"9656",121901,"RIVERSIDE COMMUNITY COLLEGE                                 ","2003-2004",16,"Softball",16000,9100,6900,0,0,0,16000,9100,6900,".","14",0,9000
"16657",134079,"FLORIDA SOUTHERN COLLEGE                                    ","2003-2004",39,"Total Participants",1271523,1264625,6898,597956,593134,4822,673567,671491,2076,"114","111",244244,239801
"5240",194310,"PACE UNIVERSITY-NEW YORK                                    ","2003-2004",8,"Golf",90929,84041,6888,48941,42370,6571,41988,41671,317,"5","4",12002,14003
"1173",162928,"JOHNS HOPKINS UNIVERSITY                                    ","2003-2004",1,"Baseball",152481,145597,6884,152481,145597,6884,0,0,0,"54",".",37029,0
"17229",176664,"BAPTIST BIBLE COLLEGE AND GRADUATE SCHOOL                   ","2003-2004",39,"Total Participants",31878,25000,6878,16721,12500,4221,15157,12500,2657,"30","24",33000,30000
"13161",140447,"MERCER UNIVERSITY                                           ","2003-2004",26,"Volleyball",61885,55010,6875,0,0,0,61885,55010,6875,".","11",0,26138
"4299",200253,"MINOT STATE UNIVERSITY                                      ","2003-2004",7,"Football",72312,65438,6874,72312,65438,6874,0,0,0,"75",".",40770,0
"307",199069,"MOUNT OLIVE COLLEGE                                         ","2003-2004",1,"Baseball",135984,129120,6864,135984,129120,6864,0,0,0,"38",".",40406,0
"11111",219976,"DAVID LIPSCOMB UNIVERSITY                                   ","2003-2004",22,"Tennis",223979,217121,6858,114762,108528,6234,109217,108593,624,"10","12",24890,23783
"4502",174491,"NORTHWESTERN COLLEGE                                        ","2003-2004",7,"Football",137836,130983,6853,137836,130983,6853,0,0,0,"62",".",49477,0
"10856",173300,"CONCORDIA COLLEGE AT MOORHEAD                               ","2003-2004",22,"Tennis",39061,32210,6851,19513,16297,3216,19548,15913,3635,"8","15",378,574
"9511",148007,"PRAIRIE STATE COLLEGE                                       ","2003-2004",16,"Softball",27000,20150,6850,0,0,0,27000,20150,6850,".","18",0,19700
"11482",151379,"INDIANA UNIVERSITY-SOUTHEAST                                ","2003-2004",22,"Tennis",41003,34160,6843,13068,13936,-868,27935,20224,7711,"7","8",6290,9123
"14428",196158,"SUNY COLLEGE AT FREDONIA                                    ","2003-2004",26,"Volleyball",34978,28137,6841,0,0,0,34978,28137,6841,".","12",0,19607
"15405",243106,"UNIVERSITY OF PUERTO RICO-AGUADILLA                         ","2003-2004",38,"Weight Lifting",11181,4344,6837,6289,2432,3857,4892,1912,2980,"9","7",864,864
"14838",191968,"ITHACA COLLEGE                                              ","2003-2004",28,"Wrestling",97120,90289,6831,97120,90289,6831,0,0,0,"29","0",47388,0
"10156",191515,"HAMILTON COLLEGE                                            ","2003-2004",18,"Swimming and Diving",94592,87763,6829,43041,39831,3210,51551,47932,3619,"23","31",12221,13003
"9942",143613,"CARL SANDBURG COLLEGE                                       ","2003-2004",16,"Softball",18506,11679,6827,0,0,0,18506,11679,6827,".","11",0,11682
"7266",204945,"OWENS COMMUNITY COLLEGE                                     ","2003-2004",15,"Soccer",42383,35561,6822,42383,35561,6822,0,0,0,"19",".",9732,0
"6109",227243,"NORTHWOOD UNIVERSITY                                        ","2003-2004",8,"Golf",166566,159745,6821,85690,87334,-1644,80876,72411,8465,"10","4",14966,14487
"10433",240189,"UNIVERSITY OF WISCONSIN-WHITEWATER                          ","2003-2004",18,"Swimming and Diving",59129,52318,6811,29439,25387,4052,29690,26931,2759,"16","21",11944,13897
"3098",106713,"CENTRAL BAPTIST COLLEGE                                     ","2003-2004",2,"Basketball",122042,115232,6810,71492,63422,8070,50550,51810,-1260,"14","13",16900,15950
"5452",220589,"LAMBUTH UNIVERSITY                                          ","2003-2004",8,"Golf",17860,11051,6809,8330,5333,2997,9530,5718,3812,"7","5",3139,4977
"11405",159717,"MCNEESE STATE UNIVERSITY                                    ","2003-2004",22,"Tennis",139822,133014,6808,0,0,0,139822,133014,6808,"0","10",0,25246
"2886",169974,"GLEN OAKS COMMUNITY COLLEGE                                 ","2003-2004",2,"Basketball",65466,58665,6801,38475,32835,5640,26991,25830,1161,"12","10",9066,6103
"2098",173045,"AUGSBURG COLLEGE                                            ","2003-2004",2,"Basketball",96716,89927,6789,52261,47794,4467,44455,42133,2322,"25","14",16463,15820
"10632",134079,"FLORIDA SOUTHERN COLLEGE                                    ","2003-2004",19,"Swimming",36972,30184,6788,18486,15092,3394,18486,15092,3394,"5","13",2527,2527
"15066",243133,"UNIVERSITY OF PUERTO RICO-BAYAMON                           ","2003-2004",29,"Other Sports",15000,8223,6777,15000,8223,6777,0,0,0,"26",".",1364,0
"9981",201548,"CAPITAL UNIVERSITY                                          ","2003-2004",16,"Softball",116666,109903,6763,0,0,0,116666,109903,6763,".","27",0,37965
"3092",212197,"ELIZABETHTOWN COLLEGE                                       ","2003-2004",2,"Basketball",114894,108136,6758,53614,52900,714,61280,55236,6044,"24","11",18358,14982
"7534",102368,"TROY STATE UNIVERSITY-MAIN CAMPUS                           ","2003-2004",15,"Soccer",253168,246435,6733,0,0,0,253168,246435,6733,".","21",0,35093
"8351",119164,"MT SAN ANTONIO COLLEGE                                      ","2003-2004",15,"Soccer",134872,128139,6733,60539,60353,186,74333,67786,6547,"27","23",8300,8229
"956",155177,"HESSTON COLLEGE                                             ","2003-2004",1,"Baseball",46072,39372,6700,46072,39372,6700,0,0,0,"22",".",25572,0
"16030",179308,"SAINT LOUIS COMMUNITY COLLEGE-FOREST PARK                   ","2003-2004",39,"Total Participants",74097,67397,6700,44658,39958,4700,29439,27439,2000,"62","49",2499,2499
"10788",100706,"UNIVERSITY OF ALABAMA IN HUNTSVILLE                         ","2003-2004",22,"Tennis",85659,78960,6699,40292,36943,3349,45367,42017,3350,"8","8",4829,4828
"7340",139393,"COVENANT COLLEGE                                            ","2003-2004",15,"Soccer",420128,413436,6692,215212,210489,4723,204916,202947,1969,"32","29",29632,30256
"16869",224554,"TEXAS A &amp; M UNIVERSITY-COMMERCE                             ","2003-2004",39,"Total Participants",158692,152000,6692,39000,41000,-2000,119692,111000,8692,"162","74",183404,141350
"5432",140818,"PIEDMONT COLLEGE                                            ","2003-2004",8,"Golf",26398,19712,6686,14064,10721,3343,12334,8991,3343,"5","4",9351,7260
"9651",125462,"WEST HILLS COMMUNITY COLLEGE                                ","2003-2004",16,"Softball",26607,19926,6681,0,0,0,26607,19926,6681,".","13",0,5217
"3913",181783,"WAYNE STATE COLLEGE                                         ","2003-2004",3,"All Track Combined",133602,126923,6679,68488,65966,2522,65114,60957,4157,"25","20",25544,26760
"15037",146825,"MACMURRAY COLLEGE                                           ","2003-2004",28,"Wrestling",39728,33055,6673,39728,33055,6673,0,0,0,"11","0",10330,0
"15016",216694,"WAYNESBURG COLLEGE                                          ","2003-2004",28,"Wrestling",45788,39117,6671,45788,39117,6671,0,0,0,"13",".",37459,0
"16020",179265,"ST LOUIS COLLEGE OF PHARMACY                                ","2003-2004",39,"Total Participants",27050,20388,6662,5600,2730,2870,21450,17658,3792,"14","33",17981,31134
"2451",177542,"HANNIBAL-LAGRANGE COLLEGE                                   ","2003-2004",2,"Basketball",313664,307005,6659,158215,156954,1261,155449,150051,5398,"15","15",18359,16252
"1113",191719,"HUDSON VALLEY COMMUNITY COLLEGE                             ","2003-2004",1,"Baseball",39398,32740,6658,39398,32740,6658,0,0,0,"29",".",22533,0
"822",226578,"MCLENNAN COMMUNITY COLLEGE                                  ","2003-2004",1,"Baseball",138341,131689,6652,138341,131689,6652,0,0,0,"30",".",21904,0
"4870",213668,"LYCOMING COLLEGE                                            ","2003-2004",7,"Football",193383,186735,6648,193383,186735,6648,0,0,0,"99",".",52545,0
"12346",114789,"FRESNO CITY COLLEGE                                         ","2003-2004",25,"Track and Field, X-Country",33600,26954,6646,16800,13477,3323,16800,13477,3323,"51","45",7204,7204
"1032",129941,"UNIVERSITY OF NEW HAVEN                                     ","2003-2004",1,"Baseball",284459,277823,6636,284459,277823,6636,0,0,0,"47",".",42742,0
"9746",191621,"HILBERT COLLEGE                                             ","2003-2004",16,"Softball",25129,18494,6635,0,0,0,25129,18494,6635,".","13",0,8407
"6000",228042,"SCHREINER UNIVERSITY                                        ","2003-2004",8,"Golf",15576,8943,6633,15576,8943,6633,0,0,0,"10",".",4500,0
"7154",174358,"MINNESOTA STATE UNIVERSITY-MOORHEAD                         ","2003-2004",15,"Soccer",77724,71092,6632,0,0,0,77724,71092,6632,".","17",0,16249
"4971",153162,"CORNELL COLLEGE                                             ","2003-2004",7,"Football",206818,200198,6620,206818,200198,6620,0,0,0,"76",".",42334,0
"6803",214175,"MUHLENBERG COLLEGE                                          ","2003-2004",11,"Lacrosse",66736,60119,6617,35413,26733,8680,31323,33386,-2063,"28","22",18316,28764
"2778",146481,"LAKE FOREST COLLEGE                                         ","2003-2004",2,"Basketball",154578,147964,6614,65799,63249,2550,88779,84715,4064,"13","16",18404,19815
"2560",137847,"THE UNIVERSITY OF TAMPA                                     ","2003-2004",2,"Basketball",569582,562971,6611,336862,319918,16944,232720,243053,-10333,"18","16",69044,50017
"13358",191083,"ERIE COMMUNITY COLLEGE                                      ","2003-2004",26,"Volleyball",20747,14147,6600,0,0,0,20747,14147,6600,".","10",0,13236
"4111",166850,"MERRIMACK COLLEGE                                           ","2003-2004",6,"Field hocky",114165,107590,6575,0,0,0,114165,107590,6575,".","23",0,15835
"7959",161235,"UNIVERSITY OF MAINE AT FORT KENT                            ","2003-2004",15,"Soccer",73086,66519,6567,38511,36296,2215,34575,30223,4352,"19","16",29810,21988
"12716",229267,"TRINITY UNIVERSITY                                          ","2003-2004",25,"Track and Field, X-Country",131940,125374,6566,65970,62687,3283,65970,62687,3283,"39","33",29410,29410
"11421",216694,"WAYNESBURG COLLEGE                                          ","2003-2004",22,"Tennis",46012,39447,6565,23524,21378,2146,22488,18069,4419,"10","14",19225,15817
"2639",206437,"WALSH UNIVERSITY                                            ","2003-2004",2,"Basketball",170371,163807,6564,97380,95087,2293,72991,68720,4271,"25","18",39262,27813
"13401",122339,"SAN DIEGO CITY COLLEGE                                      ","2003-2004",26,"Volleyball",23669,17105,6564,0,0,0,23669,17105,6564,".","12",0,5271
"7989",149781,"WHEATON COLLEGE                                             ","2003-2004",15,"Soccer",200809,194252,6557,118746,113028,5718,82063,81224,839,"27","23",23905,27958
"14372",228042,"SCHREINER UNIVERSITY                                        ","2003-2004",26,"Volleyball",61205,54655,6550,0,0,0,61205,54655,6550,".","12",0,18100
"1929",179256,"SAINT LOUIS CHRISTIAN COLLEGE                               ","2003-2004",2,"Basketball",6538,0,6538,6538,6280,258,0,0,0,"14",".",4763,0
"1273",227429,"PAUL QUINN COLLEGE                                          ","2003-2004",1,"Baseball",41725,35192,6533,41725,35192,6533,0,0,0,"15",".",22069,0
"11084",206941,"UNIVERSITY OF CENTRAL OKLAHOMA                              ","2003-2004",22,"Tennis",16747,10222,6525,11637,5111,6526,5110,5111,-1,"14","6",5110,5110
"13871",127185,"FORT LEWIS COLLEGE                                          ","2003-2004",26,"Volleyball",134867,128351,6516,0,0,0,134867,128351,6516,".","11",0,28688
"9779",226578,"MCLENNAN COMMUNITY COLLEGE                                  ","2003-2004",16,"Softball",91324,84820,6504,0,0,0,91324,84820,6504,".","16",0,20656
"1978",168290,"WHEELOCK COLLEGE                                            ","2003-2004",2,"Basketball",6500,0,6500,0,0,0,6500,16145,-9645,".","8",0,6000
"8570",153250,"DORDT COLLEGE                                               ","2003-2004",16,"Softball",59527,53027,6500,0,0,0,59527,53027,6500,".","18",0,12618
"16839",414823,"JOHNSON &amp; WALES UNIVERSITY-FLORIDA CAMPUS                   ","2003-2004",39,"Total Participants",34500,28000,6500,21000,17500,3500,13500,10500,3000,"31","8",28000,7500
"1433",439145,"PIERCE COLLEGE AT PUYALLUP                                  ","2003-2004",1,"Baseball",44235,37737,6498,44235,37737,6498,0,0,0,"20",".",11308,0
"839",156356,"BRESCIA UNIVERSITY                                          ","2003-2004",1,"Baseball",34996,28500,6496,34996,28500,6496,0,0,0,"30",".",27796,0
"8654",240338,"WISCONSIN LUTHERAN COLLEGE                                  ","2003-2004",16,"Softball",38769,32276,6493,0,0,0,38769,32276,6493,".","13",0,5979
"9270",128498,"ALBERTUS MAGNUS COLLEGE                                     ","2003-2004",16,"Softball",15900,9414,6486,0,0,0,15900,9414,6486,".","11",0,9416
"2515",201371,"BLUFFTON COLLEGE                                            ","2003-2004",2,"Basketball",115066,108584,6482,67233,63059,4174,47833,45525,2308,"26","10",22482,17952
"12494",182795,"FRANKLIN PIERCE COLLEGE                                     ","2003-2004",25,"Track and Field, X-Country",21464,14982,6482,12340,9045,3295,9124,5937,3187,"13","11",3295,3187
"10794",202763,"THE UNIVERSITY OF FINDLAY                                   ","2003-2004",22,"Tennis",70414,63948,6466,36028,36380,-352,34386,27568,6818,"8","7",6220,5348
"5059",122658,"SAN JOAQUIN DELTA COLLEGE                                   ","2003-2004",7,"Football",98708,92246,6462,98708,92246,6462,0,0,0,"77",".",31803,0
"7835",439145,"PIERCE COLLEGE AT PUYALLUP                                  ","2003-2004",15,"Soccer",29903,23445,6458,29903,23445,6458,0,0,0,"16",".",6554,0
"10552",168290,"WHEELOCK COLLEGE                                            ","2003-2004",19,"Swimming",6450,0,6450,0,0,0,6450,12340,-5890,".","12",0,6000
"1806",199625,"SAMPSON COMMUNITY COLLEGE                                   ","2003-2004",2,"Basketball",6440,0,6440,6440,6000,440,0,0,0,"7",".",4500,0
"8766",113193,"CUESTA COLLEGE                                              ","2003-2004",16,"Softball",23333,16902,6431,0,0,0,23333,16902,6431,".","13",0,10320
"7771",168290,"WHEELOCK COLLEGE                                            ","2003-2004",15,"Soccer",6430,0,6430,0,0,0,6430,18600,-12170,".","13",0,6000
"1509",210331,"WESTERN BAPTIST COLLEGE                                     ","2003-2004",1,"Baseball",63138,56712,6426,63138,56712,6426,0,0,0,"26",".",32299,0
"8378",192022,"JEFFERSON COMMUNITY COLLEGE                                 ","2003-2004",15,"Soccer",28402,21986,6416,14776,12910,1866,13626,9076,4550,"25","17",9310,5476
"4126",211981,"DELAWARE VALLEY COLLEGE                                     ","2003-2004",6,"Field hocky",41170,34770,6400,0,0,0,41170,34770,6400,".","22",0,7570
"16022",147411,"MORTON COLLEGE                                              ","2003-2004",39,"Total Participants",213120,206720,6400,130536,126616,3920,82584,80104,2480,"62","43",49166,34099
"16879",115393,"HARTNELL COLLEGE                                            ","2003-2004",39,"Total Participants",180950,174568,6382,92330,88039,4291,88620,86529,2091,"161","71",81645,48811
"12526",218070,"FURMAN UNIVERSITY                                           ","2003-2004",25,"Track and Field, X-Country",154184,147803,6381,86551,63302,23249,67633,84501,-16868,"18","20",5807,7089
"14318",138789,"ARMSTRONG ATLANTIC STATE UNIVERSITY                         ","2003-2004",26,"Volleyball",173045,166665,6380,0,0,0,173045,166665,6380,".","14",0,96714
"1976",150756,"HANOVER COLLEGE                                             ","2003-2004",2,"Basketball",257390,251012,6378,145754,144753,1001,111636,106259,5377,"14","12",50543,39817
"4039",168290,"WHEELOCK COLLEGE                                            ","2003-2004",6,"Field hocky",6375,0,6375,0,0,0,6375,13900,-7525,".","13",0,6000
"5749",107558,"UNIVERSITY OF THE OZARKS                                    ","2003-2004",8,"Golf",22475,16100,6375,22475,16100,6375,0,0,0,"9",".",2950,0
"6308",240268,"UNIVERSITY OF WISCONSIN-EAU CLAIRE                          ","2003-2004",9,"Gymnastics",33617,27246,6371,0,0,0,33617,27246,6371,".","15",0,7155
"5022",125462,"WEST HILLS COMMUNITY COLLEGE                                ","2003-2004",7,"Football",57595,51226,6369,57595,51226,6369,0,0,0,"66",".",13900,0
"15452",184694,"FAIRLEIGH DICKINSON UNIVERSITY-COLLEGE AT FLORHAM           ","2003-2004",39,"Total Participants",411535,405175,6360,165550,152162,13388,245985,253013,-7028,"223","139",187403,116780
"2245",147004,"MCHENRY COUNTY COLLEGE                                      ","2003-2004",2,"Basketball",59927,53576,6351,30226,27526,2700,29701,26050,3651,"16","12",9326,9272
"13131",211608,"CHEYNEY UNIVERSITY OF PENNSYLVANIA                          ","2003-2004",26,"Volleyball",15552,9205,6347,0,0,0,15552,9205,6347,".","8",0,8171
"13253",235097,"EASTERN WASHINGTON UNIVERSITY                               ","2003-2004",26,"Volleyball",337906,331559,6347,0,0,0,337906,331559,6347,".","18",0,101264
"7494",177250,"EAST CENTRAL COLLEGE                                        ","2003-2004",15,"Soccer",93000,86660,6340,93000,86660,6340,0,0,0,"21",".",33285,0
"17244",177250,"EAST CENTRAL COLLEGE                                        ","2003-2004",39,"Total Participants",145750,139410,6340,93000,86660,6340,52750,52750,0,"21","14",33285,13790
"17015",204185,"MOUNT UNION COLLEGE                                         ","2003-2004",39,"Total Participants",516317,509981,6336,289324,283681,5643,226993,226300,693,"475","215",271476,101024
"6080",230171,"DIXIE STATE COLLEGE OF UTAH                                 ","2003-2004",8,"Golf",47020,40689,6331,47020,40689,6331,0,0,0,"10",".",33015,0
"13026",219046,"BLACK HILLS STATE UNIVERSITY                                ","2003-2004",26,"Volleyball",105131,98811,6320,0,0,0,105131,98811,6320,".","14",0,30000
"6425",167729,"SALEM STATE COLLEGE                                         ","2003-2004",10,"Ice Hockey",67864,61546,6318,67864,61546,6318,0,0,0,"30","0",38106,0
"1837",198862,"LIVINGSTONE COLLEGE                                         ","2003-2004",2,"Basketball",483987,477672,6315,253534,248862,4672,230453,228810,1643,"15","17",36270,22049
"6161",117140,"UNIVERSITY OF LA VERNE                                      ","2003-2004",8,"Golf",54790,48480,6310,54790,48480,6310,0,0,0,"10",".",9923,0
"9190",176169,"NORTHEAST MISSISSIPPI COMMUNITY COLLEGE                     ","2003-2004",16,"Softball",70924,64614,6310,0,0,0,70924,64614,6310,".","17",0,12787
"13012",167996,"STONEHILL COLLEGE                                           ","2003-2004",26,"Volleyball",26731,20422,6309,0,0,0,26731,20422,6309,".","11",0,11308
"4483",221519,"SEWANEE-THE UNIVERSITY OF THE SOUTH                         ","2003-2004",7,"Football",326975,320668,6307,326975,320668,6307,0,0,0,"55",".",137693,0
"16222",166948,"MOUNT IDA COLLEGE                                           ","2003-2004",39,"Total Participants",269522,263222,6300,97983,90783,7200,171539,172439,-900,"138","86",162100,167061
"4426",175810,"HOLMES COMMUNITY COLLEGE                                    ","2003-2004",7,"Football",345628,339332,6296,345628,339332,6296,0,0,0,"65",".",138150,0
"6673",232609,"LYNCHBURG COLLEGE                                           ","2003-2004",11,"Lacrosse",133423,127128,6295,78553,72308,6245,54870,54820,50,"39","19",26582,14793
"4323",167899,"SPRINGFIELD COLLEGE                                         ","2003-2004",7,"Football",97681,91426,6255,97681,91426,6255,0,0,0,"168",".",42455,0
"8278",147341,"MONMOUTH COLLEGE                                            ","2003-2004",15,"Soccer",48110,41860,6250,24993,22240,2753,23117,19620,3497,"25","17",14897,13970
"7294",151801,"INDIANA WESLEYAN UNIVERSITY                                 ","2003-2004",15,"Soccer",87481,81233,6248,35233,30993,4240,52248,50240,2008,"24","24",17664,38304
"6959",236577,"SEATTLE PACIFIC UNIVERSITY                                  ","2003-2004",13,"Rowing",128843,122599,6244,43935,45951,-2016,84908,76648,8260,"16","25",15342,28495
"937",172264,"SIENA HEIGHTS UNIVERSITY                                    ","2003-2004",1,"Baseball",43379,37152,6227,43379,37152,6227,0,0,0,"38",".",16663,0
"2244",139861,"GEORGIA COLLEGE AND STATE UNIVERSITY                        ","2003-2004",2,"Basketball",321611,315388,6223,165059,158274,6785,156552,157114,-562,"19","15",49900,42330
"7225",185572,"MONMOUTH UNIVERSITY                                         ","2003-2004",15,"Soccer",528535,522312,6223,272370,266471,5899,256165,255841,324,"21","23",30908,34888
"6083",201371,"BLUFFTON COLLEGE                                            ","2003-2004",8,"Golf",19568,13347,6221,9352,9011,341,10216,4336,5880,"9","5",2410,2353
"6117",240055,"UNIVERSITY OF WISCONSIN COLLEGES                            ","2003-2004",8,"Golf",27517,21313,6204,26129,19135,6994,1388,2178,-790,"56","4",16315,1388
"15380",197221,"WEBB INSTITUTE                                              ","2003-2004",36,"Sailing",6200,0,6200,6200,6200,0,0,0,0,"8",".",3700,0
"4210",216278,"SUSQUEHANNA UNIVERSITY                                      ","2003-2004",6,"Field hocky",56539,50359,6180,0,0,0,56539,50359,6180,".","28",0,13453
"15415",180197,"FLATHEAD VALLEY COMMUNITY COLLEGE                           ","2003-2004",39,"Total Participants",40276,34097,6179,20238,20897,-659,20038,13200,6838,"17","17",14897,7200
"10674",131469,"GEORGE WASHINGTON UNIVERSITY                                ","2003-2004",22,"Tennis",328293,322117,6176,153442,154487,-1045,174851,167630,7221,"10","10",15800,12182
"12637",181446,"NEBRASKA WESLEYAN UNIVERSITY                                ","2003-2004",25,"Track and Field, X-Country",88023,81861,6162,49314,44562,4752,38709,37299,1410,"59","39",22703,15938
"4024",212054,"DREXEL UNIVERSITY                                           ","2003-2004",6,"Field hocky",403304,397143,6161,0,0,0,403304,397143,6161,".","22",0,38667
"13935",131469,"GEORGE WASHINGTON UNIVERSITY                                ","2003-2004",26,"Volleyball",661728,655567,6161,0,0,0,661728,655567,6161,".","14",0,56726
"4669",104708,"GLENDALE COMMUNITY COLLEGE                                  ","2003-2004",7,"Football",71692,65538,6154,71692,65538,6154,0,0,0,"85",".",13360,0
"9151",194222,"ONONDAGA COMMUNITY COLLEGE                                  ","2003-2004",16,"Softball",15603,9497,6106,0,0,0,15603,9497,6106,".","7",0,100
"748",212115,"EAST STROUDSBURG UNIVERSITY OF PENNSYLVANIA                 ","2003-2004",1,"Baseball",78170,72065,6105,78170,72065,6105,0,0,0,"24",".",13788,0
"7829",206941,"UNIVERSITY OF CENTRAL OKLAHOMA                              ","2003-2004",15,"Soccer",26396,20300,6096,0,0,0,26396,20300,6096,".","28",0,16900
"2574",167899,"SPRINGFIELD COLLEGE                                         ","2003-2004",2,"Basketball",63196,57106,6090,34405,30040,4365,28791,27066,1725,"28","26",21085,21785
"13756",178387,"MISSOURI WESTERN STATE COLLEGE                              ","2003-2004",26,"Volleyball",214597,208507,6090,0,0,0,214597,208507,6090,".","11",0,21631
"10816",134945,"JACKSONVILLE UNIVERSITY                                     ","2003-2004",22,"Tennis",249440,243353,6087,90585,89878,707,158855,153475,5380,"8","8",14969,11269
"6722",196130,"SUNY COLLEGE AT BUFFALO                                     ","2003-2004",11,"Lacrosse",73144,67069,6075,0,0,0,73144,67069,6075,".","15",0,15782
"1031",218441,"NORTH GREENVILLE COLLEGE                                    ","2003-2004",1,"Baseball",27679,21624,6055,27679,21624,6055,0,0,0,"31",".",19272,0
"9028",237330,"CONCORD COLLEGE                                             ","2003-2004",16,"Softball",53292,47247,6045,0,0,0,53292,47247,6045,".","14",0,6430
"10906",216764,"WEST CHESTER UNIVERSITY OF PENNSYLVANIA                     ","2003-2004",22,"Tennis",19171,13139,6032,8653,7629,1024,10518,5510,5008,"11","10",5085,4126
"7068",195216,"ST LAWRENCE UNIVERSITY                                      ","2003-2004",14,"Skiing",179596,173568,6028,89798,86784,3014,89798,86784,3014,"18","18",24409,24409
"870",184694,"FAIRLEIGH DICKINSON UNIVERSITY-COLLEGE AT FLORHAM           ","2003-2004",1,"Baseball",55939,49912,6027,55939,49912,6027,0,0,0,"29",".",25254,0
"4876",155201,"INDEPENDENCE COMMUNITY COLLEGE                              ","2003-2004",7,"Football",180255,174243,6012,180255,174243,6012,0,0,0,"55",".",58271,0
"2857",117274,"LASSEN COMMUNITY COLLEGE                                    ","2003-2004",2,"Basketball",126213,120204,6009,59448,56448,3000,66765,63756,3009,"24","23",16200,16200
"2491",121691,"UNIVERSITY OF REDLANDS                                      ","2003-2004",2,"Basketball",227350,221347,6003,155374,149991,5383,71976,71356,620,"21","14",69947,15040
"5002",154235,"SAINT AMBROSE UNIVERSITY                                    ","2003-2004",7,"Football",648166,642166,6000,648166,642166,6000,0,0,0,"131",".",65000,0
"10053",136516,"POLK COMMUNITY COLLEGE                                      ","2003-2004",16,"Softball",120597,114597,6000,0,0,0,120597,114597,6000,".","18",0,66024
"11379",193645,"THE COLLEGE OF NEW ROCHELLE                                 ","2003-2004",22,"Tennis",6000,0,6000,0,0,0,6000,11440,-5440,".","9",0,6940
"11874",168786,"AQUINAS COLLEGE                                             ","2003-2004",23,"Track and Field, Indoor",24000,18000,6000,12000,9000,3000,12000,9000,3000,"42","43",12012,11997
"12070",168786,"AQUINAS COLLEGE                                             ","2003-2004",24,"Track and Field, Outdoor",24000,18000,6000,12000,9000,3000,12000,9000,3000,"48","41",12000,12013
"12686",176318,"RUST COLLEGE                                                ","2003-2004",25,"Track and Field, X-Country",14288,8288,6000,7144,4144,3000,7144,4144,3000,"24","12",954,954
"15332",224891,"FRANK PHILLIPS COLLEGE                                      ","2003-2004",35,"Rodeo",180888,174888,6000,146408,143408,3000,34480,31480,3000,"29","6",22140,4860
"10984",217484,"UNIVERSITY OF RHODE ISLAND                                  ","2003-2004",22,"Tennis",94653,88674,5979,39688,36579,3109,54965,52095,2870,"14","15",11788,22609
"12540",141237,"1TT-MCCONNELL COLLEGE                                       ","2003-2004",25,"Track and Field, X-Country",38426,32448,5978,23256,20267,2989,15170,12181,2989,"8","1",4426,4071
"15904",141237,"1TT-MCCONNELL COLLEGE                                       ","2003-2004",39,"Total Participants",241743,235765,5978,182758,179769,2989,58985,55996,2989,"56","23",74822,35970
"8848",139630,"EMMANUEL COLLEGE                                            ","2003-2004",16,"Softball",86344,80368,5976,0,0,0,86344,80368,5976,".","13",0,21656
"10157",196866,"UNION COLLEGE                                               ","2003-2004",18,"Swimming and Diving",128642,122671,5971,64321,61410,2911,64321,61261,3060,"13","12",7760,7760
"1472",184612,"FELICIAN COLLEGE                                            ","2003-2004",1,"Baseball",273981,268020,5961,273981,268020,5961,0,0,0,"29",".",77581,0
"15488",214069,"COLLEGE MISERICORDIA                                        ","2003-2004",39,"Total Participants",143006,137045,5961,64567,61586,2981,78439,75459,2980,"191","208",25768,24493
"6612",212197,"ELIZABETHTOWN COLLEGE                                       ","2003-2004",11,"Lacrosse",76027,70073,5954,47294,43874,3420,28733,26199,2534,"33","20",16930,10131
"16042",150604,"FRANKLIN COLLEGE                                            ","2003-2004",39,"Total Participants",376818,370870,5948,224417,220912,3505,152401,149958,2443,"221","123",309912,138609
"493",217536,"SALVE REGINA UNIVERSITY                                     ","2003-2004",1,"Baseball",36505,30563,5942,36505,30563,5942,0,0,0,"25",".",22563,0
"17018",364016,"PARADISE VALLEY COMMUNITY COLLEGE                           ","2003-2004",39,"Total Participants",189927,183988,5939,45711,45186,525,144216,138802,5414,"75","76",23660,33795
"14961",216931,"WILKES UNIVERSITY                                           ","2003-2004",28,"Wrestling",54792,48854,5938,54792,48854,5938,0,0,0,"24",".",15551,0
"14810",152992,"BRIAR CLIFF UNIVERSITY                                      ","2003-2004",28,"Wrestling",117520,111595,5925,117520,111595,5925,0,0,0,"15",".",11234,0
"11701",198695,"HIGH POINT UNIVERSITY                                       ","2003-2004",22,"Tennis",282309,276387,5922,136144,125273,10871,146165,151114,-4949,"8","8",15303,14709
"16062",186131,"PRINCETON UNIVERSITY                                        ","2003-2004",39,"Total Participants",6606792,6600882,5910,3556199,3483511,72688,3050593,3117371,-66778,"679","417",1993098,1240854
"9923",217518,"ROGER WILLIAMS UNIVERSITY                                   ","2003-2004",16,"Softball",62413,56516,5897,0,0,0,62413,56516,5897,".","16",0,31939
"2175",167376,"NORTHERN ESSEX COMMUNITY COLLEGE                            ","2003-2004",2,"Basketball",28095,22200,5895,14350,11100,3250,13745,11100,2645,"15","9",5600,5600
"11188",128498,"ALBERTUS MAGNUS COLLEGE                                     ","2003-2004",22,"Tennis",8600,2735,5865,4900,1878,3022,3700,857,2843,"10","5",1880,855
"5101",240374,"UNIVERSITY OF WISCONSIN-PARKSIDE                            ","2003-2004",8,"Golf",65770,59922,5848,65770,59922,5848,0,0,0,"10",".",18623,0
"2206",217156,"BROWN UNIVERSITY                                            ","2003-2004",2,"Basketball",933644,927811,5833,521619,521619,0,412025,406192,5833,"12","18",154603,99491
"10063",191515,"HAMILTON COLLEGE                                            ","2003-2004",17,"Squash",65200,59369,5831,36182,33572,2610,29018,25797,3221,"17","18",10044,8478
"1248",213020,"INDIANA UNIVERSITY OF PENNSYLVANIA-MAIN CAMPUS              ","2003-2004",1,"Baseball",128867,123055,5812,128867,123055,5812,0,0,0,"31",".",47257,0
"13915",235750,"LOWER COLUMBIA COLLEGE                                      ","2003-2004",26,"Volleyball",19880,14068,5812,0,0,0,19880,14068,5812,".","11",0,5590
"12653",168546,"ALBION COLLEGE                                              ","2003-2004",25,"Track and Field, X-Country",59967,54164,5803,28094,25185,2909,31873,28979,2894,"19","28",11962,13009
"2795",107600,"PHILANDER SMITH COLLEGE                                     ","2003-2004",2,"Basketball",142585,136786,5799,89834,86885,2949,52751,49901,2850,"13","13",29576,18461
"4249",214175,"MUHLENBERG COLLEGE                                          ","2003-2004",6,"Field hocky",34791,28992,5799,0,0,0,34791,28992,5799,".","28",0,17058
"1021",218414,"NEWBERRY COLLEGE                                            ","2003-2004",1,"Baseball",55203,49405,5798,55203,49405,5798,0,0,0,"34",".",44608,0
"8078",236577,"SEATTLE PACIFIC UNIVERSITY                                  ","2003-2004",15,"Soccer",726055,720265,5790,459250,417843,41407,266805,302422,-35617,"24","26",83385,97064
"10280",153834,"LUTHER COLLEGE                                              ","2003-2004",18,"Swimming and Diving",51764,45975,5789,26428,22654,3774,25336,23321,2015,"16","19",11040,11918
"1673",173559,"MINNESOTA STATE COMM AND TECH COLLEGE-FERGUS FALLS          ","2003-2004",2,"Basketball",100054,94266,5788,54853,53162,1691,45201,41104,4097,"11","15",18760,19276
"13370",215929,"UNIVERSITY OF SCRANTON                                      ","2003-2004",26,"Volleyball",38791,33003,5788,0,0,0,38791,33003,5788,".","14",0,18164
"9059",225371,"HILL COLLEGE                                                ","2003-2004",16,"Softball",40167,34384,5783,0,0,0,40167,34384,5783,".","22",0,6778
"16252",237066,"WHITWORTH COLLEGE                                           ","2003-2004",39,"Total Participants",651074,645291,5783,302402,296826,5576,348672,348465,207,"237","147",294096,212507
"8221",213020,"INDIANA UNIVERSITY OF PENNSYLVANIA-MAIN CAMPUS              ","2003-2004",15,"Soccer",118730,112949,5781,0,0,0,118730,112949,5781,".","26",0,16734
"7648",219976,"DAVID LIPSCOMB UNIVERSITY                                   ","2003-2004",15,"Soccer",506386,500607,5779,261162,260202,960,245224,240405,4819,"24","25",77671,48562
"4423",206437,"WALSH UNIVERSITY                                            ","2003-2004",7,"Football",415659,409885,5774,415659,409885,5774,0,0,0,"96",".",225060,0
"14296",196079,"SUNY AT BINGHAMTON                                          ","2003-2004",26,"Volleyball",367154,361384,5770,0,0,0,367154,361384,5770,".","13",0,34441
"14283",131450,"GALLAUDET UNIVERSITY                                        ","2003-2004",26,"Volleyball",43457,37692,5765,0,0,0,43457,37692,5765,".","12",0,31492
"17212",180373,"MILES COMMUNITY COLLEGE                                     ","2003-2004",39,"Total Participants",249552,243789,5763,195795,195487,308,53757,48302,5455,"68","24",169616,72310
"13952",151263,"UNIVERSITY OF INDIANAPOLIS                                  ","2003-2004",26,"Volleyball",219903,214145,5758,0,0,0,219903,214145,5758,"0","17",0,40879
"12290",179265,"ST LOUIS COLLEGE OF PHARMACY                                ","2003-2004",25,"Track and Field, X-Country",11200,5460,5740,5600,2730,2870,5600,2730,2870,"4","10",2680,2680
"13386",210331,"WESTERN BAPTIST COLLEGE                                     ","2003-2004",26,"Volleyball",48644,42932,5712,0,0,0,48644,42932,5712,".","12",0,18519
"5462",144865,"COLLEGE OF DUPAGE                                           ","2003-2004",8,"Golf",18500,12800,5700,18500,12800,5700,0,0,0,"8","0",8500,0
"120",140234,"LAGRANGE COLLEGE                                            ","2003-2004",1,"Baseball",125970,120285,5685,125970,120285,5685,0,0,0,"40",".",54770,0
"6186",167394,"COLLEGE OF OUR LADY OF THE ELMS                             ","2003-2004",8,"Golf",12106,6422,5684,12106,6422,5684,0,0,0,"10",".",2122,0
"1251",235750,"LOWER COLUMBIA COLLEGE                                      ","2003-2004",1,"Baseball",48457,42777,5680,48457,42777,5680,0,0,0,"30",".",21060,0
"12317",147341,"MONMOUTH COLLEGE                                            ","2003-2004",25,"Track and Field, X-Country",31078,25402,5676,15539,12701,2838,15539,12701,2838,"7","11",6784,6784
"14606",146205,"JOHN A LOGAN COLLEGE                                        ","2003-2004",26,"Volleyball",39624,33957,5667,0,0,0,39624,33957,5667,"0","12",0,26913
"7426",179867,"WASHINGTON UNIVERSITY IN ST LOUIS                           ","2003-2004",15,"Soccer",198897,193252,5645,105624,101467,4157,93273,91785,1488,"28","31",37593,42648
"3562",204185,"MOUNT UNION COLLEGE                                         ","2003-2004",3,"All Track Combined",138820,133177,5643,87791,82148,5643,51029,51029,0,"90","98",31953,20353
"7537",140818,"PIEDMONT COLLEGE                                            ","2003-2004",15,"Soccer",95763,90129,5634,42872,40055,2817,52891,50074,2817,"24","13",12997,22660
"13291",207582,"ORAL ROBERTS UNIVERSITY                                     ","2003-2004",26,"Volleyball",467818,462186,5632,0,0,0,467818,462186,5632,".","12",0,98260
"11027",214041,"MILLERSVILLE UNIVERSITY OF PENNSYLVANIA                     ","2003-2004",22,"Tennis",57424,51796,5628,25712,22213,3499,31712,29583,2129,"9","11",4730,7094
"14782",153001,"BUENA VISTA UNIVERSITY                                      ","2003-2004",28,"Wrestling",79155,73531,5624,79155,73531,5624,0,0,0,"27",".",17850,0
"3450",164270,"MCDANIEL COLLEGE                                            ","2003-2004",2,"Basketball",129656,124036,5620,63696,62433,1263,65960,61603,4357,"14","16",25536,22503
"7422",146825,"MACMURRAY COLLEGE                                           ","2003-2004",15,"Soccer",68045,62434,5611,47088,42303,4785,20957,20131,826,"29","13",11422,7200
"6290",217165,"BRYANT COLLEGE                                              ","2003-2004",8,"Golf",61051,55444,5607,42070,40107,1963,18981,15337,3644,"12","9",27816,8289
"5290",224554,"TEXAS A &amp; M UNIVERSITY-COMMERCE                             ","2003-2004",8,"Golf",45600,40000,5600,18000,21000,-3000,27600,19000,8600,"7","5",15403,16605
"16878",240055,"UNIVERSITY OF WISCONSIN COLLEGES                            ","2003-2004",39,"Total Participants",143779,138188,5591,79907,73838,6069,63872,64350,-478,"309","227",134183,108194
"1092",112172,"CITRUS COLLEGE                                              ","2003-2004",1,"Baseball",40846,35258,5588,40846,35258,5588,0,0,0,"26",".",12223,0
"5950",210331,"WESTERN BAPTIST COLLEGE                                     ","2003-2004",8,"Golf",31105,25524,5581,31105,25524,5581,0,0,0,"9",".",1111,0
"6260",147916,"PARKLAND COLLEGE                                            ","2003-2004",8,"Golf",24800,19227,5573,24800,19227,5573,0,0,0,"10",".",10250,0
"7314",161086,"COLBY COLLEGE                                               ","2003-2004",15,"Soccer",44343,38770,5573,21574,19547,2027,22769,19223,3546,"21","21",18099,18463
"10686",133881,"FLORIDA INSTITUTE OF TECHNOLOGY-MELBOURNE                   ","2003-2004",22,"Tennis",160601,155029,5572,87900,100778,-12878,72701,54251,18450,"9","9",7596,7596
"590",120971,"PALOMAR COLLEGE                                             ","2003-2004",1,"Baseball",30359,24796,5563,30359,24796,5563,0,0,0,"27",".",17100,0
"5255",132657,"LYNN UNIVERSITY                                             ","2003-2004",8,"Golf",286291,280731,5560,156673,152263,4410,129618,128468,1150,"14","7",45763,28976
"3054",101435,"HUNTINGDON COLLEGE                                          ","2003-2004",2,"Basketball",262157,256616,5541,156825,156825,0,105332,99791,5541,"17","12",48088,39413
"7786",191302,"FULTON-MONTGOMERY COMMUNITY COLLEGE                         ","2003-2004",15,"Soccer",19386,13846,5540,12530,7210,5320,6856,6636,220,"21","11",4418,3968
"6006",236708,"SPOKANE FALLS COMMUNITY COLLEGE                             ","2003-2004",8,"Golf",48071,42535,5536,23489,20408,3081,24582,22127,2455,"5","6",18356,18075
"2306",176178,"NORTHWEST MISSISSIPPI COMMUNITY COLLEGE                     ","2003-2004",2,"Basketball",355249,349720,5529,187805,185040,2765,167444,164680,2764,"14","15",42559,37876
"4987",155098,"FORT SCOTT COMMUNITY COLLEGE                                ","2003-2004",7,"Football",334241,328714,5527,334241,328714,5527,0,0,0,"98",".",65681,0
"3339",154688,"BAKER UNIVERSITY COLLEGE OF ARTS AND SCIENCES               ","2003-2004",2,"Basketball",223276,217750,5526,121741,124092,-2351,101535,93658,7877,"13","15",27640,26838
"16643",176178,"NORTHWEST MISSISSIPPI COMMUNITY COLLEGE                     ","2003-2004",39,"Total Participants",363877,358354,5523,196140,192764,3376,167737,165590,2147,"120","53",198942,75962
"6800",167996,"STONEHILL COLLEGE                                           ","2003-2004",11,"Lacrosse",80903,75383,5520,0,0,0,80903,75383,5520,".","19",0,41103
"9297",210234,"TREASURE VALLEY COMMUNITY COLLEGE                           ","2003-2004",16,"Softball",30767,25252,5515,0,0,0,30767,25252,5515,".","16",0,25000
"13088",197133,"VASSAR COLLEGE                                              ","2003-2004",26,"Volleyball",103230,97721,5509,44590,44565,25,58640,53156,5484,"9","15",15810,24401
"17300",174738,"ROCHESTER COMMUNITY AND TECHNICAL COLLEGE                   ","2003-2004",39,"Total Participants",200165,194662,5503,92794,89180,3614,107371,105482,1889,"138","50",97439,80454
"9251",147828,"OLIVET NAZARENE UNIVERSITY                                  ","2003-2004",16,"Softball",160604,155102,5502,0,0,0,160604,155102,5502,".","18",0,26486
"2739",180984,"CONCORDIA UNIVERSITY                                        ","2003-2004",2,"Basketball",153952,148452,5500,74084,71334,2750,79868,77118,2750,"19","20",17993,18000
"14554",113236,"CYPRESS COLLEGE                                             ","2003-2004",26,"Volleyball",51317,45817,5500,0,0,0,51317,45817,5500,".","11",0,13599
"4661",229267,"TRINITY UNIVERSITY                                          ","2003-2004",7,"Football",318559,313068,5491,318559,313068,5491,0,0,0,"97",".",168589,0
"16941",154022,"THE FRANCISCAN UNIVERSITY                                   ","2003-2004",39,"Total Participants",73076,67589,5487,34663,30450,4213,38413,37139,1274,"82","73",36650,41000
"10304",133951,"FLORIDA INTERNATIONAL UNIVERSITY                            ","2003-2004",18,"Swimming and Diving",215927,210442,5485,0,0,0,215927,210442,5485,".","14",0,40230
"16199",237358,"DAVIS AND ELKINS COLLEGE                                    ","2003-2004",39,"Total Participants",238470,232995,5475,139225,135750,3475,99245,97245,2000,"71","66",71128,69605
"10461",196158,"SUNY COLLEGE AT FREDONIA                                    ","2003-2004",18,"Swimming and Diving",88826,83355,5471,42686,35462,7224,46140,47893,-1753,"7","14",11391,21207
"9450",104708,"GLENDALE COMMUNITY COLLEGE                                  ","2003-2004",16,"Softball",29542,24081,5461,0,0,0,29542,24081,5461,".","19",0,6335
"2288",198303,"CHOWAN COLLEGE                                              ","2003-2004",2,"Basketball",131026,125570,5456,85169,80488,4681,45857,45082,775,"24","13",29125,16767
"4791",218070,"FURMAN UNIVERSITY                                           ","2003-2004",7,"Football",3375463,3370007,5456,3375463,3370007,5456,0,0,0,"97",".",297959,0
"8202",198695,"HIGH POINT UNIVERSITY                                       ","2003-2004",15,"Soccer",523430,517982,5448,265916,264018,1898,257514,253964,3550,"27","23",30163,29103
"11168",102377,"TUSKEGEE UNIVERSITY                                         ","2003-2004",22,"Tennis",123594,118146,5448,71560,67284,4276,52034,50862,1172,"7","8",5821,6110
"2964",146825,"MACMURRAY COLLEGE                                           ","2003-2004",2,"Basketball",81013,75569,5444,42637,37763,4874,38376,37806,570,"32","23",13295,11987
"15417",133085,"CLEARWATER CHRISTIAN COLLEGE                                ","2003-2004",39,"Total Participants",82598,77168,5430,40105,35364,4741,42493,41804,689,"67","50",55581,60898
"1209",136206,"NORTHWOOD UNIVERSITY-FLORIDA EDUCATION CENTER               ","2003-2004",1,"Baseball",222718,217291,5427,222718,217291,5427,0,0,0,"46",".",38253,0
"5028",180416,"MONTANA TECH OF THE UNIVERSITY OF MONTANA                   ","2003-2004",7,"Football",533155,527728,5427,533155,527728,5427,0,0,0,"98",".",63434,0
"1100",154907,"CLOUD COUNTY COMMUNITY COLLEGE                              ","2003-2004",1,"Baseball",94325,88921,5404,94325,88921,5404,0,0,0,"32",".",416,0
"5107",229267,"TRINITY UNIVERSITY                                          ","2003-2004",8,"Golf",112134,106732,5402,56067,53366,2701,56067,53366,2701,"10","5",12467,12467
"197",198598,"GREENSBORO COLLEGE                                          ","2003-2004",1,"Baseball",90822,85424,5398,90822,85424,5398,0,0,0,"40",".",31048,0
"11140",139658,"EMORY UNIVERSITY                                            ","2003-2004",22,"Tennis",185776,180390,5386,91294,86298,4996,94482,94092,390,"14","11",24454,25198
"7793",212197,"ELIZABETHTOWN COLLEGE                                       ","2003-2004",15,"Soccer",89312,83929,5383,60707,56548,4159,28605,27381,1224,"36","33",12369,15581
"10508",220589,"LAMBUTH UNIVERSITY                                          ","2003-2004",19,"Swimming",13200,7817,5383,6850,3792,3058,6350,4025,2325,"4","6",2043,1458
"1979",153375,"GRAND VIEW COLLEGE                                          ","2003-2004",2,"Basketball",270554,265184,5370,136473,132963,3510,134081,132221,1860,"20","20",27761,20596
"8897",161086,"COLBY COLLEGE                                               ","2003-2004",16,"Softball",34236,28878,5358,0,0,0,34236,28878,5358,".","15",0,28365
"9804",190983,"ELMIRA COLLEGE                                              ","2003-2004",16,"Softball",66305,60957,5348,0,0,0,66305,60957,5348,".","15",0,24852
"10818",161086,"COLBY COLLEGE                                               ","2003-2004",22,"Tennis",48134,42799,5335,22651,19626,3025,25483,23173,2310,"11","12",19511,22902
"2423",107558,"UNIVERSITY OF THE OZARKS                                    ","2003-2004",2,"Basketball",130330,125000,5330,74965,70000,4965,55365,55000,365,"22","19",23500,25500
"3397",161086,"COLBY COLLEGE                                               ","2003-2004",2,"Basketball",81430,76114,5316,36818,38725,-1907,44612,37389,7223,"17","14",27858,35330
"7834",210234,"TREASURE VALLEY COMMUNITY COLLEGE                           ","2003-2004",15,"Soccer",58565,53264,5301,29126,26427,2699,29439,26837,2602,"29","23",16000,16000
"3836",101693,"UNIVERSITY OF MOBILE                                        ","2003-2004",3,"All Track Combined",85767,80469,5298,58794,56145,2649,26973,24324,2649,"6","1",3515,2997
"7238",225371,"HILL COLLEGE                                                ","2003-2004",15,"Soccer",29118,23833,5285,0,0,0,29118,23833,5285,"0","15",0,5285
"13411",155210,"JOHNSON COUNTY COMMUNITY COLLEGE                            ","2003-2004",26,"Volleyball",80199,74915,5284,0,0,0,80199,74915,5284,".","10",0,17852
"5811",147828,"OLIVET NAZARENE UNIVERSITY                                  ","2003-2004",8,"Golf",20160,14881,5279,20160,14881,5279,0,0,0,"8",".",6300,0
"7684",191515,"HAMILTON COLLEGE                                            ","2003-2004",15,"Soccer",98126,92849,5277,49506,47209,2297,48620,45640,2980,"39","27",18507,17558
"4",149781,"WHEATON COLLEGE                                             ","2003-2004",1,"Baseball",74946,69673,5273,74946,69673,5273,0,0,0,"17",".",26779,0
"1680",174738,"ROCHESTER COMMUNITY AND TECHNICAL COLLEGE                   ","2003-2004",2,"Basketball",64903,59653,5250,33634,30439,3195,31269,29214,2055,"15","12",14597,14597
"11458",111948,"CHAPMAN UNIVERSITY                                          ","2003-2004",22,"Tennis",26150,20900,5250,12750,10000,2750,13400,10900,2500,"9","10",6000,6000
"11144",160977,"BATES COLLEGE                                               ","2003-2004",22,"Tennis",78484,73241,5243,43077,39234,3843,35407,34007,1400,"10","11",14887,9660
"13274",218821,"SPARTANBURG METHODIST COLLEGE                               ","2003-2004",26,"Volleyball",54796,49553,5243,0,0,0,54796,49553,5243,".","15",0,20835
"8454",213367,"LA SALLE UNIVERSITY                                         ","2003-2004",15,"Soccer",718557,713316,5241,344135,340678,3457,374422,372638,1784,"21","20",45472,46692
"7809",162779,"HOWARD COMMUNITY COLLEGE                                    ","2003-2004",15,"Soccer",28676,23447,5229,16496,11374,5122,12180,12073,107,"21","15",9334,10033
"17211",168430,"WORCESTER STATE COLLEGE                                     ","2003-2004",39,"Total Participants",324278,319053,5225,198947,185147,13800,125331,133906,-8575,"231","152",240169,166632
"16037",140234,"LAGRANGE COLLEGE                                            ","2003-2004",39,"Total Participants",395888,390670,5218,217945,213571,4374,177943,177099,844,"105","81",140845,129405
"902",123217,"COLLEGE OF THE SEQUOIAS                                     ","2003-2004",1,"Baseball",26812,21600,5212,26812,21600,5212,0,0,0,"21",".",8550,0
"16457",123217,"COLLEGE OF THE SEQUOIAS                                     ","2003-2004",39,"Total Participants",194796,189584,5212,70179,64967,5212,124617,124617,0,"169","122",43080,50115
"10591",216524,"URSINUS COLLEGE                                             ","2003-2004",19,"Swimming",35065,29858,5207,17535,15261,2274,17530,14597,2933,"9","20",11935,11930
"9312",210331,"WESTERN BAPTIST COLLEGE                                     ","2003-2004",16,"Softball",51835,46632,5203,0,0,0,51835,46632,5203,".","15",0,22219
"7473",148380,"ROCK VALLEY COLLEGE                                         ","2003-2004",15,"Soccer",18000,12798,5202,9000,8056,944,9000,4742,4258,"24","11",4028,2371
"15840",102377,"TUSKEGEE UNIVERSITY                                         ","2003-2004",39,"Total Participants",586411,581209,5202,280563,275043,5520,305848,306166,-318,"177","74",258859,84359
"9391",224891,"FRANK PHILLIPS COLLEGE                                      ","2003-2004",16,"Softball",92875,87675,5200,0,0,0,92875,87675,5200,".","10",0,38600
"10772",137546,"STETSON UNIVERSITY                                          ","2003-2004",22,"Tennis",420162,414977,5185,183050,182725,325,237112,232252,4860,"12","15",19426,24182
"1305",219833,"CHRISTIAN BROTHERS UNIVERSITY                               ","2003-2004",1,"Baseball",25800,20619,5181,25800,20619,5181,0,0,0,"41",".",18919,0
"3243",146427,"KNOX COLLEGE                                                ","2003-2004",2,"Basketball",89563,84391,5172,55233,52316,2917,34330,32075,2255,"25","13",16181,13758
"228",141185,"TOCCOA FALLS COLLEGE                                        ","2003-2004",1,"Baseball",20871,15701,5170,20871,15701,5170,0,0,0,"15",".",7896,0
"15386",243106,"UNIVERSITY OF PUERTO RICO-AGUADILLA                         ","2003-2004",37,"Table Tennis",6990,1824,5166,3495,912,2583,3495,912,2583,"5","5",573,573
"3446",234845,"CENTRALIA COLLEGE                                           ","2003-2004",2,"Basketball",69971,64806,5165,33159,32961,198,36812,31845,4967,"13","9",23995,21972
"7088",132657,"LYNN UNIVERSITY                                             ","2003-2004",15,"Soccer",660480,655320,5160,325550,321980,3570,334930,333340,1590,"18","20",41630,39097
"12031",366711,"CALIFORNIA STATE UNIVERSITY-SAN MARCOS                      ","2003-2004",24,"Track and Field, Outdoor",67798,62640,5158,33899,31320,2579,33899,31320,2579,"24","16",9486,9486
"14007",197221,"WEBB INSTITUTE                                              ","2003-2004",26,"Volleyball",5150,0,5150,5150,5150,0,0,0,0,"16",".",2650,0
"1844",187134,"THE COLLEGE OF NEW JERSEY                                   ","2003-2004",2,"Basketball",200390,195255,5135,94649,91536,3113,105741,103719,2022,"16","16",23837,19165
"6254",164562,"ASSUMPTION COLLEGE                                          ","2003-2004",8,"Golf",15024,9900,5124,15024,9900,5124,0,0,0,"12",".",3900,0
"13963",196112,"SUNY INSTITUTE OF TECHNOLOGY AT UTICA-ROME                  ","2003-2004",26,"Volleyball",32689,27569,5120,0,0,0,32689,27569,5120,".","9",0,5364
"3266",171456,"NORTHERN MICHIGAN UNIVERSITY                                ","2003-2004",2,"Basketball",989040,983925,5115,486567,476123,10444,502473,507802,-5329,"15","10",66423,59704
"34",197911,"BARTON COLLEGE                                              ","2003-2004",1,"Baseball",120932,115829,5103,120932,115829,5103,0,0,0,"36",".",29314,0
"10907",230959,"MIDDLEBURY COLLEGE                                          ","2003-2004",22,"Tennis",133119,128021,5098,75270,72559,2711,57849,55462,2387,"14","12",18685,14712
"15850",230913,"JOHNSON STATE COLLEGE                                       ","2003-2004",39,"Total Participants",73637,68554,5083,30878,30458,420,42759,38096,4663,"61","58",40872,50878
"11013",153834,"LUTHER COLLEGE                                              ","2003-2004",22,"Tennis",46615,41537,5078,18924,17298,1626,27691,24239,3452,"22","21",10770,11181
"6140",191515,"HAMILTON COLLEGE                                            ","2003-2004",8,"Golf",27237,22162,5075,27237,22162,5075,0,0,0,"13",".",8619,0
"8775",232609,"LYNCHBURG COLLEGE                                           ","2003-2004",16,"Softball",70903,65828,5075,0,0,0,70903,65828,5075,".","17",0,23939
"6408",174817,"SAINT MARY'S UNIVERSITY OF MINNESOTA                        ","2003-2004",10,"Ice Hockey",205870,200803,5067,124155,123491,664,81715,77312,4403,"49","25",43851,27841
"9078",122889,"SANTA BARBARA CITY COLLEGE                                  ","2003-2004",16,"Softball",45356,40289,5067,0,0,0,45356,40289,5067,".","14",0,14394
"12443",153834,"LUTHER COLLEGE                                              ","2003-2004",25,"Track and Field, X-Country",134885,129831,5054,69187,67203,1984,65698,62628,3070,"61","49",29982,27547
"1913",110246,"BUTTE COLLEGE                                               ","2003-2004",2,"Basketball",78766,73715,5051,39842,39475,367,38924,34240,4684,"13","15",32956,26957
"13294",162584,"FROSTBURG STATE UNIVERSITY                                  ","2003-2004",26,"Volleyball",148462,143412,5050,0,0,0,148462,143412,5050,".","11",0,23950
"9456",240189,"UNIVERSITY OF WISCONSIN-WHITEWATER                          ","2003-2004",16,"Softball",63424,58378,5046,0,0,0,63424,58378,5046,".","22",0,29972
"11245",137847,"THE UNIVERSITY OF TAMPA                                     ","2003-2004",22,"Tennis",51444,46399,5045,0,0,0,51444,46399,5045,".","8",0,16791
"15436",187134,"THE COLLEGE OF NEW JERSEY                                   ","2003-2004",39,"Total Participants",998631,993591,5040,477844,476286,1558,520787,517305,3482,"314","232",196126,141136
"1441",232423,"JAMES MADISON UNIVERSITY                                    ","2003-2004",1,"Baseball",466850,461811,5039,466850,461811,5039,0,0,0,"34",".",81285,0
"5775",117946,"LOYOLA MARYMOUNT UNIVERSITY                                 ","2003-2004",8,"Golf",220411,215372,5039,220411,215372,5039,0,0,0,"9",".",48592,0
"8301",101693,"UNIVERSITY OF MOBILE                                        ","2003-2004",15,"Soccer",593850,588813,5037,352152,349407,2745,241698,239406,2292,"19","17",66181,30906
"3656",168263,"WESTFIELD STATE COLLEGE                                     ","2003-2004",3,"All Track Combined",47220,42193,5027,26082,25586,496,21138,16607,4531,"59","45",16395,8124
"6948",123554,"SAINT MARYS COLLEGE OF CALIFORNIA                           ","2003-2004",13,"Rowing",102760,97735,5025,0,0,0,102760,97735,5025,".","17",0,31495
"241",207069,"REDLANDS COMMUNITY COLLEGE                                  ","2003-2004",1,"Baseball",59618,54595,5023,59618,54595,5023,0,0,0,"39",".",20130,0
"6965",111188,"CALIFORNIA MARITIME ACADEMY                                 ","2003-2004",13,"Rowing",36000,30999,5001,30000,25833,4167,6000,5166,834,"20","4",15833,3164
"1375",243115,"UNIVERSITY OF PUERTO RICO-ARECIBO                           ","2003-2004",1,"Baseball",24218,19218,5000,24218,19218,5000,0,0,0,"18",".",6588,0
"1949",168786,"AQUINAS COLLEGE                                             ","2003-2004",2,"Basketball",77000,72000,5000,45000,40000,5000,32000,32000,0,"15","15",27000,27000
"3619",212656,"GENEVA COLLEGE                                              ","2003-2004",3,"All Track Combined",250515,245515,5000,157624,155124,2500,92891,90391,2500,"35","32",12644,12644
"5057",111920,"CHABOT COLLEGE                                              ","2003-2004",7,"Football",13600,8600,5000,13600,8600,5000,0,0,0,"66",".",18480,0
"5169",153250,"DORDT COLLEGE                                               ","2003-2004",8,"Golf",23495,18495,5000,23495,18495,5000,0,0,0,"12",".",2851,0
"7656",243115,"UNIVERSITY OF PUERTO RICO-ARECIBO                           ","2003-2004",15,"Soccer",14864,9864,5000,14864,9864,5000,0,0,0,"12",".",2544,0
"8594",183655,"ATLANTIC CAPE COMMUNITY COLLEGE                             ","2003-2004",16,"Softball",10000,5000,5000,0,0,0,10000,5000,5000,".","21",0,4000
"8602",364025,"CHANDLER/GILBERT COMMUNITY COLLEGE                          ","2003-2004",16,"Softball",33862,28862,5000,0,0,0,33862,28862,5000,".","16",0,14112
"8750",121363,"PORTERVILLE COLLEGE                                         ","2003-2004",16,"Softball",25000,20000,5000,0,0,0,25000,20000,5000,".","14",0,1785
"9600",243115,"UNIVERSITY OF PUERTO RICO-ARECIBO                           ","2003-2004",16,"Softball",13640,8640,5000,0,0,0,13640,8640,5000,".","11",0,990
"10656",150145,"BETHEL COLLEGE                                              ","2003-2004",22,"Tennis",21000,16000,5000,11500,8000,3500,9500,8000,1500,"9","8",7500,7500
"12961",182980,"NEW ENGLAND COLLEGE                                         ","2003-2004",25,"Track and Field, X-Country",14280,9280,5000,7320,7320,0,6960,1960,5000,"10","6",1989,1728
"14894",243115,"UNIVERSITY OF PUERTO RICO-ARECIBO                           ","2003-2004",28,"Wrestling",7553,2553,5000,7553,2553,5000,0,0,0,"7","0",483,0
"15926",117867,"LOS ANGELES MISSION COLLEGE                                 ","2003-2004",39,"Total Participants",246000,241000,5000,127000,123700,3300,119000,117300,1700,"52","35",46104,35000
"7416",107877,"WILLIAMS BAPTIST COLLEGE                                    ","2003-2004",15,"Soccer",73894,68896,4998,73894,68896,4998,0,0,0,"20",".",17478,0
"9293",439145,"PIERCE COLLEGE AT PUYALLUP                                  ","2003-2004",16,"Softball",32710,27717,4993,0,0,0,32710,27717,4993,".","13",0,7063
"12707",153001,"BUENA VISTA UNIVERSITY                                      ","2003-2004",25,"Track and Field, X-Country",112174,107183,4991,56485,53994,2491,55689,53189,2500,"23","24",13337,13337
"6574",183239,"SAINT ANSELM COLLEGE                                        ","2003-2004",11,"Lacrosse",64058,59069,4989,34937,33138,1799,29121,25931,3190,"27","16",21574,16220
"674",146366,"KASKASKIA COLLEGE                                           ","2003-2004",1,"Baseball",100831,95846,4985,100831,95846,4985,0,0,0,"26",".",45087,0
"5331",140951,"SAVANNAH COLLEGE OF ART AND DESIGN                          ","2003-2004",8,"Golf",194856,189875,4981,115331,111733,3598,79525,78142,1383,"8","8",26553,30034
"30",191241,"FORDHAM UNIVERSITY                                          ","2003-2004",1,"Baseball",472790,467815,4975,472790,467815,4975,0,0,0,"30",".",142205,0
"1669",170082,"GRAND VALLEY STATE UNIVERSITY                               ","2003-2004",2,"Basketball",785317,780351,4966,368199,375604,-7405,417118,404747,12371,"20","13",47048,60186
"13802",170620,"LAKE MICHIGAN COLLEGE                                       ","2003-2004",26,"Volleyball",29839,24889,4950,0,0,0,29839,24889,4950,".","11",0,7706
"1265",138558,"ABRAHAM BALDWIN AGRICULTURAL COLLEGE                        ","2003-2004",1,"Baseball",77546,72601,4945,77546,72601,4945,0,0,0,"25",".",58581,0
"6748",186876,"THE RICHARD STOCKTON COLLEGE OF NEW JERSEY                  ","2003-2004",11,"Lacrosse",39816,34871,4945,39816,34871,4945,0,0,0,"23",".",18794,0
"4245",150455,"EARLHAM COLLEGE                                             ","2003-2004",6,"Field hocky",59975,55032,4943,0,0,0,59975,55032,4943,".","17",0,8036
"13333",177995,"LONGVIEW COMMUNITY COLLEGE                                  ","2003-2004",26,"Volleyball",55830,50887,4943,0,0,0,55830,50887,4943,"0","10",0,21270
"14427",137032,"SAINT LEO UNIVERSITY                                        ","2003-2004",26,"Volleyball",82419,77484,4935,0,0,0,82419,77484,4935,".","13",0,22780
"14825",217518,"ROGER WILLIAMS UNIVERSITY                                   ","2003-2004",28,"Wrestling",114705,109777,4928,114705,109777,4928,0,0,0,"33",".",71577,0
"4312",165024,"BRIDGEWATER STATE COLLEGE                                   ","2003-2004",7,"Football",38350,33430,4920,38350,33430,4920,0,0,0,"74",".",30410,0
"4968",161086,"COLBY COLLEGE                                               ","2003-2004",7,"Football",74748,69838,4910,74748,69838,4910,0,0,0,"75",".",50071,0
"12395",243133,"UNIVERSITY OF PUERTO RICO-BAYAMON                           ","2003-2004",25,"Track and Field, X-Country",60000,55096,4904,30000,27548,2452,30000,27548,2452,"26","14",2467,2467
"9701",144944,"ELGIN COMMUNITY COLLEGE                                     ","2003-2004",16,"Softball",19200,14300,4900,0,0,0,19200,14300,4900,".","15",0,11000
"12881",155210,"JOHNSON COUNTY COMMUNITY COLLEGE                            ","2003-2004",25,"Track and Field, X-Country",225168,220268,4900,114632,112182,2450,110536,108086,2450,"64","39",29663,30331
"3907",232609,"LYNCHBURG COLLEGE                                           ","2003-2004",3,"All Track Combined",136459,131561,4898,71018,68178,2840,65441,63383,2058,"79","54",25638,20927
"9803",201645,"CASE WESTERN RESERVE UNIVERSITY                             ","2003-2004",16,"Softball",76118,71221,4897,0,0,0,76118,71221,4897,".","14",0,44812
"11309",163912,"ST MARY'S COLLEGE OF MARYLAND                               ","2003-2004",22,"Tennis",25886,21000,4886,12943,10500,2443,12943,10500,2443,"12","12",3550,3550
"8877",154907,"CLOUD COUNTY COMMUNITY COLLEGE                              ","2003-2004",16,"Softball",68055,63170,4885,0,0,0,68055,63170,4885,".","16",0,469
"15257",140951,"SAVANNAH COLLEGE OF ART AND DESIGN                          ","2003-2004",34,"Equestrian",1282716,1277833,4883,0,0,0,1282716,1277833,4883,".","30",0,228270
"17357",204857,"OHIO UNIVERSITY-MAIN CAMPUS                                 ","2003-2004",39,"Total Participants",4015334,4010453,4881,1145821,1144066,1755,2869513,2866387,3126,"335","253",635288,465286
"3699",186876,"THE RICHARD STOCKTON COLLEGE OF NEW JERSEY                  ","2003-2004",3,"All Track Combined",139624,134747,4877,86052,78786,7266,53572,55961,-2389,"56","45",19334,19334
"4198",183239,"SAINT ANSELM COLLEGE                                        ","2003-2004",6,"Field hocky",27755,22882,4873,0,0,0,27755,22882,4873,".","23",0,14782
"6686",162779,"HOWARD COMMUNITY COLLEGE                                    ","2003-2004",11,"Lacrosse",19147,14278,4869,19147,14278,4869,0,0,0,"22",".",10248,0
"12036",120342,"ORANGE COAST COLLEGE                                        ","2003-2004",24,"Track and Field, Outdoor",67676,62810,4866,33838,31405,2433,33838,31405,2433,"37","27",27808,27808
"15269",184348,"DREW UNIVERSITY                                             ","2003-2004",34,"Equestrian",18506,13647,4859,0,0,0,18506,13647,4859,".","12",0,7755
"8114",134079,"FLORIDA SOUTHERN COLLEGE                                    ","2003-2004",15,"Soccer",197022,192173,4849,105691,104672,1019,91331,87501,3830,"27","22",18753,18096
"11363",179326,"SOUTHWEST BAPTIST UNIVERSITY                                ","2003-2004",22,"Tennis",224431,219599,4832,116659,112213,4446,107772,107386,386,"11","11",22196,14305
"10065",215062,"UNIVERSITY OF PENNSYLVANIA                                  ","2003-2004",17,"Squash",108826,104004,4822,0,0,0,108826,104004,4822,".","18",0,48520
"8914",196112,"SUNY INSTITUTE OF TECHNOLOGY AT UTICA-ROME                  ","2003-2004",16,"Softball",49318,44498,4820,0,0,0,49318,44498,4820,".","14",0,11816
"10868",213020,"INDIANA UNIVERSITY OF PENNSYLVANIA-MAIN CAMPUS              ","2003-2004",22,"Tennis",52987,48169,4818,0,0,0,52987,48169,4818,".","10",0,5606
"10274",149781,"WHEATON COLLEGE                                             ","2003-2004",18,"Swimming and Diving",76072,71256,4816,38036,35628,2408,38036,35628,2408,"19","26",12041,12041
"4740",167260,"NICHOLS COLLEGE                                             ","2003-2004",7,"Football",92514,87701,4813,92514,87701,4813,0,0,0,"83",".",64701,0
"12516",175980,"MILLSAPS COLLEGE                                            ","2003-2004",25,"Track and Field, X-Country",11312,6500,4812,5656,3250,2406,5656,3250,2406,"5","9",2250,2250
"1298",219824,"CHATTANOOGA STATE TECHNICAL COMMUNITY COLLEGE               ","2003-2004",1,"Baseball",66786,61980,4806,66786,61980,4806,0,0,0,"26",".",12443,0
"9467",152992,"BRIAR CLIFF UNIVERSITY                                      ","2003-2004",16,"Softball",169949,165147,4802,0,0,0,169949,165147,4802,".","21",0,25004
"339",111948,"CHAPMAN UNIVERSITY                                          ","2003-2004",1,"Baseball",70400,65600,4800,70400,65600,4800,0,0,0,"30",".",22500,0
"10948",150756,"HANOVER COLLEGE                                             ","2003-2004",22,"Tennis",44314,39515,4799,19013,16294,2719,25301,23221,2080,"11","7",6634,6150
"4918",155812,"UNIVERSITY OF SAINT MARY                                    ","2003-2004",7,"Football",66696,61898,4798,66696,61898,4798,0,0,0,"51",".",35980,0
"7448",173647,"GUSTAVUS ADOLPHUS COLLEGE                                   ","2003-2004",15,"Soccer",221015,216221,4794,112505,107718,4787,108510,108503,7,"38","35",20643,13433
"5991",233277,"RADFORD UNIVERSITY                                          ","2003-2004",8,"Golf",106346,101558,4788,62616,42755,19861,43730,58803,-15073,"11","8",15654,14959
"10859",239716,"SAINT NORBERT COLLEGE                                       ","2003-2004",22,"Tennis",21847,17063,4784,10646,9502,1144,11201,7561,3640,"12","10",3237,3971
"13384",128498,"ALBERTUS MAGNUS COLLEGE                                     ","2003-2004",26,"Volleyball",9400,4621,4779,0,0,0,9400,4621,4779,".","8",0,4624
"3452",237136,"APPALACHIAN BIBLE COLLEGE                                   ","2003-2004",2,"Basketball",36538,31763,4775,20223,16988,3235,16315,14775,1540,"13","11",12035,11025
"3087",154013,"MOUNT MERCY COLLEGE                                         ","2003-2004",2,"Basketball",43472,38700,4772,22341,19350,2991,21131,19350,1781,"20","11",17415,17415
"4388",102377,"TUSKEGEE UNIVERSITY                                         ","2003-2004",7,"Football",1792295,1787523,4772,1792295,1787523,4772,0,0,0,"111",".",187136,0
"1095",155681,"PITTSBURG STATE UNIVERSITY                                  ","2003-2004",1,"Baseball",149300,144531,4769,149300,144531,4769,0,0,0,"39",".",35587,0
"4822",144971,"EUREKA COLLEGE                                              ","2003-2004",7,"Football",88882,84115,4767,88882,84115,4767,0,0,0,"61",".",29354,0
"10246",120342,"ORANGE COAST COLLEGE                                        ","2003-2004",18,"Swimming and Diving",43378,38614,4764,14717,12335,2382,28661,26279,2382,"12","14",10894,24838
"9094",143215,"SOUTHWESTERN ILLINOIS COLLEGE                               ","2003-2004",16,"Softball",78350,73591,4759,0,0,0,78350,73591,4759,".","20",0,10051
"4873",230995,"NORWICH UNIVERSITY                                          ","2003-2004",7,"Football",287059,282302,4757,287059,282302,4757,0,0,0,"114",".",68581,0
"8527",151801,"INDIANA WESLEYAN UNIVERSITY                                 ","2003-2004",16,"Softball",34065,29322,4743,0,0,0,34065,29322,4743,".","19",0,20026
"4477",184694,"FAIRLEIGH DICKINSON UNIVERSITY-COLLEGE AT FLORHAM           ","2003-2004",7,"Football",193036,188299,4737,193036,188299,4737,0,0,0,"87",".",90794,0
"3259",164739,"BENTLEY COLLEGE                                             ","2003-2004",2,"Basketball",1140810,1136080,4730,526149,522928,3221,614661,613152,1509,"13","13",54067,79985
"7354",146481,"LAKE FOREST COLLEGE                                         ","2003-2004",15,"Soccer",52124,47398,4726,20451,20451,0,31673,26947,4726,"25","22",9801,9097
"413",170620,"LAKE MICHIGAN COLLEGE                                       ","2003-2004",1,"Baseball",43736,39012,4724,43736,39012,4724,0,0,0,"22",".",16561,0
"2333",217624,"ALLEN UNIVERSITY                                            ","2003-2004",2,"Basketball",329441,324724,4717,167547,165062,2485,161894,159662,2232,"15","10",50887,50888
"3006",213668,"LYCOMING COLLEGE                                            ","2003-2004",2,"Basketball",148113,143396,4717,92421,89114,3307,55692,54282,1410,"15","15",31265,22518
"11290",155335,"NEWMAN UNIVERSITY                                           ","2003-2004",22,"Tennis",47966,43250,4716,25553,21625,3928,22413,21625,788,"4","5",11625,11625
"2975",211477,"CENTRAL PENNSYLVANIA COLLEGE                                ","2003-2004",2,"Basketball",23400,18687,4713,11700,5747,5953,11700,12940,-1240,"12","7",1047,9140
"12409",164173,"VILLA JULIE COLLEGE                                         ","2003-2004",25,"Track and Field, X-Country",11914,7201,4713,6507,3596,2911,5407,3605,1802,"3","7",940,983
"6812",198598,"GREENSBORO COLLEGE                                          ","2003-2004",11,"Lacrosse",115161,110452,4709,69263,67479,1784,45898,42973,2925,"34","17",26649,12097
"1827",157216,"LINDSEY WILSON COLLEGE                                      ","2003-2004",2,"Basketball",522726,518022,4704,299246,295846,3400,223480,222176,1304,"13","13",36718,22792
"555",148007,"PRAIRIE STATE COLLEGE                                       ","2003-2004",1,"Baseball",28500,23800,4700,28500,23800,4700,0,0,0,"25",".",21700,0
"14699",111948,"CHAPMAN UNIVERSITY                                          ","2003-2004",27,"Water Polo",26700,22000,4700,13200,12000,1200,13500,10000,3500,"8","16",9500,9500
"7921",216694,"WAYNESBURG COLLEGE                                          ","2003-2004",15,"Soccer",73321,68626,4695,36498,34048,2450,36823,34578,2245,"18","14",26680,30411
"10498",213349,"KUTZTOWN UNIVERSITY OF PENNSYLVANIA                         ","2003-2004",19,"Swimming",181051,176356,4695,88002,85596,2406,93049,90760,2289,"15","29",20853,19392
"4148",217536,"SALVE REGINA UNIVERSITY                                     ","2003-2004",6,"Field hocky",20525,15840,4685,0,0,0,20525,15840,4685,".","21",0,7590
"14218",439145,"PIERCE COLLEGE AT PUYALLUP                                  ","2003-2004",26,"Volleyball",28879,24198,4681,0,0,0,28879,24198,4681,".","7",0,8324
"2766",212656,"GENEVA COLLEGE                                              ","2003-2004",2,"Basketball",470258,465579,4679,279466,277434,2032,190792,188145,2647,"16","13",54909,31868
"8255",108807,"ALLAN HANCOCK COLLEGE                                       ","2003-2004",15,"Soccer",37352,32677,4675,20228,19677,551,17124,13000,4124,"22","17",8970,7328
"10854",220589,"LAMBUTH UNIVERSITY                                          ","2003-2004",22,"Tennis",43512,38846,4666,18655,16468,2187,24857,22378,2479,"7","7",2194,4094
"7439",232609,"LYNCHBURG COLLEGE                                           ","2003-2004",15,"Soccer",143527,138862,4665,63317,61897,1420,80210,76965,3245,"28","28",23015,26076
"12878",230959,"MIDDLEBURY COLLEGE                                          ","2003-2004",25,"Track and Field, X-Country",82707,78044,4663,40761,38627,2134,41946,39417,2529,"25","29",7671,8461
"103",245953,"MID-AMERICA CHRISTIAN UNIVERSITY                            ","2003-2004",1,"Baseball",45846,41187,4659,45846,41187,4659,0,0,0,"33",".",12987,0
"13305",150756,"HANOVER COLLEGE                                             ","2003-2004",26,"Volleyball",72344,67687,4657,0,0,0,72344,67687,4657,".","11",0,24504
"1902",161767,"ANNE ARUNDEL COMMUNITY COLLEGE                              ","2003-2004",2,"Basketball",22081,17438,4643,11298,10013,1285,10783,7425,3358,"11","6",5900,5400
"15304",236887,"WALLA WALLA COMMUNITY COLLEGE                               ","2003-2004",35,"Rodeo",87007,82367,4640,76449,68365,8084,10558,14002,-3444,"25","5",52615,6252
"11686",153162,"CORNELL COLLEGE                                             ","2003-2004",22,"Tennis",33489,28852,4637,8845,8845,0,24644,20007,4637,"10","9",3247,13027
"2328",191719,"HUDSON VALLEY COMMUNITY COLLEGE                             ","2003-2004",2,"Basketball",74596,69960,4636,24564,22587,1977,50032,47373,2659,"11","7",13662,15169
"14503",217536,"SALVE REGINA UNIVERSITY                                     ","2003-2004",26,"Volleyball",21111,16486,4625,0,0,0,21111,16486,4625,".","10",0,10486
"14176",134608,"INDIAN RIVER COMMUNITY COLLEGE                              ","2003-2004",26,"Volleyball",58754,54146,4608,0,0,0,58754,54146,4608,".","12",0,4608
"14317",172051,"SAGINAW VALLEY STATE UNIVERSITY                             ","2003-2004",26,"Volleyball",70830,66225,4605,0,0,0,70830,66225,4605,".","12",0,24907
"4385",112190,"CITY COLLEGE OF SAN FRANCISCO                               ","2003-2004",7,"Football",92443,87840,4603,92443,87840,4603,0,0,0,"69",".",33357,0
"8074",106148,"YAVAPAI COLLEGE                                             ","2003-2004",15,"Soccer",176670,172086,4584,176670,172086,4584,0,0,0,"24",".",46827,0
"12800",184603,"FAIRLEIGH DICKINSON UNIVERSITY-METROPOLITAN CAMPUS          ","2003-2004",25,"Track and Field, X-Country",550265,545685,4580,255258,252968,2290,295007,292717,2290,"48","45",38791,38791
"15643",118976,"MODESTO JUNIOR COLLEGE                                      ","2003-2004",39,"Total Participants",685845,681267,4578,365906,368757,-2851,319939,312510,7429,"256","130",107298,60194
"3902",216524,"URSINUS COLLEGE                                             ","2003-2004",3,"All Track Combined",57155,52578,4577,28577,26503,2074,28578,26075,2503,"30","17",19075,19065
"6837",197133,"VASSAR COLLEGE                                              ","2003-2004",11,"Lacrosse",99734,95184,4550,52009,47459,4550,47725,47725,0,"19","17",16472,14564
"12982",166850,"MERRIMACK COLLEGE                                           ","2003-2004",25,"Track and Field, X-Country",48628,44078,4550,23814,21539,2275,24814,22539,2275,"12","10",2786,2786
"3344",163426,"MONTGOMERY COLLEGE                                          ","2003-2004",2,"Basketball",94828,90282,4546,61042,55907,5135,33786,34375,-589,"43","17",26073,14735
"13214",226231,"LETOURNEAU UNIVERSITY                                       ","2003-2004",26,"Volleyball",50567,46022,4545,0,0,0,50567,46022,4545,".","13",0,13634
"10331",221519,"SEWANEE-THE UNIVERSITY OF THE SOUTH                         ","2003-2004",18,"Swimming and Diving",144162,139626,4536,72890,72890,0,71272,66736,4536,"15","19",24018,17864
"3068",133085,"CLEARWATER CHRISTIAN COLLEGE                                ","2003-2004",2,"Basketball",45366,40831,4535,24377,20942,3435,20989,19889,1100,"14","14",20689,19648
"2631",144218,"CITY COLLEGES OF CHICAGO-WILBUR WRIGHT COLLEGE              ","2003-2004",2,"Basketball",60000,55466,4534,30000,28716,1284,30000,26750,3250,"8","9",313,278
"16479",190530,"CUNY BRONX COMMUNITY COLLEGE                                ","2003-2004",39,"Total Participants",82434,77911,4523,40810,37717,3093,41624,40194,1430,"65","53",27436,19648
"16992",216542,"VALLEY FORGE CHRISTIAN COLLEGE                              ","2003-2004",39,"Total Participants",24480,19962,4518,11715,7388,4327,12765,12574,191,"44","30",14363,14970
"8222",170806,"MADONNA UNIVERSITY                                          ","2003-2004",15,"Soccer",155844,151330,4514,76045,72510,3535,79799,78820,979,"18","16",17234,17705
"11960",150455,"EARLHAM COLLEGE                                             ","2003-2004",24,"Track and Field, Outdoor",28800,24294,4506,14357,12147,2210,14443,12147,2296,"27","21",2253,2252
"5132",150145,"BETHEL COLLEGE                                              ","2003-2004",8,"Golf",18475,13971,4504,10375,11971,-1596,8100,2000,6100,"6","3",9200,1375
"11807",150455,"EARLHAM COLLEGE                                             ","2003-2004",23,"Track and Field, Indoor",28798,24294,4504,14356,12147,2209,14442,12147,2295,"23","23",2252,2253
"1212",179308,"SAINT LOUIS COMMUNITY COLLEGE-FOREST PARK                   ","2003-2004",1,"Baseball",26132,21632,4500,26132,21632,4500,0,0,0,"26",".",833,0
"4942",122791,"COLLEGE OF SAN MATEO                                        ","2003-2004",7,"Football",78026,73526,4500,78026,73526,4500,0,0,0,"79",".",23325,0
"5495",139144,"BERRY COLLEGE                                               ","2003-2004",8,"Golf",249066,244566,4500,124533,122283,2250,124533,122283,2250,"12","7",30727,30727
"13571",150145,"BETHEL COLLEGE                                              ","2003-2004",26,"Volleyball",19800,15300,4500,0,0,0,19800,15300,4500,".","10",0,15000
"15255",167394,"COLLEGE OF OUR LADY OF THE ELMS                             ","2003-2004",34,"Equestrian",12239,7751,4488,0,0,0,12239,7751,4488,".","8",0,1292
"1676",244437,"GEORGIA PERIMETER COLLEGE                                   ","2003-2004",2,"Basketball",260152,255679,4473,130076,130500,-424,130076,125179,4897,"12","15",61906,64097
"11812",152992,"BRIAR CLIFF UNIVERSITY                                      ","2003-2004",23,"Track and Field, Indoor",69402,64939,4463,32854,30602,2252,36548,34337,2211,"10","12",2824,2765
"12012",152992,"BRIAR CLIFF UNIVERSITY                                      ","2003-2004",24,"Track and Field, Outdoor",69402,64939,4463,32854,30602,2252,36548,34337,2211,"7","11",2824,2765
"8911",198598,"GREENSBORO COLLEGE                                          ","2003-2004",16,"Softball",69775,65326,4449,0,0,0,69775,65326,4449,".","13",0,21037
"2918",237932,"WEST LIBERTY STATE COLLEGE                                  ","2003-2004",2,"Basketball",258149,253706,4443,118521,115698,2823,139628,138008,1620,"15","14",16636,21315
"14791",153834,"LUTHER COLLEGE                                              ","2003-2004",28,"Wrestling",72507,68065,4442,72507,68065,4442,0,0,0,"25",".",20638,0
"6899",140951,"SAVANNAH COLLEGE OF ART AND DESIGN                          ","2003-2004",13,"Rowing",192151,187712,4439,100813,98593,2220,91338,89119,2219,"21","17",32170,26042
"13482",113333,"DE ANZA COLLEGE                                             ","2003-2004",26,"Volleyball",26397,21958,4439,0,0,0,26397,21958,4439,".","15",0,9816
"3858",216038,"SLIPPERY ROCK UNIVERSITY OF PENNSYLVANIA                    ","2003-2004",3,"All Track Combined",373646,369209,4437,170543,166963,3580,203103,202246,857,"68","107",64572,66286
"2827",148672,"SAUK VALLEY COMMUNITY COLLEGE                               ","2003-2004",2,"Basketball",115180,110749,4431,63609,60756,2853,51571,49993,1578,"14","10",19594,17269
"7243",153834,"LUTHER COLLEGE                                              ","2003-2004",15,"Soccer",65837,61408,4429,33209,31067,2142,32628,30341,2287,"29","32",15318,15389
"1454",216931,"WILKES UNIVERSITY                                           ","2003-2004",1,"Baseball",24738,20312,4426,24738,20312,4426,0,0,0,"27",".",14588,0
"7529",235750,"LOWER COLUMBIA COLLEGE                                      ","2003-2004",15,"Soccer",15141,10722,4419,0,0,0,15141,10722,4419,".","15",0,4523
"10940",191515,"HAMILTON COLLEGE                                            ","2003-2004",22,"Tennis",62192,57779,4413,29137,27477,1660,33055,30302,2753,"12","11",6413,9418
"7852",106342,"LYON COLLEGE                                                ","2003-2004",15,"Soccer",262803,258395,4408,145776,143507,2269,117027,114888,2139,"23","16",18300,17746
"6598",184348,"DREW UNIVERSITY                                             ","2003-2004",11,"Lacrosse",140585,136182,4403,81264,78202,3062,59321,57980,1341,"29","24",16428,12509
"6462",172440,"FINLANDIA UNIVERSITY                                        ","2003-2004",10,"Ice Hockey",58650,54252,4398,58650,54252,4398,0,0,0,"22",".",47052,0
"17175",120865,"PACIFIC UNION COLLEGE                                       ","2003-2004",39,"Total Participants",29000,24608,4392,7500,4022,3478,21500,20586,914,"20","30",16518,29722
"14895",165024,"BRIDGEWATER STATE COLLEGE                                   ","2003-2004",28,"Wrestling",13500,9113,4387,13500,9113,4387,0,0,0,"18",".",9040,0
"8383",218733,"SOUTH CAROLINA STATE UNIVERSITY                             ","2003-2004",15,"Soccer",214107,209722,4385,0,0,0,214107,209722,4385,".","18",0,43858
"9058",154350,"SIMPSON COLLEGE                                             ","2003-2004",16,"Softball",68118,63735,4383,0,0,0,68118,63735,4383,".","32",0,40631
"16760",165699,"ENDICOTT COLLEGE                                            ","2003-2004",39,"Total Participants",492622,488242,4380,225888,223711,2177,266734,264531,2203,"222","151",161900,146800
"16837",123299,"SHASTA COLLEGE                                              ","2003-2004",39,"Total Participants",280049,275669,4380,143500,141050,2450,136549,134619,1930,"184","94",102570,73658
"9705",234164,"VIRGINIA UNION UNIVERSITY                                   ","2003-2004",16,"Softball",53745,49373,4372,0,0,0,53745,49373,4372,".","13",0,3223
"9340",184694,"FAIRLEIGH DICKINSON UNIVERSITY-COLLEGE AT FLORHAM           ","2003-2004",16,"Softball",54510,50141,4369,0,0,0,54510,50141,4369,".","17",0,15360
"14942",216010,"SHIPPENSBURG UNIVERSITY OF PENNSYLVANIA                     ","2003-2004",28,"Wrestling",50381,46025,4356,50381,46025,4356,0,0,0,"23",".",19376,0
"15009",153162,"CORNELL COLLEGE                                             ","2003-2004",28,"Wrestling",71619,67277,4342,71619,67277,4342,0,0,0,"12",".",26138,0
"7443",140696,"OGLETHORPE UNIVERSITY                                       ","2003-2004",15,"Soccer",37338,33000,4338,20332,16500,3832,17006,16500,506,"24","16",10662,10662
"15279",229814,"WEST TEXAS A &amp; M UNIVERSITY                                 ","2003-2004",34,"Equestrian",21929,17592,4337,0,0,0,21929,17592,4337,".","25",0,12706
"2580",195003,"ROCHESTER INSTITUTE OF TECHNOLOGY                           ","2003-2004",2,"Basketball",113760,109428,4332,60267,58101,2166,53493,51327,2166,"20","12",27449,21977
"1226",203085,"HEIDELBERG COLLEGE                                          ","2003-2004",1,"Baseball",67784,63465,4319,67784,63465,4319,0,0,0,"27",".",14966,0
"640",177676,"JEFFERSON COLLEGE                                           ","2003-2004",1,"Baseball",83095,78777,4318,83095,78777,4318,0,0,0,"26",".",33314,0
"4288",202514,"DEFIANCE COLLEGE                                            ","2003-2004",7,"Football",191129,186811,4318,191129,186811,4318,0,0,0,"101",".",55515,0
"10380",196200,"SUNY-POTSDAM                                                ","2003-2004",18,"Swimming and Diving",130048,125730,4318,65024,62865,2159,65024,62865,2159,"9","15",32510,32510
"2824",204264,"MUSKINGUM COLLEGE                                           ","2003-2004",2,"Basketball",54520,50212,4308,28062,25762,2300,26458,24450,2008,"26","24",24078,22124
"1795",181020,"DOANE COLLEGE                                               ","2003-2004",2,"Basketball",365748,361450,4298,194112,191831,2281,171636,169619,2017,"30","33",41409,26724
"7742",228042,"SCHREINER UNIVERSITY                                        ","2003-2004",15,"Soccer",119465,115173,4292,62988,57074,5914,56477,58099,-1622,"23","13",16600,15600
"9111",235750,"LOWER COLUMBIA COLLEGE                                      ","2003-2004",16,"Softball",22611,18320,4291,0,0,0,22611,18320,4291,".","15",0,9709
"12190",122339,"SAN DIEGO CITY COLLEGE                                      ","2003-2004",25,"Track and Field, X-Country",23608,19318,4290,11804,9659,2145,11804,9659,2145,"11","8",2482,2482
"591",186584,"SETON HALL UNIVERSITY                                       ","2003-2004",1,"Baseball",609757,605468,4289,609757,605468,4289,0,0,0,"34",".",142177,0
"4832",111461,"COLLEGE OF THE CANYONS                                      ","2003-2004",7,"Football",48844,44556,4288,48844,44556,4288,0,0,0,"63",".",27467,0
"16934",173063,"RIVERLAND COMMUNITY COLLEGE                                 ","2003-2004",39,"Total Participants",104731,100448,4283,47802,46724,1078,56929,53724,3205,"39","40",26973,28404
"7121",180197,"FLATHEAD VALLEY COMMUNITY COLLEGE                           ","2003-2004",15,"Soccer",20038,15762,4276,10019,9915,104,10019,5847,4172,"13","10",6915,2847
"512",144962,"ELMHURST COLLEGE                                            ","2003-2004",1,"Baseball",75925,71658,4267,75925,71658,4267,0,0,0,"36",".",37317,0
"10095",173647,"GUSTAVUS ADOLPHUS COLLEGE                                   ","2003-2004",18,"Swimming and Diving",151068,146801,4267,64510,62691,1819,86558,84110,2448,"29","39",31177,41927
"1151",154688,"BAKER UNIVERSITY COLLEGE OF ARTS AND SCIENCES               ","2003-2004",1,"Baseball",93974,89708,4266,93974,89708,4266,0,0,0,"28",".",30568,0
"6590",191968,"ITHACA COLLEGE                                              ","2003-2004",11,"Lacrosse",168889,164627,4262,75425,76146,-721,93464,88481,4983,"33","28",36924,40202
"3685",237181,"BETHANY COLLEGE                                             ","2003-2004",3,"All Track Combined",28308,24050,4258,14154,11775,2379,14154,12275,1879,"22","27",3630,4590
"12296",137546,"STETSON UNIVERSITY                                          ","2003-2004",25,"Track and Field, X-Country",57541,53294,4247,27111,24300,2811,30430,28994,1436,"8","8",4634,4081
"382",143215,"SOUTHWESTERN ILLINOIS COLLEGE                               ","2003-2004",1,"Baseball",130486,126244,4242,130486,126244,4242,0,0,0,"30",".",16199,0
"4946",175236,"RIDGEWATER COLLEGE                                          ","2003-2004",7,"Football",62135,57899,4236,62135,57899,4236,0,0,0,"71",".",24400,0
"8927",199582,"SAINT AUGUSTINES COLLEGE                                    ","2003-2004",16,"Softball",100665,96430,4235,0,0,0,100665,96430,4235,".","14",0,15197
"11100",150455,"EARLHAM COLLEGE                                             ","2003-2004",22,"Tennis",35025,30796,4229,17240,15398,1842,17785,15398,2387,"9","11",2460,2460
"8159",176664,"BAPTIST BIBLE COLLEGE AND GRADUATE SCHOOL                   ","2003-2004",15,"Soccer",16721,12500,4221,16721,12500,4221,0,0,0,"20",".",12000,0
"99",191621,"HILBERT COLLEGE                                             ","2003-2004",1,"Baseball",24970,20751,4219,24970,20751,4219,0,0,0,"19",".",9222,0
"16035",206525,"WITTENBERG UNIVERSITY                                       ","2003-2004",39,"Total Participants",716317,712100,4217,330060,310318,19742,386257,401782,-15525,"367","244",175047,128593
"12467",183239,"SAINT ANSELM COLLEGE                                        ","2003-2004",25,"Track and Field, X-Country",28054,23838,4216,14227,12254,1973,13827,11584,2243,"9","6",7757,7284
"2103",237358,"DAVIS AND ELKINS COLLEGE                                    ","2003-2004",2,"Basketball",99184,94973,4211,48846,46712,2134,50338,48261,2077,"12","11",22969,23007
"5377",220701,"MARTIN METHODIST COLLEGE                                    ","2003-2004",8,"Golf",72450,68245,4205,72450,68245,4205,0,0,0,"8",".",4999,0
"12738",226231,"LETOURNEAU UNIVERSITY                                       ","2003-2004",25,"Track and Field, X-Country",21855,17653,4202,10927,8827,2100,10928,8826,2102,"9","2",5000,4316
"4684",170532,"KALAMAZOO COLLEGE                                           ","2003-2004",7,"Football",234460,230259,4201,234460,230259,4201,0,0,0,"58",".",73195,0
"9767",179955,"WILLIAM JEWELL COLLEGE                                      ","2003-2004",16,"Softball",41622,37421,4201,0,0,0,41622,37421,4201,".","13",0,23800
"6345",240417,"UNIVERSITY OF WISCONSIN-STOUT                               ","2003-2004",9,"Gymnastics",65719,61528,4191,0,0,0,65719,61528,4191,".","11",0,19932
"929",161165,"HUSSON COLLEGE                                              ","2003-2004",1,"Baseball",78793,74610,4183,78793,74610,4183,0,0,0,"27",".",29453,0
"8907",157632,"SAINT CATHARINE COLLEGE                                     ","2003-2004",16,"Softball",63788,59613,4175,0,0,0,63788,59613,4175,".","17",0,13400
"13582",125028,"VENTURA COLLEGE                                             ","2003-2004",26,"Volleyball",39413,35241,4172,0,0,0,39413,35241,4172,".","12",0,6981
"1738",231554,"BLUEFIELD COLLEGE                                           ","2003-2004",2,"Basketball",250923,246755,4168,142317,140201,2116,108606,106554,2052,"14","9",19194,17882
"4800",113980,"EL CAMINO COLLEGE                                           ","2003-2004",7,"Football",91575,87407,4168,91575,87407,4168,0,0,0,"105",".",42584,0
"14978",114789,"FRESNO CITY COLLEGE                                         ","2003-2004",28,"Wrestling",14843,10677,4166,14843,10677,4166,0,0,0,"25",".",10137,0
"14587",199582,"SAINT AUGUSTINES COLLEGE                                    ","2003-2004",26,"Volleyball",88385,84223,4162,0,0,0,88385,84223,4162,".","9",0,14813
"10282",196024,"SUNY COLLEGE OF TECHNOLOGY AT DELHI                         ","2003-2004",18,"Swimming and Diving",12400,8246,4154,6200,4123,2077,6200,4123,2077,"12","8",1558,1557
"11339",168546,"ALBION COLLEGE                                              ","2003-2004",22,"Tennis",55763,51609,4154,26782,25371,1411,28981,26238,2743,"12","15",9570,10417
"8797",364016,"PARADISE VALLEY COMMUNITY COLLEGE                           ","2003-2004",16,"Softball",61138,56998,4140,0,0,0,61138,56998,4140,".","16",0,10135
"11125",155201,"INDEPENDENCE COMMUNITY COLLEGE                              ","2003-2004",22,"Tennis",22154,18022,4132,11077,9011,2066,11077,9011,2066,"6","6",4511,4511
"16130",216296,"THADDEUS STEVENS COLLEGE OF TECHNOLOGY                      ","2003-2004",39,"Total Participants",86350,82218,4132,69350,67163,2187,17000,15055,1945,"129","12",117429,9115
"8942",132657,"LYNN UNIVERSITY                                             ","2003-2004",16,"Softball",227692,223563,4129,0,0,0,227692,223563,4129,".","17",0,38188
"13381",146481,"LAKE FOREST COLLEGE                                         ","2003-2004",26,"Volleyball",44993,40868,4125,0,0,0,44993,40868,4125,".","14",0,15993
"13534",101435,"HUNTINGDON COLLEGE                                          ","2003-2004",26,"Volleyball",69080,64960,4120,0,0,0,69080,64960,4120,".","11",0,19200
"8033",228343,"SOUTHWESTERN UNIVERSITY                                     ","2003-2004",15,"Soccer",206081,201962,4119,104343,101697,2646,101738,100265,1473,"24","24",47605,41634
"2610",234669,"BELLEVUE COMMUNITY COLLEGE                                  ","2003-2004",2,"Basketball",80100,76000,4100,40000,40000,0,40100,36000,4100,"15","10",11834,9000
"9209",217536,"SALVE REGINA UNIVERSITY                                     ","2003-2004",16,"Softball",36166,32066,4100,0,0,0,36166,32066,4100,".","14",0,18578
"9980",174862,"CROWN COLLEGE                                               ","2003-2004",16,"Softball",26217,22118,4099,0,0,0,26217,22118,4099,".","11",0,18550
"4482",240338,"WISCONSIN LUTHERAN COLLEGE                                  ","2003-2004",7,"Football",321910,317818,4092,321910,317818,4092,0,0,0,"64",".",91772,0
"1445",162210,"COLUMBIA UNION COLLEGE                                      ","2003-2004",1,"Baseball",47745,43670,4075,47745,43670,4075,0,0,0,"12",".",12863,0
"17218",215309,"UNIVERSITY OF PITTSBURGH-TITUSVILLE                         ","2003-2004",39,"Total Participants",41992,37918,4074,5832,1832,4000,36160,36086,74,"18","21",6834,4086
"7536",114789,"FRESNO CITY COLLEGE                                         ","2003-2004",15,"Soccer",29476,25406,4070,14296,12948,1348,15180,12458,2722,"28","21",8867,9870
"9243",140818,"PIEDMONT COLLEGE                                            ","2003-2004",16,"Softball",77307,73238,4069,0,0,0,77307,73238,4069,".","15",0,16355
"6432",195526,"SKIDMORE COLLEGE                                            ","2003-2004",10,"Ice Hockey",96619,92551,4068,96619,92551,4068,0,0,0,"29",".",31588,0
"16143",214379,"NORTHAMPTON COUNTY AREA COMMUNITY COLLEGE                   ","2003-2004",39,"Total Participants",92145,88086,4059,59485,56870,2615,32660,31216,1444,"116","48",31248,20683
"5081",173559,"MINNESOTA STATE COMM AND TECH COLLEGE-FERGUS FALLS          ","2003-2004",7,"Football",61276,57219,4057,61276,57219,4057,0,0,0,"50",".",24637,0
"4466",146825,"MACMURRAY COLLEGE                                           ","2003-2004",7,"Football",170230,166175,4055,170230,166175,4055,0,0,0,"62",".",58058,0
"11614",130226,"QUINNIPIAC UNIVERSITY                                       ","2003-2004",22,"Tennis",241273,237224,4049,65815,65516,299,175458,171708,3750,"12","9",14975,33491
"5557",175980,"MILLSAPS COLLEGE                                            ","2003-2004",8,"Golf",13550,9506,4044,8297,4753,3544,5253,4753,500,"5","3",2253,2252
"5261",221971,"UNION UNIVERSITY                                            ","2003-2004",8,"Golf",57208,53168,4040,57208,53168,4040,0,0,0,"10",".",16424,0
"2675",210401,"WILLAMETTE UNIVERSITY                                       ","2003-2004",2,"Basketball",140306,136270,4036,90796,94398,-3602,49510,41872,7638,"24","14",28157,19722
"16589",236258,"PENINSULA COLLEGE                                           ","2003-2004",39,"Total Participants",72200,68166,4034,35300,32850,2450,36900,35316,1584,"27","23",35951,31231
"3010",236577,"SEATTLE PACIFIC UNIVERSITY                                  ","2003-2004",2,"Basketball",969822,965790,4032,537660,492221,45439,432162,473569,-41407,"15","14",89285,88113
"16364",154101,"NORTHWESTERN COLLEGE                                        ","2003-2004",39,"Total Participants",715387,711374,4013,366253,365874,379,349134,345500,3634,"216","115",210194,115047
"4977",114938,"GAVILAN COLLEGE                                             ","2003-2004",7,"Football",81533,77530,4003,81533,77530,4003,0,0,0,"67",".",47835,0
"903",212197,"ELIZABETHTOWN COLLEGE                                       ","2003-2004",1,"Baseball",43246,39245,4001,43246,39245,4001,0,0,0,"27",".",20696,0
"4384",173452,"MARTIN LUTHER COLLEGE                                       ","2003-2004",7,"Football",16000,12000,4000,16000,12000,4000,0,0,0,"56",".",9000,0
"4765",178369,"MISSOURI VALLEY COLLEGE                                     ","2003-2004",7,"Football",53200,49200,4000,53200,49200,4000,0,0,0,"141",".",45497,0
"5712",215309,"UNIVERSITY OF PITTSBURGH-TITUSVILLE                         ","2003-2004",8,"Golf",5832,1832,4000,5832,1832,4000,0,0,0,"5",".",832,0
"7752",214643,"PENNSYLVANIA STATE UNIVERSITY-PENN STATE WILKES-BA          ","2003-2004",15,"Soccer",10000,6000,4000,10000,6000,4000,0,0,0,"18",".",3000,0
"12568",193645,"THE COLLEGE OF NEW ROCHELLE                                 ","2003-2004",25,"Track and Field, X-Country",4000,0,4000,0,0,0,4000,7994,-3994,".","5",0,4994
"13278",146296,"JOLIET JUNIOR COLLEGE                                       ","2003-2004",26,"Volleyball",31000,27000,4000,0,0,0,31000,27000,4000,".","12",0,11500
"14991",211981,"DELAWARE VALLEY COLLEGE                                     ","2003-2004",28,"Wrestling",54950,50950,4000,54950,50950,4000,0,0,0,"32",".",15800,0
"11643",214175,"MUHLENBERG COLLEGE                                          ","2003-2004",22,"Tennis",12451,8452,3999,5377,2420,2957,7074,6032,1042,"8","14",1960,4142
"8839",230995,"NORWICH UNIVERSITY                                          ","2003-2004",16,"Softball",20540,16542,3998,0,0,0,20540,16542,3998,".","17",0,11128
"8304",190983,"ELMIRA COLLEGE                                              ","2003-2004",15,"Soccer",136424,132446,3978,61031,61004,27,75393,71442,3951,"23","21",18788,21513
"4490",152318,"ROSE-HULMAN INSTITUTE OF TECHNOLOGY                         ","2003-2004",7,"Football",261970,258000,3970,261970,258000,3970,0,0,0,"80",".",98970,0
"11749",240055,"UNIVERSITY OF WISCONSIN COLLEGES                            ","2003-2004",22,"Tennis",18664,14695,3969,9488,7525,1963,9176,7170,2006,"26","16",6541,6186
"13821",134945,"JACKSONVILLE UNIVERSITY                                     ","2003-2004",26,"Volleyball",288202,284235,3967,0,0,0,288202,284235,3967,".","12",0,24464
"13337",161086,"COLBY COLLEGE                                               ","2003-2004",26,"Volleyball",23139,19180,3959,0,0,0,23139,19180,3959,".","12",0,18816
"5457",153144,"COE COLLEGE                                                 ","2003-2004",8,"Golf",23522,19589,3933,15270,11337,3933,8252,8252,0,"18","9",9937,3352
"11505",221519,"SEWANEE-THE UNIVERSITY OF THE SOUTH                         ","2003-2004",22,"Tennis",100487,96555,3932,55038,55038,0,45449,41517,3932,"12","8",23836,9078
"9925",146205,"JOHN A LOGAN COLLEGE                                        ","2003-2004",16,"Softball",82057,78135,3922,0,0,0,82057,78135,3922,".","20",0,46668
"3824",154688,"BAKER UNIVERSITY COLLEGE OF ARTS AND SCIENCES               ","2003-2004",3,"All Track Combined",134533,130612,3921,69646,68383,1263,64887,62229,2658,"30","24",23186,19953
"4371",228501,"SUL ROSS STATE UNIVERSITY                                   ","2003-2004",7,"Football",126273,122362,3911,126273,122362,3911,0,0,0,"85",".",71643,0
"11796",110486,"CALIFORNIA STATE UNIVERSITY-BAKERSFIELD                     ","2003-2004",22,"Tennis",51328,47436,3892,0,0,0,51328,47436,3892,".","8",0,9500
"2763",206941,"UNIVERSITY OF CENTRAL OKLAHOMA                              ","2003-2004",2,"Basketball",70117,66230,3887,37168,33565,3603,32949,32665,284,"13","13",27265,27265
"13347",224891,"FRANK PHILLIPS COLLEGE                                      ","2003-2004",26,"Volleyball",117734,113852,3882,0,0,0,117734,113852,3882,"0","13",0,20300
"5397",237066,"WHITWORTH COLLEGE                                           ","2003-2004",8,"Golf",56760,52880,3880,30178,28238,1940,26582,24642,1940,"6","5",10788,7191
"8576",236610,"SHORELINE COMMUNITY COLLEGE                                 ","2003-2004",16,"Softball",30540,26666,3874,0,0,0,30540,26666,3874,".","12",0,13514
"15119",226578,"MCLENNAN COMMUNITY COLLEGE                                  ","2003-2004",29,"Other Sports",22850,18976,3874,0,0,0,22850,18976,3874,".","16",0,4435
"3254",216524,"URSINUS COLLEGE                                             ","2003-2004",2,"Basketball",99836,95968,3868,49918,49978,-60,49918,45990,3928,"11","13",28526,28526
"12845",240268,"UNIVERSITY OF WISCONSIN-EAU CLAIRE                          ","2003-2004",25,"Track and Field, X-Country",41697,37831,3866,20440,17038,3402,21257,20793,464,"17","26",7061,7289
"12242",101587,"UNIVERSITY OF WEST ALABAMA                                  ","2003-2004",25,"Track and Field, X-Country",54000,50138,3862,27000,25069,1931,27000,25069,1931,"7","6",3749,3749
"9812",208035,"WESTERN OKLAHOMA STATE COLLEGE                              ","2003-2004",16,"Softball",51458,47598,3860,0,0,0,51458,47598,3860,".","17",0,21527
"14822",174358,"MINNESOTA STATE UNIVERSITY-MOORHEAD                         ","2003-2004",28,"Wrestling",95396,91537,3859,95396,91537,3859,0,0,0,"35",".",24596,0
"14128",238980,"LAKELAND COLLEGE                                            ","2003-2004",26,"Volleyball",31710,27857,3853,0,0,0,31710,27857,3853,".","18",0,13068
"11109",211644,"CLARION UNIVERSITY OF PENNSYLVANIA                          ","2003-2004",22,"Tennis",26970,23120,3850,0,0,0,26970,23120,3850,".","9",0,7281
"2249",221519,"SEWANEE-THE UNIVERSITY OF THE SOUTH                         ","2003-2004",2,"Basketball",194648,190800,3848,108049,108049,0,86599,82751,3848,"15","12",50561,42452
"16654",155715,"PRATT COMMUNITY COLLEGE                                     ","2003-2004",39,"Total Participants",477154,473312,3842,249849,256141,-6292,227305,217171,10134,"107","58",36275,36755
"7022",183239,"SAINT ANSELM COLLEGE                                        ","2003-2004",14,"Skiing",36758,32918,3840,18379,20444,-2065,18379,12474,5905,"8","4",16632,8661
"11374",134079,"FLORIDA SOUTHERN COLLEGE                                    ","2003-2004",22,"Tennis",142547,138710,3837,67910,67825,85,74637,70885,3752,"9","9",16187,15699
"8802",156286,"BELLARMINE UNIVERSITY                                       ","2003-2004",16,"Softball",134049,130214,3835,0,0,0,134049,130214,3835,".","18",0,27315
"1880",221485,"SOUTHWEST TENNESSEE COMMUNITY COLLEGE                       ","2003-2004",2,"Basketball",410990,407160,3830,280425,278510,1915,130565,128650,1915,"26","16",34770,31122
"4713",218414,"NEWBERRY COLLEGE                                            ","2003-2004",7,"Football",144464,140642,3822,144464,140642,3822,0,0,0,"107",".",125083,0
"8823",165024,"BRIDGEWATER STATE COLLEGE                                   ","2003-2004",16,"Softball",25075,21255,3820,0,0,0,25075,21255,3820,".","13",0,21075
"4225",163912,"ST MARY'S COLLEGE OF MARYLAND                               ","2003-2004",6,"Field hocky",56147,52331,3816,0,0,0,56147,52331,3816,".","23",0,9500
"15209",172051,"SAGINAW VALLEY STATE UNIVERSITY                             ","2003-2004",33,"Bowling",45056,41242,3814,45056,41242,3814,0,0,0,"20",".",31886,0
"14245",154907,"CLOUD COUNTY COMMUNITY COLLEGE                              ","2003-2004",26,"Volleyball",47220,43408,3812,0,0,0,47220,43408,3812,".","12",0,588
"1585",164739,"BENTLEY COLLEGE                                             ","2003-2004",1,"Baseball",110420,106610,3810,110420,106610,3810,0,0,0,"23",".",31745,0
"9159",189848,"CAZENOVIA COLLEGE                                           ","2003-2004",16,"Softball",34766,30962,3804,0,0,0,34766,30962,3804,".","16",0,30832
"13129",216694,"WAYNESBURG COLLEGE                                          ","2003-2004",26,"Volleyball",33638,29838,3800,0,0,0,33638,29838,3800,".","10",0,25806
"13876",153278,"UNIVERSITY OF DUBUQUE                                       ","2003-2004",26,"Volleyball",74872,71078,3794,0,0,0,74872,71078,3794,".","20",0,20417
"3185",177144,"CULVER-STOCKTON COLLEGE                                     ","2003-2004",2,"Basketball",120801,117009,3792,65355,63459,1896,55446,53550,1896,"12","15",20492,18611
"2068",180416,"MONTANA TECH OF THE UNIVERSITY OF MONTANA                   ","2003-2004",2,"Basketball",348304,344521,3783,184883,184640,243,163421,159881,3540,"25","13",43809,43061
"13192",229267,"TRINITY UNIVERSITY                                          ","2003-2004",26,"Volleyball",100155,96379,3776,0,0,0,100155,96379,3776,".","16",0,47206
"14842",146676,"LINCOLN COLLEGE                                             ","2003-2004",28,"Wrestling",85088,81340,3748,85088,81340,3748,0,0,0,"38",".",23344,0
"2159",183974,"CENTENARY COLLEGE                                           ","2003-2004",2,"Basketball",88825,85080,3745,38269,35534,2735,50556,49546,1010,"17","10",22532,16511
"9648",172264,"SIENA HEIGHTS UNIVERSITY                                    ","2003-2004",16,"Softball",37442,33704,3738,0,0,0,37442,33704,3738,".","23",0,12406
"9818",148256,"REND LAKE COLLEGE                                           ","2003-2004",16,"Softball",56833,53098,3735,0,0,0,56833,53098,3735,".","15",0,22395
"56",206048,"TIFFIN UNIVERSITY                                           ","2003-2004",1,"Baseball",26677,22944,3733,26677,22944,3733,0,0,0,"41",".",8133,0
"10516",163912,"ST MARY'S COLLEGE OF MARYLAND                               ","2003-2004",19,"Swimming",66962,63240,3722,33481,31620,1861,33481,31620,1861,"5","13",8000,8000
"9188",219976,"DAVID LIPSCOMB UNIVERSITY                                   ","2003-2004",16,"Softball",346381,342660,3721,0,0,0,346381,342660,3721,".","18",0,89319
"58",191515,"HAMILTON COLLEGE                                            ","2003-2004",1,"Baseball",38628,34908,3720,38628,34908,3720,0,0,0,"26",".",14195,0
"2693",176354,"SOUTHWEST MISSISSIPPI COMMUNITY COLLEGE                     ","2003-2004",2,"Basketball",218890,215171,3719,118697,116838,1859,100193,98333,1860,"15","11",16940,14730
"10944",149231,"SOUTHERN ILLINOIS UNIVERSITY-EDWARDSVILLE                   ","2003-2004",22,"Tennis",106755,103044,3711,51674,51222,452,55081,51822,3259,"9","7",8399,5870
"13586",152318,"ROSE-HULMAN INSTITUTE OF TECHNOLOGY                         ","2003-2004",26,"Volleyball",83707,80000,3707,0,0,0,83707,80000,3707,".","9",0,37655
"3387",149505,"TRINITY CHRISTIAN COLLEGE                                   ","2003-2004",2,"Basketball",68296,64596,3700,35951,34451,1500,32345,30145,2200,"13","13",22051,17745
"14578",212197,"ELIZABETHTOWN COLLEGE                                       ","2003-2004",26,"Volleyball",22354,18656,3698,0,0,0,22354,18656,3698,".","13",0,10746
"8847",168263,"WESTFIELD STATE COLLEGE                                     ","2003-2004",16,"Softball",30857,27173,3684,0,0,0,30857,27173,3684,".","19",0,16031
"8917",170620,"LAKE MICHIGAN COLLEGE                                       ","2003-2004",16,"Softball",53321,49641,3680,0,0,0,53321,49641,3680,".","13",0,24827
"15972",147004,"MCHENRY COUNTY COLLEGE                                      ","2003-2004",39,"Total Participants",130299,126625,3674,70834,68327,2507,59465,58298,1167,"61","41",31665,30592
"3490",122658,"SAN JOAQUIN DELTA COLLEGE                                   ","2003-2004",2,"Basketball",85219,81567,3652,41308,39239,2069,43911,42328,1583,"14","15",12123,14362
"5168",140872,"REINHARDT COLLEGE                                           ","2003-2004",8,"Golf",35492,31842,3650,35492,31842,3650,0,0,0,"11",".",1349,0
"11570",197221,"WEBB INSTITUTE                                              ","2003-2004",22,"Tennis",3650,0,3650,3650,3650,0,0,0,0,"12",".",1450,0
"13372",220631,"LINCOLN MEMORIAL UNIVERSITY                                 ","2003-2004",26,"Volleyball",172189,168539,3650,0,0,0,172189,168539,3650,"0","12",0,61097
"3221",140951,"SAVANNAH COLLEGE OF ART AND DESIGN                          ","2003-2004",2,"Basketball",481580,477934,3646,271838,270320,1518,209742,207614,2128,"9","15",102761,99659
"16000",220613,"LEE UNIVERSITY                                              ","2003-2004",39,"Total Participants",1212770,1209126,3644,612542,605034,7508,600228,604092,-3864,"96","76",203213,190233
"8439",167394,"COLLEGE OF OUR LADY OF THE ELMS                             ","2003-2004",15,"Soccer",44582,40940,3642,22626,25222,-2596,21956,15718,6238,"23","13",10064,8918
"1057",111939,"CHAFFEY COLLEGE                                             ","2003-2004",1,"Baseball",17045,13406,3639,17045,13406,3639,0,0,0,"31",".",6602,0
"14450",154101,"NORTHWESTERN COLLEGE                                        ","2003-2004",26,"Volleyball",91559,87925,3634,0,0,0,91559,87925,3634,".","18",0,17305
"7730",214591,"PENNSYLVANIA STATE UNIV-PENN ST ERIE-BEHREND COLL           ","2003-2004",15,"Soccer",102707,99079,3628,32612,53835,-21223,70095,45244,24851,"24","20",21594,21827
"17177",115001,"GLENDALE COMMUNITY COLLEGE                                  ","2003-2004",39,"Total Participants",180347,176719,3628,97754,95309,2445,82593,81410,1183,"168","81",89933,25842
"15962",208275,"BLUE MOUNTAIN COMMUNITY COLLEGE                             ","2003-2004",39,"Total Participants",258129,254502,3627,141046,138196,2850,117083,116306,777,"70","46",81530,62477
"12777",144865,"COLLEGE OF DUPAGE                                           ","2003-2004",25,"Track and Field, X-Country",54825,51200,3625,43875,27000,16875,10950,24200,-13250,"13","8",8875,5950
"1312",178341,"MISSOURI SOUTHERN STATE UNIVERSITY                          ","2003-2004",1,"Baseball",160862,157239,3623,160862,157239,3623,0,0,0,"32",".",25958,0
"249",192703,"MANHATTAN COLLEGE                                           ","2003-2004",1,"Baseball",383863,380261,3602,383863,380261,3602,0,0,0,"31",".",140342,0
"3039",177339,"EVANGEL UNIVERSITY                                          ","2003-2004",2,"Basketball",448319,444719,3600,226481,223881,2600,221838,220838,1000,"17","12",41400,49800
"8066",211927,"DELAWARE COUNTY COMMUNITY COLLEGE                           ","2003-2004",15,"Soccer",6800,3200,3600,6800,3200,3600,0,0,0,"16",".",3680,0
"5762",149781,"WHEATON COLLEGE                                             ","2003-2004",8,"Golf",65536,61956,3580,42269,42268,1,23267,19688,3579,"7","6",5427,4777
"1703",140818,"PIEDMONT COLLEGE                                            ","2003-2004",2,"Basketball",133428,129850,3578,89252,85949,3303,44176,43901,275,"12","12",18285,15512
"638",133085,"CLEARWATER CHRISTIAN COLLEGE                                ","2003-2004",1,"Baseball",19355,15794,3561,19355,15794,3561,0,0,0,"22",".",15603,0
"12076",210234,"TREASURE VALLEY COMMUNITY COLLEGE                           ","2003-2004",24,"Track and Field, Outdoor",29020,25463,3557,14720,13591,1129,14300,11872,2428,"15","9",12000,8000
"2719",216010,"SHIPPENSBURG UNIVERSITY OF PENNSYLVANIA                     ","2003-2004",2,"Basketball",455894,452342,3552,217522,209025,8497,238372,243317,-4945,"14","14",34346,36641
"7787",130776,"WESTERN CONNECTICUT STATE UNIVERSITY                        ","2003-2004",15,"Soccer",123613,120062,3551,58636,55085,3551,64977,64977,0,"27","23",28238,27627
"5772",119216,"MT SAN JACINTO COLLEGE                                      ","2003-2004",8,"Golf",12615,9068,3547,12615,9068,3547,0,0,0,"5",".",3243,0
"9959",101693,"UNIVERSITY OF MOBILE                                        ","2003-2004",16,"Softball",218540,214994,3546,0,0,0,218540,214994,3546,".","16",0,28267
"4252",182980,"NEW ENGLAND COLLEGE                                         ","2003-2004",6,"Field hocky",24590,21046,3544,0,0,0,24590,21046,3544,".","22",0,9094
"11949",160977,"BATES COLLEGE                                               ","2003-2004",24,"Track and Field, Outdoor",101481,97943,3538,50672,47964,2708,50809,49979,830,"37","41",26979,19911
"1162",153144,"COE COLLEGE                                                 ","2003-2004",1,"Baseball",33311,29777,3534,33311,29777,3534,0,0,0,"37",".",17778,0
"9527",118976,"MODESTO JUNIOR COLLEGE                                      ","2003-2004",16,"Softball",22898,19364,3534,0,0,0,22898,19364,3534,".","17",0,5171
"6327",166683,"MASSACHUSETTS INSTITUTE OF TECHNOLOGY                       ","2003-2004",9,"Gymnastics",119640,116112,3528,38021,36674,1347,81619,79438,2181,"10","9",16379,55883
"11543",219718,"BETHEL COLLEGE                                              ","2003-2004",22,"Tennis",46143,42616,3527,23015,21175,1840,23128,21441,1687,"11","7",10353,13119
"3713",186584,"SETON HALL UNIVERSITY                                       ","2003-2004",3,"All Track Combined",1308802,1305285,3517,666021,568951,97070,642781,736334,-93553,"65","51",93177,93034
"8197",217059,"YORK COLLEGE PENNSYLVANIA                                   ","2003-2004",15,"Soccer",107940,104423,3517,66020,61500,4520,41920,42923,-1003,"33","27",17450,14793
"152",140696,"OGLETHORPE UNIVERSITY                                       ","2003-2004",1,"Baseball",31509,28000,3509,31509,28000,3509,0,0,0,"19",".",21846,0
"14087",169974,"GLEN OAKS COMMUNITY COLLEGE                                 ","2003-2004",26,"Volleyball",23660,20151,3509,0,0,0,23660,20151,3509,".","12",0,6187
"5587",414823,"JOHNSON &amp; WALES UNIVERSITY-FLORIDA CAMPUS                   ","2003-2004",8,"Golf",24500,21000,3500,16000,14000,2000,8500,7000,1500,"12","5",13500,5000
"5647",144944,"ELGIN COMMUNITY COLLEGE                                     ","2003-2004",8,"Golf",7300,3800,3500,7300,3800,3500,0,0,0,"6",".",2100,0
"6012",235334,"GRAYS HARBOR COLLEGE                                        ","2003-2004",8,"Golf",16036,12536,3500,12855,10694,2161,3181,1842,1339,"6","1",6575,1070
"8734",190169,"COLUMBIA-GREENE COMMUNITY COLLEGE                           ","2003-2004",16,"Softball",12000,8500,3500,0,0,0,12000,8500,3500,".","15",0,8000
"313",230959,"MIDDLEBURY COLLEGE                                          ","2003-2004",1,"Baseball",93695,90198,3497,93695,90198,3497,0,0,0,"29",".",14627,0
"12412",150455,"EARLHAM COLLEGE                                             ","2003-2004",25,"Track and Field, X-Country",40180,36694,3486,20090,18347,1743,20090,18347,1743,"14","9",1850,1850
"14496",148256,"REND LAKE COLLEGE                                           ","2003-2004",26,"Volleyball",44770,41286,3484,0,0,0,44770,41286,3484,".","13",0,10595
"13674",183239,"SAINT ANSELM COLLEGE                                        ","2003-2004",26,"Volleyball",36219,32741,3478,0,0,0,36219,32741,3478,".","11",0,22235
"6127",148256,"REND LAKE COLLEGE                                           ","2003-2004",8,"Golf",107735,104259,3476,46536,45767,769,61199,58492,2707,"10","12",23650,27360
"4749",110246,"BUTTE COLLEGE                                               ","2003-2004",7,"Football",98497,95024,3473,98497,95024,3473,0,0,0,"83",".",85214,0
"6482",191719,"HUDSON VALLEY COMMUNITY COLLEGE                             ","2003-2004",10,"Ice Hockey",30921,27453,3468,30921,27453,3468,0,0,0,"21",".",20202,0
"13256",239716,"SAINT NORBERT COLLEGE                                       ","2003-2004",26,"Volleyball",71327,67866,3461,0,0,0,71327,67866,3461,".","16",0,22700
"14404",154998,"DODGE CITY COMMUNITY COLLEGE                                ","2003-2004",26,"Volleyball",19349,15889,3460,0,0,0,19349,15889,3460,".","11",0,11651
"12578",139658,"EMORY UNIVERSITY                                            ","2003-2004",25,"Track and Field, X-Country",263860,260402,3458,131930,130201,1729,131930,130201,1729,"64","55",63101,63101
"11948",209056,"LEWIS &amp; CLARK COLLEGE                                       ","2003-2004",24,"Track and Field, Outdoor",62130,58674,3456,28920,27269,1651,33210,31405,1805,"14","17",9364,13500
"12192",209056,"LEWIS &amp; CLARK COLLEGE                                       ","2003-2004",25,"Track and Field, X-Country",62130,58674,3456,28920,27269,1651,33210,31405,1805,"13","23",9364,13500
"505",160977,"BATES COLLEGE                                               ","2003-2004",1,"Baseball",76733,73278,3455,76733,73278,3455,0,0,0,"29",".",23023,0
"987",155210,"JOHNSON COUNTY COMMUNITY COLLEGE                            ","2003-2004",1,"Baseball",94298,90861,3437,94298,90861,3437,0,0,0,"30",".",35474,0
"13437",114789,"FRESNO CITY COLLEGE                                         ","2003-2004",26,"Volleyball",12727,9290,3437,0,0,0,12727,9290,3437,".","11",0,7106
"8974",204200,"COLLEGE OF MOUNT SAINT JOSEPH                               ","2003-2004",16,"Softball",52487,49057,3430,0,0,0,52487,49057,3430,".","17",0,27183
"11418",206048,"TIFFIN UNIVERSITY                                           ","2003-2004",22,"Tennis",12536,9118,3418,4339,4339,0,8197,4779,3418,"14","16",2222,3419
"13810",211440,"CARNEGIE MELLON UNIVERSITY                                  ","2003-2004",26,"Volleyball",82152,78736,3416,0,0,0,82152,78736,3416,".","13",0,43790
"12649",173300,"CONCORDIA COLLEGE AT MOORHEAD                               ","2003-2004",25,"Track and Field, X-Country",158964,155553,3411,81299,82782,-1483,77665,72771,4894,"61","95",2986,499
"4037",233541,"SHENANDOAH UNIVERSITY                                       ","2003-2004",6,"Field hocky",29524,26116,3408,0,0,0,29524,26116,3408,".","10",0,5157
"12628",128498,"ALBERTUS MAGNUS COLLEGE                                     ","2003-2004",25,"Track and Field, X-Country",4800,1392,3408,2400,696,1704,2400,696,1704,"7","8",693,696
"13941",164562,"ASSUMPTION COLLEGE                                          ","2003-2004",26,"Volleyball",27302,23900,3402,0,0,0,27302,23900,3402,".","17",0,12500
"9075",162210,"COLUMBIA UNION COLLEGE                                      ","2003-2004",16,"Softball",48315,44916,3399,0,0,0,48315,44916,3399,".","12",0,18841
"13151",119164,"MT SAN ANTONIO COLLEGE                                      ","2003-2004",26,"Volleyball",74081,70687,3394,0,0,0,74081,70687,3394,".","14",0,6121
"8212",195526,"SKIDMORE COLLEGE                                            ","2003-2004",15,"Soccer",96466,93078,3388,52197,52527,-330,44269,40551,3718,"32","19",20271,14474
"5338",150756,"HANOVER COLLEGE                                             ","2003-2004",8,"Golf",39438,36065,3373,27407,26359,1048,12031,9706,2325,"10","9",11598,8091
"2480",138558,"ABRAHAM BALDWIN AGRICULTURAL COLLEGE                        ","2003-2004",2,"Basketball",130000,126631,3369,63000,63200,-200,67000,63431,3569,"19","15",50000,50000
"14010",122889,"SANTA BARBARA CITY COLLEGE                                  ","2003-2004",26,"Volleyball",46330,42964,3366,25861,24877,984,20469,18087,2382,"11","11",6681,4740
"7152",122339,"SAN DIEGO CITY COLLEGE                                      ","2003-2004",15,"Soccer",37668,34303,3365,16241,14168,2073,21427,20135,1292,"20","18",4174,5177
"16600",228501,"SUL ROSS STATE UNIVERSITY                                   ","2003-2004",39,"Total Participants",168764,165400,3364,74969,74873,96,93795,90527,3268,"160","71",150219,80239
"5777",234164,"VIRGINIA UNION UNIVERSITY                                   ","2003-2004",8,"Golf",31426,28066,3360,31426,28066,3360,0,0,0,"6",".",7035,0
"13923",171535,"OAKLAND COMMUNITY COLLEGE                                   ","2003-2004",26,"Volleyball",22166,18807,3359,0,0,0,22166,18807,3359,".","12",0,11185
"9205",155201,"INDEPENDENCE COMMUNITY COLLEGE                              ","2003-2004",16,"Softball",47220,43862,3358,0,0,0,47220,43862,3358,".","19",0,15085
"7584",111939,"CHAFFEY COLLEGE                                             ","2003-2004",15,"Soccer",16788,13433,3355,7807,5876,1931,8981,7557,1424,"27","21",2255,2730
"6708",190044,"CLARKSON UNIVERSITY                                         ","2003-2004",11,"Lacrosse",138716,135364,3352,92788,92613,175,45928,42751,3177,"41","21",58700,16432
"10874",210401,"WILLAMETTE UNIVERSITY                                       ","2003-2004",22,"Tennis",37004,33662,3342,18502,15527,2975,18502,18135,367,"11","13",5727,8335
"9459",221892,"TREVECCA NAZARENE UNIVERSITY                                ","2003-2004",16,"Softball",131591,128252,3339,0,0,0,131591,128252,3339,".","17",0,18967
"16563",208035,"WESTERN OKLAHOMA STATE COLLEGE                              ","2003-2004",39,"Total Participants",189280,185945,3335,123882,124657,-775,65398,61288,4110,"62","38",82261,59339
"943",212656,"GENEVA COLLEGE                                              ","2003-2004",1,"Baseball",203471,200137,3334,203471,200137,3334,0,0,0,"22",".",27071,0
"2911",196033,"SUNY COLLEGE OF AGRIC AND TECHN AT COBLESKILL               ","2003-2004",2,"Basketball",54167,50837,3330,42683,39713,2970,11484,11124,360,"17","12",32776,9348
"14289",110486,"CALIFORNIA STATE UNIVERSITY-BAKERSFIELD                     ","2003-2004",26,"Volleyball",186581,183252,3329,0,0,0,186581,183252,3329,".","16",0,32793
"8130",187134,"THE COLLEGE OF NEW JERSEY                                   ","2003-2004",15,"Soccer",156346,153021,3325,74402,73085,1317,81944,79936,2008,"28","22",13274,13043
"13260",148405,"ROCKFORD COLLEGE                                            ","2003-2004",26,"Volleyball",20903,17578,3325,0,0,0,20903,17578,3325,".","10",0,5934
"10131",174817,"SAINT MARY'S UNIVERSITY OF MINNESOTA                        ","2003-2004",18,"Swimming and Diving",55962,52645,3317,27098,25539,1559,28864,27106,1758,"4","14",7342,9093
"14523",214175,"MUHLENBERG COLLEGE                                          ","2003-2004",26,"Volleyball",28359,25042,3317,0,0,0,28359,25042,3317,".","10",0,14808
"10169",117140,"UNIVERSITY OF LA VERNE                                      ","2003-2004",18,"Swimming and Diving",81286,77972,3314,40643,38986,1657,40643,38986,1657,"11","10",6355,6355
"13845",154721,"BETHANY COLLEGE                                             ","2003-2004",26,"Volleyball",53507,50196,3311,0,0,0,53507,50196,3311,"0","9",0,9341
"3363",226383,"LUBBOCK CHRISTIAN UNIVERSITY                                ","2003-2004",2,"Basketball",656263,652962,3301,309561,304395,5166,346702,348567,-1865,"10","14",63047,73161
"742",117867,"LOS ANGELES MISSION COLLEGE                                 ","2003-2004",1,"Baseball",76300,73000,3300,76300,73000,3300,0,0,0,"29",".",31352,0
"9077",145707,"ILLINOIS EASTERN COMMUNITY COLLS-OLNEY CTRL COLL            ","2003-2004",16,"Softball",81243,77943,3300,0,0,0,81243,77943,3300,".","22",0,39945
"14078",105747,"SCOTTSDALE COMMUNITY COLLEGE                                ","2003-2004",26,"Volleyball",54591,51291,3300,0,0,0,54591,51291,3300,".","15",0,5000
"14530",211927,"DELAWARE COUNTY COMMUNITY COLLEGE                           ","2003-2004",26,"Volleyball",6000,2700,3300,0,0,0,6000,2700,3300,".","8",0,2800
"16964",105747,"SCOTTSDALE COMMUNITY COLLEGE                                ","2003-2004",39,"Total Participants",256162,252862,3300,120249,120249,0,135913,132613,3300,"197","110",89114,50257
"17254",118930,"MISSION COLLEGE                                             ","2003-2004",39,"Total Participants",129296,126005,3291,74157,70567,3590,55139,55438,-299,"47","36",13864,16102
"14801",119164,"MT SAN ANTONIO COLLEGE                                      ","2003-2004",28,"Wrestling",72684,69398,3286,72684,69398,3286,0,0,0,"21",".",6255,0
"1522",237066,"WHITWORTH COLLEGE                                           ","2003-2004",1,"Baseball",89344,86062,3282,89344,86062,3282,0,0,0,"33",".",51438,0
"8121",216524,"URSINUS COLLEGE                                             ","2003-2004",15,"Soccer",54412,51134,3278,27206,26193,1013,27206,24941,2265,"24","20",20046,20046
"13878",117751,"THE MASTER'S COLLEGE AND SEMINARY                           ","2003-2004",26,"Volleyball",146738,143463,3275,0,0,0,146738,143463,3275,".","12",0,18877
"8045",134945,"JACKSONVILLE UNIVERSITY                                     ","2003-2004",15,"Soccer",513065,509798,3267,241201,239680,1521,271864,270118,1746,"30","28",32425,33149
"12647",194310,"PACE UNIVERSITY-NEW YORK                                    ","2003-2004",25,"Track and Field, X-Country",19700,16444,3256,11850,9222,2628,7850,7222,628,"9","1",2722,2722
"8812",215743,"SAINT FRANCIS UNIVERSITY                                    ","2003-2004",16,"Softball",168004,164753,3251,0,0,0,168004,164753,3251,".","22",0,32995
"12391",179326,"SOUTHWEST BAPTIST UNIVERSITY                                ","2003-2004",25,"Track and Field, X-Country",166875,163624,3251,80670,78562,2108,86205,85062,1143,"12","11",8748,8748
"6300",173647,"GUSTAVUS ADOLPHUS COLLEGE                                   ","2003-2004",9,"Gymnastics",75330,72081,3249,0,0,0,75330,72081,3249,".","24",0,29834
"661",154022,"THE FRANCISCAN UNIVERSITY                                   ","2003-2004",1,"Baseball",16400,13158,3242,16400,13158,3242,0,0,0,"24",".",11500,0
"9763",113236,"CYPRESS COLLEGE                                             ","2003-2004",16,"Softball",54024,50783,3241,0,0,0,54024,50783,3241,".","17",0,23149
"8575",166850,"MERRIMACK COLLEGE                                           ","2003-2004",16,"Softball",193584,190346,3238,0,0,0,193584,190346,3238,".","16",0,29397
"11640",232089,"FERRUM COLLEGE                                              ","2003-2004",22,"Tennis",37362,34133,3229,18881,16689,2192,18481,17444,1037,"10","8",8264,9944
"1767",157863,"UNION COLLEGE                                               ","2003-2004",2,"Basketball",298775,295550,3225,150000,147775,2225,148775,147775,1000,"17","15",15775,15775
"6333",240189,"UNIVERSITY OF WISCONSIN-WHITEWATER                          ","2003-2004",9,"Gymnastics",50371,47146,3225,0,0,0,50371,47146,3225,".","12",0,16698
"667",216694,"WAYNESBURG COLLEGE                                          ","2003-2004",1,"Baseball",34368,31144,3224,34368,31144,3224,0,0,0,"36",".",28791,0
"11511",232423,"JAMES MADISON UNIVERSITY                                    ","2003-2004",22,"Tennis",252333,249117,3216,89021,90961,-1940,163312,158156,5156,"11","10",24652,32616
"1295",182980,"NEW ENGLAND COLLEGE                                         ","2003-2004",1,"Baseball",27203,23991,3212,27203,23991,3212,0,0,0,"18",".",10940,0
"2794",204185,"MOUNT UNION COLLEGE                                         ","2003-2004",2,"Basketball",175782,172570,3212,112107,108895,3212,63675,63675,0,"26","16",33233,17734
"5013",204264,"MUSKINGUM COLLEGE                                           ","2003-2004",7,"Football",82604,79404,3200,82604,79404,3200,0,0,0,"151",".",77927,0
"8352",170091,"GREAT LAKES CHRISTIAN COLLEGE                               ","2003-2004",15,"Soccer",3200,0,3200,3200,2821,379,0,0,0,"18",".",2121,0
"13392",143084,"AUGUSTANA COLLEGE                                           ","2003-2004",26,"Volleyball",61574,58374,3200,0,0,0,61574,58374,3200,".","28",0,17619
"14259",364025,"CHANDLER/GILBERT COMMUNITY COLLEGE                          ","2003-2004",26,"Volleyball",65326,62126,3200,0,0,0,65326,62126,3200,".","12",0,12718
"16892",170091,"GREAT LAKES CHRISTIAN COLLEGE                               ","2003-2004",39,"Total Participants",3200,0,3200,3200,2821,379,0,0,0,"18","0",2121,0
"14071",212577,"FRANKLIN AND MARSHALL COLLEGE                               ","2003-2004",26,"Volleyball",25450,22254,3196,0,0,0,25450,22254,3196,".","13",0,10137
"10982",132657,"LYNN UNIVERSITY                                             ","2003-2004",22,"Tennis",321780,318585,3195,112053,110373,1680,209727,208212,1515,"12","9",18403,21312
"7746",191083,"ERIE COMMUNITY COLLEGE                                      ","2003-2004",15,"Soccer",31408,28214,3194,18845,15766,3079,12563,12448,115,"25","15",11516,11198
"5662",190099,"COLGATE UNIVERSITY                                          ","2003-2004",8,"Golf",102655,99467,3188,102655,99467,3188,0,0,0,"13",".",14957,0
"11447",174817,"SAINT MARY'S UNIVERSITY OF MINNESOTA                        ","2003-2004",22,"Tennis",41011,37824,3187,20652,19711,941,20359,18113,2246,"10","13",7037,5793
"5091",105747,"SCOTTSDALE COMMUNITY COLLEGE                                ","2003-2004",7,"Football",87946,84760,3186,87946,84760,3186,0,0,0,"90",".",40500,0
"4185",161086,"COLBY COLLEGE                                               ","2003-2004",6,"Field hocky",23849,20671,3178,0,0,0,23849,20671,3178,".","21",0,19874
"14352",174075,"UNIVERSITY OF MINNESOTA-CROOKSTON                           ","2003-2004",26,"Volleyball",99750,96572,3178,0,0,0,99750,96572,3178,".","11",0,33522
"5514",155681,"PITTSBURG STATE UNIVERSITY                                  ","2003-2004",8,"Golf",20831,17654,3177,20831,17654,3177,0,0,0,"10",".",9362,0
"3284",175810,"HOLMES COMMUNITY COLLEGE                                    ","2003-2004",2,"Basketball",183061,179885,3176,99027,97528,1499,84034,82357,1677,"15","16",44760,43340
"3395",190521,"CUNY BOROUGH OF MANHATTAN COMMUNITY COLLEGE                 ","2003-2004",2,"Basketball",62388,59212,3176,29689,29395,294,32699,29817,2882,"17","18",16584,15306
"16485",170967,"ROCHESTER COLLEGE                                           ","2003-2004",39,"Total Participants",220535,217360,3175,104369,103917,452,116166,113443,2723,"59","57",64923,39856
"7141",166513,"UNIVERSITY OF MASSACHUSETTS-LOWELL                          ","2003-2004",15,"Soccer",233854,230687,3167,131856,133808,-1952,101998,96879,5119,"29","27",16802,18520
"3768",110574,"CALIFORNIA STATE UNIVERSITY-HAYWARD                         ","2003-2004",3,"All Track Combined",89678,86514,3164,42324,40988,1336,47354,45526,1828,"8","7",15624,20058
"16605",237057,"WHITMAN COLLEGE                                             ","2003-2004",39,"Total Participants",564367,561218,3149,290115,287597,2518,274252,273621,631,"114","117",221117,187155
"2407",219879,"CLEVELAND STATE COMMUNITY COLLEGE                           ","2003-2004",2,"Basketball",116770,113623,3147,58814,62163,-3349,57956,51460,6496,"15","13",34449,30904
"13246",204945,"OWENS COMMUNITY COLLEGE                                     ","2003-2004",26,"Volleyball",48133,44987,3146,0,0,0,48133,44987,3146,".","14",0,17244
"15605",155812,"UNIVERSITY OF SAINT MARY                                    ","2003-2004",39,"Total Participants",91199,88060,3139,40364,39856,508,50835,48204,2631,"121","60",74849,53343
"2287",215743,"SAINT FRANCIS UNIVERSITY                                    ","2003-2004",2,"Basketball",1432176,1429051,3125,761468,710983,50485,670708,718068,-47360,"15","14",139028,133130
"11679",106342,"LYON COLLEGE                                                ","2003-2004",22,"Tennis",64185,61063,3122,33099,31538,1561,31086,29525,1561,"8","7",5278,5278
"5140",110671,"UNIVERSITY OF CALIFORNIA-RIVERSIDE                          ","2003-2004",8,"Golf",250229,247115,3114,143057,131500,11557,107172,115615,-8443,"9","9",691,760
"16223",180984,"CONCORDIA UNIVERSITY                                        ","2003-2004",39,"Total Participants",732672,729562,3110,325740,325310,430,406932,404252,2680,"214","140",111667,79557
"1469",220613,"LEE UNIVERSITY                                              ","2003-2004",1,"Baseball",266933,263824,3109,266933,263824,3109,0,0,0,"30",".",57415,0
"3422",203535,"KENYON COLLEGE                                              ","2003-2004",2,"Basketball",168298,165191,3107,91173,89316,1857,77125,75875,1250,"11","9",29322,23642
"8176",216278,"SUSQUEHANNA UNIVERSITY                                      ","2003-2004",15,"Soccer",78471,75365,3106,43128,39429,3699,35343,35936,-593,"35","22",11327,10778
"12773",144944,"ELGIN COMMUNITY COLLEGE                                     ","2003-2004",25,"Track and Field, X-Country",11000,7900,3100,5500,4100,1400,5500,3800,1700,"4","4",2400,2100
"13987",210304,"WARNER PACIFIC COLLEGE                                      ","2003-2004",26,"Volleyball",21781,18681,3100,0,0,0,21781,18681,3100,".","11",0,11680
"9299",439288,"JOHNSON &amp; WALES UNIVERSITY-DENVER                           ","2003-2004",16,"Softball",15795,12699,3096,0,0,0,15795,12699,3096,".","13",0,7699
"5913",214591,"PENNSYLVANIA STATE UNIV-PENN ST ERIE-BEHREND COLL           ","2003-2004",8,"Golf",7472,4380,3092,3736,2190,1546,3736,2190,1546,"10","5",2161,2161
"1165",211644,"CLARION UNIVERSITY OF PENNSYLVANIA                          ","2003-2004",1,"Baseball",37871,34781,3090,37871,34781,3090,0,0,0,"27",".",10002,0
"3328",111461,"COLLEGE OF THE CANYONS                                      ","2003-2004",2,"Basketball",29397,26307,3090,16339,14918,1421,13058,11389,1669,"11","11",11732,11302
"10242",204857,"OHIO UNIVERSITY-MAIN CAMPUS                                 ","2003-2004",18,"Swimming and Diving",517698,514608,3090,105116,104160,956,412582,410448,2134,"21","26",13766,41910
"3299",119216,"MT SAN JACINTO COLLEGE                                      ","2003-2004",2,"Basketball",63908,60832,3076,39745,36845,2900,24163,23987,176,"14","11",9666,9848
"1873",154642,"ALLEN COUNTY COMMUNITY COLLEGE                              ","2003-2004",2,"Basketball",65130,62061,3069,35346,33825,1521,29784,28236,1548,"13","11",20092,12964
"3263",173638,"MINNESOTA WEST COMMUNITY AND TECHNICAL COLLEGE              ","2003-2004",2,"Basketball",41548,38495,3053,21345,19907,1438,20203,18588,1615,"11","9",10866,9544
"4546",148584,"UNIVERSITY OF ST FRANCIS                                    ","2003-2004",7,"Football",622661,619612,3049,622661,619612,3049,0,0,0,"62",".",88339,0
"8582",184348,"DREW UNIVERSITY                                             ","2003-2004",16,"Softball",58338,55290,3048,0,0,0,58338,55290,3048,".","18",0,9539
"16104",121691,"UNIVERSITY OF REDLANDS                                      ","2003-2004",39,"Total Participants",762996,759953,3043,366823,364280,2543,396173,395673,500,"305","181",277396,131655
"2066",174899,"THE COLLEGE OF SAINT SCHOLASTICA                            ","2003-2004",2,"Basketball",175335,172293,3042,84682,82874,1808,90653,89419,1234,"15","12",31340,26940
"3192",178059,"MARYVILLE UNIVERSITY OF SAINT LOUIS                         ","2003-2004",2,"Basketball",72393,69356,3037,31314,36154,-4840,41079,33202,7877,"16","16",30221,28060
"5806",155335,"NEWMAN UNIVERSITY                                           ","2003-2004",8,"Golf",85311,82275,3036,64153,61175,2978,21158,21100,58,"12","9",22625,13100
"14135",139393,"COVENANT COLLEGE                                            ","2003-2004",26,"Volleyball",154502,151472,3030,0,0,0,154502,151472,3030,".","17",0,23607
"9131",198066,"BREVARD COLLEGE                                             ","2003-2004",16,"Softball",53600,50571,3029,0,0,0,53600,50571,3029,".","16",0,17071
"10526",214041,"MILLERSVILLE UNIVERSITY OF PENNSYLVANIA                     ","2003-2004",19,"Swimming",35422,32393,3029,0,0,0,35422,32393,3029,".","14",0,6601
"4618",240365,"UNIVERSITY OF WISCONSIN-OSHKOSH                             ","2003-2004",7,"Football",129432,126405,3027,129432,126405,3027,0,0,0,"98",".",73600,0
"8434",178244,"MISSOURI BAPTIST UNIVERSITY                                 ","2003-2004",15,"Soccer",553017,550006,3011,333807,330796,3011,219210,219210,0,"34","20",23011,21291
"9458",178402,"UNIVERSITY OF MISSOURI-KANSAS CITY                          ","2003-2004",16,"Softball",273201,270199,3002,0,0,0,273201,270199,3002,".","19",0,40767
"12470",199962,"WINGATE UNIVERSITY                                          ","2003-2004",25,"Track and Field, X-Country",21622,18620,3002,10711,9310,1401,10911,9310,1601,"11","13",4595,4975
"10041",153472,"INDIAN HILLS COMMUNITY COLLEGE                              ","2003-2004",16,"Softball",122756,119755,3001,0,0,0,122756,119755,3001,".","16",0,48374
"680",201195,"BALDWIN-WALLACE COLLEGE                                     ","2003-2004",1,"Baseball",94149,91149,3000,94149,91149,3000,0,0,0,"53",".",35495,0
"2018",414823,"JOHNSON &amp; WALES UNIVERSITY-FLORIDA CAMPUS                   ","2003-2004",2,"Basketball",22000,19000,3000,22000,19000,3000,0,0,0,"14",".",12000,0
"2471",214704,"PENNSYLVANIA STATE UNIVERSITY-PENN STATE BERKS              ","2003-2004",2,"Basketball",58025,55025,3000,31125,29125,2000,26900,25900,1000,"12","11",13125,11200
"2866",152318,"ROSE-HULMAN INSTITUTE OF TECHNOLOGY                         ","2003-2004",2,"Basketball",235734,232734,3000,142034,140034,2000,93700,92700,1000,"18","9",50923,43700
"3660",150145,"BETHEL COLLEGE                                              ","2003-2004",3,"All Track Combined",37000,34000,3000,18500,17000,1500,18500,17000,1500,"31","23",15000,15000
"3678",414823,"JOHNSON &amp; WALES UNIVERSITY-FLORIDA CAMPUS                   ","2003-2004",3,"All Track Combined",10000,7000,3000,5000,3500,1500,5000,3500,1500,"5","3",2500,2500
"4506",117706,"LOS ANGELES PIERCE COLLEGE                                  ","2003-2004",7,"Football",101080,98080,3000,101080,98080,3000,0,0,0,"57",".",40330,0
"7028",230898,"GREEN MOUNTAIN COLLEGE                                      ","2003-2004",14,"Skiing",68493,65493,3000,34914,33414,1500,33579,32079,1500,"8","10",14209,14209
"9488",230898,"GREEN MOUNTAIN COLLEGE                                      ","2003-2004",16,"Softball",37420,34420,3000,0,0,0,37420,34420,3000,".","13",0,17420
"10708",217475,"COMMUNITY COLLEGE OF RHODE ISLAND                           ","2003-2004",22,"Tennis",6000,3000,3000,3000,1500,1500,3000,1500,1500,"6","3",1200,1200
"16966",201195,"BALDWIN-WALLACE COLLEGE                                     ","2003-2004",39,"Total Participants",847449,844449,3000,438219,435219,3000,409230,409230,0,"441","242",401286,239872
"6927",195003,"ROCHESTER INSTITUTE OF TECHNOLOGY                           ","2003-2004",13,"Rowing",45026,42027,2999,0,0,0,45026,42027,2999,".","26",0,27311
"1874",189547,"BROOME COMMUNITY COLLEGE                                    ","2003-2004",2,"Basketball",46476,43480,2996,23665,22073,1592,22811,21407,1404,"16","12",16318,15652
"14985",164270,"MCDANIEL COLLEGE                                            ","2003-2004",28,"Wrestling",36435,33445,2990,36435,33445,2990,0,0,0,"24",".",24135,0
"12960",134079,"FLORIDA SOUTHERN COLLEGE                                    ","2003-2004",25,"Track and Field, X-Country",56666,53687,2979,21114,20059,1055,35552,33628,1924,"11","12",10318,11133
"6296",232557,"LIBERTY UNIVERSITY                                          ","2003-2004",8,"Golf",58556,55580,2976,58556,55580,2976,0,0,0,"15",".",24074,0
"5707",138789,"ARMSTRONG ATLANTIC STATE UNIVERSITY                         ","2003-2004",8,"Golf",48206,45231,2975,48206,45231,2975,0,0,0,"9",".",20039,0
"8037",230913,"JOHNSON STATE COLLEGE                                       ","2003-2004",15,"Soccer",29808,26838,2970,13373,12953,420,16435,13885,2550,"18","18",10182,11174
"6880",166683,"MASSACHUSETTS INSTITUTE OF TECHNOLOGY                       ","2003-2004",12,"Rifle",29647,26689,2958,29647,26689,2958,0,0,0,"17",".",10822,0
"12276",366711,"CALIFORNIA STATE UNIVERSITY-SAN MARCOS                      ","2003-2004",25,"Track and Field, X-Country",67798,64842,2956,33899,32421,1478,33899,32421,1478,"16","13",8885,8885
"1975",240471,"UNIVERSITY OF WISCONSIN-RIVER FALLS                         ","2003-2004",2,"Basketball",212109,209156,2953,127656,115210,12446,84453,93946,-9493,"18","19",26944,37209
"8529",234669,"BELLEVUE COMMUNITY COLLEGE                                  ","2003-2004",16,"Softball",20000,17050,2950,0,0,0,20000,17050,2950,".","15",0,13000
"14600",192022,"JEFFERSON COMMUNITY COLLEGE                                 ","2003-2004",26,"Volleyball",9174,6230,2944,0,0,0,9174,6230,2944,".","11",0,2630
"14744",113236,"CYPRESS COLLEGE                                             ","2003-2004",27,"Water Polo",18583,15639,2944,0,0,0,18583,15639,2944,".","11",0,9510
"11622",144944,"ELGIN COMMUNITY COLLEGE                                     ","2003-2004",22,"Tennis",17340,14400,2940,8670,7100,1570,8670,7300,1370,"8","8",5600,5900
"11157",145372,"GREENVILLE COLLEGE                                          ","2003-2004",22,"Tennis",28433,25495,2938,13728,13772,-44,14705,11723,2982,"6","8",6246,5046
"1175",189848,"CAZENOVIA COLLEGE                                           ","2003-2004",1,"Baseball",61000,58071,2929,61000,58071,2929,0,0,0,"22",".",57071,0
"852",179326,"SOUTHWEST BAPTIST UNIVERSITY                                ","2003-2004",1,"Baseball",164998,162070,2928,164998,162070,2928,0,0,0,"29",".",21918,0
"13684",173665,"HAMLINE UNIVERSITY                                          ","2003-2004",26,"Volleyball",70256,67328,2928,0,0,0,70256,67328,2928,".","17",0,16241
"6584",183974,"CENTENARY COLLEGE                                           ","2003-2004",11,"Lacrosse",98018,95095,2923,62824,60801,2023,35194,34294,900,"28","15",25816,7327
"4214",164173,"VILLA JULIE COLLEGE                                         ","2003-2004",6,"Field hocky",25288,22366,2922,0,0,0,25288,22366,2922,".","28",0,15100
"11763",210234,"TREASURE VALLEY COMMUNITY COLLEGE                           ","2003-2004",22,"Tennis",22555,19634,2921,11655,9472,2183,10900,10162,738,"6","6",7000,7000
"10171",119164,"MT SAN ANTONIO COLLEGE                                      ","2003-2004",18,"Swimming and Diving",124459,121541,2918,66091,64632,1459,58368,56909,1459,"23","27",4213,4177
"14654",119164,"MT SAN ANTONIO COLLEGE                                      ","2003-2004",27,"Water Polo",128180,125262,2918,67658,66199,1459,60522,59063,1459,"15","12",5780,6331
"14665",111939,"CHAFFEY COLLEGE                                             ","2003-2004",27,"Water Polo",31769,28855,2914,9938,9224,714,21831,19631,2200,"13","18",3934,4588
"5017",165699,"ENDICOTT COLLEGE                                            ","2003-2004",7,"Football",92410,89500,2910,92410,89500,2910,0,0,0,"75",".",36550,0
"11347",196167,"SUNY COLLEGE AT GENESEO                                     ","2003-2004",22,"Tennis",34084,31181,2903,0,0,0,34084,31181,2903,".","14",0,15512
"6537",190983,"ELMIRA COLLEGE                                              ","2003-2004",11,"Lacrosse",136528,133628,2900,81475,78376,3099,55053,55252,-199,"30","30",30224,23349
"14359",174862,"CROWN COLLEGE                                               ","2003-2004",26,"Volleyball",18805,15906,2899,0,0,0,18805,15906,2899,".","11",0,10721
"5313",122889,"SANTA BARBARA CITY COLLEGE                                  ","2003-2004",8,"Golf",69593,66695,2898,40058,37973,2085,29535,28722,813,"8","8",15098,5847
"4226",130226,"QUINNIPIAC UNIVERSITY                                       ","2003-2004",6,"Field hocky",415701,412804,2897,0,0,0,415701,412804,2897,".","23",0,67790
"15950",110468,"ALLIANT INTERNATIONAL UNIVERSITY-SAN DIEGO                  ","2003-2004",39,"Total Participants",304000,301103,2897,133000,135935,-2935,171000,165168,5832,"51","47",42953,52701
"15078",194310,"PACE UNIVERSITY-NEW YORK                                    ","2003-2004",29,"Other Sports",7395,4500,2895,1250,1250,0,6145,3250,2895,"0","18",1,2500
"11928",202222,"COLUMBUS STATE COMMUNITY COLLEGE                            ","2003-2004",24,"Track and Field, Outdoor",10050,7158,2892,5025,3579,1446,5025,3579,1446,"7","4",2647,1512
"1347",120290,"OHLONE COLLEGE                                              ","2003-2004",1,"Baseball",38737,35848,2889,38737,35848,2889,0,0,0,"31",".",19259,0
"6890",164562,"ASSUMPTION COLLEGE                                          ","2003-2004",13,"Rowing",25642,22754,2888,6106,5417,689,19536,17337,2199,"5","16",3200,10172
"13387",207069,"REDLANDS COMMUNITY COLLEGE                                  ","2003-2004",26,"Volleyball",28928,26043,2885,0,0,0,28928,26043,2885,".","18",0,19427
"14980",143084,"AUGUSTANA COLLEGE                                           ","2003-2004",28,"Wrestling",50163,47278,2885,50163,47278,2885,0,0,0,"22",".",25960,0
"13548",167899,"SPRINGFIELD COLLEGE                                         ","2003-2004",26,"Volleyball",47700,44825,2875,24944,23944,1000,22756,20881,1875,"17","30",18583,15888
"887",123013,"SANTA ROSA JUNIOR COLLEGE                                   ","2003-2004",1,"Baseball",44273,41408,2865,44273,41408,2865,0,0,0,"35",".",28979,0
"6713",215099,"PHILADELPHIA UNIVERSITY                                     ","2003-2004",11,"Lacrosse",131571,128712,2859,0,0,0,131571,128712,2859,".","24",0,7540
"5884",137847,"THE UNIVERSITY OF TAMPA                                     ","2003-2004",8,"Golf",59203,56346,2857,59203,56346,2857,0,0,0,"13","0",29103,0
"11714",117946,"LOYOLA MARYMOUNT UNIVERSITY                                 ","2003-2004",22,"Tennis",641221,638365,2856,254013,253419,594,387208,384946,2262,"9","10",43491,50740
"2600",170620,"LAKE MICHIGAN COLLEGE                                       ","2003-2004",2,"Basketball",80425,77570,2855,39850,37905,1945,40575,39665,910,"14","14",8839,8591
"13494",198303,"CHOWAN COLLEGE                                              ","2003-2004",26,"Volleyball",32910,30056,2854,0,0,0,32910,30056,2854,".","9",0,11599
"12203",146825,"MACMURRAY COLLEGE                                           ","2003-2004",25,"Track and Field, X-Country",12727,9893,2834,7000,5583,1417,5727,4310,1417,"4","6",2378,1105
"14812",174738,"ROCHESTER COMMUNITY AND TECHNICAL COLLEGE                   ","2003-2004",28,"Wrestling",38817,35983,2834,38817,35983,2834,0,0,0,"21",".",19675,0
"16631",238616,"CONCORDIA UNIVERSITY-WISCONSIN                              ","2003-2004",39,"Total Participants",194187,191358,2829,109871,107933,1938,84316,83425,891,"266","98",117505,66480
"3951",146427,"KNOX COLLEGE                                                ","2003-2004",3,"All Track Combined",73996,71171,2825,38019,36309,1710,35977,34862,1115,"72","67",16985,15538
"15072",110635,"UNIVERSITY OF CALIFORNIA-BERKELEY                           ","2003-2004",29,"Other Sports",388387,385565,2822,388387,385565,2822,0,0,0,"49",".",142388,0
"12967",213613,"LOCK HAVEN UNIVERSITY OF PENNSYLVANIA                       ","2003-2004",25,"Track and Field, X-Country",356782,353962,2820,190698,183580,7118,166084,170382,-4298,"73","62",27743,27743
"15849",151777,"MANCHESTER COLLEGE                                          ","2003-2004",39,"Total Participants",368501,365681,2820,202965,201490,1475,165536,164191,1345,"341","204",165980,84264
"322",239512,"NORTHLAND COLLEGE                                           ","2003-2004",1,"Baseball",71367,68554,2813,71367,68554,2813,0,0,0,"22",".",49008,0
"4112",186201,"RAMAPO COLLEGE OF NEW JERSEY                                ","2003-2004",6,"Field hocky",39992,37190,2802,0,0,0,39992,37190,2802,".","13",0,23566
"5430",213233,"JOHNSON COLLEGE                                             ","2003-2004",8,"Golf",2800,0,2800,2800,2702,98,0,0,0,"6",".",450,0
"9891",211927,"DELAWARE COUNTY COMMUNITY COLLEGE                           ","2003-2004",16,"Softball",6000,3200,2800,0,0,0,6000,3200,2800,".","14",0,2800
"11426",112260,"CLAREMONT MCKENNA COLLEGE                                   ","2003-2004",22,"Tennis",114112,111312,2800,50935,49399,1536,63177,61913,1264,"12","9",14651,13451
"16614",174817,"SAINT MARY'S UNIVERSITY OF MINNESOTA                        ","2003-2004",39,"Total Participants",762905,760105,2800,372033,370978,1055,390872,389127,1745,"173","171",159646,159415
"4217",191515,"HAMILTON COLLEGE                                            ","2003-2004",6,"Field hocky",42300,39501,2799,0,0,0,42300,39501,2799,".","25",0,13681
"10843",118976,"MODESTO JUNIOR COLLEGE                                      ","2003-2004",22,"Tennis",88249,85452,2797,22698,22202,496,65551,63250,2301,"10","9",5379,5833
"8365",143215,"SOUTHWESTERN ILLINOIS COLLEGE                               ","2003-2004",15,"Soccer",105311,102517,2794,50121,48417,1704,55190,54100,1090,"25","19",9478,10748
"14592",161767,"ANNE ARUNDEL COMMUNITY COLLEGE                              ","2003-2004",26,"Volleyball",11755,8961,2794,0,0,0,11755,8961,2794,".","10",0,6800
"10215",167899,"SPRINGFIELD COLLEGE                                         ","2003-2004",18,"Swimming and Diving",40292,37502,2790,16040,15320,720,24252,22182,2070,"20","33",13885,19936
"3616",174817,"SAINT MARY'S UNIVERSITY OF MINNESOTA                        ","2003-2004",3,"All Track Combined",102750,99969,2781,53901,50270,3631,48849,49699,-850,"22","29",15620,21232
"12320",228149,"ST MARYS UNIVERSITY                                         ","2003-2004",25,"Track and Field, X-Country",10300,7522,2778,0,0,0,10300,7522,2778,".","10",0,4644
"7206",166391,"LASELL COLLEGE                                              ","2003-2004",15,"Soccer",53572,50795,2777,29867,28868,999,23705,21927,1778,"23","21",17614,13137
"4541",155681,"PITTSBURG STATE UNIVERSITY                                  ","2003-2004",7,"Football",807419,804646,2773,807419,804646,2773,0,0,0,"107",".",90149,0
"5854",217484,"UNIVERSITY OF RHODE ISLAND                                  ","2003-2004",8,"Golf",302423,299657,2766,302423,299657,2766,0,0,0,"17",".",72520,0
"5315",179326,"SOUTHWEST BAPTIST UNIVERSITY                                ","2003-2004",8,"Golf",48098,45340,2758,48098,45340,2758,0,0,0,"9",".",14826,0
"9988",206048,"TIFFIN UNIVERSITY                                           ","2003-2004",16,"Softball",18638,15892,2746,0,0,0,18638,15892,2746,".","39",0,7146
"2",184603,"FAIRLEIGH DICKINSON UNIVERSITY-METROPOLITAN CAMPUS          ","2003-2004",1,"Baseball",216109,213364,2745,216109,213364,2745,0,0,0,"24",".",78299,0
"2728",145521,"HIGHLAND COMMUNITY COLLEGE                                  ","2003-2004",2,"Basketball",42026,39287,2739,22935,20733,2202,19091,18554,537,"12","8",17150,13204
"509",119331,"NAPA VALLEY COLLEGE                                         ","2003-2004",1,"Baseball",27226,24492,2734,27226,24492,2734,0,0,0,"27",".",6891,0
"4809",173638,"MINNESOTA WEST COMMUNITY AND TECHNICAL COLLEGE              ","2003-2004",7,"Football",38510,35784,2726,38510,35784,2726,0,0,0,"51",".",28377,0
"6054",133711,"FLAGLER COLLEGE                                             ","2003-2004",8,"Golf",43460,40739,2721,22710,22310,400,20750,18429,2321,"8","8",10450,6679
"14190",413723,"CASCADE COLLEGE                                             ","2003-2004",26,"Volleyball",22534,19816,2718,0,0,0,22534,19816,2718,"0","10",0,7565
"17119",413723,"CASCADE COLLEGE                                             ","2003-2004",39,"Total Participants",78127,75409,2718,27372,28916,-1544,50755,46493,4262,"45","42",22503,22428
"10833",198598,"GREENSBORO COLLEGE                                          ","2003-2004",22,"Tennis",34493,31779,2714,15984,14627,1357,18509,17152,1357,"7","8",5976,6001
"3416",144971,"EUREKA COLLEGE                                              ","2003-2004",2,"Basketball",78275,75564,2711,35212,33591,1621,43063,41973,1090,"15","11",13489,11517
"10839",146825,"MACMURRAY COLLEGE                                           ","2003-2004",22,"Tennis",6297,3590,2707,3127,1357,1770,3170,2233,937,"8","6",345,2083
"11826",160977,"BATES COLLEGE                                               ","2003-2004",23,"Track and Field, Indoor",77767,75060,2707,36662,34729,1933,41105,40331,774,"35","39",13252,10263
"7380",233541,"SHENANDOAH UNIVERSITY                                       ","2003-2004",15,"Soccer",94351,91647,2704,48516,48772,-256,45835,42875,2960,"23","14",21933,11052
"8298",115393,"HARTNELL COLLEGE                                            ","2003-2004",15,"Soccer",50138,47441,2697,33137,30440,2697,17001,17001,0,"26","13",10175,10131
"3753",207582,"ORAL ROBERTS UNIVERSITY                                     ","2003-2004",3,"All Track Combined",894784,892093,2691,393872,392781,1091,500912,499312,1600,"45","48",60245,57468
"5603",213349,"KUTZTOWN UNIVERSITY OF PENNSYLVANIA                         ","2003-2004",8,"Golf",34250,31561,2689,0,0,0,34250,31561,2689,".","7",0,12718
"7641",211352,"CABRINI COLLEGE                                             ","2003-2004",15,"Soccer",38358,35680,2678,20258,17957,2301,18100,17723,377,"26","23",16946,16447
"5428",153001,"BUENA VISTA UNIVERSITY                                      ","2003-2004",8,"Golf",34757,32082,2675,14967,13556,1411,19790,18526,1264,"14","9",7643,10900
"2049",107512,"OUACHITA BAPTIST UNIVERSITY                                 ","2003-2004",2,"Basketball",654162,651494,2668,358003,355335,2668,296159,296159,0,"16","11",42826,33812
"1675",144564,"DANVILLE AREA COMMUNITY COLLEGE                             ","2003-2004",2,"Basketball",50968,48301,2667,27327,25993,1334,23641,22308,1333,"18","11",25992,22307
"8707",239512,"NORTHLAND COLLEGE                                           ","2003-2004",16,"Softball",68973,66306,2667,0,0,0,68973,66306,2667,".","14",0,37231
"4638",175643,"EAST CENTRAL COMMUNITY COLLEGE                              ","2003-2004",7,"Football",281824,279161,2663,281824,279161,2663,0,0,0,"55",".",51465,0
"14624",176664,"BAPTIST BIBLE COLLEGE AND GRADUATE SCHOOL                   ","2003-2004",26,"Volleyball",15157,12500,2657,0,0,0,15157,12500,2657,".","12",0,12000
"14774",167899,"SPRINGFIELD COLLEGE                                         ","2003-2004",28,"Wrestling",42046,39391,2655,42046,39391,2655,0,0,0,"38",".",24622,0
"10495",243133,"UNIVERSITY OF PUERTO RICO-BAYAMON                           ","2003-2004",19,"Swimming",5000,2346,2654,2500,1173,1327,2500,1173,1327,"8","2",691,691
"3175",161457,"UNIVERSITY OF NEW ENGLAND                                   ","2003-2004",2,"Basketball",80507,77856,2651,42556,41061,1495,37951,36795,1156,"16","11",19239,13630
"15259",195216,"ST LAWRENCE UNIVERSITY                                      ","2003-2004",34,"Equestrian",71581,68930,2651,0,0,0,71581,68930,2651,".","24",0,16784
"8075",217475,"COMMUNITY COLLEGE OF RHODE ISLAND                           ","2003-2004",15,"Soccer",38000,35350,2650,18000,15350,2650,20000,20000,0,"23","23",12300,16000
"14757",237783,"SALEM INTERNATIONAL UNIVERSITY                              ","2003-2004",27,"Water Polo",61434,58785,2649,32144,30944,1200,29290,27841,1449,"13","14",19895,16792
"5316",206941,"UNIVERSITY OF CENTRAL OKLAHOMA                              ","2003-2004",8,"Golf",20156,17514,2642,9162,8736,426,10994,8778,2216,"11","10",8735,8777
"13254",168546,"ALBION COLLEGE                                              ","2003-2004",26,"Volleyball",47611,44977,2634,0,0,0,47611,44977,2634,".","23",0,14008
"5426",171492,"NORTHWOOD UNIVERSITY                                        ","2003-2004",8,"Golf",125233,122600,2633,65599,60592,5007,59634,62008,-2374,"15","10",14263,13031
"1172",214175,"MUHLENBERG COLLEGE                                          ","2003-2004",1,"Baseball",30379,27755,2624,30379,27755,2624,0,0,0,"34",".",20871,0
"12484",212197,"ELIZABETHTOWN COLLEGE                                       ","2003-2004",25,"Track and Field, X-Country",86988,84364,2624,42044,40732,1312,44944,43632,1312,"88","74",15242,15242
"15594",127918,"REGIS UNIVERSITY                                            ","2003-2004",39,"Total Participants",1664090,1661472,2618,653242,693624,-40382,1010848,967848,43000,"92","89",188929,164146
"6619",192703,"MANHATTAN COLLEGE                                           ","2003-2004",11,"Lacrosse",391031,388415,2616,222643,220028,2615,168388,168387,1,"35","19",77986,57552
"2826",111188,"CALIFORNIA MARITIME ACADEMY                                 ","2003-2004",2,"Basketball",33615,31000,2615,33615,31000,2615,0,0,0,"9",".",14200,0
"1384",243133,"UNIVERSITY OF PUERTO RICO-BAYAMON                           ","2003-2004",1,"Baseball",8000,5389,2611,8000,5389,2611,0,0,0,"26",".",2447,0
"1855",197911,"BARTON COLLEGE                                              ","2003-2004",2,"Basketball",363823,361221,2602,197358,195335,2023,166465,165886,579,"18","16",21657,24175
"16241",149505,"TRINITY CHRISTIAN COLLEGE                                   ","2003-2004",39,"Total Participants",220600,218000,2600,105313,104313,1000,115287,113687,1600,"75","81",88164,90632
"11635",110468,"ALLIANT INTERNATIONAL UNIVERSITY-SAN DIEGO                  ","2003-2004",22,"Tennis",52000,49410,2590,26000,24611,1389,26000,24799,1201,"8","7",2157,2157
"10603",198598,"GREENSBORO COLLEGE                                          ","2003-2004",19,"Swimming",18540,15952,2588,0,0,0,18540,15952,2588,"0","12",0,6130
"14452",228769,"THE UNIVERSITY OF TEXAS AT ARLINGTON                        ","2003-2004",26,"Volleyball",370502,367916,2586,0,0,0,370502,367916,2586,".","12",0,96152
"16980",146427,"KNOX COLLEGE                                                ","2003-2004",39,"Total Participants",281881,279295,2586,110139,117173,-7034,171742,162122,9620,"257","160",127252,84840
"3330",228343,"SOUTHWESTERN UNIVERSITY                                     ","2003-2004",2,"Basketball",241600,239015,2585,124437,123968,469,117163,115047,2116,"16","14",59435,61065
"6767",216278,"SUSQUEHANNA UNIVERSITY                                      ","2003-2004",11,"Lacrosse",112815,110231,2584,46612,45791,821,66203,64440,1763,"26","16",15439,14668
"2661",220701,"MARTIN METHODIST COLLEGE                                    ","2003-2004",2,"Basketball",433653,431079,2574,234867,231981,2886,198786,199098,-312,"18","10",37064,15885
"12115",209065,"LINFIELD COLLEGE                                            ","2003-2004",24,"Track and Field, Outdoor",83472,80912,2560,41736,40456,1280,41736,40456,1280,"47","22",13771,13794
"3045",217059,"YORK COLLEGE PENNSYLVANIA                                   ","2003-2004",2,"Basketball",138455,135902,2553,75628,72282,3346,62827,63620,-793,"15","10",22955,20073
"7063",166683,"MASSACHUSETTS INSTITUTE OF TECHNOLOGY                       ","2003-2004",14,"Skiing",40438,37885,2553,40438,37885,2553,0,0,0,"14",".",28660,0
"11440",240365,"UNIVERSITY OF WISCONSIN-OSHKOSH                             ","2003-2004",22,"Tennis",21741,19188,2553,10671,10599,72,11070,8589,2481,"10","12",9566,7556
"2991",105747,"SCOTTSDALE COMMUNITY COLLEGE                                ","2003-2004",2,"Basketball",112602,110051,2551,55716,54965,751,56886,55086,1800,"15","18",10134,10134
"15188",155335,"NEWMAN UNIVERSITY                                           ","2003-2004",33,"Bowling",58000,55450,2550,29000,27725,1275,29000,27725,1275,"8","7",17727,17725
"14374",144351,"CONCORDIA UNIVERSITY                                        ","2003-2004",26,"Volleyball",13853,11305,2548,0,0,0,13853,11305,2548,".","18",0,10070
"16189",236896,"WALLA WALLA COLLEGE                                         ","2003-2004",39,"Total Participants",84564,82020,2544,43589,43246,343,40975,38774,2201,"52","40",55323,49618
"12288",153126,"CLARKE COLLEGE                                              ","2003-2004",25,"Track and Field, X-Country",11230,8689,2541,5285,4345,940,5945,4344,1601,"5","11",2024,2024
"6850",178402,"UNIVERSITY OF MISSOURI-KANSAS CITY                          ","2003-2004",12,"Rifle",69564,67025,2539,43478,41115,2363,26086,25910,176,"8","0",38013,22808
"2129",236975,"WENATCHEE VALLEY COLLEGE                                    ","2003-2004",2,"Basketball",68565,66028,2537,37702,37697,5,30863,28331,2532,"14","10",37696,28330
"9990",137032,"SAINT LEO UNIVERSITY                                        ","2003-2004",16,"Softball",101939,99406,2533,0,0,0,101939,99406,2533,".","14",0,38736
"17008",226930,"MOUNTAIN VIEW COLLEGE                                       ","2003-2004",39,"Total Participants",88100,85567,2533,28100,27171,929,60000,58396,1604,"44","42",26268,23730
"4526",177144,"CULVER-STOCKTON COLLEGE                                     ","2003-2004",7,"Football",225960,223430,2530,225960,223430,2530,0,0,0,"83",".",60459,0
"7388",166683,"MASSACHUSETTS INSTITUTE OF TECHNOLOGY                       ","2003-2004",15,"Soccer",80461,77933,2528,50832,49468,1364,29629,28465,1164,"26","26",21999,11851
"14327",212601,"GANNON UNIVERSITY                                           ","2003-2004",26,"Volleyball",146491,143965,2526,0,0,0,146491,143965,2526,".","12",0,25685
"135",176318,"RUST COLLEGE                                                ","2003-2004",1,"Baseball",13000,10475,2525,13000,10475,2525,0,0,0,"11",".",4579,0
"1997",238263,"MADISON AREA TECHNICAL COLLEGE                              ","2003-2004",2,"Basketball",67924,65402,2522,36472,34258,2214,31452,31144,308,"15","15",18088,15362
"9485",208275,"BLUE MOUNTAIN COMMUNITY COLLEGE                             ","2003-2004",16,"Softball",52942,50422,2520,0,0,0,52942,50422,2520,".","16",0,17482
"9276",240365,"UNIVERSITY OF WISCONSIN-OSHKOSH                             ","2003-2004",16,"Softball",44615,42096,2519,0,0,0,44615,42096,2519,".","18",0,39498
"11888",231581,"BRIDGEWATER COLLEGE                                         ","2003-2004",23,"Track and Field, Indoor",40722,38204,2518,22406,20565,1841,18316,17639,677,"23","11",5316,2383
"14371",107877,"WILLIAMS BAPTIST COLLEGE                                    ","2003-2004",26,"Volleyball",67913,65397,2516,0,0,0,67913,65397,2516,".","13",0,15616
"12690",165866,"FRAMINGHAM STATE COLLEGE                                    ","2003-2004",25,"Track and Field, X-Country",7075,4570,2505,3250,2245,1005,3825,2325,1500,"1","2",201,325
"13727",111939,"CHAFFEY COLLEGE                                             ","2003-2004",26,"Volleyball",11373,8869,2504,0,0,0,11373,8869,2504,".","13",0,3530
"13248",215099,"PHILADELPHIA UNIVERSITY                                     ","2003-2004",26,"Volleyball",104744,102241,2503,0,0,0,104744,102241,2503,".","12",0,10282
"8934",237792,"SHEPHERD COLLEGE                                            ","2003-2004",16,"Softball",79589,77087,2502,0,0,0,79589,77087,2502,".","16",0,21792
"15277",193292,"MOLLOY COLLEGE                                              ","2003-2004",34,"Equestrian",17000,14500,2500,0,0,0,17000,14500,2500,".","10",0,10000
"15175",211608,"CHEYNEY UNIVERSITY OF PENNSYLVANIA                          ","2003-2004",33,"Bowling",12866,10367,2499,0,0,0,12866,10367,2499,".","5",0,2267
"7867",100654,"ALABAMA A &amp; M UNIVERSITY                                    ","2003-2004",15,"Soccer",409882,407384,2498,206518,204020,2498,203364,203364,0,"19","25",49518,33971
"10159",240268,"UNIVERSITY OF WISCONSIN-EAU CLAIRE                          ","2003-2004",18,"Swimming and Diving",73884,71388,2496,38082,36831,1251,35802,34557,1245,"24","34",9970,9409
"10373",150400,"DEPAUW UNIVERSITY                                           ","2003-2004",18,"Swimming and Diving",107611,105115,2496,49736,48429,1307,57875,56686,1189,"19","18",17810,17644
"6672",214157,"MORAVIAN COLLEGE AND THEOLOGICAL SEMINARY                   ","2003-2004",11,"Lacrosse",102636,100142,2494,61469,59422,2047,41167,40720,447,"15","14",28252,13683
"12897",110529,"CALIFORNIA STATE POLYTECHNIC UNIVERSITY-POMONA              ","2003-2004",25,"Track and Field, X-Country",273284,270796,2488,141143,139669,1474,132141,131127,1014,"35","28",23572,18035
"13852",147341,"MONMOUTH COLLEGE                                            ","2003-2004",26,"Volleyball",29606,27126,2480,0,0,0,29606,27126,2480,"0","17",0,18609
"14955",155061,"FORT HAYS STATE UNIVERSITY                                  ","2003-2004",28,"Wrestling",86113,83634,2479,86113,83634,2479,0,0,0,"31",".",17474,0
"11498",240189,"UNIVERSITY OF WISCONSIN-WHITEWATER                          ","2003-2004",22,"Tennis",49655,47178,2477,20850,22915,-2065,28805,24263,4542,"12","12",9818,10884
"16287",181312,"MID PLAINS COMMUNITY COLLEGE AREA                           ","2003-2004",39,"Total Participants",201983,199507,2476,86057,78760,7297,115926,120747,-4821,"67","71",72792,89463
"1061",125462,"WEST HILLS COMMUNITY COLLEGE                                ","2003-2004",1,"Baseball",39782,37309,2473,39782,37309,2473,0,0,0,"24",".",6374,0
"15590",101569,"LAWSON STATE COMMUNITY COLLEGE                              ","2003-2004",39,"Total Participants",30861,28398,2463,10120,8740,1380,20741,19658,1083,"30","27",42985,38803
"10466",190044,"CLARKSON UNIVERSITY                                         ","2003-2004",18,"Swimming and Diving",69000,66541,2459,40710,39259,1451,28290,27282,1008,"24","17",15822,10995
"17",139630,"EMMANUEL COLLEGE                                            ","2003-2004",1,"Baseball",98300,95842,2458,98300,95842,2458,0,0,0,"21",".",27862,0
"11741",201548,"CAPITAL UNIVERSITY                                          ","2003-2004",22,"Tennis",17130,14672,2458,8410,6845,1565,8720,7827,893,"8","9",4315,5237
"6469",239080,"MARIAN COLLEGE OF FOND DU LAC                               ","2003-2004",10,"Ice Hockey",88989,86534,2455,88989,86534,2455,0,0,0,"23",".",32210,0
"15361",110653,"UNIVERSITY OF CALIFORNIA-IRVINE                             ","2003-2004",36,"Sailing",75134,72680,2454,37567,36340,1227,37567,36340,1227,"11","7",5439,5439
"13375",164739,"BENTLEY COLLEGE                                             ","2003-2004",26,"Volleyball",144874,142421,2453,0,0,0,144874,142421,2453,".","13",0,31724
"7315",236258,"PENINSULA COLLEGE                                           ","2003-2004",15,"Soccer",35300,32850,2450,35300,32850,2450,0,0,0,"13",".",15674,0
"9605",191302,"FULTON-MONTGOMERY COMMUNITY COLLEGE                         ","2003-2004",16,"Softball",9076,6636,2440,0,0,0,9076,6636,2440,".","12",0,2531
"98",209056,"LEWIS &amp; CLARK COLLEGE                                       ","2003-2004",1,"Baseball",101078,98641,2437,101078,98641,2437,0,0,0,"23",".",45481,0
"3107",146366,"KASKASKIA COLLEGE                                           ","2003-2004",2,"Basketball",141745,139308,2437,62259,60954,1305,79486,78354,1132,"13","11",21972,24368
"686",237057,"WHITMAN COLLEGE                                             ","2003-2004",1,"Baseball",67059,64625,2434,67059,64625,2434,0,0,0,"18",".",45155,0
"5929",218414,"NEWBERRY COLLEGE                                            ","2003-2004",8,"Golf",29888,27455,2433,23218,20971,2247,6670,6484,186,"14","5",20972,6485
"9973",178244,"MISSOURI BAPTIST UNIVERSITY                                 ","2003-2004",16,"Softball",154741,152309,2432,0,0,0,154741,152309,2432,".","13",0,17093
"2397",130943,"UNIVERSITY OF DELAWARE                                      ","2003-2004",2,"Basketball",1910420,1907994,2426,1253332,1054761,198571,657088,853233,-196145,"15","14",175969,115540
"3035",161299,"MAINE MARITIME ACADEMY                                      ","2003-2004",2,"Basketball",60530,58104,2426,17122,18191,-1069,43408,39913,3495,"11","11",16084,15505
"10903",144962,"ELMHURST COLLEGE                                            ","2003-2004",22,"Tennis",46869,44450,2419,24063,20335,3728,22806,24115,-1309,"9","11",12085,4545
"5382",151801,"INDIANA WESLEYAN UNIVERSITY                                 ","2003-2004",8,"Golf",19599,17181,2418,19599,17181,2418,0,0,0,"8","0",14632,0
"1581",165866,"FRAMINGHAM STATE COLLEGE                                    ","2003-2004",1,"Baseball",44311,41897,2414,44311,41897,2414,0,0,0,"20",".",14295,0
"7432",191719,"HUDSON VALLEY COMMUNITY COLLEGE                             ","2003-2004",15,"Soccer",33703,31292,2411,21049,19240,1809,12654,12052,602,"23","18",12489,6912
"11867",196130,"SUNY COLLEGE AT BUFFALO                                     ","2003-2004",23,"Track and Field, Indoor",54890,52480,2410,27445,31488,-4043,27445,20992,6453,"24","16",14184,9456
"12133",196130,"SUNY COLLEGE AT BUFFALO                                     ","2003-2004",24,"Track and Field, Outdoor",54890,52480,2410,27445,34112,-6667,27445,18368,9077,"26","14",15366,8274
"11311",220598,"LANE COLLEGE                                                ","2003-2004",22,"Tennis",14280,11875,2405,7140,4988,2152,7140,6887,253,"10","11",2205,2389
"8591",150066,"ANDERSON UNIVERSITY                                         ","2003-2004",16,"Softball",34615,32213,2402,0,0,0,34615,32213,2402,".","13",0,23023
"10493",147660,"NORTH CENTRAL COLLEGE                                       ","2003-2004",19,"Swimming",20110,17708,2402,6849,8571,-1722,13261,9137,4124,"4","12",3571,4137
"15753",180692,"THE UNIVERSITY OF MONTANA-WESTERN                           ","2003-2004",39,"Total Participants",306547,304150,2397,97082,97061,21,209465,207089,2376,"154","83",389040,253234
"1215",229267,"TRINITY UNIVERSITY                                          ","2003-2004",1,"Baseball",83446,81052,2394,83446,81052,2394,0,0,0,"44",".",46218,0
"12042",118976,"MODESTO JUNIOR COLLEGE                                      ","2003-2004",24,"Track and Field, Outdoor",112141,109756,2385,43138,42821,317,69003,66935,2068,"37","29",9795,10483
"10710",213251,"JUNIATA COLLEGE                                             ","2003-2004",22,"Tennis",18059,15678,2381,9330,7306,2024,8729,8372,357,"9","10",5006,6027
"9399",218645,"UNIVERSITY OF SOUTH CAROLINA-AIKEN                          ","2003-2004",16,"Softball",171163,168789,2374,0,0,0,171163,168789,2374,".","20",0,28100
"11905",219046,"BLACK HILLS STATE UNIVERSITY                                ","2003-2004",23,"Track and Field, Indoor",76450,74078,2372,38225,37039,1186,38225,37039,1186,"27","15",15075,15075
"12102",219046,"BLACK HILLS STATE UNIVERSITY                                ","2003-2004",24,"Track and Field, Outdoor",76450,74078,2372,38225,37039,1186,38225,37039,1186,"26","25",15075,15075
"12849",219046,"BLACK HILLS STATE UNIVERSITY                                ","2003-2004",25,"Track and Field, X-Country",76450,74078,2372,38225,37039,1186,38225,37039,1186,"13","10",15075,15075
"17252",217059,"YORK COLLEGE PENNSYLVANIA                                   ","2003-2004",39,"Total Participants",642529,640158,2371,371978,368145,3833,270551,272013,-1462,"211","148",168279,123000
"10281",164739,"BENTLEY COLLEGE                                             ","2003-2004",18,"Swimming and Diving",116702,114337,2365,58644,56761,1883,58058,57576,482,"17","21",12357,18670
"1417",175573,"COPIAH-LINCOLN COMMUNITY COLLEGE                            ","2003-2004",1,"Baseball",131690,129328,2362,131690,129328,2362,0,0,0,"20",".",23380,0
"16970",175573,"COPIAH-LINCOLN COMMUNITY COLLEGE                            ","2003-2004",39,"Total Participants",246443,244081,2362,177036,174674,2362,69407,69407,0,"107","40",81086,31802
"12581",196167,"SUNY COLLEGE AT GENESEO                                     ","2003-2004",25,"Track and Field, X-Country",109062,106704,2358,53794,53352,442,55268,53352,1916,"73","68",33656,33656
"10628",209065,"LINFIELD COLLEGE                                            ","2003-2004",19,"Swimming",54756,52402,2354,27378,26201,1177,27378,26201,1177,"25","20",12175,12160
"4778",223898,"CISCO JUNIOR COLLEGE                                        ","2003-2004",7,"Football",277448,275095,2353,277448,275095,2353,0,0,0,"115",".",126295,0
"1430",230995,"NORWICH UNIVERSITY                                          ","2003-2004",1,"Baseball",28752,26400,2352,28752,26400,2352,0,0,0,"25",".",14206,0
"12305",198598,"GREENSBORO COLLEGE                                          ","2003-2004",25,"Track and Field, X-Country",37270,34921,2349,18635,17461,1174,18635,17460,1175,"6","6",2992,2991
"3399",136473,"PENSACOLA JUNIOR COLLEGE                                    ","2003-2004",2,"Basketball",412681,410333,2348,206126,204952,1174,206555,205381,1174,"17","18",38457,35808
"9871",119331,"NAPA VALLEY COLLEGE                                         ","2003-2004",16,"Softball",26226,23879,2347,0,0,0,26226,23879,2347,".","15",0,6278
"7460",231581,"BRIDGEWATER COLLEGE                                         ","2003-2004",15,"Soccer",86452,84108,2344,49152,47790,1362,37300,36318,982,"29","28",17657,16548
"682",187912,"NEW MEXICO MILITARY INSTITUTE                               ","2003-2004",1,"Baseball",164256,161920,2336,164256,161920,2336,0,0,0,"31",".",29296,0
"13953",240666,"SHERIDAN COLLEGE                                            ","2003-2004",26,"Volleyball",96640,94307,2333,0,0,0,96640,94307,2333,".","11",0,20159
"15747",240666,"SHERIDAN COLLEGE                                            ","2003-2004",39,"Total Participants",160329,157996,2333,36394,36394,0,123935,121602,2333,"20","31",42387,55561
"8860",161518,"SAINT JOSEPHS COLLEGE                                       ","2003-2004",16,"Softball",27124,24799,2325,0,0,0,27124,24799,2325,".","16",0,18414
"9837",156356,"BRESCIA UNIVERSITY                                          ","2003-2004",16,"Softball",17323,15000,2323,0,0,0,17323,15000,2323,".","24",0,14923
"2512",164614,"BOSTON BAPTIST COLLEGE                                      ","2003-2004",2,"Basketball",15900,13578,2322,9550,9012,538,6350,4566,1784,"13","7",1500,1500
"10210",160977,"BATES COLLEGE                                               ","2003-2004",18,"Swimming and Diving",89355,87033,2322,42411,41528,883,46944,45505,1439,"19","24",18766,22743
"5399",104708,"GLENDALE COMMUNITY COLLEGE                                  ","2003-2004",8,"Golf",10842,8522,2320,10842,8522,2320,0,0,0,"8",".",1600,0
"10064",160977,"BATES COLLEGE                                               ","2003-2004",17,"Squash",86247,83927,2320,43528,41708,1820,42719,42219,500,"16","13",17884,18325
"3841",155089,"FRIENDS UNIVERSITY                                          ","2003-2004",3,"All Track Combined",222353,220034,2319,141004,136518,4486,81349,83516,-2167,"26","15",19370,11175
"10519",130776,"WESTERN CONNECTICUT STATE UNIVERSITY                        ","2003-2004",19,"Swimming",74869,72556,2313,0,0,0,74869,72556,2313,".","12",0,7700
"2469",148821,"SHAWNEE COMMUNITY COLLEGE                                   ","2003-2004",2,"Basketball",98911,96600,2311,50700,50052,648,48211,46548,1663,"14","15",32046,24842
"16995",162122,"COLLEGE OF SOUTHERN MARYLAND                                ","2003-2004",39,"Total Participants",84185,81880,2305,38412,37675,737,45773,44205,1568,"64","51",25964,26840
"12856",139393,"COVENANT COLLEGE                                            ","2003-2004",25,"Track and Field, X-Country",104672,102371,2301,51539,50389,1150,53133,51982,1151,"12","11",7669,7263
"3152",227979,"SAN JACINTO COLLEGE-CENTRAL CAMPUS                          ","2003-2004",2,"Basketball",113389,111089,2300,113389,111089,2300,0,0,0,"14",".",22480,0
"14351",155177,"HESSTON COLLEGE                                             ","2003-2004",26,"Volleyball",22258,19958,2300,0,0,0,22258,19958,2300,".","12",0,8458
"14167",243133,"UNIVERSITY OF PUERTO RICO-BAYAMON                           ","2003-2004",26,"Volleyball",10000,7702,2298,5000,3652,1348,5000,4050,950,"20","25",2844,3242
"6210",125028,"VENTURA COLLEGE                                             ","2003-2004",8,"Golf",25216,22919,2297,25216,22919,2297,0,0,0,"11",".",6827,0
"631",216542,"VALLEY FORGE CHRISTIAN COLLEGE                              ","2003-2004",1,"Baseball",4920,2624,2296,4920,2624,2296,0,0,0,"12",".",1620,0
"1700",182980,"NEW ENGLAND COLLEGE                                         ","2003-2004",2,"Basketball",124995,122705,2290,77328,71546,5782,47667,51159,-3492,"17","13",18956,18466
"11490",122339,"SAN DIEGO CITY COLLEGE                                      ","2003-2004",22,"Tennis",31367,29086,2281,17188,15697,1491,14179,13389,790,"8","7",1518,2331
"8541",196130,"SUNY COLLEGE AT BUFFALO                                     ","2003-2004",16,"Softball",98577,96303,2274,0,0,0,98577,96303,2274,".","17",0,36415
"14499",195526,"SKIDMORE COLLEGE                                            ","2003-2004",26,"Volleyball",39578,37304,2274,0,0,0,39578,37304,2274,".","13",0,25001
"11555",110529,"CALIFORNIA STATE POLYTECHNIC UNIVERSITY-POMONA              ","2003-2004",22,"Tennis",93806,91534,2272,40728,38546,2182,53078,52988,90,"13","8",4264,9286
"15657",167376,"NORTHERN ESSEX COMMUNITY COLLEGE                            ","2003-2004",39,"Total Participants",33324,31061,2263,33324,31061,2263,0,0,0,"37","9",13200,5600
"111",140164,"KENNESAW STATE UNIVERSITY                                   ","2003-2004",1,"Baseball",441020,438766,2254,441020,438766,2254,0,0,0,"35",".",63184,0
"3461",193353,"MOUNT SAINT MARY COLLEGE                                    ","2003-2004",2,"Basketball",66695,64445,2250,30383,30383,0,36312,34062,2250,"11","13",23529,28652
"11932",240268,"UNIVERSITY OF WISCONSIN-EAU CLAIRE                          ","2003-2004",24,"Track and Field, Outdoor",63431,61181,2250,29970,31998,-2028,33461,29183,4278,"43","36",14667,9101
"14434",180984,"CONCORDIA UNIVERSITY                                        ","2003-2004",26,"Volleyball",93743,91493,2250,0,0,0,93743,91493,2250,"0","24",0,13992
"10028",122746,"SAN JOSE CITY COLLEGE                                       ","2003-2004",16,"Softball",81487,79240,2247,0,0,0,81487,79240,2247,".","16",0,5551
"13147",209065,"LINFIELD COLLEGE                                            ","2003-2004",26,"Volleyball",45030,42784,2246,0,0,0,45030,42784,2246,".","28",0,20692
"889",148821,"SHAWNEE COMMUNITY COLLEGE                                   ","2003-2004",1,"Baseball",58446,56201,2245,58446,56201,2245,0,0,0,"25",".",28353,0
"2860",226231,"LETOURNEAU UNIVERSITY                                       ","2003-2004",2,"Basketball",172210,169965,2245,97022,95858,1164,75188,74107,1081,"15","15",34671,27455
"5506",207069,"REDLANDS COMMUNITY COLLEGE                                  ","2003-2004",8,"Golf",40396,38153,2243,0,0,0,40396,38153,2243,".","7",0,33447
"2291",174075,"UNIVERSITY OF MINNESOTA-CROOKSTON                           ","2003-2004",2,"Basketball",328766,326524,2242,175886,180498,-4612,152880,146026,6854,"14","13",46412,36244
"9162",150400,"DEPAUW UNIVERSITY                                           ","2003-2004",16,"Softball",65299,63057,2242,0,0,0,65299,63057,2242,".","17",0,29297
"7405",118912,"MIRACOSTA COLLEGE                                           ","2003-2004",15,"Soccer",116927,114693,2234,0,0,0,116927,114693,2234,"0","18",0,600
"17041",118912,"MIRACOSTA COLLEGE                                           ","2003-2004",39,"Total Participants",116927,114693,2234,0,0,0,116927,114693,2234,"13","18",550,600
"9875",138761,"ANDREW COLLEGE                                              ","2003-2004",16,"Softball",13909,11679,2230,0,0,0,13909,11679,2230,".","14",0,9444
"15265",202763,"THE UNIVERSITY OF FINDLAY                                   ","2003-2004",34,"Equestrian",48430,46201,2229,0,0,0,48430,46201,2229,".","126",0,25506
"15218",214379,"NORTHAMPTON COUNTY AREA COMMUNITY COLLEGE                   ","2003-2004",33,"Bowling",3790,1575,2215,1895,1050,845,1895,525,1370,"8","3",525,315
"15080",166683,"MASSACHUSETTS INSTITUTE OF TECHNOLOGY                       ","2003-2004",29,"Other Sports",49890,47680,2210,49890,47680,2210,0,0,0,"35",".",14347,0
"13655",153834,"LUTHER COLLEGE                                              ","2003-2004",26,"Volleyball",38978,36770,2208,0,0,0,38978,36770,2208,".","14",0,16657
"5960",196112,"SUNY INSTITUTE OF TECHNOLOGY AT UTICA-ROME                  ","2003-2004",8,"Golf",16849,14648,2201,16849,14648,2201,0,0,0,"8",".",1928,0
"37",237358,"DAVIS AND ELKINS COLLEGE                                    ","2003-2004",1,"Baseball",57088,54888,2200,57088,54888,2200,0,0,0,"25",".",14274,0
"5940",105525,"PIMA COMMUNITY COLLEGE                                      ","2003-2004",8,"Golf",27554,25354,2200,15082,14716,366,12472,10638,1834,"10","4",9206,6616
"7052",188641,"ALFRED UNIVERSITY                                           ","2003-2004",14,"Skiing",18500,16300,2200,9250,9150,100,9250,7150,2100,"6","6",4000,3000
"13354",141334,"STATE UNIVERSITY OF WEST GEORGIA                            ","2003-2004",26,"Volleyball",94095,91895,2200,0,0,0,94095,91895,2200,".","20",0,36920
"16669",119331,"NAPA VALLEY COLLEGE                                         ","2003-2004",39,"Total Participants",136456,134262,2194,68778,69046,-268,67678,65216,2462,"72","42",21654,16599
"11693",214157,"MORAVIAN COLLEGE AND THEOLOGICAL SEMINARY                   ","2003-2004",22,"Tennis",75902,73710,2192,30575,29309,1266,45327,44401,926,"6","13",3354,5263
"1895",110529,"CALIFORNIA STATE POLYTECHNIC UNIVERSITY-POMONA              ","2003-2004",2,"Basketball",542571,540380,2191,270720,270395,325,271851,269985,1866,"13","15",29543,37061
"6326",167899,"SPRINGFIELD COLLEGE                                         ","2003-2004",9,"Gymnastics",46571,44381,2190,26773,26083,690,19798,18298,1500,"18","24",19034,12369
"4773",127185,"FORT LEWIS COLLEGE                                          ","2003-2004",7,"Football",339884,337699,2185,339884,337699,2185,0,0,0,"81",".",75460,0
"2562",240170,"WESTERN WISCONSIN TECHNICAL COLLEGE                         ","2003-2004",2,"Basketball",29000,26820,2180,15000,13410,1590,14000,13410,590,"10","10",7410,7410
"14241",136206,"NORTHWOOD UNIVERSITY-FLORIDA EDUCATION CENTER               ","2003-2004",26,"Volleyball",114361,112181,2180,0,0,0,114361,112181,2180,".","12",0,10758
"10580",209056,"LEWIS &amp; CLARK COLLEGE                                       ","2003-2004",19,"Swimming",80520,78341,2179,33211,30804,2407,47309,47537,-228,"5","19",4396,16530
"15167",243106,"UNIVERSITY OF PUERTO RICO-AGUADILLA                         ","2003-2004",32,"Beach Volleyball",2795,616,2179,0,0,0,2795,616,2179,"0","4",0,615
"13805",236188,"OLYMPIC COLLEGE                                             ","2003-2004",26,"Volleyball",26950,24773,2177,0,0,0,26950,24773,2177,".","10",0,5374
"1435",204200,"COLLEGE OF MOUNT SAINT JOSEPH                               ","2003-2004",1,"Baseball",80747,78573,2174,80747,78573,2174,0,0,0,"25",".",45328,0
"12984",145831,"ILLINOIS VALLEY COMMUNITY COLLEGE                           ","2003-2004",26,"Volleyball",15800,13627,2173,0,0,0,15800,13627,2173,".","10",0,5081
"1455",190530,"CUNY BRONX COMMUNITY COLLEGE                                ","2003-2004",1,"Baseball",22742,20571,2171,22742,20571,2171,0,0,0,"20",".",12520,0
"12331",163426,"MONTGOMERY COLLEGE                                          ","2003-2004",25,"Track and Field, X-Country",16681,14512,2169,9982,8541,1441,6699,5971,728,"14","2",2196,2175
"12700",152992,"BRIAR CLIFF UNIVERSITY                                      ","2003-2004",25,"Track and Field, X-Country",51826,49665,2161,27274,26006,1268,24552,23659,893,"7","6",1758,1486
"8746",140234,"LAGRANGE COLLEGE                                            ","2003-2004",16,"Softball",53165,51005,2160,0,0,0,53165,51005,2160,".","23",0,27965
"13689",218414,"NEWBERRY COLLEGE                                            ","2003-2004",26,"Volleyball",27321,25163,2158,0,0,0,27321,25163,2158,".","10",0,16530
"8972",153834,"LUTHER COLLEGE                                              ","2003-2004",16,"Softball",45308,43151,2157,0,0,0,45308,43151,2157,".","23",0,22119
"14217",241100,"AMERICAN UNIVERSITY OF PUERTO RICO                          ","2003-2004",26,"Volleyball",39830,37676,2154,18829,18829,0,21001,18847,2154,"12","9",17314,16851
"1699",175236,"RIDGEWATER COLLEGE                                          ","2003-2004",2,"Basketball",54639,52489,2150,25690,24615,1075,28949,27874,1075,"11","10",13340,13340
"11411",147341,"MONMOUTH COLLEGE                                            ","2003-2004",22,"Tennis",36424,34278,2146,24274,23080,1194,12150,11198,952,"9","11",3175,3175
"4651",175157,"VERMILION COMMUNITY COLLEGE                                 ","2003-2004",7,"Football",49173,47030,2143,49173,47030,2143,0,0,0,"56",".",8452,0
"3139",115296,"GROSSMONT COLLEGE                                           ","2003-2004",2,"Basketball",87209,85067,2142,53323,51522,1801,33886,33545,341,"17","9",18621,13441
"12599",215266,"UNIVERSITY OF PITTSBURGH-BRADFORD                           ","2003-2004",25,"Track and Field, X-Country",7250,5112,2138,3625,2494,1131,3625,2618,1007,"8","10",1474,1618
"14959",215929,"UNIVERSITY OF SCRANTON                                      ","2003-2004",28,"Wrestling",26324,24187,2137,26324,24187,2137,0,0,0,"13",".",10144,0
"807",170806,"MADONNA UNIVERSITY                                          ","2003-2004",1,"Baseball",150133,147997,2136,150133,147997,2136,0,0,0,"37",".",23664,0
"786",147004,"MCHENRY COUNTY COLLEGE                                      ","2003-2004",1,"Baseball",32139,30016,2123,32139,30016,2123,0,0,0,"14",".",9996,0
"13585",110529,"CALIFORNIA STATE POLYTECHNIC UNIVERSITY-POMONA              ","2003-2004",26,"Volleyball",156073,153952,2121,0,0,0,156073,153952,2121,".","17",0,32941
"6688",167394,"COLLEGE OF OUR LADY OF THE ELMS                             ","2003-2004",11,"Lacrosse",23550,21430,2120,0,0,0,23550,21430,2120,".","15",0,6066
"14265",127732,"NORTHEASTERN JUNIOR COLLEGE                                 ","2003-2004",26,"Volleyball",20620,18500,2120,0,0,0,20620,18500,2120,".","13",0,13500
"10654",179867,"WASHINGTON UNIVERSITY IN ST LOUIS                           ","2003-2004",22,"Tennis",147981,145864,2117,65454,68132,-2678,82527,77732,4795,"10","14",24789,21431
"3464",219824,"CHATTANOOGA STATE TECHNICAL COMMUNITY COLLEGE               ","2003-2004",2,"Basketball",168033,165918,2115,74982,74982,0,93051,90936,2115,"15","15",10112,11040
"13163",155812,"UNIVERSITY OF SAINT MARY                                    ","2003-2004",26,"Volleyball",18602,16488,2114,0,0,0,18602,16488,2114,".","9",0,13200
"9156",161767,"ANNE ARUNDEL COMMUNITY COLLEGE                              ","2003-2004",16,"Softball",12506,10393,2113,0,0,0,12506,10393,2113,".","14",0,6800
"9374",230913,"JOHNSON STATE COLLEGE                                       ","2003-2004",16,"Softball",20014,17901,2113,0,0,0,20014,17901,2113,".","14",0,15150
"9491",155335,"NEWMAN UNIVERSITY                                           ","2003-2004",16,"Softball",75631,73519,2112,0,0,0,75631,73519,2112,".","19",0,34985
"6555",165024,"BRIDGEWATER STATE COLLEGE                                   ","2003-2004",11,"Lacrosse",9400,7289,2111,0,0,0,9400,7289,2111,".","15",0,6920
"974",172644,"WAYNE STATE UNIVERSITY                                      ","2003-2004",1,"Baseball",226746,224640,2106,226746,224640,2106,0,0,0,"38",".",27421,0
"7466",161226,"UNIVERSITY OF MAINE AT FARMINGTON                           ","2003-2004",15,"Soccer",24627,22522,2105,10615,10186,429,14012,12336,1676,"22","23",8091,10622
"511",153366,"GRACELAND UNIVERSITY-LAMONI                                 ","2003-2004",1,"Baseball",178200,176096,2104,178200,176096,2104,0,0,0,"38",".",30856,0
"352",167376,"NORTHERN ESSEX COMMUNITY COLLEGE                            ","2003-2004",1,"Baseball",28196,26095,2101,28196,26095,2101,0,0,0,"20",".",5600,0
"7436",121691,"UNIVERSITY OF REDLANDS                                      ","2003-2004",15,"Soccer",109904,107806,2098,64568,62470,2098,45336,45336,0,"21","26",12262,7592
"13037",232423,"JAMES MADISON UNIVERSITY                                    ","2003-2004",26,"Volleyball",374473,372376,2097,0,0,0,374473,372376,2097,"0","14",0,51593
"13477",201371,"BLUFFTON COLLEGE                                            ","2003-2004",26,"Volleyball",46399,44304,2095,0,0,0,46399,44304,2095,".","17",0,13675
"5156",239080,"MARIAN COLLEGE OF FOND DU LAC                               ","2003-2004",8,"Golf",24756,22669,2087,14476,12445,2031,10280,10224,56,"8","5",5343,4494
"10748",238616,"CONCORDIA UNIVERSITY-WISCONSIN                              ","2003-2004",22,"Tennis",16752,14666,2086,10792,9647,1145,5960,5019,941,"12","9",2795,2785
"12325",104346,"CENTRAL ARIZONA COLLEGE                                     ","2003-2004",25,"Track and Field, X-Country",70642,68556,2086,35321,35889,-568,35321,32667,2654,"12","6",11780,9958
"1051",194222,"ONONDAGA COMMUNITY COLLEGE                                  ","2003-2004",1,"Baseball",28913,26829,2084,28913,26829,2084,0,0,0,"21",".",18332,0
"6347",128744,"UNIVERSITY OF BRIDGEPORT                                    ","2003-2004",9,"Gymnastics",103165,101083,2082,0,0,0,103165,101083,2082,".","9",0,9391
"16962",181640,"SOUTHEAST COMMUNITY COLLEGE AREA                            ","2003-2004",39,"Total Participants",66786,64704,2082,29010,27952,1058,37776,36752,1024,"20","23",25827,31144
"10176",165024,"BRIDGEWATER STATE COLLEGE                                   ","2003-2004",18,"Swimming and Diving",12500,10422,2078,6250,5461,789,6250,4961,1289,"15","16",4750,4750
"5711",153162,"CORNELL COLLEGE                                             ","2003-2004",8,"Golf",21819,19742,2077,11690,9794,1896,10129,9948,181,"14","8",5947,5721
"12112",111939,"CHAFFEY COLLEGE                                             ","2003-2004",24,"Track and Field, Outdoor",8118,6042,2076,4059,3021,1038,4059,3021,1038,"16","9",1784,1784
"6714",160977,"BATES COLLEGE                                               ","2003-2004",11,"Lacrosse",149992,147921,2071,101971,99537,2434,48021,48384,-363,"40","20",25530,16392
"7520",216542,"VALLEY FORGE CHRISTIAN COLLEGE                              ","2003-2004",15,"Soccer",11500,9437,2063,6795,4764,2031,4705,4673,32,"20","13",2669,2523
"14642",202356,"CUYAHOGA COMMUNITY COLLEGE DISTRICT                         ","2003-2004",26,"Volleyball",37644,35583,2061,0,0,0,37644,35583,2061,".","8",0,18990
"12863",196130,"SUNY COLLEGE AT BUFFALO                                     ","2003-2004",25,"Track and Field, X-Country",38114,36058,2056,19057,22946,-3889,19057,13112,5945,"14","8",16380,9360
"7076",237358,"DAVIS AND ELKINS COLLEGE                                    ","2003-2004",15,"Soccer",80965,78915,2050,46978,45928,1050,33987,32987,1000,"16","15",13756,17919
"9171",240374,"UNIVERSITY OF WISCONSIN-PARKSIDE                            ","2003-2004",16,"Softball",153310,151261,2049,0,0,0,153310,151261,2049,".","16",0,40682
"6734",161767,"ANNE ARUNDEL COMMUNITY COLLEGE                              ","2003-2004",11,"Lacrosse",28810,26765,2045,18527,17306,1221,10283,9459,824,"33","18",9960,6600
"5981",152992,"BRIAR CLIFF UNIVERSITY                                      ","2003-2004",8,"Golf",159236,157192,2044,96860,95498,1362,62376,61694,682,"13","7",5762,6201
"15873",234845,"CENTRALIA COLLEGE                                           ","2003-2004",39,"Total Participants",118428,116384,2044,49938,49831,107,68490,66553,1937,"38","37",56293,64502
"7688",167899,"SPRINGFIELD COLLEGE                                         ","2003-2004",15,"Soccer",36276,34236,2040,18134,16114,2020,18142,18122,20,"35","51",12038,15295
"1475",190442,"CORNING COMMUNITY COLLEGE                                   ","2003-2004",1,"Baseball",10300,8264,2036,10300,8264,2036,0,0,0,"21",".",4014,0
"10577",237312,"UNIVERSITY OF CHARLESTON                                    ","2003-2004",19,"Swimming",12559,10523,2036,5661,4943,718,6898,5580,1318,"2","3",1371,1708
"5841",154721,"BETHANY COLLEGE                                             ","2003-2004",8,"Golf",70736,68702,2034,70736,68702,2034,0,0,0,"15","0",15568,0
"12025",240189,"UNIVERSITY OF WISCONSIN-WHITEWATER                          ","2003-2004",24,"Track and Field, Outdoor",46037,44004,2033,23550,24838,-1288,22487,19166,3321,"51","49",15080,7292
"11816",240189,"UNIVERSITY OF WISCONSIN-WHITEWATER                          ","2003-2004",23,"Track and Field, Indoor",46035,44003,2032,23549,24838,-1289,22486,19165,3321,"48","48",15080,7291
"6043",111461,"COLLEGE OF THE CANYONS                                      ","2003-2004",8,"Golf",37260,35238,2022,19680,18767,913,17580,16471,1109,"10","7",16830,14529
"13576",409698,"CALIFORNIA STATE UNIVERSITY-MONTEREY BAY                    ","2003-2004",26,"Volleyball",21315,19296,2019,0,0,0,21315,19296,2019,".","13",0,14857
"57",139861,"GEORGIA COLLEGE AND STATE UNIVERSITY                        ","2003-2004",1,"Baseball",152040,150027,2013,152040,150027,2013,0,0,0,"43",".",37700,0
"12357",218821,"SPARTANBURG METHODIST COLLEGE                               ","2003-2004",25,"Track and Field, X-Country",53700,51688,2012,26850,25844,1006,26850,25844,1006,"14","12",8746,8746
"10317",168263,"WESTFIELD STATE COLLEGE                                     ","2003-2004",18,"Swimming and Diving",25996,23991,2005,0,0,0,25996,23991,2005,".","26",0,17080
"5840",118976,"MODESTO JUNIOR COLLEGE                                      ","2003-2004",8,"Golf",95836,93833,2003,48577,47843,734,47259,45990,1269,"12","3",6340,4487
"16590",199069,"MOUNT OLIVE COLLEGE                                         ","2003-2004",39,"Total Participants",701017,699014,2003,347853,333902,13951,353164,365112,-11948,"118","73",121407,128469
"837",147411,"MORTON COLLEGE                                              ","2003-2004",1,"Baseball",66600,64600,2000,66600,64600,2000,0,0,0,"25",".",19825,0
"1152",234669,"BELLEVUE COMMUNITY COLLEGE                                  ","2003-2004",1,"Baseball",120000,118000,2000,120000,118000,2000,0,0,0,"30",".",13876,0
"1407",152318,"ROSE-HULMAN INSTITUTE OF TECHNOLOGY                         ","2003-2004",1,"Baseball",104230,102230,2000,104230,102230,2000,0,0,0,"38",".",42000,0
"2538",147411,"MORTON COLLEGE                                              ","2003-2004",2,"Basketball",66600,64600,2000,34632,33592,1040,31968,31008,960,"13","12",10309,9516
"3071",205443,"SHAWNEE STATE UNIVERSITY                                    ","2003-2004",2,"Basketball",204804,202804,2000,103520,102520,1000,101284,100284,1000,"16","14",42390,40154
"3351",210775,"ALVERNIA COLLEGE                                            ","2003-2004",2,"Basketball",73373,71373,2000,33705,33205,500,39668,38168,1500,"13","15",13871,18922
"3527",221014,"MILLIGAN COLLEGE                                            ","2003-2004",3,"All Track Combined",163498,161498,2000,80749,79749,1000,82749,81749,1000,"16","12",9525,9525
"3706",224554,"TEXAS A &amp; M UNIVERSITY-COMMERCE                             ","2003-2004",3,"All Track Combined",42000,40000,2000,21000,20000,1000,21000,20000,1000,"32","22",18558,18558
"3766",210146,"SOUTHERN OREGON UNIVERSITY                                  ","2003-2004",3,"All Track Combined",72127,70127,2000,36070,35070,1000,36057,35057,1000,"27","26",23000,24000
"5144",199625,"SAMPSON COMMUNITY COLLEGE                                   ","2003-2004",8,"Golf",2000,0,2000,2000,1000,1000,0,0,0,"4",".",700,0
"5692",157863,"UNION COLLEGE                                               ","2003-2004",8,"Golf",107000,105000,2000,53500,55000,-1500,53500,50000,3500,"10","6",7000,8000
"9356",166692,"MASSACHUSETTS MARITIME ACADEMY                              ","2003-2004",16,"Softball",10000,8000,2000,0,0,0,10000,8000,2000,".","17",0,4500
"9372",129774,"MITCHELL COLLEGE                                            ","2003-2004",16,"Softball",42438,40438,2000,0,0,0,42438,40438,2000,".","12",0,7025
"9556",179308,"SAINT LOUIS COMMUNITY COLLEGE-FOREST PARK                   ","2003-2004",16,"Softball",16444,14444,2000,0,0,0,16444,14444,2000,".","18",0,833
"10879",168786,"AQUINAS COLLEGE                                             ","2003-2004",22,"Tennis",28000,26000,2000,14000,13000,1000,14000,13000,1000,"10","11",14000,14003
"11145",221014,"MILLIGAN COLLEGE                                            ","2003-2004",22,"Tennis",90844,88844,2000,43824,42824,1000,47020,46020,1000,"10","12",3350,3350
"11862",214069,"COLLEGE MISERICORDIA                                        ","2003-2004",23,"Track and Field, Indoor",4000,2000,2000,2000,1000,1000,2000,1000,1000,"20","24",800,800
"12067",214069,"COLLEGE MISERICORDIA                                        ","2003-2004",24,"Track and Field, Outdoor",14026,12026,2000,7013,6013,1000,7013,6013,1000,"25","27",1179,1179
"13039",214643,"PENNSYLVANIA STATE UNIVERSITY-PENN STATE WILKES-BA          ","2003-2004",26,"Volleyball",6000,4000,2000,1000,500,500,5000,3500,1500,"10","8",300,1500
"16137",199625,"SAMPSON COMMUNITY COLLEGE                                   ","2003-2004",39,"Total Participants",2000,0,2000,2000,1000,1000,0,0,0,"11","0",5200,0
"13432",180692,"THE UNIVERSITY OF MONTANA-WESTERN                           ","2003-2004",26,"Volleyball",106542,104543,1999,0,0,0,106542,104543,1999,".","11",0,76496
"6811",196200,"SUNY-POTSDAM                                                ","2003-2004",11,"Lacrosse",149506,147510,1996,90610,88033,2577,58896,59477,-581,"31","15",53485,35711
"9714",130697,"WESLEYAN UNIVERSITY                                         ","2003-2004",16,"Softball",58821,56825,1996,0,0,0,58821,56825,1996,".","14",0,17938
"7887",239071,"MARANATHA BAPTIST BIBLE COLLEGE INC                         ","2003-2004",15,"Soccer",20951,18958,1993,11391,11913,-522,9560,7045,2515,"27","25",5503,4602
"5003",164739,"BENTLEY COLLEGE                                             ","2003-2004",7,"Football",484059,482071,1988,484059,482071,1988,0,0,0,"93",".",76511,0
"9462",146676,"LINCOLN COLLEGE                                             ","2003-2004",16,"Softball",32842,30856,1986,0,0,0,32842,30856,1986,".","14",0,19957
"6585",164270,"MCDANIEL COLLEGE                                            ","2003-2004",11,"Lacrosse",106637,104657,1980,61788,60990,798,44849,43667,1182,"37","28",24138,24065
"438",110529,"CALIFORNIA STATE POLYTECHNIC UNIVERSITY-POMONA              ","2003-2004",1,"Baseball",183789,181815,1974,183789,181815,1974,0,0,0,"33",".",35811,0
"15079",190415,"CORNELL UNIVERSITY-ENDOWED COLLEGES                         ","2003-2004",29,"Other Sports",374453,372479,1974,305849,275670,30179,68604,96809,-28205,"70","13",46474,10844
"12554",151379,"INDIANA UNIVERSITY-SOUTHEAST                                ","2003-2004",25,"Track and Field, X-Country",14809,12837,1972,7063,7132,-69,7746,5705,2041,"5","3",2479,2105
"10961",192703,"MANHATTAN COLLEGE                                           ","2003-2004",22,"Tennis",248937,246967,1970,165901,165901,0,83036,81066,1970,"8","7",31864,8226
"5463",197911,"BARTON COLLEGE                                              ","2003-2004",8,"Golf",72746,70777,1969,72746,70777,1969,0,0,0,"11","0",25315,0
"7264",115861,"IMPERIAL VALLEY COLLEGE                                     ","2003-2004",15,"Soccer",37897,35931,1966,19417,18882,535,18480,17049,1431,"25","16",18875,17056
"14096",181020,"DOANE COLLEGE                                               ","2003-2004",26,"Volleyball",232970,231005,1965,0,0,0,232970,231005,1965,".","30",0,49644
"16848",182980,"NEW ENGLAND COLLEGE                                         ","2003-2004",39,"Total Participants",423885,421923,1962,218750,215250,3500,205135,206673,-1538,"117","118",113052,98195
"8957",150604,"FRANKLIN COLLEGE                                            ","2003-2004",16,"Softball",25494,23533,1961,0,0,0,25494,23533,1961,".","19",0,7331
"16274",175786,"HINDS COMMUNITY COLLEGE                                     ","2003-2004",39,"Total Participants",299683,297726,1957,191514,189557,1957,108169,108169,0,"169","69",166627,41842
"10606",121619,"SANTA ANA COLLEGE                                           ","2003-2004",19,"Swimming",8000,6049,1951,4000,3702,298,4000,2347,1653,"3","4",2532,1705
"12574",211608,"CHEYNEY UNIVERSITY OF PENNSYLVANIA                          ","2003-2004",25,"Track and Field, X-Country",19239,17288,1951,10593,10092,501,8646,7196,1450,"24","10",5317,2421
"14233",156356,"BRESCIA UNIVERSITY                                          ","2003-2004",26,"Volleyball",10500,8550,1950,0,0,0,10500,8550,1950,".","12",0,8500
"5922",231581,"BRIDGEWATER COLLEGE                                         ","2003-2004",8,"Golf",40197,38250,1947,40197,38250,1947,0,0,0,"15",".",14633,0
"11603",216931,"WILKES UNIVERSITY                                           ","2003-2004",22,"Tennis",15986,14052,1934,11296,9607,1689,4690,4445,245,"13","9",3775,4288
"13512",216931,"WILKES UNIVERSITY                                           ","2003-2004",26,"Volleyball",14912,12980,1932,0,0,0,14912,12980,1932,".","15",0,10065
"12291",120971,"PALOMAR COLLEGE                                             ","2003-2004",25,"Track and Field, X-Country",6902,4972,1930,3451,2486,965,3451,2486,965,"9","6",721,721
"2391",155098,"FORT SCOTT COMMUNITY COLLEGE                                ","2003-2004",2,"Basketball",160956,159028,1928,83435,82471,964,77521,76557,964,"16","12",20731,22088
"1596",150145,"BETHEL COLLEGE                                              ","2003-2004",2,"Basketball",131500,129575,1925,91500,82457,9043,40000,47118,-7118,"14","13",45675,32480
"7817",115001,"GLENDALE COMMUNITY COLLEGE                                  ","2003-2004",15,"Soccer",51225,49302,1923,33697,32641,1056,17528,16661,867,"25","15",14550,4700
"6023",146676,"LINCOLN COLLEGE                                             ","2003-2004",8,"Golf",49288,47370,1918,41788,41030,758,7500,6340,1160,"9","9",14267,6335
"7868",164270,"MCDANIEL COLLEGE                                            ","2003-2004",15,"Soccer",66140,64222,1918,34398,33223,1175,31742,30999,743,"28","21",24016,22499
"7377",364016,"PARADISE VALLEY COMMUNITY COLLEGE                           ","2003-2004",15,"Soccer",68451,66538,1913,15446,14690,756,53005,51848,1157,"24","21",6000,6000
"10431",111939,"CHAFFEY COLLEGE                                             ","2003-2004",18,"Swimming and Diving",6643,4731,1912,3476,2278,1198,3167,2453,714,"16","15",2138,2138
"15250",195304,"SARAH LAWRENCE COLLEGE                                      ","2003-2004",34,"Equestrian",15000,13089,1911,0,0,0,15000,13089,1911,".","8",0,7689
"17154",161457,"UNIVERSITY OF NEW ENGLAND                                   ","2003-2004",39,"Total Participants",212432,210524,1908,76660,74741,1919,135772,135783,-11,"81","115",53839,73181
"2638",118976,"MODESTO JUNIOR COLLEGE                                      ","2003-2004",2,"Basketball",159408,157505,1903,101376,102833,-1457,58032,54672,3360,"14","12",23260,7562
"12784",180197,"FLATHEAD VALLEY COMMUNITY COLLEGE                           ","2003-2004",25,"Track and Field, X-Country",20238,18335,1903,10219,10982,-763,10019,7353,2666,"4","7",7982,4353
"16365",199485,"ROCKINGHAM COMMUNITY COLLEGE                                ","2003-2004",39,"Total Participants",35583,33680,1903,25376,23757,1619,10207,9923,284,"39","8",37946,6424
"8503",149505,"TRINITY CHRISTIAN COLLEGE                                   ","2003-2004",15,"Soccer",66647,64747,1900,34737,33737,1000,31910,31010,900,"24","23",23937,21210
"11394",111434,"CANADA COLLEGE                                              ","2003-2004",22,"Tennis",2700,800,1900,2700,800,1900,0,0,0,"9",".",1215,0
"6115",174862,"CROWN COLLEGE                                               ","2003-2004",8,"Golf",5004,3106,1898,2603,2606,-3,2401,500,1901,"9","1",2506,400
"15132",230995,"NORWICH UNIVERSITY                                          ","2003-2004",29,"Other Sports",43190,41292,1898,21595,20646,949,21595,20646,949,"53","39",7866,7866
"6261",178244,"MISSOURI BAPTIST UNIVERSITY                                 ","2003-2004",8,"Golf",120088,118192,1896,120088,118192,1896,0,0,0,"14",".",17001,0
"13985",161244,"UNIVERSITY OF MAINE AT MACHIAS                              ","2003-2004",26,"Volleyball",22407,20512,1895,0,0,0,22407,20512,1895,".","10",0,11438
"15560",148584,"UNIVERSITY OF ST FRANCIS                                    ","2003-2004",39,"Total Participants",1220184,1218293,1891,488972,488089,883,731212,730204,1008,"160","104",147129,81468
"3884",237066,"WHITWORTH COLLEGE                                           ","2003-2004",3,"All Track Combined",117796,115906,1890,58416,57471,945,59380,58435,945,"47","43",29818,30491
"7549",218414,"NEWBERRY COLLEGE                                            ","2003-2004",15,"Soccer",43014,41125,1889,19345,19345,0,23669,21780,1889,"23","14",19527,19866
"11284",140818,"PIEDMONT COLLEGE                                            ","2003-2004",22,"Tennis",33252,31363,1889,18833,17889,944,14419,13474,945,"7","10",11906,8105
"445",118930,"MISSION COLLEGE                                             ","2003-2004",1,"Baseball",29679,27793,1886,29679,27793,1886,0,0,0,"24",".",8409,0
"1016",111461,"COLLEGE OF THE CANYONS                                      ","2003-2004",1,"Baseball",17670,15784,1886,17670,15784,1886,0,0,0,"23",".",12644,0
"4359",153524,"IOWA CENTRAL COMMUNITY COLLEGE                              ","2003-2004",7,"Football",135373,133490,1883,135373,133490,1883,0,0,0,"112",".",57990,0
"1790",112190,"CITY COLLEGE OF SAN FRANCISCO                               ","2003-2004",2,"Basketball",45910,44028,1882,24677,23618,1059,21233,20410,823,"13","16",10619,14480
"7738",162210,"COLUMBIA UNION COLLEGE                                      ","2003-2004",15,"Soccer",112411,110529,1882,63221,59346,3875,49190,51183,-1993,"18","11",12484,13423
"14735",131469,"GEORGE WASHINGTON UNIVERSITY                                ","2003-2004",27,"Water Polo",196776,194894,1882,69462,71397,-1935,127314,123497,3817,"14","15",13274,12143
"10773",107983,"SOUTHERN ARKANSAS UNIVERSITY MAIN CAMPUS                    ","2003-2004",22,"Tennis",12117,10241,1876,0,0,0,12117,10241,1876,".","6",0,7120
"1904",175573,"COPIAH-LINCOLN COMMUNITY COLLEGE                            ","2003-2004",2,"Basketball",174476,172602,1874,95769,94832,937,78707,77770,937,"10","11",12162,13290
"2305",154855,"CENTRAL CHRISTIAN COLLEGE OF KANSAS                         ","2003-2004",2,"Basketball",47390,45518,1872,24129,23193,936,23261,22325,936,"17","15",15618,13080
"6216",180106,"CARROLL COLLEGE                                             ","2003-2004",8,"Golf",34471,32600,1871,27214,25737,1477,7257,6863,394,"15","4",9230,2461
"8093",165699,"ENDICOTT COLLEGE                                            ","2003-2004",15,"Soccer",76608,74740,1868,24175,24175,0,52433,50565,1868,"28","23",10500,18600
"5901",232423,"JAMES MADISON UNIVERSITY                                    ","2003-2004",8,"Golf",256644,254777,1867,152723,108737,43986,103921,146040,-42119,"10","8",34204,41745
"7571",178059,"MARYVILLE UNIVERSITY OF SAINT LOUIS                         ","2003-2004",15,"Soccer",28206,26340,1866,14067,13134,933,14139,13206,933,"16","21",12288,12360
"14207",153162,"CORNELL COLLEGE                                             ","2003-2004",26,"Volleyball",45891,44027,1864,0,0,0,45891,44027,1864,".","25",0,17987
"8484",203535,"KENYON COLLEGE                                              ","2003-2004",15,"Soccer",132221,130358,1863,68648,68648,0,63573,61710,1863,"25","23",17356,17374
"5359",220613,"LEE UNIVERSITY                                              ","2003-2004",8,"Golf",65081,63221,1860,65081,63221,1860,0,0,0,"12",".",12393,0
"7042",160977,"BATES COLLEGE                                               ","2003-2004",14,"Skiing",154832,152979,1853,88289,86436,1853,66543,66543,0,"25","17",49354,29461
"556",172051,"SAGINAW VALLEY STATE UNIVERSITY                             ","2003-2004",1,"Baseball",106250,104403,1847,106250,104403,1847,0,0,0,"44",".",63781,0
"13551",186201,"RAMAPO COLLEGE OF NEW JERSEY                                ","2003-2004",26,"Volleyball",65956,64109,1847,39970,38976,994,25986,25133,853,"17","14",22773,16756
"9117",212160,"EDINBORO UNIVERSITY OF PENNSYLVANIA                         ","2003-2004",16,"Softball",99274,97429,1845,0,0,0,99274,97429,1845,".","25",0,29691
"13421",170532,"KALAMAZOO COLLEGE                                           ","2003-2004",26,"Volleyball",40338,38497,1841,0,0,0,40338,38497,1841,".","11",0,11246
"7372",176178,"NORTHWEST MISSISSIPPI COMMUNITY COLLEGE                     ","2003-2004",15,"Soccer",127308,125468,1840,62787,61867,920,64521,63601,920,"19","16",14229,14628
"13183",153001,"BUENA VISTA UNIVERSITY                                      ","2003-2004",26,"Volleyball",45816,43976,1840,0,0,0,45816,43976,1840,".","24",0,19757
"1629",115001,"GLENDALE COMMUNITY COLLEGE                                  ","2003-2004",2,"Basketball",43375,41536,1839,27587,24119,3468,15788,17417,-1629,"14","8",8959,3811
"8881",120290,"OHLONE COLLEGE                                              ","2003-2004",16,"Softball",31530,29699,1831,0,0,0,31530,29699,1831,".","13",0,12541
"14042",191302,"FULTON-MONTGOMERY COMMUNITY COLLEGE                         ","2003-2004",26,"Volleyball",8873,7043,1830,0,0,0,8873,7043,1830,".","9",0,5837
"14999",153524,"IOWA CENTRAL COMMUNITY COLLEGE                              ","2003-2004",28,"Wrestling",63889,62066,1823,63889,62066,1823,0,0,0,"22",".",24566,0
"14598",190521,"CUNY BOROUGH OF MANHATTAN COMMUNITY COLLEGE                 ","2003-2004",26,"Volleyball",17421,15603,1818,0,0,0,17421,15603,1818,".","12",0,8066
"13231",189848,"CAZENOVIA COLLEGE                                           ","2003-2004",26,"Volleyball",15230,13416,1814,0,0,0,15230,13416,1814,".","12",0,13216
"17156",198303,"CHOWAN COLLEGE                                              ","2003-2004",39,"Total Participants",288472,286661,1811,146900,149233,-2333,141572,137428,4144,"202","60",170815,68061
"9534",147341,"MONMOUTH COLLEGE                                            ","2003-2004",16,"Softball",26070,24263,1807,0,0,0,26070,24263,1807,".","17",0,21585
"9325",184603,"FAIRLEIGH DICKINSON UNIVERSITY-METROPOLITAN CAMPUS          ","2003-2004",16,"Softball",176758,174956,1802,0,0,0,176758,174956,1802,".","16",0,34897
"1772",111920,"CHABOT COLLEGE                                              ","2003-2004",2,"Basketball",8200,6400,1800,4400,3200,1200,3800,3200,600,"15","10",5100,5060
"6342",232423,"JAMES MADISON UNIVERSITY                                    ","2003-2004",9,"Gymnastics",168343,166543,1800,107774,74155,33619,60569,92388,-31819,"14","24",28985,28929
"10012",214175,"MUHLENBERG COLLEGE                                          ","2003-2004",16,"Softball",39993,38193,1800,0,0,0,39993,38193,1800,".","22",0,33500
"11420",140951,"SAVANNAH COLLEGE OF ART AND DESIGN                          ","2003-2004",22,"Tennis",107431,105636,1795,54497,53599,898,52934,52037,897,"6","8",16421,15844
"1577",155335,"NEWMAN UNIVERSITY                                           ","2003-2004",1,"Baseball",90659,88865,1794,90659,88865,1794,0,0,0,"28",".",52515,0
"12205",191968,"ITHACA COLLEGE                                              ","2003-2004",25,"Track and Field, X-Country",57154,55360,1794,35351,36604,-1253,21803,18756,3047,"18","23",14234,17016
"9702",165866,"FRAMINGHAM STATE COLLEGE                                    ","2003-2004",16,"Softball",29111,27320,1791,0,0,0,29111,27320,1791,".","16",0,6940
"4731",239071,"MARANATHA BAPTIST BIBLE COLLEGE INC                         ","2003-2004",7,"Football",34242,32464,1778,34242,32464,1778,0,0,0,"74",".",14939,0
"14571",166391,"LASELL COLLEGE                                              ","2003-2004",26,"Volleyball",37145,35371,1774,17370,12029,5341,19775,23342,-3567,"8","10",4279,13552
"15502",141185,"TOCCOA FALLS COLLEGE                                        ","2003-2004",39,"Total Participants",80631,78860,1771,42020,37983,4037,38611,40877,-2266,"43","34",30015,31382
"7030",217156,"BROWN UNIVERSITY                                            ","2003-2004",14,"Skiing",50648,48887,1761,0,0,0,50648,48887,1761,".","13",0,32394
"13426",110468,"ALLIANT INTERNATIONAL UNIVERSITY-SAN DIEGO                  ","2003-2004",26,"Volleyball",38000,36241,1759,0,0,0,38000,36241,1759,".","9",0,12518
"7128",226930,"MOUNTAIN VIEW COLLEGE                                       ","2003-2004",15,"Soccer",56100,54342,1758,28100,27171,929,28000,27171,829,"22","13",10516,6214
"6007",173063,"RIVERLAND COMMUNITY COLLEGE                                 ","2003-2004",8,"Golf",23202,21448,1754,11601,10724,877,11601,10724,877,"6","5",3146,3146
"11691",206525,"WITTENBERG UNIVERSITY                                       ","2003-2004",22,"Tennis",28027,26276,1751,13831,13712,119,14196,12564,1632,"13","16",5008,4596
"4342",123299,"SHASTA COLLEGE                                              ","2003-2004",7,"Football",59803,58053,1750,59803,58053,1750,0,0,0,"60",".",23799,0
"5649",161457,"UNIVERSITY OF NEW ENGLAND                                   ","2003-2004",8,"Golf",10281,8531,1750,10281,8531,1750,0,0,0,"10",".",3831,0
"10556",241225,"BAYAMON CENTRAL UNIVERSITY                                  ","2003-2004",19,"Swimming",2250,500,1750,2250,500,1750,0,0,0,"1",".",385,0
"10860",146481,"LAKE FOREST COLLEGE                                         ","2003-2004",22,"Tennis",34915,33165,1750,14612,12862,1750,20303,20303,0,"10","10",6862,5390
"14386",154688,"BAKER UNIVERSITY COLLEGE OF ARTS AND SCIENCES               ","2003-2004",26,"Volleyball",85426,83680,1746,0,0,0,85426,83680,1746,".","17",0,22951
"13220",236896,"WALLA WALLA COLLEGE                                         ","2003-2004",26,"Volleyball",35840,34099,1741,18220,17879,341,17620,16220,1400,"12","12",12986,10916
"15140",216296,"THADDEUS STEVENS COLLEGE OF TECHNOLOGY                      ","2003-2004",30,"Archery",25000,23263,1737,21000,20000,1000,4000,3263,737,"12",".",12600,3052
"12978",104708,"GLENDALE COMMUNITY COLLEGE                                  ","2003-2004",25,"Track and Field, X-Country",13956,12220,1736,7228,6328,900,6728,5892,836,"8","8",695,695
"6632",191719,"HUDSON VALLEY COMMUNITY COLLEGE                             ","2003-2004",11,"Lacrosse",12359,10627,1732,12359,10627,1732,0,0,0,"16",".",6000,0
"8960",119164,"MT SAN ANTONIO COLLEGE                                      ","2003-2004",16,"Softball",126211,124480,1731,0,0,0,126211,124480,1731,".","21",0,12864
"11205",230995,"NORWICH UNIVERSITY                                          ","2003-2004",22,"Tennis",18630,16899,1731,18630,16899,1731,0,0,0,"7","0",2433,0
"1352",153834,"LUTHER COLLEGE                                              ","2003-2004",1,"Baseball",52050,50324,1726,52050,50324,1726,0,0,0,"29",".",24732,0
"4887",216852,"WIDENER UNIVERSITY-MAIN CAMPUS                              ","2003-2004",7,"Football",263340,261619,1721,263340,261619,1721,0,0,0,"124",".",96146,0
"7916",216038,"SLIPPERY ROCK UNIVERSITY OF PENNSYLVANIA                    ","2003-2004",15,"Soccer",291051,289332,1719,114462,112598,1864,176589,176734,-145,"22","23",40619,52678
"14862",180522,"MONTANA STATE UNIVERSITY-NORTHERN                           ","2003-2004",28,"Wrestling",180243,178524,1719,180243,178524,1719,0,0,0,"28",".",33370,0
"15821",180522,"MONTANA STATE UNIVERSITY-NORTHERN                           ","2003-2004",39,"Total Participants",286493,284774,1719,187384,185665,1719,99109,99109,0,"143","34",156673,77448
"2477",243133,"UNIVERSITY OF PUERTO RICO-BAYAMON                           ","2003-2004",2,"Basketball",60000,58283,1717,30000,28650,1350,30000,29633,367,"15","21",3433,4416
"14703",166683,"MASSACHUSETTS INSTITUTE OF TECHNOLOGY                       ","2003-2004",27,"Water Polo",47960,46245,1715,47960,46245,1715,0,0,0,"18",".",22198,0
"8754",145372,"GREENVILLE COLLEGE                                          ","2003-2004",16,"Softball",45615,43903,1712,0,0,0,45615,43903,1712,".","12",0,8431
"10547",113236,"CYPRESS COLLEGE                                             ","2003-2004",19,"Swimming",29755,28044,1711,13593,13507,86,16162,14537,1625,"6","13",2040,3336
"1179",144351,"CONCORDIA UNIVERSITY                                        ","2003-2004",1,"Baseball",33904,32195,1709,33904,32195,1709,0,0,0,"31",".",15869,0
"15024",110486,"CALIFORNIA STATE UNIVERSITY-BAKERSFIELD                     ","2003-2004",28,"Wrestling",214972,213268,1704,214972,213268,1704,0,0,0,"25",".",42019,0
"8900",165529,"CURRY COLLEGE                                               ","2003-2004",16,"Softball",33062,31360,1702,0,0,0,33062,31360,1702,".","18",0,20308
"14657",111461,"COLLEGE OF THE CANYONS                                      ","2003-2004",27,"Water Polo",16783,15081,1702,0,0,0,16783,15081,1702,".","11",0,11052
"8414",229780,"WAYLAND BAPTIST UNIVERSITY                                  ","2003-2004",15,"Soccer",68100,66400,1700,0,0,0,68100,66400,1700,".","17",0,23600
"3067",114433,"FEATHER RIVER COMMUNITY COLLEGE DISTRICT                    ","2003-2004",2,"Basketball",65328,63630,1698,33337,32678,659,31991,30952,1039,"19","11",20350,18133
"6634",212115,"EAST STROUDSBURG UNIVERSITY OF PENNSYLVANIA                 ","2003-2004",11,"Lacrosse",56728,55033,1695,0,0,0,56728,55033,1695,"0","22",0,10831
"13850",161226,"UNIVERSITY OF MAINE AT FARMINGTON                           ","2003-2004",26,"Volleyball",13096,11401,1695,0,0,0,13096,11401,1695,"0","12",0,9780
"13032",174738,"ROCHESTER COMMUNITY AND TECHNICAL COLLEGE                   ","2003-2004",26,"Volleyball",37775,36086,1689,0,0,0,37775,36086,1689,".","9",0,22036
"4886",146481,"LAKE FOREST COLLEGE                                         ","2003-2004",7,"Football",111884,110198,1686,111884,110198,1686,0,0,0,"63",".",36598,0
"9718",183239,"SAINT ANSELM COLLEGE                                        ","2003-2004",16,"Softball",31985,30299,1686,0,0,0,31985,30299,1686,".","16",0,20847
"4158",165866,"FRAMINGHAM STATE COLLEGE                                    ","2003-2004",6,"Field hocky",16700,15017,1683,0,0,0,16700,15017,1683,".","15",0,6142
"13469",170806,"MADONNA UNIVERSITY                                          ","2003-2004",26,"Volleyball",160716,159033,1683,0,0,0,160716,159033,1683,".","12",0,16150
"7217",113236,"CYPRESS COLLEGE                                             ","2003-2004",15,"Soccer",78675,76995,1680,33431,32867,564,45244,44128,1116,"21","21",5153,17375
"14927",153144,"COE COLLEGE                                                 ","2003-2004",28,"Wrestling",88796,87121,1675,88796,87121,1675,0,0,0,"35",".",25477,0
"589",195234,"THE COLLEGE OF SAINT ROSE                                   ","2003-2004",1,"Baseball",348157,346490,1667,348157,346490,1667,0,0,0,"60",".",57151,0
"12316",118976,"MODESTO JUNIOR COLLEGE                                      ","2003-2004",25,"Track and Field, X-Country",52642,50976,1666,13921,11724,2197,38721,39252,-531,"14","8",2889,5520
"2233",121619,"SANTA ANA COLLEGE                                           ","2003-2004",2,"Basketball",26906,25244,1662,15521,13760,1761,11385,11484,-99,"14","16",12036,9927
"7594",190567,"CUNY CITY COLLEGE                                           ","2003-2004",15,"Soccer",32190,30532,1658,18575,20605,-2030,13615,9927,3688,"22","14",15155,7202
"7048",171128,"MICHIGAN TECHNOLOGICAL UNIVERSITY                           ","2003-2004",14,"Skiing",60101,58451,1650,17568,25373,-7805,42533,33078,9455,"9","5",12962,12962
"7889",133085,"CLEARWATER CHRISTIAN COLLEGE                                ","2003-2004",15,"Soccer",34525,32875,1650,17317,15677,1640,17208,17198,10,"22","22",15487,16990
"11609",237181,"BETHANY COLLEGE                                             ","2003-2004",22,"Tennis",36460,34810,1650,18300,15955,2345,18160,18855,-695,"13","11",2834,4169
"7751",167729,"SALEM STATE COLLEGE                                         ","2003-2004",15,"Soccer",42135,40489,1646,20878,20452,426,21257,20037,1220,"22","21",12052,12516
"15327",208275,"BLUE MOUNTAIN COMMUNITY COLLEGE                             ","2003-2004",35,"Rodeo",79038,77392,1646,58488,55120,3368,20550,22272,-1722,"25","9",24613,8648
"13276",145372,"GREENVILLE COLLEGE                                          ","2003-2004",26,"Volleyball",26090,24446,1644,0,0,0,26090,24446,1644,".","10",0,9949
"8063",170967,"ROCHESTER COLLEGE                                           ","2003-2004",15,"Soccer",86068,84427,1641,49549,49097,452,36519,35330,1189,"22","16",7778,10337
"7267",139630,"EMMANUEL COLLEGE                                            ","2003-2004",15,"Soccer",183010,181374,1636,91396,91614,-218,91614,89760,1854,"17","16",21516,19662
"10323",173300,"CONCORDIA COLLEGE AT MOORHEAD                               ","2003-2004",18,"Swimming and Diving",44620,42987,1633,0,0,0,44620,42987,1633,".","17",0,857
"8861",144962,"ELMHURST COLLEGE                                            ","2003-2004",16,"Softball",53804,52175,1629,0,0,0,53804,52175,1629,".","20",0,25315
"10597",216038,"SLIPPERY ROCK UNIVERSITY OF PENNSYLVANIA                    ","2003-2004",19,"Swimming",102899,101273,1626,36824,36908,-84,66075,64365,1710,"15","21",10398,12095
"14722",114789,"FRESNO CITY COLLEGE                                         ","2003-2004",27,"Water Polo",8650,7024,1626,0,0,0,8650,7024,1626,".","16",0,4524
"9518",170806,"MADONNA UNIVERSITY                                          ","2003-2004",16,"Softball",85327,83703,1624,0,0,0,85327,83703,1624,".","14",0,15455
"3372",230995,"NORWICH UNIVERSITY                                          ","2003-2004",2,"Basketball",124636,123013,1623,64260,63279,981,60376,59734,642,"14","14",23540,29475
"13307",217688,"CHARLESTON SOUTHERN UNIVERSITY                              ","2003-2004",26,"Volleyball",198139,196519,1620,0,0,0,198139,196519,1620,".","13",0,33225
"453",199485,"ROCKINGHAM COMMUNITY COLLEGE                                ","2003-2004",1,"Baseball",25376,23757,1619,25376,23757,1619,0,0,0,"24",".",19417,0
"13184",148131,"QUINCY UNIVERSITY                                           ","2003-2004",26,"Volleyball",330816,329203,1613,154627,155042,-415,176189,174161,2028,"15","16",51069,27875
"6274",172291,"ST CLAIR COUNTY COMMUNITY COLLEGE                           ","2003-2004",8,"Golf",18601,16990,1611,18601,16990,1611,0,0,0,"7","0",12088,0
"13936",211477,"CENTRAL PENNSYLVANIA COLLEGE                                ","2003-2004",26,"Volleyball",11400,9793,1607,5700,2400,3300,5700,7393,-1693,"7","8",1200,4893
"671",236975,"WENATCHEE VALLEY COLLEGE                                    ","2003-2004",1,"Baseball",50806,49200,1606,50806,49200,1606,0,0,0,"28",".",49199,0
"10510",217059,"YORK COLLEGE PENNSYLVANIA                                   ","2003-2004",19,"Swimming",62120,60514,1606,31060,30136,924,31060,30378,682,"17","14",6456,6698
"9602",146278,"JOHN WOOD COMMUNITY COLLEGE                                 ","2003-2004",16,"Softball",21440,19837,1603,0,0,0,21440,19837,1603,".","16",0,9429
"10875",231581,"BRIDGEWATER COLLEGE                                         ","2003-2004",22,"Tennis",43572,41971,1601,20197,19580,617,23375,22391,984,"11","12",8411,7838
"7357",147411,"MORTON COLLEGE                                              ","2003-2004",15,"Soccer",53280,51680,1600,53280,51680,1600,0,0,0,"20",".",15860,0
"7468",211981,"DELAWARE VALLEY COLLEGE                                     ","2003-2004",15,"Soccer",48561,46961,1600,23180,21880,1300,25381,25081,300,"30","15",9250,9515
"10855",197133,"VASSAR COLLEGE                                              ","2003-2004",22,"Tennis",137904,136304,1600,62457,61357,1100,75447,74947,500,"15","11",4916,11519
"13319",175980,"MILLSAPS COLLEGE                                            ","2003-2004",26,"Volleyball",51221,49630,1591,0,0,0,51221,49630,1591,".","13",0,18630
"8317",155335,"NEWMAN UNIVERSITY                                           ","2003-2004",15,"Soccer",126749,125161,1588,59080,58286,794,67669,66875,794,"23","28",23475,30375
"9508",236258,"PENINSULA COLLEGE                                           ","2003-2004",16,"Softball",36900,35316,1584,0,0,0,36900,35316,1584,".","13",0,14994
"5952",230959,"MIDDLEBURY COLLEGE                                          ","2003-2004",8,"Golf",65392,63809,1583,34618,33826,792,30774,29983,791,"14","6",5914,2071
"6794",209065,"LINFIELD COLLEGE                                            ","2003-2004",11,"Lacrosse",39567,37987,1580,0,0,0,39567,37987,1580,".","25",0,22475
"12181",146676,"LINCOLN COLLEGE                                             ","2003-2004",25,"Track and Field, X-Country",12230,10654,1576,6989,6088,901,5241,4566,675,"8","6",4150,3113
"13099",100724,"ALABAMA STATE UNIVERSITY                                    ","2003-2004",26,"Volleyball",131968,130397,1571,0,0,0,131968,130397,1571,".","13",0,43678
"9040",183974,"CENTENARY COLLEGE                                           ","2003-2004",16,"Softball",57290,55721,1569,0,0,0,57290,55721,1569,".","18",0,26582
"10081",212577,"FRANKLIN AND MARSHALL COLLEGE                               ","2003-2004",17,"Squash",56204,54637,1567,21972,24385,-2413,34232,30252,3980,"18","11",17344,12242
"1704",176169,"NORTHEAST MISSISSIPPI COMMUNITY COLLEGE                     ","2003-2004",2,"Basketball",160304,158740,1564,78594,81971,-3377,81710,76769,4941,"15","14",12518,14413
"13823",221519,"SEWANEE-THE UNIVERSITY OF THE SOUTH                         ","2003-2004",26,"Volleyball",60063,58501,1562,0,0,0,60063,58501,1562,".","7",0,21148
"5188",240268,"UNIVERSITY OF WISCONSIN-EAU CLAIRE                          ","2003-2004",8,"Golf",56325,54766,1559,32917,28541,4376,23408,26225,-2817,"14","13",13864,13499
"6604",129941,"UNIVERSITY OF NEW HAVEN                                     ","2003-2004",11,"Lacrosse",179369,177816,1553,0,0,0,179369,177816,1553,".","20",0,17190
"10177",170532,"KALAMAZOO COLLEGE                                           ","2003-2004",18,"Swimming and Diving",79049,77498,1551,34155,32539,1616,44894,44959,-65,"18","20",8578,9531
"15229",185129,"NEW JERSEY CITY UNIVERSITY                                  ","2003-2004",33,"Bowling",12425,10877,1548,0,0,0,12425,10877,1548,".","7",0,6182
"687",161767,"ANNE ARUNDEL COMMUNITY COLLEGE                              ","2003-2004",1,"Baseball",18028,16482,1546,18028,16482,1546,0,0,0,"17",".",11800,0
"5554",215266,"UNIVERSITY OF PITTSBURGH-BRADFORD                           ","2003-2004",8,"Golf",10804,9258,1546,6404,6040,364,4400,3218,1182,"8","7",4530,1706
"8293",228787,"THE UNIVERSITY OF TEXAS AT DALLAS                           ","2003-2004",15,"Soccer",50324,48779,1545,25662,25662,0,24662,23117,1545,"24","21",25656,22449
"14066",234711,"BIG BEND COMMUNITY COLLEGE                                  ","2003-2004",26,"Volleyball",24315,22778,1537,0,0,0,24315,22778,1537,".","10",0,19500
"10840",140447,"MERCER UNIVERSITY                                           ","2003-2004",22,"Tennis",69224,67688,1536,32785,32783,2,36439,34905,1534,"9","7",12939,15062
"414",143613,"CARL SANDBURG COLLEGE                                       ","2003-2004",1,"Baseball",14420,12885,1535,14420,12885,1535,0,0,0,"16",".",12880,0
"13306",212133,"EASTERN UNIVERSITY                                          ","2003-2004",26,"Volleyball",34415,32880,1535,0,0,0,34415,32880,1535,".","9",0,17170
"13596",170967,"ROCHESTER COLLEGE                                           ","2003-2004",26,"Volleyball",44329,42795,1534,0,0,0,44329,42795,1534,".","12",0,10263
"1478",403487,"ILLINOIS EASTERN COMMUNITY COLLS-WABASH VLY COLL            ","2003-2004",1,"Baseball",81973,80443,1530,81973,80443,1530,0,0,0,"28",".",21757,0
"8258",152318,"ROSE-HULMAN INSTITUTE OF TECHNOLOGY                         ","2003-2004",15,"Soccer",137530,136000,1530,68760,68000,760,68770,68000,770,"29","20",27260,27270
"16281",196033,"SUNY COLLEGE OF AGRIC AND TECHN AT COBLESKILL               ","2003-2004",39,"Total Participants",122491,120964,1527,73666,72389,1277,48825,48575,250,"168","105",88094,41387
"3206",164492,"ANNA MARIA COLLEGE                                          ","2003-2004",2,"Basketball",89643,88117,1526,46053,45430,623,43590,42687,903,"14","10",44628,42165
"5746",106342,"LYON COLLEGE                                                ","2003-2004",8,"Golf",72206,70680,1526,29342,29092,250,42864,41588,1276,"8","6",3909,11186
"7798",176910,"CENTRAL CHRISTIAN COLLEGE OF THE BIBLE                      ","2003-2004",15,"Soccer",12391,10865,1526,12391,10865,1526,0,0,0,"19",".",7257,0
"8516",212656,"GENEVA COLLEGE                                              ","2003-2004",15,"Soccer",330910,329389,1521,192564,192564,0,138346,136825,1521,"18","17",29993,21118
"12360",213251,"JUNIATA COLLEGE                                             ","2003-2004",25,"Track and Field, X-Country",31923,30403,1520,13247,13593,-346,18676,16810,1866,"14","19",6981,10198
"5644",107983,"SOUTHERN ARKANSAS UNIVERSITY MAIN CAMPUS                    ","2003-2004",8,"Golf",9795,8278,1517,9795,8278,1517,0,0,0,"10",".",6327,0
"7341",183974,"CENTENARY COLLEGE                                           ","2003-2004",15,"Soccer",100241,98727,1514,22743,22743,0,77498,75984,1514,"22","17",14364,29108
"4412",115001,"GLENDALE COMMUNITY COLLEGE                                  ","2003-2004",7,"Football",73796,72283,1513,73796,72283,1513,0,0,0,"65",".",38270,0
"12426",219976,"DAVID LIPSCOMB UNIVERSITY                                   ","2003-2004",25,"Track and Field, X-Country",110291,108779,1512,70566,68460,2106,39725,40319,-594,"8","11",11535,9979
"258",157447,"NORTHERN KENTUCKY UNIVERSITY                                ","2003-2004",1,"Baseball",214110,212599,1511,214110,212599,1511,0,0,0,"43",".",57222,0
"796",165529,"CURRY COLLEGE                                               ","2003-2004",1,"Baseball",33096,31585,1511,33096,31585,1511,0,0,0,"25",".",20533,0
"6167",184603,"FAIRLEIGH DICKINSON UNIVERSITY-METROPOLITAN CAMPUS          ","2003-2004",8,"Golf",59178,57668,1510,59178,57668,1510,0,0,0,"5",".",13092,0
"12576",140951,"SAVANNAH COLLEGE OF ART AND DESIGN                          ","2003-2004",25,"Track and Field, X-Country",71372,69862,1510,35685,34930,755,35687,34932,755,"5","13",5964,15508
"5076",171599,"OLIVET COLLEGE                                              ","2003-2004",7,"Football",179379,177871,1508,179379,177871,1508,0,0,0,"154",".",45768,0
"2670",179308,"SAINT LOUIS COMMUNITY COLLEGE-FOREST PARK                   ","2003-2004",2,"Basketball",26440,24940,1500,12662,11662,1000,13778,13278,500,"14","16",833,833
"7888",161518,"SAINT JOSEPHS COLLEGE                                       ","2003-2004",15,"Soccer",31380,29880,1500,14115,13365,750,17265,16515,750,"21","22",8038,11390
"9104",221014,"MILLIGAN COLLEGE                                            ","2003-2004",16,"Softball",135248,133748,1500,0,0,0,135248,133748,1500,".","16",0,14800
"9929",176318,"RUST COLLEGE                                                ","2003-2004",16,"Softball",6886,5386,1500,0,0,0,6886,5386,1500,".","13",0,3832
"10364",203535,"KENYON COLLEGE                                              ","2003-2004",18,"Swimming and Diving",207389,205889,1500,101917,101167,750,105472,104722,750,"31","31",39365,35488
"13164",176318,"RUST COLLEGE                                                ","2003-2004",26,"Volleyball",8664,7164,1500,0,0,0,8664,7164,1500,"0","16",0,4659
"15396",243133,"UNIVERSITY OF PUERTO RICO-BAYAMON                           ","2003-2004",37,"Table Tennis",2000,500,1500,2000,500,1500,0,0,0,"4","0",375,0
"12220",150400,"DEPAUW UNIVERSITY                                           ","2003-2004",25,"Track and Field, X-Country",187510,186013,1497,93998,96968,-2970,93512,89045,4467,"51","39",37807,30098
"16392",199643,"SHAW UNIVERSITY                                             ","2003-2004",39,"Total Participants",956539,955045,1494,401585,401435,150,554954,553610,1344,"147","91",259773,121044
"3962",154721,"BETHANY COLLEGE                                             ","2003-2004",3,"All Track Combined",180536,179044,1492,110587,109841,746,69949,69203,746,"26","9",21694,7510
"763",165024,"BRIDGEWATER STATE COLLEGE                                   ","2003-2004",1,"Baseball",27474,25986,1488,27474,25986,1488,0,0,0,"29",".",25474,0
"5911",183239,"SAINT ANSELM COLLEGE                                        ","2003-2004",8,"Golf",14926,13443,1483,14926,13443,1483,0,0,0,"13",".",9206,0
"336",183974,"CENTENARY COLLEGE                                           ","2003-2004",1,"Baseball",104340,102859,1481,104340,102859,1481,0,0,0,"32",".",40278,0
"9336",155210,"JOHNSON COUNTY COMMUNITY COLLEGE                            ","2003-2004",16,"Softball",89207,87731,1476,0,0,0,89207,87731,1476,".","16",0,30804
"1714",115861,"IMPERIAL VALLEY COLLEGE                                     ","2003-2004",2,"Basketball",68822,67348,1474,34432,33331,1101,34390,34017,373,"16","11",33328,34012
"4030",187134,"THE COLLEGE OF NEW JERSEY                                   ","2003-2004",6,"Field hocky",88011,86537,1474,0,0,0,88011,86537,1474,".","26",0,20076
"14035",173045,"AUGSBURG COLLEGE                                            ","2003-2004",26,"Volleyball",38052,36580,1472,0,0,0,38052,36580,1472,".","14",0,22102
"387",167899,"SPRINGFIELD COLLEGE                                         ","2003-2004",1,"Baseball",27376,25906,1470,27376,25906,1470,0,0,0,"58",".",19045,0
"3571",202514,"DEFIANCE COLLEGE                                            ","2003-2004",3,"All Track Combined",77092,75623,1469,38400,36898,1502,38692,38725,-33,"14","15",11977,13755
"7883",146676,"LINCOLN COLLEGE                                             ","2003-2004",15,"Soccer",77636,76170,1466,61785,63479,-1694,15851,12691,3160,"16","20",18235,5531
"7949",167288,"MASSACHUSETTS COLLEGE OF LIBERAL ARTS                       ","2003-2004",15,"Soccer",92279,90814,1465,55454,53708,1746,36825,37106,-281,"22","18",19956,13638
"9740",212197,"ELIZABETHTOWN COLLEGE                                       ","2003-2004",16,"Softball",16956,15492,1464,0,0,0,16956,15492,1464,".","17",0,8692
"4173",231581,"BRIDGEWATER COLLEGE                                         ","2003-2004",6,"Field hocky",34505,33043,1462,0,0,0,34505,33043,1462,".","24",0,15990
"15449",167288,"MASSACHUSETTS COLLEGE OF LIBERAL ARTS                       ","2003-2004",39,"Total Participants",215116,213662,1454,123782,122033,1749,91334,91629,-295,"72","58",77583,56356
"10037",123013,"SANTA ROSA JUNIOR COLLEGE                                   ","2003-2004",16,"Softball",42228,40775,1453,0,0,0,42228,40775,1453,".","12",0,17141
"11525",175980,"MILLSAPS COLLEGE                                            ","2003-2004",22,"Tennis",16452,15000,1452,8952,7500,1452,7500,7500,0,"7","7",4500,4500
"4200",168263,"WESTFIELD STATE COLLEGE                                     ","2003-2004",6,"Field hocky",17447,15997,1450,0,0,0,17447,15997,1450,".","21",0,7842
"9609",215266,"UNIVERSITY OF PITTSBURGH-BRADFORD                           ","2003-2004",16,"Softball",41808,40358,1450,0,0,0,41808,40358,1450,".","14",0,14491
"9703",215929,"UNIVERSITY OF SCRANTON                                      ","2003-2004",16,"Softball",26563,25118,1445,0,0,0,26563,25118,1445,".","21",0,10997
"8198",178341,"MISSOURI SOUTHERN STATE UNIVERSITY                          ","2003-2004",15,"Soccer",212757,211318,1439,95772,97735,-1963,116985,113583,3402,"24","17",21099,19040
"6601",192022,"JEFFERSON COMMUNITY COLLEGE                                 ","2003-2004",11,"Lacrosse",17300,15866,1434,9900,8512,1388,7400,7354,46,"17","14",4912,3754
"10541",239716,"SAINT NORBERT COLLEGE                                       ","2003-2004",19,"Swimming",24584,23151,1433,0,0,0,24584,23151,1433,".","21",0,16058
"6628",216524,"URSINUS COLLEGE                                             ","2003-2004",11,"Lacrosse",101327,99896,1431,55112,55492,-380,46215,44404,1811,"33","20",29112,20215
"9007",218414,"NEWBERRY COLLEGE                                            ","2003-2004",16,"Softball",36154,34733,1421,0,0,0,36154,34733,1421,".","18",0,25992
"7268",153001,"BUENA VISTA UNIVERSITY                                      ","2003-2004",15,"Soccer",71545,70125,1420,36607,36297,310,34938,33828,1110,"26","19",11286,8636
"7678",210739,"DESALES UNIVERSITY                                          ","2003-2004",15,"Soccer",70433,69013,1420,47262,46402,860,23171,22611,560,"24","23",17756,15191
"9482",173063,"RIVERLAND COMMUNITY COLLEGE                                 ","2003-2004",16,"Softball",21289,19874,1415,0,0,0,21289,19874,1415,".","11",0,7464
"13398",228343,"SOUTHWESTERN UNIVERSITY                                     ","2003-2004",26,"Volleyball",107263,105848,1415,0,0,0,107263,105848,1415,".","12",0,48693
"2993",181640,"SOUTHEAST COMMUNITY COLLEGE AREA                            ","2003-2004",2,"Basketball",107680,106266,1414,65276,64387,889,42404,41879,525,"15","11",19625,19785
"6113",209065,"LINFIELD COLLEGE                                            ","2003-2004",8,"Golf",27127,25713,1414,14511,13727,784,12616,11986,630,"10","9",8930,6570
"11618",196158,"SUNY COLLEGE AT FREDONIA                                    ","2003-2004",22,"Tennis",12190,10776,1414,5016,3226,1790,7174,7550,-376,"13","14",910,4052
"1770",175883,"JONES COUNTY JUNIOR COLLEGE                                 ","2003-2004",2,"Basketball",208138,206730,1408,107801,107097,704,100337,99633,704,"15","15",38419,30454
"3210",218399,"MORRIS COLLEGE                                              ","2003-2004",2,"Basketball",48612,47204,1408,24306,23602,704,24306,23602,704,"14","16",17934,17934
"15956",175236,"RIDGEWATER COLLEGE                                          ","2003-2004",39,"Total Participants",131226,129824,1402,61858,61342,516,69368,68482,886,"126","44",65690,39720
"12794",218645,"UNIVERSITY OF SOUTH CAROLINA-AIKEN                          ","2003-2004",25,"Track and Field, X-Country",38726,37325,1401,0,0,0,38726,37325,1401,".","9",0,3489
"13529",203085,"HEIDELBERG COLLEGE                                          ","2003-2004",26,"Volleyball",37710,36309,1401,0,0,0,37710,36309,1401,".","14",0,10588
"10782",114716,"FOOTHILL COLLEGE                                            ","2003-2004",22,"Tennis",5000,3600,1400,5000,3600,1400,0,0,0,"11",".",3400,0
"10960",230898,"GREEN MOUNTAIN COLLEGE                                      ","2003-2004",22,"Tennis",67692,66292,1400,44947,43547,1400,22745,22745,0,"7","8",8897,1271
"11718",153144,"COE COLLEGE                                                 ","2003-2004",22,"Tennis",50492,49092,1400,27044,26344,700,23448,22748,700,"11","20",6981,3385
"12802",197221,"WEBB INSTITUTE                                              ","2003-2004",25,"Track and Field, X-Country",1400,0,1400,1400,1400,0,0,0,0,"8",".",1399,0
"6496",167260,"NICHOLS COLLEGE                                             ","2003-2004",10,"Ice Hockey",49835,48436,1399,49835,48436,1399,0,0,0,"30",".",42436,0
"11711",217518,"ROGER WILLIAMS UNIVERSITY                                   ","2003-2004",22,"Tennis",22046,20648,1398,11402,10902,500,10644,9746,898,"9","13",5796,4566
"2912",154378,"SOUTHEASTERN COMMUNITY COLLEGE                              ","2003-2004",2,"Basketball",109869,108472,1397,109869,108472,1397,0,0,0,"12",".",51525,0
"11410",228343,"SOUTHWESTERN UNIVERSITY                                     ","2003-2004",22,"Tennis",103171,101775,1396,51459,50761,698,51712,51014,698,"10","10",23249,23298
"1301",157216,"LINDSEY WILSON COLLEGE                                      ","2003-2004",1,"Baseball",247331,245941,1390,247331,245941,1390,0,0,0,"23",".",21470,0
"7694",172051,"SAGINAW VALLEY STATE UNIVERSITY                             ","2003-2004",15,"Soccer",97170,95783,1387,36466,35079,1387,60704,60704,0,"19","22",11770,34693
"7133",165024,"BRIDGEWATER STATE COLLEGE                                   ","2003-2004",15,"Soccer",21690,20308,1382,10745,10136,609,10945,10172,773,"22","21",9745,9745
"12704",170532,"KALAMAZOO COLLEGE                                           ","2003-2004",25,"Track and Field, X-Country",21194,19812,1382,12048,10902,1146,9146,8910,236,"11","22",3698,7397
"11991",101569,"LAWSON STATE COMMUNITY COLLEGE                              ","2003-2004",24,"Track and Field, Outdoor",10120,8740,1380,10120,8740,1380,0,0,0,"12",".",3210,0
"11776",216278,"SUSQUEHANNA UNIVERSITY                                      ","2003-2004",22,"Tennis",13660,12281,1379,7300,6201,1099,6360,6080,280,"9","14",2467,2443
"6695",182980,"NEW ENGLAND COLLEGE                                         ","2003-2004",11,"Lacrosse",84210,82836,1374,50864,49083,1781,33346,33753,-407,"22","18",18821,10548
"193",114938,"GAVILAN COLLEGE                                             ","2003-2004",1,"Baseball",29453,28084,1369,29453,28084,1369,0,0,0,"23",".",14578,0
"7478",139144,"BERRY COLLEGE                                               ","2003-2004",15,"Soccer",648963,647598,1365,323329,323329,0,325634,324269,1365,"23","24",49625,49625
"2885",167288,"MASSACHUSETTS COLLEGE OF LIBERAL ARTS                       ","2003-2004",2,"Basketball",59757,58393,1364,28278,27250,1028,31479,31143,336,"16","9",14750,11695
"13060",164614,"BOSTON BAPTIST COLLEGE                                      ","2003-2004",26,"Volleyball",9050,7687,1363,0,0,0,9050,7687,1363,"0","8",0,1500
"11980",210304,"WARNER PACIFIC COLLEGE                                      ","2003-2004",24,"Track and Field, Outdoor",18192,16830,1362,12922,10322,2600,5270,6508,-1238,"15","6",6447,2633
"10572",215743,"SAINT FRANCIS UNIVERSITY                                    ","2003-2004",19,"Swimming",76621,75261,1360,0,0,0,76621,75261,1360,".","14",0,12772
"14546",196015,"SUNY COLLEGE OF TECHNOLOGY AT CANTON                        ","2003-2004",26,"Volleyball",22027,20667,1360,0,0,0,22027,20667,1360,".","8",0,13113
"4255",212197,"ELIZABETHTOWN COLLEGE                                       ","2003-2004",6,"Field hocky",31306,29952,1354,0,0,0,31306,29952,1354,".","23",0,11984
"9313",107558,"UNIVERSITY OF THE OZARKS                                    ","2003-2004",16,"Softball",39850,38500,1350,0,0,0,39850,38500,1350,".","19",0,18000
"12758",224323,"UNIVERSITY OF DALLAS                                        ","2003-2004",25,"Track and Field, X-Country",43128,41783,1345,21745,21915,-170,21383,19868,1515,"28","29",16560,15184
"7704",237066,"WHITWORTH COLLEGE                                           ","2003-2004",15,"Soccer",109407,108063,1344,53754,53039,715,55653,55024,629,"24","22",27408,20257
"16835",190521,"CUNY BOROUGH OF MANHATTAN COMMUNITY COLLEGE                 ","2003-2004",39,"Total Participants",65448,64105,1343,48027,48502,-475,17421,15603,1818,"57","30",51731,23372
"11568",154721,"BETHANY COLLEGE                                             ","2003-2004",22,"Tennis",77229,75889,1340,46746,45113,1633,30483,30776,-293,"10","7",5400,3780
"7689",110529,"CALIFORNIA STATE POLYTECHNIC UNIVERSITY-POMONA              ","2003-2004",15,"Soccer",193417,192078,1339,94844,93521,1323,98573,98557,16,"25","23",21781,21383
"9736",161226,"UNIVERSITY OF MAINE AT FARMINGTON                           ","2003-2004",16,"Softball",10775,9442,1333,0,0,0,10775,9442,1333,".","17",0,6739
"11538",212197,"ELIZABETHTOWN COLLEGE                                       ","2003-2004",22,"Tennis",16358,15028,1330,8374,7519,855,7984,7509,475,"8","10",4019,4009
"2265",194222,"ONONDAGA COMMUNITY COLLEGE                                  ","2003-2004",2,"Basketball",45771,44445,1326,25684,26279,-595,20087,18166,1921,"17","8",17557,9739
"7261",218821,"SPARTANBURG METHODIST COLLEGE                               ","2003-2004",15,"Soccer",133589,132264,1325,65362,65007,355,68227,67257,970,"31","22",17596,19936
"8393",130226,"QUINNIPIAC UNIVERSITY                                       ","2003-2004",15,"Soccer",769789,768464,1325,375699,375024,675,394090,393440,650,"30","26",39503,34981
"800",190521,"CUNY BOROUGH OF MANHATTAN COMMUNITY COLLEGE                 ","2003-2004",1,"Baseball",26349,25029,1320,26349,25029,1320,0,0,0,"18",".",18324,0
"5728",147341,"MONMOUTH COLLEGE                                            ","2003-2004",8,"Golf",28287,26969,1318,17983,17346,637,10304,9623,681,"14","8",8553,9075
"14612",186876,"THE RICHARD STOCKTON COLLEGE OF NEW JERSEY                  ","2003-2004",26,"Volleyball",31744,30426,1318,0,0,0,31744,30426,1318,".","13",0,12600
"13651",216524,"URSINUS COLLEGE                                             ","2003-2004",26,"Volleyball",22391,21076,1315,0,0,0,22391,21076,1315,".","13",0,16441
"23",139658,"EMORY UNIVERSITY                                            ","2003-2004",1,"Baseball",141041,139730,1311,141041,139730,1311,0,0,0,"30",".",57522,0
"3115",190530,"CUNY BRONX COMMUNITY COLLEGE                                ","2003-2004",2,"Basketball",16064,14753,1311,16064,14753,1311,0,0,0,"14",".",7640,0
"15944",170532,"KALAMAZOO COLLEGE                                           ","2003-2004",39,"Total Participants",289920,288614,1306,145521,129059,16462,144399,159555,-15156,"168","122",154304,84912
"11088",237066,"WHITWORTH COLLEGE                                           ","2003-2004",22,"Tennis",54328,53026,1302,23397,22035,1362,30931,30991,-60,"9","8",8848,11175
"2463",236896,"WALLA WALLA COLLEGE                                         ","2003-2004",2,"Basketball",59994,58694,1300,30047,29347,700,29947,29347,600,"12","12",23554,23143
"5719",110246,"BUTTE COLLEGE                                               ","2003-2004",8,"Golf",28595,27298,1297,13208,14402,-1194,15387,12896,2491,"14","6",12206,11079
"7295",150756,"HANOVER COLLEGE                                             ","2003-2004",15,"Soccer",101512,100222,1290,53324,51698,1626,48188,48524,-336,"21","26",24923,18588
"3361",237066,"WHITWORTH COLLEGE                                           ","2003-2004",2,"Basketball",195789,194501,1288,112213,112312,-99,83576,82189,1387,"12","22",50753,32128
"7766",144962,"ELMHURST COLLEGE                                            ","2003-2004",15,"Soccer",58101,56813,1288,0,0,0,58101,56813,1288,"0","27",0,25068
"2452",216542,"VALLEY FORGE CHRISTIAN COLLEGE                              ","2003-2004",2,"Basketball",22145,20863,1282,12940,10813,2127,9205,10050,-845,"12","8",10074,6796
"7053",231059,"SAINT MICHAELS COLLEGE                                      ","2003-2004",14,"Skiing",84899,83619,1280,46694,45990,704,38205,37629,576,"16","13",11769,9630
"7390",240453,"UNIVERSITY OF WISCONSIN-MILWAUKEE                           ","2003-2004",15,"Soccer",914138,912860,1278,478775,501866,-23091,435363,410994,24369,"32","34",107423,38684
"2321",168263,"WESTFIELD STATE COLLEGE                                     ","2003-2004",2,"Basketball",55990,54720,1270,30339,28423,1916,25651,26297,-646,"14","16",13196,13488
"14549",153144,"COE COLLEGE                                                 ","2003-2004",26,"Volleyball",44526,43258,1268,0,0,0,44526,43258,1268,".","27",0,16602
"6424",189547,"BROOME COMMUNITY COLLEGE                                    ","2003-2004",10,"Ice Hockey",30665,29398,1267,30665,29398,1267,0,0,0,"23",".",22048,0
"17065",189547,"BROOME COMMUNITY COLLEGE                                    ","2003-2004",39,"Total Participants",170464,169197,1267,99385,98118,1267,71079,71079,0,"120","77",82689,66665
"200",115001,"GLENDALE COMMUNITY COLLEGE                                  ","2003-2004",1,"Baseball",31115,29851,1264,31115,29851,1264,0,0,0,"30",".",14769,0
"14639",220701,"MARTIN METHODIST COLLEGE                                    ","2003-2004",26,"Volleyball",175656,174392,1264,0,0,0,175656,174392,1264,".","12",0,12099
"2552",146603,"LEWIS AND CLARK COMMUNITY COLLEGE                           ","2003-2004",2,"Basketball",111105,109844,1261,60802,60193,609,50303,49651,652,"14","15",17148,15089
"8406",140951,"SAVANNAH COLLEGE OF ART AND DESIGN                          ","2003-2004",15,"Soccer",249328,248067,1261,136065,137436,-1371,113263,110631,2632,"19","24",49944,46187
"16819",190442,"CORNING COMMUNITY COLLEGE                                   ","2003-2004",39,"Total Participants",43750,42489,1261,18250,16177,2073,25500,26312,-812,"50","55",15491,20760
"12425",148496,"DOMINICAN UNIVERSITY                                        ","2003-2004",25,"Track and Field, X-Country",20000,18740,1260,10000,9370,630,10000,9370,630,"6","6",1870,1870
"3037",226930,"MOUNTAIN VIEW COLLEGE                                       ","2003-2004",2,"Basketball",76500,75242,1258,48000,47721,279,28500,27521,979,"22","15",15752,9060
"6580",217059,"YORK COLLEGE PENNSYLVANIA                                   ","2003-2004",11,"Lacrosse",42880,41622,1258,42880,41622,1258,0,0,0,"22",".",18972,0
"1958",154509,"VENNARD COLLEGE                                             ","2003-2004",2,"Basketball",21412,20156,1256,12126,10498,1628,9286,9658,-372,"12","8",10126,9286
"11790",220631,"LINCOLN MEMORIAL UNIVERSITY                                 ","2003-2004",22,"Tennis",193287,192032,1255,87771,87771,0,105516,104261,1255,"7","6",14053,10933
"2378",192022,"JEFFERSON COMMUNITY COLLEGE                                 ","2003-2004",2,"Basketball",48782,47530,1252,24112,22860,1252,24670,24670,0,"14","15",12760,13570
"3224",161563,"THOMAS COLLEGE                                              ","2003-2004",2,"Basketball",42477,41225,1252,18028,18026,2,24449,23199,1250,"13","11",10026,7949
"1630",201858,"CINCINNATI BIBLE COLLEGE AND SEMINARY                       ","2003-2004",2,"Basketball",36860,35612,1248,21402,20210,1192,15458,15402,56,"12","11",12710,7902
"3984",190567,"CUNY CITY COLLEGE                                           ","2003-2004",5,"Fencing",13615,12367,1248,0,0,0,13615,12367,1248,".","17",0,6350
"11204",113333,"DE ANZA COLLEGE                                             ","2003-2004",22,"Tennis",18709,17464,1245,7985,7741,244,10724,9723,1001,"10","8",3106,4694
"9184",199643,"SHAW UNIVERSITY                                             ","2003-2004",16,"Softball",135360,134116,1244,0,0,0,135360,134116,1244,".","13",0,22626
"7394",204200,"COLLEGE OF MOUNT SAINT JOSEPH                               ","2003-2004",15,"Soccer",35310,34074,1236,0,0,0,35310,34074,1236,".","20",0,11467
"10808",147004,"MCHENRY COUNTY COLLEGE                                      ","2003-2004",22,"Tennis",19400,18164,1236,9700,9341,359,9700,8823,877,"9","6",1425,3616
"3999",172644,"WAYNE STATE UNIVERSITY                                      ","2003-2004",5,"Fencing",183102,181867,1235,91791,91146,645,91311,90721,590,"11","9",19031,14716
"4948",174473,"NORTHLAND COMMUNITY AND TECHNICAL COLLEGE                   ","2003-2004",7,"Football",34286,33054,1232,34286,33054,1232,0,0,0,"75",".",29021,0
"14174",111461,"COLLEGE OF THE CANYONS                                      ","2003-2004",26,"Volleyball",15743,14511,1232,0,0,0,15743,14511,1232,".","13",0,11595
"6018",160977,"BATES COLLEGE                                               ","2003-2004",8,"Golf",29643,28413,1230,18074,16844,1230,11569,11569,0,"8","4",8422,3167
"9630",146366,"KASKASKIA COLLEGE                                           ","2003-2004",16,"Softball",56499,55269,1230,0,0,0,56499,55269,1230,".","19",0,34221
"12919",189848,"CAZENOVIA COLLEGE                                           ","2003-2004",25,"Track and Field, X-Country",9458,8229,1229,2460,1860,600,6998,6369,629,"3","7",1760,6169
"17213",164614,"BOSTON BAPTIST COLLEGE                                      ","2003-2004",39,"Total Participants",18050,16824,1226,9000,9137,-137,9050,7687,1363,"27","15",3000,3000
"6796",164739,"BENTLEY COLLEGE                                             ","2003-2004",11,"Lacrosse",97273,96048,1225,71649,70549,1100,25624,25499,125,"37","25",25083,8946
"5593",121886,"RIO HONDO COLLEGE                                           ","2003-2004",8,"Golf",15540,14316,1224,15540,14316,1224,0,0,0,"12",".",6159,0
"9691",164270,"MCDANIEL COLLEGE                                            ","2003-2004",16,"Softball",31615,30392,1223,0,0,0,31615,30392,1223,".","16",0,20632
"12162",173647,"GUSTAVUS ADOLPHUS COLLEGE                                   ","2003-2004",25,"Track and Field, X-Country",234691,233469,1222,109419,108413,1006,125272,125056,216,"117","110",27350,27893
"775",199281,"UNIVERSITY OF NORTH CAROLINA AT PEMBROKE                    ","2003-2004",1,"Baseball",49666,48446,1220,49666,48446,1220,0,0,0,"30",".",34526,0
"9568",228769,"THE UNIVERSITY OF TEXAS AT ARLINGTON                        ","2003-2004",16,"Softball",294672,293453,1219,0,0,0,294672,293453,1219,".","14",0,84433
"3875",130226,"QUINNIPIAC UNIVERSITY                                       ","2003-2004",3,"All Track Combined",217919,216704,1215,128833,128118,715,89086,88586,500,"74","60",39655,36473
"8888",145521,"HIGHLAND COMMUNITY COLLEGE                                  ","2003-2004",16,"Softball",11000,9785,1215,0,0,0,11000,9785,1215,".","11",0,7376
"11412",167260,"NICHOLS COLLEGE                                             ","2003-2004",22,"Tennis",16993,15778,1215,8504,8504,0,8489,7274,1215,"7","7",4004,2443
"246",198817,"LENOIR COMMUNITY COLLEGE                                    ","2003-2004",1,"Baseball",59430,58221,1209,59430,58221,1209,0,0,0,"25",".",32131,0
"10258",169798,"EASTERN MICHIGAN UNIVERSITY                                 ","2003-2004",18,"Swimming and Diving",642198,640989,1209,328637,274489,54148,313561,366500,-52939,"27","31",33772,58569
"16523",198817,"LENOIR COMMUNITY COLLEGE                                    ","2003-2004",39,"Total Participants",76434,75225,1209,59430,58221,1209,17004,17004,0,"38","9",51229,11490
"15646",181020,"DOANE COLLEGE                                               ","2003-2004",39,"Total Participants",1379142,1377935,1207,608918,609254,-336,770224,768681,1543,"276","175",210800,194708
"2182",175786,"HINDS COMMUNITY COLLEGE                                     ","2003-2004",2,"Basketball",133707,132502,1205,78853,77648,1205,54854,54854,0,"15","15",22893,13405
"9068",230959,"MIDDLEBURY COLLEGE                                          ","2003-2004",16,"Softball",56538,55337,1201,0,0,0,56538,55337,1201,".","15",0,9725
"1267",211981,"DELAWARE VALLEY COLLEGE                                     ","2003-2004",1,"Baseball",36970,35770,1200,36970,35770,1200,0,0,0,"32",".",13300,0
"1800",117715,"LOS ANGELES SOUTHWEST COLLEGE                               ","2003-2004",2,"Basketball",53200,52000,1200,26600,26000,600,26600,26000,600,"15","13",10000,10000
"9512",153144,"COE COLLEGE                                                 ","2003-2004",16,"Softball",41669,40469,1200,0,0,0,41669,40469,1200,".","24",0,26169
"13898",144944,"ELGIN COMMUNITY COLLEGE                                     ","2003-2004",26,"Volleyball",17300,16100,1200,0,0,0,17300,16100,1200,".","8",0,13200
"13235",140818,"PIEDMONT COLLEGE                                            ","2003-2004",26,"Volleyball",56478,55281,1197,0,0,0,56478,55281,1197,".","12",0,12402
"9578",191719,"HUDSON VALLEY COMMUNITY COLLEGE                             ","2003-2004",16,"Softball",24704,23513,1191,0,0,0,24704,23513,1191,".","15",0,16635
"5120",110574,"CALIFORNIA STATE UNIVERSITY-HAYWARD                         ","2003-2004",8,"Golf",74154,72966,1188,41227,40634,593,32927,32332,595,"7","6",15323,7022
"15413",243133,"UNIVERSITY OF PUERTO RICO-BAYAMON                           ","2003-2004",38,"Weight Lifting",20000,18812,1188,10000,9431,569,10000,9381,619,"9","7",6801,6751
"3437",224572,"EASTFIELD COLLEGE                                           ","2003-2004",2,"Basketball",82356,81170,1186,82356,81170,1186,0,0,0,"14",".",34726,0
"4366",170055,"GRAND RAPIDS COMMUNITY COLLEGE                              ","2003-2004",7,"Football",55662,54479,1183,55662,54479,1183,0,0,0,"80",".",26031,0
"15025",240268,"UNIVERSITY OF WISCONSIN-EAU CLAIRE                          ","2003-2004",28,"Wrestling",27007,25828,1179,27007,25828,1179,0,0,0,"19",".",12034,0
"15268",232681,"MARY WASHINGTON COLLEGE                                     ","2003-2004",34,"Equestrian",20293,19117,1176,0,0,0,20293,19117,1176,".","20",0,13079
"4027",167996,"STONEHILL COLLEGE                                           ","2003-2004",6,"Field hocky",54127,52953,1174,0,0,0,54127,52953,1174,".","22",0,19143
"7813",196200,"SUNY-POTSDAM                                                ","2003-2004",15,"Soccer",126436,125262,1174,80815,79530,1285,45621,45732,-111,"26","26",25241,23229
"10569",146427,"KNOX COLLEGE                                                ","2003-2004",19,"Swimming",14322,13148,1174,6225,5700,525,8097,7448,649,"5","16",2975,4723
"1752",218414,"NEWBERRY COLLEGE                                            ","2003-2004",2,"Basketball",67421,66248,1173,37779,39789,-2010,29642,26459,3183,"17","17",33932,22916
"321",167260,"NICHOLS COLLEGE                                             ","2003-2004",1,"Baseball",40768,39599,1169,40768,39599,1169,0,0,0,"25",".",33599,0
"18",204945,"OWENS COMMUNITY COLLEGE                                     ","2003-2004",1,"Baseball",51749,50582,1167,51749,50582,1167,0,0,0,"21",".",7373,0
"9126",102377,"TUSKEGEE UNIVERSITY                                         ","2003-2004",16,"Softball",94656,93491,1165,0,0,0,94656,93491,1165,".","19",0,21410
"13042",154022,"THE FRANCISCAN UNIVERSITY                                   ","2003-2004",26,"Volleyball",12100,10937,1163,0,0,0,12100,10937,1163,".","17",0,8600
"5703",153366,"GRACELAND UNIVERSITY-LAMONI                                 ","2003-2004",8,"Golf",48026,46866,1160,33138,32558,580,14888,14308,580,"14","6",5215,5215
"7750",184612,"FELICIAN COLLEGE                                            ","2003-2004",15,"Soccer",287768,286608,1160,158564,158902,-338,129204,127706,1498,"17","14",35264,25104
"16632",237136,"APPALACHIAN BIBLE COLLEGE                                   ","2003-2004",39,"Total Participants",25398,24238,1160,14993,14048,945,10405,10190,215,"32","25",21130,17465
"10939",226231,"LETOURNEAU UNIVERSITY                                       ","2003-2004",22,"Tennis",38018,36860,1158,19079,18500,579,18939,18360,579,"9","6",3039,4352
"7406",228325,"SOUTHWESTERN ASSEMBLIES OF GOD UNIVERSITY                   ","2003-2004",15,"Soccer",39881,38725,1156,39881,38725,1156,0,0,0,"23",".",19206,0
"12971",161767,"ANNE ARUNDEL COMMUNITY COLLEGE                              ","2003-2004",25,"Track and Field, X-Country",7852,6697,1155,7852,6697,1155,0,0,0,"9",".",3252,0
"12018",111461,"COLLEGE OF THE CANYONS                                      ","2003-2004",24,"Track and Field, Outdoor",16934,15780,1154,8467,8890,-423,8467,6890,1577,"23","16",7176,4992
"5987",156356,"BRESCIA UNIVERSITY                                          ","2003-2004",8,"Golf",13075,11925,1150,6650,5950,700,6425,5975,450,"10","6",5900,5950
"234",115393,"HARTNELL COLLEGE                                            ","2003-2004",1,"Baseball",31553,30404,1149,31553,30404,1149,0,0,0,"27",".",19025,0
"13912",195003,"ROCHESTER INSTITUTE OF TECHNOLOGY                           ","2003-2004",26,"Volleyball",66032,64884,1148,0,0,0,66032,64884,1148,".","16",0,36797
"6561",165699,"ENDICOTT COLLEGE                                            ","2003-2004",11,"Lacrosse",95378,94233,1145,49275,48130,1145,46103,46103,0,"37","18",19350,24800
"2640",125462,"WEST HILLS COMMUNITY COLLEGE                                ","2003-2004",2,"Basketball",26030,24886,1144,26030,24886,1144,0,0,0,"18",".",11484,0
"8377",206862,"SOUTHERN NAZARENE UNIVERSITY                                ","2003-2004",15,"Soccer",330269,329125,1144,183076,182504,572,147193,146621,572,"39","24",21721,16308
"16473",206862,"SOUTHERN NAZARENE UNIVERSITY                                ","2003-2004",39,"Total Participants",1268567,1267423,1144,619747,619175,572,648820,648248,572,"211","109",296584,141442
"4183",164270,"MCDANIEL COLLEGE                                            ","2003-2004",6,"Field hocky",39995,38853,1142,0,0,0,39995,38853,1142,".","31",0,19251
"10919",196079,"SUNY AT BINGHAMTON                                          ","2003-2004",22,"Tennis",247538,246397,1141,116547,119511,-2964,130991,126886,4105,"9","13",12573,9643
"13068",133085,"CLEARWATER CHRISTIAN COLLEGE                                ","2003-2004",26,"Volleyball",21852,20713,1139,0,0,0,21852,20713,1139,"0","14",0,20458
"2760",161217,"UNIVERSITY OF MAINE AT AUGUSTA                              ","2003-2004",2,"Basketball",41217,40082,1135,25769,24671,1098,15448,15411,37,"12","7",21410,8233
"14604",162779,"HOWARD COMMUNITY COLLEGE                                    ","2003-2004",26,"Volleyball",11345,10210,1135,0,0,0,11345,10210,1135,".","8",0,7508
"3141",216852,"WIDENER UNIVERSITY-MAIN CAMPUS                              ","2003-2004",2,"Basketball",105475,104358,1117,56502,56502,0,48973,47856,1117,"21","17",14907,15260
"14391",166683,"MASSACHUSETTS INSTITUTE OF TECHNOLOGY                       ","2003-2004",26,"Volleyball",78357,77240,1117,33056,33199,-143,45301,44041,1260,"8","14",16594,29626
"5275",183974,"CENTENARY COLLEGE                                           ","2003-2004",8,"Golf",9464,8349,1115,9464,8349,1115,0,0,0,"8",".",2699,0
"9769",111939,"CHAFFEY COLLEGE                                             ","2003-2004",16,"Softball",12157,11043,1114,0,0,0,12157,11043,1114,".","16",0,4377
"10784",191241,"FORDHAM UNIVERSITY                                          ","2003-2004",22,"Tennis",238401,237288,1113,116152,116626,-474,122249,120662,1587,"10","7",12062,11695
"5845",174817,"SAINT MARY'S UNIVERSITY OF MINNESOTA                        ","2003-2004",8,"Golf",35684,34573,1111,18808,18613,195,16876,15960,916,"15","10",8030,6184
"11821",240268,"UNIVERSITY OF WISCONSIN-EAU CLAIRE                          ","2003-2004",23,"Track and Field, Indoor",31241,30132,1109,14761,15759,-998,16480,14373,2107,"46","36",7228,4485
"3986",169716,"UNIVERSITY OF DETROIT MERCY                                 ","2003-2004",5,"Fencing",44771,43663,1108,22218,21664,554,22553,21999,554,"6","8",8542,8542
"14202",234845,"CENTRALIA COLLEGE                                           ","2003-2004",26,"Volleyball",23925,22819,1106,0,0,0,23925,22819,1106,"0","11",0,13526
"2641",147341,"MONMOUTH COLLEGE                                            ","2003-2004",2,"Basketball",73875,72771,1104,50244,49504,740,23631,23267,364,"20","13",23321,14487
"909",120342,"ORANGE COAST COLLEGE                                        ","2003-2004",1,"Baseball",42782,41679,1103,42782,41679,1103,0,0,0,"31",".",32414,0
"5818",221519,"SEWANEE-THE UNIVERSITY OF THE SOUTH                         ","2003-2004",8,"Golf",56218,55116,1102,25729,25579,150,30489,29537,952,"12","6",7350,7350
"13062",239512,"NORTHLAND COLLEGE                                           ","2003-2004",26,"Volleyball",39769,38667,1102,0,0,0,39769,38667,1102,".","9",0,18898
"15214",198862,"LIVINGSTONE COLLEGE                                         ","2003-2004",33,"Bowling",17596,16494,1102,0,0,0,17596,16494,1102,".","5",0,7995
"3226",125499,"WEST VALLEY COLLEGE                                         ","2003-2004",2,"Basketball",19885,18785,1100,19885,18785,1100,0,0,0,"13",".",2080,0
"6654",189848,"CAZENOVIA COLLEGE                                           ","2003-2004",11,"Lacrosse",52184,51084,1100,23882,24782,-900,28302,26302,2000,"18","17",23782,25302
"10979",164739,"BENTLEY COLLEGE                                             ","2003-2004",22,"Tennis",33938,32838,1100,16759,15659,1100,17179,17179,0,"15","10",8453,5531
"12595",196112,"SUNY INSTITUTE OF TECHNOLOGY AT UTICA-ROME                  ","2003-2004",25,"Track and Field, X-Country",26374,25274,1100,12431,12431,0,13943,12843,1100,"5","5",1390,1470
"13701",203535,"KENYON COLLEGE                                              ","2003-2004",26,"Volleyball",56614,55514,1100,0,0,0,56614,55514,1100,".","17",0,22203
"11780",123013,"SANTA ROSA JUNIOR COLLEGE                                   ","2003-2004",22,"Tennis",35838,34743,1095,17440,16345,1095,18398,18398,0,"12","8",5579,5480
"9282",165644,"EASTERN NAZARENE COLLEGE                                    ","2003-2004",16,"Softball",18378,17285,1093,0,0,0,18378,17285,1093,".","12",0,12285
"12740",120342,"ORANGE COAST COLLEGE                                        ","2003-2004",25,"Track and Field, X-Country",35860,34770,1090,17930,17385,545,17930,17385,545,"25","19",16034,16034
"13715",228501,"SUL ROSS STATE UNIVERSITY                                   ","2003-2004",26,"Volleyball",41504,40414,1090,0,0,0,41504,40414,1090,".","14",0,20354
"12311",191649,"HOFSTRA UNIVERSITY                                          ","2003-2004",25,"Track and Field, X-Country",280433,279344,1089,148028,147156,872,132405,132188,217,"9","12",22887,22887
"14325",186399,"RUTGERS UNIVERSITY-NEWARK                                   ","2003-2004",26,"Volleyball",235081,233993,1088,170586,168442,2144,64495,65551,-1056,"14","14",54332,17664
"13881",179326,"SOUTHWEST BAPTIST UNIVERSITY                                ","2003-2004",26,"Volleyball",188447,187363,1084,0,0,0,188447,187363,1084,".","14",0,19142
"14281",101569,"LAWSON STATE COMMUNITY COLLEGE                              ","2003-2004",26,"Volleyball",20741,19658,1083,0,0,0,20741,19658,1083,".","12",0,10810
"11764",152318,"ROSE-HULMAN INSTITUTE OF TECHNOLOGY                         ","2003-2004",22,"Tennis",38082,37000,1082,18867,18000,867,19215,19000,215,"11","10",10115,9215
"4065",206525,"WITTENBERG UNIVERSITY                                       ","2003-2004",6,"Field hocky",62076,61002,1074,0,0,0,62076,61002,1074,".","14",0,11856
"14715",123013,"SANTA ROSA JUNIOR COLLEGE                                   ","2003-2004",27,"Water Polo",45845,44772,1073,15810,15345,465,30035,29427,608,"13","12",4159,4511
"5277",229072,"TEXAS SOUTHMOST COLLEGE                                     ","2003-2004",8,"Golf",86660,85595,1065,53729,53069,660,32931,32526,405,"8","5",42197,25863
"13526",225548,"HOWARD PAYNE UNIVERSITY                                     ","2003-2004",26,"Volleyball",45331,44266,1065,0,0,0,45331,44266,1065,".","11",0,17300
"14514",146366,"KASKASKIA COLLEGE                                           ","2003-2004",26,"Volleyball",46655,45590,1065,0,0,0,46655,45590,1065,".","16",0,31212
"14498",123013,"SANTA ROSA JUNIOR COLLEGE                                   ","2003-2004",26,"Volleyball",22543,21481,1062,0,0,0,22543,21481,1062,".","14",0,10084
"13993",115393,"HARTNELL COLLEGE                                            ","2003-2004",26,"Volleyball",21033,19974,1059,0,0,0,21033,19974,1059,"0","6",0,5606
"6036",181640,"SOUTHEAST COMMUNITY COLLEGE AREA                            ","2003-2004",8,"Golf",29010,27952,1058,29010,27952,1058,0,0,0,"5",".",6202,0
"10231",111461,"COLLEGE OF THE CANYONS                                      ","2003-2004",18,"Swimming and Diving",17446,16388,1058,8723,4097,4626,8723,12291,-3568,"5","15",2771,8314
"12239",141486,"CHAMINADE UNIVERSITY OF HONOLULU                            ","2003-2004",25,"Track and Field, X-Country",23088,22030,1058,11544,11015,529,11544,11015,529,"9","8",11014,11014
"7167",110574,"CALIFORNIA STATE UNIVERSITY-HAYWARD                         ","2003-2004",15,"Soccer",159773,158723,1050,85982,86774,-792,73791,71949,1842,"24","16",37014,25189
"9978",207050,"EASTERN OKLAHOMA STATE COLLEGE                              ","2003-2004",16,"Softball",91000,89950,1050,0,0,0,91000,89950,1050,".","16",0,88640
"10129",182670,"DARTMOUTH COLLEGE                                           ","2003-2004",18,"Swimming and Diving",352934,351886,1048,204012,187894,16118,148922,163992,-15070,"26","27",76922,55026
"9731",111461,"COLLEGE OF THE CANYONS                                      ","2003-2004",16,"Softball",13033,11987,1046,0,0,0,13033,11987,1046,".","14",0,11977
"5852",202514,"DEFIANCE COLLEGE                                            ","2003-2004",8,"Golf",15798,14755,1043,8387,7703,684,7411,7052,359,"4","6",5746,4610
"12906",147411,"MORTON COLLEGE                                              ","2003-2004",25,"Track and Field, X-Country",34632,33592,1040,10656,10336,320,23976,23256,720,"4","9",3172,7137
"16900",115861,"IMPERIAL VALLEY COLLEGE                                     ","2003-2004",39,"Total Participants",161764,160724,1040,75027,73805,1222,86737,86919,-182,"73","58",107124,120940
"5286",153834,"LUTHER COLLEGE                                              ","2003-2004",8,"Golf",32503,31466,1037,16832,17424,-592,15671,14042,1629,"13","16",11094,9218
"6060",153126,"CLARKE COLLEGE                                              ","2003-2004",8,"Golf",30862,29825,1037,23425,23308,117,7437,6517,920,"8","5",8413,2887
"109",165699,"ENDICOTT COLLEGE                                            ","2003-2004",1,"Baseball",80712,79680,1032,80712,79680,1032,0,0,0,"27",".",47000,0
"5247",184694,"FAIRLEIGH DICKINSON UNIVERSITY-COLLEGE AT FLORHAM           ","2003-2004",8,"Golf",14950,13920,1030,14950,13920,1030,0,0,0,"14",".",3470,0
"3761",152318,"ROSE-HULMAN INSTITUTE OF TECHNOLOGY                         ","2003-2004",3,"All Track Combined",165028,164000,1028,96713,96000,713,68315,68000,315,"27","12",33929,23315
"4416",161165,"HUSSON COLLEGE                                              ","2003-2004",7,"Football",142310,141284,1026,142310,141284,1026,0,0,0,"67",".",104688,0
"14582",173559,"MINNESOTA STATE COMM AND TECH COLLEGE-FERGUS FALLS          ","2003-2004",26,"Volleyball",38826,37800,1026,0,0,0,38826,37800,1026,".","14",0,12734
"13468",181640,"SOUTHEAST COMMUNITY COLLEGE AREA                            ","2003-2004",26,"Volleyball",37776,36752,1024,0,0,0,37776,36752,1024,".","12",0,11359
"13208",173300,"CONCORDIA COLLEGE AT MOORHEAD                               ","2003-2004",26,"Volleyball",57597,56576,1021,0,0,0,57597,56576,1021,".","25",0,4240
"2172",104346,"CENTRAL ARIZONA COLLEGE                                     ","2003-2004",2,"Basketball",168482,167462,1020,66229,64660,1569,102253,102802,-549,"12","11",12844,30535
"5533",203128,"HIRAM COLLEGE                                               ","2003-2004",8,"Golf",13795,12776,1019,9450,9666,-216,4345,3110,1235,"11","5",5210,2900
"13983",439288,"JOHNSON &amp; WALES UNIVERSITY-DENVER                           ","2003-2004",26,"Volleyball",25669,24652,1017,8412,9250,-838,17257,15402,1855,"7","14",4250,10402
"15017",240374,"UNIVERSITY OF WISCONSIN-PARKSIDE                            ","2003-2004",28,"Wrestling",112938,111921,1017,112938,111921,1017,0,0,0,"15",".",13364,0
"5469",161165,"HUSSON COLLEGE                                              ","2003-2004",8,"Golf",26484,25468,1016,26484,25468,1016,0,0,0,"11",".",6214,0
"12419",106342,"LYON COLLEGE                                                ","2003-2004",25,"Track and Field, X-Country",54234,53219,1015,24887,24380,507,29347,28839,508,"9","8",3203,3203
"13870",174206,"CROSSROADS COLLEGE                                          ","2003-2004",26,"Volleyball",7830,6817,1013,0,0,0,7830,6817,1013,".","9",0,4380
"15621",174206,"CROSSROADS COLLEGE                                          ","2003-2004",39,"Total Participants",7830,6817,1013,0,0,0,7830,6817,1013,"17","9",7150,4380
"538",147828,"OLIVET NAZARENE UNIVERSITY                                  ","2003-2004",1,"Baseball",212987,211975,1012,212987,211975,1012,0,0,0,"24",".",35080,0
"7599",240417,"UNIVERSITY OF WISCONSIN-STOUT                               ","2003-2004",15,"Soccer",55042,54031,1011,0,0,0,55042,54031,1011,".","31",0,23405
"14073",220598,"LANE COLLEGE                                                ","2003-2004",26,"Volleyball",19040,18031,1009,0,0,0,19040,18031,1009,".","12",0,7040
"16164",174899,"THE COLLEGE OF SAINT SCHOLASTICA                            ","2003-2004",39,"Total Participants",702127,701118,1009,363161,363109,52,338966,338009,957,"127","154",216274,174025
"13283",148584,"UNIVERSITY OF ST FRANCIS                                    ","2003-2004",26,"Volleyball",164295,163287,1008,0,0,0,164295,163287,1008,".","14",0,12425
"1348",161226,"UNIVERSITY OF MAINE AT FARMINGTON                           ","2003-2004",1,"Baseball",11499,10496,1003,11499,10496,1003,0,0,0,"18",".",8544,0
"4260",167260,"NICHOLS COLLEGE                                             ","2003-2004",6,"Field hocky",19860,18859,1001,0,0,0,19860,18859,1001,".","12",0,12859
"2036",148335,"ROBERT MORRIS COLLEGE                                       ","2003-2004",2,"Basketball",1034381,1033381,1000,554137,553137,1000,480244,480244,0,"36","27",175506,133402
"3268",181093,"GRACE UNIVERSITY                                            ","2003-2004",2,"Basketball",43219,42219,1000,25693,24893,800,17526,17326,200,"13","10",21893,14326
"3544",211981,"DELAWARE VALLEY COLLEGE                                     ","2003-2004",3,"All Track Combined",46050,45050,1000,23650,23050,600,22400,22000,400,"31","31",6000,5400
"4291",166692,"MASSACHUSETTS MARITIME ACADEMY                              ","2003-2004",7,"Football",40000,39000,1000,40000,39000,1000,0,0,0,"71",".",20000,0
"5295",221014,"MILLIGAN COLLEGE                                            ","2003-2004",8,"Golf",49762,48762,1000,49762,48762,1000,0,0,0,"9",".",7000,0
"5642",192703,"MANHATTAN COLLEGE                                           ","2003-2004",8,"Golf",58748,57748,1000,58748,57748,1000,0,0,0,"9",".",18303,0
"6154",148007,"PRAIRIE STATE COLLEGE                                       ","2003-2004",8,"Golf",7000,6000,1000,7000,6000,1000,0,0,0,"7",".",4400,0
"6920",197133,"VASSAR COLLEGE                                              ","2003-2004",13,"Rowing",109777,108777,1000,53375,52875,500,56402,55902,500,"19","33",18617,21644
"7484",155177,"HESSTON COLLEGE                                             ","2003-2004",15,"Soccer",26366,25366,1000,26366,25366,1000,0,0,0,"21",".",11366,0
"7871",192703,"MANHATTAN COLLEGE                                           ","2003-2004",15,"Soccer",472479,471479,1000,228554,227554,1000,243925,243925,0,"23","20",44537,38802
"8013",197911,"BARTON COLLEGE                                              ","2003-2004",15,"Soccer",159128,158128,1000,94963,94963,0,64165,63165,1000,"23","15",14119,14413
"8224",175786,"HINDS COMMUNITY COLLEGE                                     ","2003-2004",15,"Soccer",89325,88325,1000,42132,41132,1000,47193,47193,0,"25","25",10592,15322
"8545",117867,"LOS ANGELES MISSION COLLEGE                                 ","2003-2004",16,"Softball",68000,67000,1000,0,0,0,68000,67000,1000,".","15",0,23000
"8596",237358,"DAVIS AND ELKINS COLLEGE                                    ","2003-2004",16,"Softball",24445,23445,1000,0,0,0,24445,23445,1000,".","14",0,12556
"9022",181534,"PERU STATE COLLEGE                                          ","2003-2004",16,"Softball",59714,58714,1000,0,0,0,59714,58714,1000,".","13",0,9803
"9612",146296,"JOLIET JUNIOR COLLEGE                                       ","2003-2004",16,"Softball",19000,18000,1000,0,0,0,19000,18000,1000,".","14",0,7500
"10084",131469,"GEORGE WASHINGTON UNIVERSITY                                ","2003-2004",17,"Squash",50843,49843,1000,29979,28979,1000,20864,20864,0,"13","12",7815,4735
"11288",146296,"JOLIET JUNIOR COLLEGE                                       ","2003-2004",22,"Tennis",16000,15000,1000,8000,7500,500,8000,7500,500,"13","3",4000,4000
"11303",203535,"KENYON COLLEGE                                              ","2003-2004",22,"Tennis",116659,115659,1000,58441,57941,500,58218,57718,500,"8","10",22872,22200
"11390",199209,"NORTH CAROLINA WESLEYAN COLLEGE                             ","2003-2004",22,"Tennis",7548,6548,1000,7048,6000,1048,500,548,-48,"10","1",1000,500
"12353",164270,"MCDANIEL COLLEGE                                            ","2003-2004",25,"Track and Field, X-Country",24088,23088,1000,12044,11544,500,12044,11544,500,"11","15",4218,4218
"13069",221014,"MILLIGAN COLLEGE                                            ","2003-2004",26,"Volleyball",124842,123842,1000,0,0,0,124842,123842,1000,".","15",0,15200
"13280",168786,"AQUINAS COLLEGE                                             ","2003-2004",26,"Volleyball",24000,23000,1000,0,0,0,24000,23000,1000,".","12",0,24000
"13488",237783,"SALEM INTERNATIONAL UNIVERSITY                              ","2003-2004",26,"Volleyball",26543,25543,1000,0,0,0,26543,25543,1000,"0","9",0,10275
"15510",181534,"PERU STATE COLLEGE                                          ","2003-2004",39,"Total Participants",358870,357870,1000,127510,127510,0,231360,230360,1000,"130","64",74647,43153
"4283",200484,"TRINITY BIBLE COLLEGE                                       ","2003-2004",7,"Football",71248,70251,997,71248,70251,997,0,0,0,"28",".",25693,0
"4073",216931,"WILKES UNIVERSITY                                           ","2003-2004",6,"Field hocky",54964,53968,996,0,0,0,54964,53968,996,".","19",0,14086
"13251",120342,"ORANGE COAST COLLEGE                                        ","2003-2004",26,"Volleyball",60637,59643,994,33843,32978,865,26794,26665,129,"12","11",27719,21940
"15032",216296,"THADDEUS STEVENS COLLEGE OF TECHNOLOGY                      ","2003-2004",28,"Wrestling",26000,25006,994,26000,25006,994,0,0,0,"17",".",18429,0
"5409",237792,"SHEPHERD COLLEGE                                            ","2003-2004",8,"Golf",18317,17326,991,18317,17326,991,0,0,0,"11",".",9593,0
"8692",204857,"OHIO UNIVERSITY-MAIN CAMPUS                                 ","2003-2004",16,"Softball",424380,423389,991,0,0,0,424380,423389,991,".","23",0,79472
"3698",157216,"LINDSEY WILSON COLLEGE                                      ","2003-2004",3,"All Track Combined",301895,300905,990,163850,163355,495,138045,137550,495,"18","15",7563,7564
"12201",214069,"COLLEGE MISERICORDIA                                        ","2003-2004",25,"Track and Field, X-Country",7100,6110,990,3550,3055,495,3550,3055,495,"18","12",2311,2311
"14576",154378,"SOUTHEASTERN COMMUNITY COLLEGE                              ","2003-2004",26,"Volleyball",10044,9055,989,0,0,0,10044,9055,989,".","11",0,5715
"16637",154378,"SOUTHEASTERN COMMUNITY COLLEGE                              ","2003-2004",39,"Total Participants",132935,131946,989,77098,77098,0,55837,54848,989,"44","30",90116,25562
"12015",213251,"JUNIATA COLLEGE                                             ","2003-2004",24,"Track and Field, Outdoor",27733,26750,983,16105,16175,-70,11628,10575,1053,"18","24",9238,3638
"5733",439288,"JOHNSON &amp; WALES UNIVERSITY-DENVER                           ","2003-2004",8,"Golf",12255,11273,982,10000,9000,1000,2255,2273,-18,"10",".",6000,1555
"10531",214069,"COLLEGE MISERICORDIA                                        ","2003-2004",19,"Swimming",12500,11528,972,6250,5764,486,6250,5764,486,"10","17",1222,1222
"14917",121619,"SANTA ANA COLLEGE                                           ","2003-2004",28,"Wrestling",12100,11133,967,12100,11133,967,0,0,0,"20",".",9664,0
"6247",140234,"LAGRANGE COLLEGE                                            ","2003-2004",8,"Golf",23770,22807,963,23770,22807,963,0,0,0,"9",".",12800,0
"4492",198598,"GREENSBORO COLLEGE                                          ","2003-2004",7,"Football",183335,182375,960,183335,182375,960,0,0,0,"83",".",41679,0
"5130",177940,"LINCOLN UNIVERSITY                                          ","2003-2004",8,"Golf",33595,32637,958,33595,32637,958,0,0,0,"6",".",14174,0
"6121",210401,"WILLAMETTE UNIVERSITY                                       ","2003-2004",8,"Golf",14575,13617,958,9287,11170,-1883,5288,2447,2841,"10","5",9170,1447
"1332",175786,"HINDS COMMUNITY COLLEGE                                     ","2003-2004",1,"Baseball",84658,83701,957,84658,83701,957,0,0,0,"30",".",22638,0
"5596",105792,"SOUTH MOUNTAIN COMMUNITY COLLEGE                            ","2003-2004",8,"Golf",77986,77031,955,36438,35483,955,41548,41548,0,"12","5",6495,6495
"1579",128744,"UNIVERSITY OF BRIDGEPORT                                    ","2003-2004",1,"Baseball",173892,172940,952,173892,172940,952,0,0,0,"32",".",19859,0
"12662",174862,"CROWN COLLEGE                                               ","2003-2004",25,"Track and Field, X-Country",4640,3688,952,2320,1765,555,2320,1923,397,"4","5",1500,1683
"601",107558,"UNIVERSITY OF THE OZARKS                                    ","2003-2004",1,"Baseball",61650,60700,950,61650,60700,950,0,0,0,"37",".",22200,0
"8726",155812,"UNIVERSITY OF SAINT MARY                                    ","2003-2004",16,"Softball",16795,15848,947,0,0,0,16795,15848,947,".","15",0,11912
"8467",237136,"APPALACHIAN BIBLE COLLEGE                                   ","2003-2004",15,"Soccer",14993,14048,945,14993,14048,945,0,0,0,"19",".",9095,0
"9948",209056,"LEWIS &amp; CLARK COLLEGE                                       ","2003-2004",16,"Softball",83354,82411,943,0,0,0,83354,82411,943,".","15",0,20782
"8767",147004,"MCHENRY COUNTY COLLEGE                                      ","2003-2004",16,"Softball",25415,24477,938,0,0,0,25415,24477,938,".","13",0,5813
"6004",218821,"SPARTANBURG METHODIST COLLEGE                               ","2003-2004",8,"Golf",32939,32010,929,32939,32010,929,0,0,0,"12",".",11870,0
"4049",212133,"EASTERN UNIVERSITY                                          ","2003-2004",6,"Field hocky",19645,18720,925,0,0,0,19645,18720,925,".","16",0,13890
"14392",179265,"ST LOUIS COLLEGE OF PHARMACY                                ","2003-2004",26,"Volleyball",15850,14928,922,0,0,0,15850,14928,922,".","14",0,14128
"119",176178,"NORTHWEST MISSISSIPPI COMMUNITY COLLEGE                     ","2003-2004",1,"Baseball",111139,110218,921,111139,110218,921,0,0,0,"19",".",25350,0
"5996",176178,"NORTHWEST MISSISSIPPI COMMUNITY COLLEGE                     ","2003-2004",8,"Golf",9805,8884,921,9805,8884,921,0,0,0,"6",".",2043,0
"6979",191968,"ITHACA COLLEGE                                              ","2003-2004",13,"Rowing",157651,156730,921,69430,73243,-3813,88221,83487,4734,"52","74",19212,42029
"8265",212160,"EDINBORO UNIVERSITY OF PENNSYLVANIA                         ","2003-2004",15,"Soccer",153205,152284,921,0,0,0,153205,152284,921,".","28",0,36466
"15295",176178,"NORTHWEST MISSISSIPPI COMMUNITY COLLEGE                     ","2003-2004",35,"Rodeo",18614,17693,921,12409,11795,614,6205,5898,307,"7","3",2713,1357
"9196",176178,"NORTHWEST MISSISSIPPI COMMUNITY COLLEGE                     ","2003-2004",16,"Softball",97011,96091,920,0,0,0,97011,96091,920,".","19",0,22101
"12475",178244,"MISSOURI BAPTIST UNIVERSITY                                 ","2003-2004",25,"Track and Field, X-Country",122698,121778,920,67831,67569,262,54867,54209,658,"14","11",3207,3207
"16876",216852,"WIDENER UNIVERSITY-MAIN CAMPUS                              ","2003-2004",39,"Total Participants",455514,454594,920,210688,210228,460,244826,244366,460,"379","175",190295,87540
"817",147341,"MONMOUTH COLLEGE                                            ","2003-2004",1,"Baseball",30765,29846,919,30765,29846,919,0,0,0,"47",".",24285,0
"6195",237011,"WESTERN WASHINGTON UNIVERSITY                               ","2003-2004",8,"Golf",113466,112547,919,69308,63978,5330,44158,48569,-4411,"8","9",27177,22829
"5944",212577,"FRANKLIN AND MARSHALL COLLEGE                               ","2003-2004",8,"Golf",55662,54749,913,35227,35535,-308,20435,19214,1221,"12","9",12536,2129
"14189",191515,"HAMILTON COLLEGE                                            ","2003-2004",26,"Volleyball",37612,36704,908,0,0,0,37612,36704,908,".","14",0,15026
"13561",154013,"MOUNT MERCY COLLEGE                                         ","2003-2004",26,"Volleyball",13637,12730,907,0,0,0,13637,12730,907,".","12",0,12094
"15838",191083,"ERIE COMMUNITY COLLEGE                                      ","2003-2004",39,"Total Participants",225797,224893,904,143903,143379,524,81894,81514,380,"236","83",179384,87299
"3705",177995,"LONGVIEW COMMUNITY COLLEGE                                  ","2003-2004",3,"All Track Combined",30301,29399,902,0,0,0,30301,29399,902,"0","5",0,3907
"8791",186399,"RUTGERS UNIVERSITY-NEWARK                                   ","2003-2004",16,"Softball",33470,32568,902,0,0,0,33470,32568,902,".","16",0,20633
"12962",231059,"SAINT MICHAELS COLLEGE                                      ","2003-2004",25,"Track and Field, X-Country",29607,28706,901,13946,13665,281,15661,15041,620,"13","15",3838,3806
"2374",123299,"SHASTA COLLEGE                                              ","2003-2004",2,"Basketball",63999,63099,900,32583,32083,500,31416,31016,400,"20","16",14429,14385
"5881",164270,"MCDANIEL COLLEGE                                            ","2003-2004",8,"Golf",33696,32796,900,16848,16398,450,16848,16398,450,"12","7",11651,11651
"6942",189848,"CAZENOVIA COLLEGE                                           ","2003-2004",13,"Rowing",26652,25752,900,4280,4280,0,22372,21472,900,"8","24",4180,21372
"7069",157818,"TRANSYLVANIA UNIVERSITY                                     ","2003-2004",15,"Soccer",114782,113882,900,52317,51867,450,62465,62015,450,"26","20",20144,18592
"17113",157818,"TRANSYLVANIA UNIVERSITY                                     ","2003-2004",39,"Total Participants",615409,614509,900,263494,263044,450,351915,351465,450,"112","128",154936,174005
"1991",208275,"BLUE MOUNTAIN COMMUNITY COLLEGE                             ","2003-2004",2,"Basketball",110637,109738,899,55784,54753,1031,54853,54985,-132,"15","12",20451,21236
"14310",109907,"BARSTOW COLLEGE                                             ","2003-2004",26,"Volleyball",12274,11380,894,0,0,0,12274,11380,894,".","10",0,5004
"9466",117946,"LOYOLA MARYMOUNT UNIVERSITY                                 ","2003-2004",16,"Softball",400944,400054,890,0,0,0,400944,400054,890,".","20",0,42799
"12161",115393,"HARTNELL COLLEGE                                            ","2003-2004",25,"Track and Field, X-Country",12671,11781,890,4788,4343,445,7883,7438,445,"12","7",3229,3229
"14907",203085,"HEIDELBERG COLLEGE                                          ","2003-2004",28,"Wrestling",42820,41930,890,42820,41930,890,0,0,0,"23",".",15942,0
"13921",175236,"RIDGEWATER COLLEGE                                          ","2003-2004",26,"Volleyball",35917,35031,886,0,0,0,35917,35031,886,".","12",0,13980
"14770",235431,"HIGHLINE COMMUNITY COLLEGE                                  ","2003-2004",28,"Wrestling",34716,33831,885,34716,33831,885,0,0,0,"20",".",12370,0
"12177",149727,"WAUBONSEE COMMUNITY COLLEGE                                 ","2003-2004",25,"Track and Field, X-Country",7950,7066,884,3975,3533,442,3975,3533,442,"11","6",2617,2617
"978",148584,"UNIVERSITY OF ST FRANCIS                                    ","2003-2004",1,"Baseball",233132,232249,883,233132,232249,883,0,0,0,"33",".",17088,0
"1461",164270,"MCDANIEL COLLEGE                                            ","2003-2004",1,"Baseball",66648,65765,883,66648,65765,883,0,0,0,"40",".",22962,0
"6638",185572,"MONMOUTH UNIVERSITY                                         ","2003-2004",11,"Lacrosse",268495,267612,883,0,0,0,268495,267612,883,".","24",0,55549
"9549",147411,"MORTON COLLEGE                                              ","2003-2004",16,"Softball",29304,28424,880,0,0,0,29304,28424,880,".","11",0,8723
"13864",147411,"MORTON COLLEGE                                              ","2003-2004",26,"Volleyball",29304,28424,880,0,0,0,29304,28424,880,".","11",0,8723
"14869",212197,"ELIZABETHTOWN COLLEGE                                       ","2003-2004",28,"Wrestling",15987,15107,880,15987,15107,880,0,0,0,"12",".",8307,0
"13787",193900,"NEW YORK UNIVERSITY                                         ","2003-2004",26,"Volleyball",324784,323908,876,109344,109344,0,215440,214564,876,"12","17",42700,135634
"15942",193900,"NEW YORK UNIVERSITY                                         ","2003-2004",39,"Total Participants",1757424,1756548,876,928199,928199,0,829225,828349,876,"224","223",669302,696332
"8009",123299,"SHASTA COLLEGE                                              ","2003-2004",15,"Soccer",43492,42617,875,22463,21938,525,21029,20679,350,"21","14",10038,8779
"14794",199281,"UNIVERSITY OF NORTH CAROLINA AT PEMBROKE                    ","2003-2004",28,"Wrestling",35837,34962,875,35837,34962,875,0,0,0,"40",".",31962,0
"10795",199281,"UNIVERSITY OF NORTH CAROLINA AT PEMBROKE                    ","2003-2004",22,"Tennis",15430,14559,871,0,0,0,15430,14559,871,".","6",0,11639
"14355",177214,"DRURY UNIVERSITY                                            ","2003-2004",26,"Volleyball",46091,45220,871,0,0,0,46091,45220,871,".","13",0,43217
"6234",211644,"CLARION UNIVERSITY OF PENNSYLVANIA                          ","2003-2004",8,"Golf",17232,16362,870,17232,16362,870,0,0,0,"11",".",8198,0
"10564",140951,"SAVANNAH COLLEGE OF ART AND DESIGN                          ","2003-2004",19,"Swimming",113229,112359,870,56614,56179,435,56615,56180,435,"8","8",19652,19652
"10092",139658,"EMORY UNIVERSITY                                            ","2003-2004",18,"Swimming and Diving",259034,258166,868,129517,129083,434,129517,129083,434,"36","36",39231,39231
"16120",105792,"SOUTH MOUNTAIN COMMUNITY COLLEGE                            ","2003-2004",39,"Total Participants",158315,157450,865,70378,69423,955,87937,88027,-90,"72","61",31860,36747
"8459",180984,"CONCORDIA UNIVERSITY                                        ","2003-2004",15,"Soccer",144568,143708,860,71464,71034,430,73104,72674,430,"18","18",12690,12690
"10435",152318,"ROSE-HULMAN INSTITUTE OF TECHNOLOGY                         ","2003-2004",18,"Swimming and Diving",46860,46000,860,29860,29000,860,17000,17000,0,"33",".",21000,9000
"13807",220473,"JOHNSON BIBLE COLLEGE                                       ","2003-2004",26,"Volleyball",15186,14326,860,0,0,0,15186,14326,860,".","10",0,6920
"16812",220473,"JOHNSON BIBLE COLLEGE                                       ","2003-2004",39,"Total Participants",41757,40897,860,26571,26571,0,15186,14326,860,"52","19",28795,17249
"6476",240471,"UNIVERSITY OF WISCONSIN-RIVER FALLS                         ","2003-2004",10,"Ice Hockey",160954,160096,858,107993,107135,858,52961,52961,0,"26","19",46253,22983
"13324",191968,"ITHACA COLLEGE                                              ","2003-2004",26,"Volleyball",85829,84971,858,0,0,0,85829,84971,858,"0","12",0,31901
"10322",197133,"VASSAR COLLEGE                                              ","2003-2004",18,"Swimming and Diving",102194,101338,856,48281,47853,428,53913,53485,428,"13","17",14731,20363
"12434",234933,"CLARK COLLEGE                                               ","2003-2004",25,"Track and Field, X-Country",14506,13652,854,7253,6826,427,7253,6826,427,"5","9",3280,3280
"5927",181783,"WAYNE STATE COLLEGE                                         ","2003-2004",8,"Golf",43014,42161,853,24487,23742,745,18527,18419,108,"10","6",5685,4982
"9853",115126,"GOLDEN WEST COLLEGE                                         ","2003-2004",16,"Softball",42850,41998,852,0,0,0,42850,41998,852,".","16",0,24693
"6010",221892,"TREVECCA NAZARENE UNIVERSITY                                ","2003-2004",8,"Golf",109652,108801,851,55959,54534,1425,53693,54267,-574,"6","6",10956,8720
"12601",231581,"BRIDGEWATER COLLEGE                                         ","2003-2004",25,"Track and Field, X-Country",24353,23502,851,12789,12326,463,11564,11176,388,"12","10",6337,5279
"5366",220631,"LINCOLN MEMORIAL UNIVERSITY                                 ","2003-2004",8,"Golf",134373,133523,850,59176,59176,0,75197,74347,850,"6","5",10703,10403
"11187",195809,"ST JOHN'S UNIVERSITY-NEW YORK                               ","2003-2004",22,"Tennis",450023,449173,850,207337,207012,325,242686,242161,525,"9","8",2708,2053
"12261",229814,"WEST TEXAS A &amp; M UNIVERSITY                                 ","2003-2004",25,"Track and Field, X-Country",25244,24400,844,12622,12200,422,12622,12200,422,"7","5",1581,1581
"13591",190530,"CUNY BRONX COMMUNITY COLLEGE                                ","2003-2004",26,"Volleyball",18721,17877,844,0,0,0,18721,17877,844,".","15",0,8522
"12742",165529,"CURRY COLLEGE                                               ","2003-2004",25,"Track and Field, X-Country",7114,6274,840,0,0,0,7114,6274,840,".","9",0,1915
"3912",203085,"HEIDELBERG COLLEGE                                          ","2003-2004",3,"All Track Combined",82557,81723,834,51565,51070,495,30992,30653,339,"37","37",11741,11411
"9765",234845,"CENTRALIA COLLEGE                                           ","2003-2004",16,"Softball",35580,34749,831,0,0,0,35580,34749,831,".","13",0,23839
"2085",236753,"TACOMA COMMUNITY COLLEGE                                    ","2003-2004",2,"Basketball",26372,25544,828,13712,13261,451,12660,12283,377,"13","9",8866,7788
"4762",238616,"CONCORDIA UNIVERSITY-WISCONSIN                              ","2003-2004",7,"Football",132874,132052,822,132874,132052,822,0,0,0,"103",".",49460,0
"8982",195526,"SKIDMORE COLLEGE                                            ","2003-2004",16,"Softball",23384,22562,822,0,0,0,23384,22562,822,".","15",0,15328
"13168",209056,"LEWIS &amp; CLARK COLLEGE                                       ","2003-2004",26,"Volleyball",70453,69632,821,0,0,0,70453,69632,821,".","10",0,19999
"10468",117946,"LOYOLA MARYMOUNT UNIVERSITY                                 ","2003-2004",19,"Swimming",176832,176014,818,0,0,0,176832,176014,818,".","20",0,23098
"8208",191621,"HILBERT COLLEGE                                             ","2003-2004",15,"Soccer",42063,41252,811,15062,15844,-782,27001,25408,1593,"15","19",6987,12208
"15343",208035,"WESTERN OKLAHOMA STATE COLLEGE                              ","2003-2004",35,"Rodeo",44969,44164,805,31029,30474,555,13940,13690,250,"11","5",17305,7775
"14177",153472,"INDIAN HILLS COMMUNITY COLLEGE                              ","2003-2004",26,"Volleyball",83540,82737,803,0,0,0,83540,82737,803,".","9",0,30248
"15520",206437,"WALSH UNIVERSITY                                            ","2003-2004",39,"Total Participants",428430,427627,803,205014,204686,328,223416,222941,475,"256","135",340026,132591
"5129",154022,"THE FRANCISCAN UNIVERSITY                                   ","2003-2004",8,"Golf",5000,4198,802,5000,4198,802,0,0,0,"6",".",3500,0
"10467",172644,"WAYNE STATE UNIVERSITY                                      ","2003-2004",19,"Swimming",261341,260539,802,98361,130005,-31644,162980,130534,32446,"16","14",16059,25889
"15691",147378,"MORAINE VALLEY COMMUNITY COLLEGE                            ","2003-2004",39,"Total Participants",104660,103858,802,54031,54030,1,50629,49828,801,"85","66",56510,43320
"6661",231581,"BRIDGEWATER COLLEGE                                         ","2003-2004",11,"Lacrosse",24014,23213,801,0,0,0,24014,23213,801,".","16",0,10311
"9349",236896,"WALLA WALLA COLLEGE                                         ","2003-2004",16,"Softball",20633,19833,800,0,0,0,20633,19833,800,".","15",0,14529
"9542",147378,"MORAINE VALLEY COMMUNITY COLLEGE                            ","2003-2004",16,"Softball",15838,15038,800,0,0,0,15838,15038,800,".","14",0,9335
"12862",157100,"KENTUCKY CHRISTIAN COLLEGE                                  ","2003-2004",25,"Track and Field, X-Country",11806,11006,800,5953,5493,460,5853,5513,340,"8","7",3699,3719
"13563",155335,"NEWMAN UNIVERSITY                                           ","2003-2004",26,"Volleyball",89821,89021,800,43525,43200,325,46296,45821,475,"19","17",27000,26821
"15667",223898,"CISCO JUNIOR COLLEGE                                        ","2003-2004",39,"Total Participants",125671,124871,800,0,0,0,125671,124871,800,"115","68",126295,97625
"16116",157100,"KENTUCKY CHRISTIAN COLLEGE                                  ","2003-2004",39,"Total Participants",77477,76677,800,30296,29836,460,47181,46841,340,"36","49",58211,62494
"16688",214704,"PENNSYLVANIA STATE UNIVERSITY-PENN STATE BERKS              ","2003-2004",39,"Total Participants",101298,100498,800,57273,57073,200,44025,43425,600,"74","58",40648,31635
"3752",204857,"OHIO UNIVERSITY-MAIN CAMPUS                                 ","2003-2004",3,"All Track Combined",524731,523933,798,196706,195908,798,328025,328025,0,"123","95",20951,35020
"2404",210234,"TREASURE VALLEY COMMUNITY COLLEGE                           ","2003-2004",2,"Basketball",63822,63026,796,35507,35507,0,28315,27519,796,"17","21",20000,20000
"10555",127060,"UNIVERSITY OF DENVER                                        ","2003-2004",19,"Swimming",804392,803596,796,452789,418709,34080,351603,384887,-33284,"21","22",73641,74092
"11006",164270,"MCDANIEL COLLEGE                                            ","2003-2004",22,"Tennis",25786,24990,796,12138,11342,796,13648,13648,0,"9","12",6342,8648
"16608",117690,"LOS ANGELES HARBOR COLLEGE                                  ","2003-2004",39,"Total Participants",223355,222560,795,139974,139714,260,83381,82846,535,"163","50",81171,30053
"10660",162122,"COLLEGE OF SOUTHERN MARYLAND                                ","2003-2004",22,"Tennis",9648,8857,791,4824,4531,293,4824,4326,498,"6","2",2031,1826
"16951",173638,"MINNESOTA WEST COMMUNITY AND TECHNICAL COLLEGE              ","2003-2004",39,"Total Participants",63195,62406,789,37444,37201,243,25751,25205,546,"90","32",58361,20360
"5571",174738,"ROCHESTER COMMUNITY AND TECHNICAL COLLEGE                   ","2003-2004",8,"Golf",45086,44306,780,22933,22153,780,22153,22153,0,"13","1",7278,7278
"10341",230959,"MIDDLEBURY COLLEGE                                          ","2003-2004",18,"Swimming and Diving",188810,188031,779,95747,95062,685,93063,92969,94,"32","49",26380,24177
"13617",115296,"GROSSMONT COLLEGE                                           ","2003-2004",26,"Volleyball",23253,22474,779,12712,11933,779,10541,10541,0,"14","11",7933,6541
"15532",115296,"GROSSMONT COLLEGE                                           ","2003-2004",39,"Total Participants",316460,315681,779,166887,166108,779,149573,149573,0,"198","126",140171,76896
"13267",226930,"MOUNTAIN VIEW COLLEGE                                       ","2003-2004",26,"Volleyball",32000,31225,775,0,0,0,32000,31225,775,".","14",0,8456
"13895",119216,"MT SAN JACINTO COLLEGE                                      ","2003-2004",26,"Volleyball",12753,11981,772,0,0,0,12753,11981,772,".","10",0,5325
"8510",137032,"SAINT LEO UNIVERSITY                                        ","2003-2004",15,"Soccer",168584,167814,770,91569,94471,-2902,77015,73343,3672,"23","21",44792,27815
"3329",173063,"RIVERLAND COMMUNITY COLLEGE                                 ","2003-2004",2,"Basketball",59241,58473,768,29322,28587,735,29919,29886,33,"12","9",10929,9923
"9348",108807,"ALLAN HANCOCK COLLEGE                                       ","2003-2004",16,"Softball",21466,20699,767,0,0,0,21466,20699,767,".","15",0,10520
"9428",162122,"COLLEGE OF SOUTHERN MARYLAND                                ","2003-2004",16,"Softball",13565,12798,767,0,0,0,13565,12798,767,".","13",0,5798
"7697",118930,"MISSION COLLEGE                                             ","2003-2004",15,"Soccer",39844,39078,766,21979,20914,1065,17865,18164,-299,"16","10",2900,2297
"12075",216296,"THADDEUS STEVENS COLLEGE OF TECHNOLOGY                      ","2003-2004",24,"Track and Field, Outdoor",17500,16737,763,14500,14347,153,3000,2390,610,"12","2",10652,1775
"11832",167899,"SPRINGFIELD COLLEGE                                         ","2003-2004",23,"Track and Field, Indoor",20490,19728,762,10581,9869,712,9909,9859,50,"40","39",9635,9237
"11956",167899,"SPRINGFIELD COLLEGE                                         ","2003-2004",24,"Track and Field, Outdoor",13775,13013,762,7181,6469,712,6594,6544,50,"49","38",6235,5922
"7055",182634,"COLBY-SAWYER COLLEGE                                        ","2003-2004",14,"Skiing",67528,66773,755,33788,33386,402,33740,33387,353,"9","8",23071,23071
"9448",149781,"WHEATON COLLEGE                                             ","2003-2004",16,"Softball",62436,61683,753,0,0,0,62436,61683,753,".","13",0,27725
"13507",217518,"ROGER WILLIAMS UNIVERSITY                                   ","2003-2004",26,"Volleyball",54946,54195,751,32476,32090,386,22470,22105,365,"12","13",19823,10907
"6551",216931,"WILKES UNIVERSITY                                           ","2003-2004",11,"Lacrosse",55102,54352,750,0,0,0,55102,54352,750,".","16",0,12032
"13194",173452,"MARTIN LUTHER COLLEGE                                       ","2003-2004",26,"Volleyball",8750,8000,750,0,0,0,8750,8000,750,".","13",0,6000
"10913",177940,"LINCOLN UNIVERSITY                                          ","2003-2004",22,"Tennis",65247,64498,749,0,0,0,65247,64498,749,".","7",0,6490
"9771",113333,"DE ANZA COLLEGE                                             ","2003-2004",16,"Softball",25510,24762,748,0,0,0,25510,24762,748,".","13",0,6652
"10240",146481,"LAKE FOREST COLLEGE                                         ","2003-2004",18,"Swimming and Diving",67731,66983,748,33378,33491,-113,34353,33492,861,"16","12",12830,12831
"14815",211158,"BLOOMSBURG UNIVERSITY OF PENNSYLVANIA                       ","2003-2004",28,"Wrestling",273430,272689,741,273430,272689,741,0,0,0,"32",".",22562,0
"14330",172264,"SIENA HEIGHTS UNIVERSITY                                    ","2003-2004",26,"Volleyball",13032,12292,740,0,0,0,13032,12292,740,".","15",0,12262
"1811",170055,"GRAND RAPIDS COMMUNITY COLLEGE                              ","2003-2004",2,"Basketball",83408,82673,735,44332,43915,417,39076,38758,318,"17","15",12276,14511
"8783",228501,"SUL ROSS STATE UNIVERSITY                                   ","2003-2004",16,"Softball",29566,28832,734,0,0,0,29566,28832,734,".","15",0,16871
"4034",165024,"BRIDGEWATER STATE COLLEGE                                   ","2003-2004",6,"Field hocky",8900,8167,733,0,0,0,8900,8167,733,".","20",0,7900
"9565",229267,"TRINITY UNIVERSITY                                          ","2003-2004",16,"Softball",78977,78245,732,0,0,0,78977,78245,732,".","14",0,33672
"5225",130226,"QUINNIPIAC UNIVERSITY                                       ","2003-2004",8,"Golf",97571,96840,731,97571,96840,731,0,0,0,"12",".",29212,0
"11293",106704,"UNIVERSITY OF CENTRAL ARKANSAS                              ","2003-2004",22,"Tennis",72761,72031,730,0,0,0,72761,72031,730,".","13",0,8835
"14155",140696,"OGLETHORPE UNIVERSITY                                       ","2003-2004",26,"Volleyball",17230,16500,730,0,0,0,17230,16500,730,".","9",0,15489
"12155",217536,"SALVE REGINA UNIVERSITY                                     ","2003-2004",24,"Track and Field, Outdoor",17720,16992,728,0,0,0,17720,16992,728,".","31",0,2851
"12209",217536,"SALVE REGINA UNIVERSITY                                     ","2003-2004",25,"Track and Field, X-Country",17720,16992,728,0,0,0,17720,16992,728,".","31",0,2851
"6642",195526,"SKIDMORE COLLEGE                                            ","2003-2004",11,"Lacrosse",116054,115328,726,76777,76008,769,39277,39320,-43,"36","18",40646,26325
"8590",167899,"SPRINGFIELD COLLEGE                                         ","2003-2004",16,"Softball",19557,18837,720,0,0,0,19557,18837,720,".","39",0,13936
"9288",157216,"LINDSEY WILSON COLLEGE                                      ","2003-2004",16,"Softball",214802,214082,720,0,0,0,214802,214082,720,".","21",0,19662
"9590",232423,"JAMES MADISON UNIVERSITY                                    ","2003-2004",16,"Softball",322865,322152,713,0,0,0,322865,322152,713,".","23",0,74767
"9223",114433,"FEATHER RIVER COMMUNITY COLLEGE DISTRICT                    ","2003-2004",16,"Softball",35352,34651,701,0,0,0,35352,34651,701,".","18",0,26417
"3374",122791,"COLLEGE OF SAN MATEO                                        ","2003-2004",2,"Basketball",37259,36559,700,0,0,0,37259,36559,700,".","10",0,10027
"7508",117867,"LOS ANGELES MISSION COLLEGE                                 ","2003-2004",15,"Soccer",101700,101000,700,50700,50700,0,51000,50300,700,"23","20",14752,12000
"7910",146296,"JOLIET JUNIOR COLLEGE                                       ","2003-2004",15,"Soccer",29200,28500,700,16000,15500,500,13200,13000,200,"23","14",7500,7500
"14085",149505,"TRINITY CHRISTIAN COLLEGE                                   ","2003-2004",26,"Volleyball",51396,50696,700,22028,22028,0,29368,28668,700,"11","12",12228,16268
"7271",236887,"WALLA WALLA COMMUNITY COLLEGE                               ","2003-2004",15,"Soccer",66594,65895,699,33571,33815,-244,33023,32080,943,"26","21",23815,22080
"14043",173063,"RIVERLAND COMMUNITY COLLEGE                                 ","2003-2004",26,"Volleyball",15539,14841,698,0,0,0,15539,14841,698,".","10",0,5494
"7462",230995,"NORWICH UNIVERSITY                                          ","2003-2004",15,"Soccer",92766,92069,697,51177,51459,-282,41589,40610,979,"23","21",17632,15531
"5633",204185,"MOUNT UNION COLLEGE                                         ","2003-2004",8,"Golf",27728,27035,693,15269,15269,0,12459,11766,693,"13","7",9786,6408
"15177",240189,"UNIVERSITY OF WISCONSIN-WHITEWATER                          ","2003-2004",33,"Bowling",25758,25065,693,0,0,0,25758,25065,693,".","12",0,12198
"17186",403487,"ILLINOIS EASTERN COMMUNITY COLLS-WABASH VLY COLL            ","2003-2004",39,"Total Participants",188449,187757,692,81973,80443,1530,106476,107314,-838,"42","30",40560,64262
"14620",148821,"SHAWNEE COMMUNITY COLLEGE                                   ","2003-2004",26,"Volleyball",39187,38498,689,0,0,0,39187,38498,689,".","15",0,21149
"13872",106342,"LYON COLLEGE                                                ","2003-2004",26,"Volleyball",149416,148731,685,0,0,0,149416,148731,685,".","9",0,16457
"8608",231554,"BLUEFIELD COLLEGE                                           ","2003-2004",16,"Softball",46846,46162,684,0,0,0,46846,46162,684,".","18",0,12621
"10601",237057,"WHITMAN COLLEGE                                             ","2003-2004",19,"Swimming",60684,60000,684,30342,30000,342,30342,30000,342,"11","22",22159,22159
"14555",237792,"SHEPHERD COLLEGE                                            ","2003-2004",26,"Volleyball",90715,90031,684,0,0,0,90715,90031,684,".","10",0,17137
"10016",219879,"CLEVELAND STATE COMMUNITY COLLEGE                           ","2003-2004",16,"Softball",32370,31688,682,0,0,0,32370,31688,682,".","15",0,29138
"14252",150604,"FRANKLIN COLLEGE                                            ","2003-2004",26,"Volleyball",27805,27123,682,0,0,0,27805,27123,682,".","16",0,11293
"15160",114789,"FRESNO CITY COLLEGE                                         ","2003-2004",31,"Badminton",2730,2050,680,0,0,0,2730,2050,680,".","8",0,1800
"8261",196033,"SUNY COLLEGE OF AGRIC AND TECHN AT COBLESKILL               ","2003-2004",15,"Soccer",20735,20058,677,11966,11289,677,8769,8769,0,"30","19",7650,7543
"8776",226231,"LETOURNEAU UNIVERSITY                                       ","2003-2004",16,"Softball",42734,42058,676,0,0,0,42734,42058,676,".","22",0,18641
"16854",234933,"CLARK COLLEGE                                               ","2003-2004",39,"Total Participants",106209,105533,676,44880,44494,386,61329,61039,290,"54","62",36825,45742
"7948",117690,"LOS ANGELES HARBOR COLLEGE                                  ","2003-2004",15,"Soccer",102787,102121,666,57376,57245,131,45411,44876,535,"38","25",12553,7831
"13396",174899,"THE COLLEGE OF SAINT SCHOLASTICA                            ","2003-2004",26,"Volleyball",42098,41438,660,0,0,0,42098,41438,660,".","13",0,23387
"7748",151777,"MANCHESTER COLLEGE                                          ","2003-2004",15,"Soccer",53179,52522,657,30346,29952,394,22833,22570,263,"30","19",14937,11384
"11588",216038,"SLIPPERY ROCK UNIVERSITY OF PENNSYLVANIA                    ","2003-2004",22,"Tennis",103888,103234,654,38092,38146,-54,65796,65088,708,"9","11",7570,11506
"7649",114716,"FOOTHILL COLLEGE                                            ","2003-2004",15,"Soccer",13000,12347,653,6500,6420,80,6500,5927,573,"25","15",3920,3427
"6209",190983,"ELMIRA COLLEGE                                              ","2003-2004",8,"Golf",40416,39765,651,21566,24145,-2579,18850,15620,3230,"12","8",14504,6736
"5751",143084,"AUGUSTANA COLLEGE                                           ","2003-2004",8,"Golf",40004,39354,650,27576,26951,625,12428,12403,25,"13","14",4298,5717
"10232",228343,"SOUTHWESTERN UNIVERSITY                                     ","2003-2004",18,"Swimming and Diving",94512,93867,645,45859,45536,323,48653,48331,322,"14","16",24851,28251
"6847",228875,"TEXAS CHRISTIAN UNIVERSITY                                  ","2003-2004",12,"Rifle",60039,59395,644,0,0,0,60039,59395,644,".","15",0,34073
"11318",118930,"MISSION COLLEGE                                             ","2003-2004",22,"Tennis",41933,41294,639,22499,21860,639,19434,19434,0,"7","9",2555,1977
"4513",216296,"THADDEUS STEVENS COLLEGE OF TECHNOLOGY                      ","2003-2004",7,"Football",76000,75364,636,76000,75364,636,0,0,0,"73",".",56729,0
"15997",131450,"GALLAUDET UNIVERSITY                                        ","2003-2004",39,"Total Participants",212829,212194,635,101915,101915,0,110914,110279,635,"112","91",102320,100033
"5367",175643,"EAST CENTRAL COMMUNITY COLLEGE                              ","2003-2004",8,"Golf",23148,22515,633,23148,22515,633,0,0,0,"9","0",4057,0
"288",102377,"TUSKEGEE UNIVERSITY                                         ","2003-2004",1,"Baseball",97095,96465,630,97095,96465,630,0,0,0,"23",".",19677,0
"7302",230898,"GREEN MOUNTAIN COLLEGE                                      ","2003-2004",15,"Soccer",142581,141952,629,82952,82952,0,59629,59000,629,"17","15",14058,16559
"9057",104346,"CENTRAL ARIZONA COLLEGE                                     ","2003-2004",16,"Softball",86148,85521,627,0,0,0,86148,85521,627,".","16",0,18051
"1479",121691,"UNIVERSITY OF REDLANDS                                      ","2003-2004",1,"Baseball",69605,68980,625,69605,68980,625,0,0,0,"30",".",18453,0
"14004",184603,"FAIRLEIGH DICKINSON UNIVERSITY-METROPOLITAN CAMPUS          ","2003-2004",26,"Volleyball",235299,234684,615,0,0,0,235299,234684,615,".","12",0,30268
"1636",191515,"HAMILTON COLLEGE                                            ","2003-2004",2,"Basketball",170858,170251,607,123567,122791,776,47291,47460,-169,"12","16",20567,14589
"9551",165699,"ENDICOTT COLLEGE                                            ","2003-2004",16,"Softball",49490,48885,605,0,0,0,49490,48885,605,".","15",0,32000
"1589",195562,"SAINT JOSEPHS COLLEGE-SUFFOLK CAMPUS                        ","2003-2004",1,"Baseball",65657,65053,604,65657,65053,604,0,0,0,"26",".",23816,0
"14891",166683,"MASSACHUSETTS INSTITUTE OF TECHNOLOGY                       ","2003-2004",28,"Wrestling",41042,40440,602,41042,40440,602,0,0,0,"16",".",21113,0
"7255",175643,"EAST CENTRAL COMMUNITY COLLEGE                              ","2003-2004",15,"Soccer",69812,69211,601,69812,69211,601,0,0,0,"13",".",12865,0
"14653",111188,"CALIFORNIA MARITIME ACADEMY                                 ","2003-2004",27,"Water Polo",20000,19399,601,17100,16628,472,2900,2771,129,"24","4",12091,2015
"2545",146506,"LAKE LAND COLLEGE                                           ","2003-2004",2,"Basketball",102505,101905,600,52871,52471,400,49634,49434,200,"14","14",27798,27258
"3641",228501,"SUL ROSS STATE UNIVERSITY                                   ","2003-2004",3,"All Track Combined",31166,30566,600,12537,13162,-625,18629,17404,1225,"14","20",8432,14523
"5477",146825,"MACMURRAY COLLEGE                                           ","2003-2004",8,"Golf",7630,7030,600,4248,3823,425,3382,3207,175,"5","3",2008,1930
"5605",217475,"COMMUNITY COLLEGE OF RHODE ISLAND                           ","2003-2004",8,"Golf",7500,6900,600,3750,3450,300,3750,3450,300,"7","0",2800,2800
"7589",121901,"RIVERSIDE COMMUNITY COLLEGE                                 ","2003-2004",15,"Soccer",12000,11400,600,6000,5800,200,6000,5600,400,"20","13",4300,4300
"10503",164270,"MCDANIEL COLLEGE                                            ","2003-2004",19,"Swimming",77508,76908,600,38754,38454,300,38754,38454,300,"10","20",9461,9461
"12318",214643,"PENNSYLVANIA STATE UNIVERSITY-PENN STATE WILKES-BA          ","2003-2004",25,"Track and Field, X-Country",1400,800,600,1400,800,600,0,0,0,"4",".",500,0
"14286",214704,"PENNSYLVANIA STATE UNIVERSITY-PENN STATE BERKS              ","2003-2004",26,"Volleyball",17088,16488,600,0,0,0,17088,16488,600,".","15",0,8228
"14759",206507,"WILMINGTON COLLEGE                                          ","2003-2004",28,"Wrestling",25673,25073,600,25673,25073,600,0,0,0,"30",".",25050,0
"15652",181093,"GRACE UNIVERSITY                                            ","2003-2004",39,"Total Participants",43030,42430,600,29428,29328,100,13602,13102,500,"29","20",49121,25428
"13536",191719,"HUDSON VALLEY COMMUNITY COLLEGE                             ","2003-2004",26,"Volleyball",8406,7807,599,0,0,0,8406,7807,599,".","9",0,4365
"13364",216296,"THADDEUS STEVENS COLLEGE OF TECHNOLOGY                      ","2003-2004",26,"Volleyball",10000,9402,598,0,0,0,10000,9402,598,".","10",0,4288
"7070",223524,"BROOKHAVEN COLLEGE                                          ","2003-2004",15,"Soccer",23252,22656,596,11626,11328,298,11626,11328,298,"20","14",7101,6368
"13078",229072,"TEXAS SOUTHMOST COLLEGE                                     ","2003-2004",26,"Volleyball",119682,119089,593,0,0,0,119682,119089,593,".","13",0,70237
"5475",199281,"UNIVERSITY OF NORTH CAROLINA AT PEMBROKE                    ","2003-2004",8,"Golf",19384,18794,590,19384,18794,590,0,0,0,"18",".",15409,0
"14964",213668,"LYCOMING COLLEGE                                            ","2003-2004",28,"Wrestling",82253,81663,590,82253,81663,590,0,0,0,"34",".",28422,0
"16739",213668,"LYCOMING COLLEGE                                            ","2003-2004",39,"Total Participants",437751,437162,589,242133,241543,590,195618,195619,-1,"250","137",167404,107773
"11315",172051,"SAGINAW VALLEY STATE UNIVERSITY                             ","2003-2004",22,"Tennis",34355,33767,588,0,0,0,34355,33767,588,".","8",0,8610
"9938",167260,"NICHOLS COLLEGE                                             ","2003-2004",16,"Softball",17580,16993,587,0,0,0,17580,16993,587,".","15",0,10993
"9960",115393,"HARTNELL COLLEGE                                            ","2003-2004",16,"Softball",22359,21772,587,0,0,0,22359,21772,587,".","18",0,10642
"4290",119164,"MT SAN ANTONIO COLLEGE                                      ","2003-2004",7,"Football",164701,164116,585,164701,164116,585,0,0,0,"111",".",20642,0
"10443",153144,"COE COLLEGE                                                 ","2003-2004",18,"Swimming and Diving",58044,57460,584,27310,27018,292,30734,30442,292,"13","22",9738,13162
"2219",114716,"FOOTHILL COLLEGE                                            ","2003-2004",2,"Basketball",21000,20420,580,8750,8725,25,12250,11695,555,"12","12",6570,9195
"8387",153162,"CORNELL COLLEGE                                             ","2003-2004",15,"Soccer",36929,36354,575,18151,17576,575,18778,18778,0,"21","19",10143,13601
"14012",220941,"CRICHTON COLLEGE                                            ","2003-2004",26,"Volleyball",5200,4625,575,0,0,0,5200,4625,575,".","12",0,4002
"11685",203085,"HEIDELBERG COLLEGE                                          ","2003-2004",22,"Tennis",27350,26777,573,19550,20254,-704,7800,6523,1277,"10","9",5370,3224
"4146",232609,"LYNCHBURG COLLEGE                                           ","2003-2004",6,"Field hocky",61235,60665,570,0,0,0,61235,60665,570,".","29",0,23825
"11676",101693,"UNIVERSITY OF MOBILE                                        ","2003-2004",22,"Tennis",57287,56717,570,0,0,0,57287,56717,570,".","9",0,9093
"8794",144351,"CONCORDIA UNIVERSITY                                        ","2003-2004",16,"Softball",11024,10456,568,0,0,0,11024,10456,568,".","14",0,7663
"13899",221892,"TREVECCA NAZARENE UNIVERSITY                                ","2003-2004",26,"Volleyball",106544,105976,568,0,0,0,106544,105976,568,".","13",0,18285
"15045",152318,"ROSE-HULMAN INSTITUTE OF TECHNOLOGY                         ","2003-2004",28,"Wrestling",27565,27000,565,27565,27000,565,0,0,0,"16",".",11565,0
"11533",148256,"REND LAKE COLLEGE                                           ","2003-2004",22,"Tennis",27360,26798,562,0,0,0,27360,26798,562,".","7",0,6734
"7796",198066,"BREVARD COLLEGE                                             ","2003-2004",15,"Soccer",89200,88639,561,45500,45957,-457,43700,42682,1018,"22","14",15957,14682
"8112",123563,"SOLANO COUNTY COMMUNITY COLLEGE DISTRICT                    ","2003-2004",15,"Soccer",29744,29183,561,0,0,0,29744,29183,561,".","20",0,12200
"11649",173063,"RIVERLAND COMMUNITY COLLEGE                                 ","2003-2004",22,"Tennis",20700,20141,559,12200,11856,344,8500,8285,215,"6","5",5948,2377
"3741",210429,"WESTERN OREGON UNIVERSITY                                   ","2003-2004",3,"All Track Combined",174766,174212,554,86998,86506,492,87768,87706,62,"114","68",40554,40554
"9524",153162,"CORNELL COLLEGE                                             ","2003-2004",16,"Softball",40211,39657,554,0,0,0,40211,39657,554,".","15",0,11944
"793",123299,"SHASTA COLLEGE                                              ","2003-2004",1,"Baseball",37091,36541,550,37091,36541,550,0,0,0,"22",".",19398,0
"5488",164739,"BENTLEY COLLEGE                                             ","2003-2004",8,"Golf",22110,21560,550,22110,21560,550,0,0,0,"13",".",13186,0
"5843",150400,"DEPAUW UNIVERSITY                                           ","2003-2004",8,"Golf",74076,73527,549,37038,36076,962,37038,37451,-413,"9","7",10656,12031
"6118",216524,"URSINUS COLLEGE                                             ","2003-2004",8,"Golf",20800,20251,549,10545,10284,261,10255,9967,288,"12","8",7115,7115
"2834",224244,"DALLAS CHRISTIAN COLLEGE                                    ","2003-2004",2,"Basketball",30000,29453,547,17500,17330,170,12500,12123,377,"20","11",12000,8000
"7450",190530,"CUNY BRONX COMMUNITY COLLEGE                                ","2003-2004",15,"Soccer",12103,11557,546,12103,11557,546,0,0,0,"23",".",4600,0
"9800",173045,"AUGSBURG COLLEGE                                            ","2003-2004",16,"Softball",41754,41208,546,0,0,0,41754,41208,546,".","18",0,19808
"13329",173638,"MINNESOTA WEST COMMUNITY AND TECHNICAL COLLEGE              ","2003-2004",26,"Volleyball",13148,12602,546,0,0,0,13148,12602,546,".","8",0,5620
"5671",123013,"SANTA ROSA JUNIOR COLLEGE                                   ","2003-2004",8,"Golf",36255,35710,545,36255,35710,545,0,0,0,"10",".",5311,0
"14547",216038,"SLIPPERY ROCK UNIVERSITY OF PENNSYLVANIA                    ","2003-2004",26,"Volleyball",137028,136485,543,0,0,0,137028,136485,543,".","17",0,31185
"14211",157216,"LINDSEY WILSON COLLEGE                                      ","2003-2004",26,"Volleyball",152030,151490,540,0,0,0,152030,151490,540,"0","11",0,17117
"13917",231554,"BLUEFIELD COLLEGE                                           ","2003-2004",26,"Volleyball",58275,57738,537,0,0,0,58275,57738,537,".","10",0,11111
"5740",238616,"CONCORDIA UNIVERSITY-WISCONSIN                              ","2003-2004",8,"Golf",14465,13931,534,8060,7526,534,6405,6405,0,"8","5",4885,4885
"13500",162122,"COLLEGE OF SOUTHERN MARYLAND                                ","2003-2004",26,"Volleyball",12300,11769,531,0,0,0,12300,11769,531,".","11",0,4769
"11940",119164,"MT SAN ANTONIO COLLEGE                                      ","2003-2004",24,"Track and Field, Outdoor",180112,179582,530,93514,93429,85,86598,86153,445,"55","29",10173,9384
"12969",233541,"SHENANDOAH UNIVERSITY                                       ","2003-2004",25,"Track and Field, X-Country",30180,29651,529,15090,15651,-561,15090,14000,1090,"6","11",5589,3836
"7435",153524,"IOWA CENTRAL COMMUNITY COLLEGE                              ","2003-2004",15,"Soccer",83624,83097,527,44181,43755,426,39443,39342,101,"32","13",1436,10860
"5872",147660,"NORTH CENTRAL COLLEGE                                       ","2003-2004",8,"Golf",16323,15797,526,11673,7797,3876,4650,8000,-3350,"12","8",3697,4000
"8697",231059,"SAINT MICHAELS COLLEGE                                      ","2003-2004",16,"Softball",70294,69769,525,0,0,0,70294,69769,525,".","16",0,28879
"9747",214379,"NORTHAMPTON COUNTY AREA COMMUNITY COLLEGE                   ","2003-2004",16,"Softball",10500,9975,525,0,0,0,10500,9975,525,".","16",0,5378
"11600",107558,"UNIVERSITY OF THE OZARKS                                    ","2003-2004",22,"Tennis",45624,45100,524,22812,22550,262,22812,22550,262,"8","7",3150,3150
"13230",115001,"GLENDALE COMMUNITY COLLEGE                                  ","2003-2004",26,"Volleyball",14216,13692,524,0,0,0,14216,13692,524,".","10",0,3475
"14827",175236,"RIDGEWATER COLLEGE                                          ","2003-2004",28,"Wrestling",25738,25222,516,25738,25222,516,0,0,0,"12",".",11950,0
"10802",220613,"LEE UNIVERSITY                                              ","2003-2004",22,"Tennis",167902,167387,515,83892,83874,18,84010,83513,497,"9","9",12624,12742
"12451",166683,"MASSACHUSETTS INSTITUTE OF TECHNOLOGY                       ","2003-2004",25,"Track and Field, X-Country",47602,47088,514,26896,27153,-257,20706,19935,771,"18","39",13108,7653
"486",119164,"MT SAN ANTONIO COLLEGE                                      ","2003-2004",1,"Baseball",75973,75463,510,75973,75463,510,0,0,0,"31",".",15099,0
"5725",157216,"LINDSEY WILSON COLLEGE                                      ","2003-2004",8,"Golf",153574,153064,510,95711,95211,500,57863,57853,10,"7","6",10347,4389
"14783",123013,"SANTA ROSA JUNIOR COLLEGE                                   ","2003-2004",28,"Wrestling",27400,26891,509,27400,26891,509,0,0,0,"16",".",10143,0
"11362",178387,"MISSOURI WESTERN STATE COLLEGE                              ","2003-2004",22,"Tennis",30738,30231,507,0,0,0,30738,30231,507,".","10",0,4045
"11814",216852,"WIDENER UNIVERSITY-MAIN CAMPUS                              ","2003-2004",23,"Track and Field, Indoor",29002,28500,502,14501,14250,251,14501,14250,251,"42","10",4631,4631
"1511",228501,"SUL ROSS STATE UNIVERSITY                                   ","2003-2004",1,"Baseball",58336,57836,500,58336,57836,500,0,0,0,"34",".",29323,0
"5604",237783,"SALEM INTERNATIONAL UNIVERSITY                              ","2003-2004",8,"Golf",8334,7834,500,8334,7834,500,0,0,0,"8","0",6259,0
"8811",215099,"PHILADELPHIA UNIVERSITY                                     ","2003-2004",16,"Softball",131499,130999,500,0,0,0,131499,130999,500,".","20",0,11064
"9065",155177,"HESSTON COLLEGE                                             ","2003-2004",16,"Softball",27438,26938,500,0,0,0,27438,26938,500,".","11",0,15438
"10841",237783,"SALEM INTERNATIONAL UNIVERSITY                              ","2003-2004",22,"Tennis",19680,19180,500,19680,19180,500,0,0,0,"9","0",7680,0
"11518",113698,"DOMINICAN UNIVERSITY OF CALIFORNIA                          ","2003-2004",22,"Tennis",9000,8500,500,3300,2900,400,5700,5600,100,"7","11",2480,5375
"12545",107558,"UNIVERSITY OF THE OZARKS                                    ","2003-2004",25,"Track and Field, X-Country",24350,23850,500,12175,11925,250,12175,11925,250,"8","7",1850,1850
"12675",213233,"JOHNSON COLLEGE                                             ","2003-2004",25,"Track and Field, X-Country",500,0,500,500,325,175,0,0,0,"3",".",108,0
"12836",237057,"WHITMAN COLLEGE                                             ","2003-2004",25,"Track and Field, X-Country",40266,39766,500,20133,19883,250,20133,19883,250,"12","8",6349,6349
"12989",214652,"PENNSYLVANIA STATE UNIV-PENN ST WORTHINGTON SCRNTN          ","2003-2004",26,"Volleyball",6500,6000,500,0,0,0,6500,6000,500,".","9",0,300
"13741",181093,"GRACE UNIVERSITY                                            ","2003-2004",26,"Volleyball",13602,13102,500,0,0,0,13602,13102,500,".","10",0,11102
"14855",237932,"WEST LIBERTY STATE COLLEGE                                  ","2003-2004",28,"Wrestling",54620,54120,500,54620,54120,500,0,0,0,"35","0",12495,0
"15713",237932,"WEST LIBERTY STATE COLLEGE                                  ","2003-2004",39,"Total Participants",329951,329451,500,192055,191555,500,137896,137896,0,"227","102",94225,50356
"11135",204200,"COLLEGE OF MOUNT SAINT JOSEPH                               ","2003-2004",22,"Tennis",17272,16775,497,7645,7509,136,9627,9266,361,"10","9",2265,3133
"5636",212106,"DUQUESNE UNIVERSITY                                         ","2003-2004",8,"Golf",100490,99995,495,100490,99995,495,0,0,0,"9",".",32785,0
"7305",154022,"THE FRANCISCAN UNIVERSITY                                   ","2003-2004",15,"Soccer",16850,16360,490,7400,7336,64,9450,9024,426,"17","12",5650,6650
"9799",199148,"UNIVERSITY OF NORTH CAROLINA AT GREENSBORO                  ","2003-2004",16,"Softball",262855,262371,484,0,0,0,262855,262371,484,".","18",0,45512
"10590",212197,"ELIZABETHTOWN COLLEGE                                       ","2003-2004",19,"Swimming",16376,15892,484,8188,7946,242,8188,7946,242,"6","24",4196,4196
"13636",146603,"LEWIS AND CLARK COMMUNITY COLLEGE                           ","2003-2004",26,"Volleyball",44697,44217,480,0,0,0,44697,44217,480,".","10",0,11782
"16280",146603,"LEWIS AND CLARK COMMUNITY COLLEGE                           ","2003-2004",39,"Total Participants",311160,310680,480,161967,161967,0,149193,148713,480,"77","66",59142,55317
"17075",138761,"ANDREW COLLEGE                                              ","2003-2004",39,"Total Participants",72450,71971,479,45925,46374,-449,26525,25597,928,"56","29",43293,21398
"4745",229063,"TEXAS SOUTHERN UNIVERSITY                                   ","2003-2004",7,"Football",1430057,1429581,476,1430057,1429581,476,0,0,0,"82",".",696572,0
"1831",220473,"JOHNSON BIBLE COLLEGE                                       ","2003-2004",2,"Basketball",47011,46537,474,25611,25487,124,21400,21050,350,"14","9",17489,10329
"10763",104708,"GLENDALE COMMUNITY COLLEGE                                  ","2003-2004",22,"Tennis",16095,15621,474,7703,7466,237,8392,8155,237,"8","8",200,200
"13722",229063,"TEXAS SOUTHERN UNIVERSITY                                   ","2003-2004",26,"Volleyball",263700,263227,473,0,0,0,263700,263227,473,".","14",0,93730
"11638",192022,"JEFFERSON COMMUNITY COLLEGE                                 ","2003-2004",22,"Tennis",3429,2960,469,0,0,0,3429,2960,469,".","6",0,1560
"12612",210234,"TREASURE VALLEY COMMUNITY COLLEGE                           ","2003-2004",25,"Track and Field, X-Country",16520,16051,469,8105,7929,176,8415,8122,293,"10","8",2000,2000
"13244",240374,"UNIVERSITY OF WISCONSIN-PARKSIDE                            ","2003-2004",26,"Volleyball",112459,111995,464,0,0,0,112459,111995,464,".","11",0,26100
"14379",151777,"MANCHESTER COLLEGE                                          ","2003-2004",26,"Volleyball",33898,33438,460,0,0,0,33898,33438,460,".","13",0,8400
"12131",190530,"CUNY BRONX COMMUNITY COLLEGE                                ","2003-2004",24,"Track and Field, Outdoor",13367,12909,458,3163,2944,219,10204,9965,239,"4","16",1452,5812
"3408",198817,"LENOIR COMMUNITY COLLEGE                                    ","2003-2004",2,"Basketball",29610,29153,457,29610,29153,457,0,0,0,"13",".",19098,0
"8190",161217,"UNIVERSITY OF MAINE AT AUGUSTA                              ","2003-2004",15,"Soccer",7933,7477,456,0,0,0,7933,7477,456,".","8",0,1764
"17137",161217,"UNIVERSITY OF MAINE AT AUGUSTA                              ","2003-2004",39,"Total Participants",7933,7477,456,0,0,0,7933,7477,456,"12","15",21410,9997
"2011",216278,"SUSQUEHANNA UNIVERSITY                                      ","2003-2004",2,"Basketball",142813,142362,451,64569,78302,-13733,78244,64060,14184,"23","14",20601,13392
"3282",113698,"DOMINICAN UNIVERSITY OF CALIFORNIA                          ","2003-2004",2,"Basketball",47900,47450,450,29500,29250,250,18400,18200,200,"15","15",22350,16700
"5623",101693,"UNIVERSITY OF MOBILE                                        ","2003-2004",8,"Golf",123848,123398,450,69504,69054,450,54344,54344,0,"13","7",16516,12861
"5699",123299,"SHASTA COLLEGE                                              ","2003-2004",8,"Golf",14597,14147,450,14597,14147,450,0,0,0,"18",".",5547,0
"10099",123299,"SHASTA COLLEGE                                              ","2003-2004",18,"Swimming and Diving",21938,21488,450,10844,10744,100,11094,10744,350,"4","14",4794,4794
"12823",123299,"SHASTA COLLEGE                                              ","2003-2004",25,"Track and Field, X-Country",15742,15292,450,7746,7646,100,7996,7646,350,"10","4",3346,3346
"13301",148672,"SAUK VALLEY COMMUNITY COLLEGE                               ","2003-2004",26,"Volleyball",28974,28524,450,0,0,0,28974,28524,450,".","8",0,10913
"14741",114716,"FOOTHILL COLLEGE                                            ","2003-2004",27,"Water Polo",9668,9218,450,5468,4103,1365,4200,5115,-915,"15","13",4003,4915
"15470",148672,"SAUK VALLEY COMMUNITY COLLEGE                               ","2003-2004",39,"Total Participants",156454,156004,450,83235,83235,0,73219,72769,450,"54","40",44727,41523
"15242",182634,"COLBY-SAWYER COLLEGE                                        ","2003-2004",34,"Equestrian",100007,99559,448,31939,31945,-6,68068,67614,454,".","22",5769,5769
"9405",154721,"BETHANY COLLEGE                                             ","2003-2004",16,"Softball",69010,68565,445,0,0,0,69010,68565,445,".","20",0,10367
"6238",161767,"ANNE ARUNDEL COMMUNITY COLLEGE                              ","2003-2004",8,"Golf",5153,4711,442,5153,4711,442,0,0,0,"7",".",3000,0
"5217",213020,"INDIANA UNIVERSITY OF PENNSYLVANIA-MAIN CAMPUS              ","2003-2004",8,"Golf",13524,13083,441,13524,13083,441,0,0,0,"6",".",9453,0
"11067",228501,"SUL ROSS STATE UNIVERSITY                                   ","2003-2004",22,"Tennis",8192,7752,440,4096,3875,221,4096,3877,219,"6","7",3621,3621
"4925",217624,"ALLEN UNIVERSITY                                            ","2003-2004",7,"Football",237497,237061,436,237497,237061,436,0,0,0,"50",".",67980,0
"2943",146676,"LINCOLN COLLEGE                                             ","2003-2004",2,"Basketball",131792,131357,435,50038,52562,-2524,81754,78795,2959,"17","17",24053,24051
"257",115861,"IMPERIAL VALLEY COLLEGE                                     ","2003-2004",1,"Baseball",39699,39265,434,39699,39265,434,0,0,0,"23",".",39261,0
"5258",157951,"WESTERN KENTUCKY UNIVERSITY                                 ","2003-2004",8,"Golf",174624,174190,434,89325,83244,6081,85299,90946,-5647,"11","13",40505,18886
"3049",122339,"SAN DIEGO CITY COLLEGE                                      ","2003-2004",2,"Basketball",21730,21298,432,21730,21298,432,0,0,0,"11",".",10145,0
"12943",206941,"UNIVERSITY OF CENTRAL OKLAHOMA                              ","2003-2004",25,"Track and Field, X-Country",9041,8611,430,0,0,0,9041,8611,430,".","9",0,8610
"1686",210270,"UMPQUA COMMUNITY COLLEGE                                    ","2003-2004",2,"Basketball",95022,94595,427,47288,44861,2427,47734,49734,-2000,"15","11",15525,24019
"1058",201371,"BLUFFTON COLLEGE                                            ","2003-2004",1,"Baseball",42623,42198,425,42623,42198,425,0,0,0,"28",".",17560,0
"12087",123299,"SHASTA COLLEGE                                              ","2003-2004",24,"Track and Field, Outdoor",34841,34416,425,17458,17208,250,17383,17208,175,"10","7",6958,6958
"7992",143118,"AURORA UNIVERSITY                                           ","2003-2004",15,"Soccer",77968,77544,424,35587,37254,-1667,42381,40290,2091,"25","34",12502,11724
"14224",245953,"MID-AMERICA CHRISTIAN UNIVERSITY                            ","2003-2004",26,"Volleyball",16956,16535,421,0,0,0,16956,16535,421,".","10",0,5711
"5610",214379,"NORTHAMPTON COUNTY AREA COMMUNITY COLLEGE                   ","2003-2004",8,"Golf",14700,14280,420,7350,7140,210,7350,7140,210,"10","0",3990,500
"6505",214379,"NORTHAMPTON COUNTY AREA COMMUNITY COLLEGE                   ","2003-2004",10,"Ice Hockey",8925,8505,420,8925,8505,420,0,0,0,"21","0",2100,0
"5351",194240,"ORANGE COUNTY COMMUNITY COLLEGE                             ","2003-2004",8,"Golf",5872,5453,419,5872,5453,419,0,0,0,"6",".",2663,0
"12417",216852,"WIDENER UNIVERSITY-MAIN CAMPUS                              ","2003-2004",25,"Track and Field, X-Country",31456,31038,418,15728,15519,209,15728,15519,209,"17","8",2025,2025
"4269",178411,"UNIVERSITY OF MISSOURI-ROLLA                                ","2003-2004",7,"Football",708427,708012,415,708427,708012,415,0,0,0,"97",".",83048,0
"6280",138761,"ANDREW COLLEGE                                              ","2003-2004",8,"Golf",7614,7204,410,7614,7204,410,0,0,0,"7",".",6454,0
"13002",239080,"MARIAN COLLEGE OF FOND DU LAC                               ","2003-2004",26,"Volleyball",48298,47891,407,0,0,0,48298,47891,407,".","13",0,15363
"14863",214379,"NORTHAMPTON COUNTY AREA COMMUNITY COLLEGE                   ","2003-2004",28,"Wrestling",6705,6300,405,6705,6300,405,0,0,0,"14","0",2100,0
"7699",234933,"CLARK COLLEGE                                               ","2003-2004",15,"Soccer",41110,40706,404,20555,20490,65,20555,20216,339,"21","13",13025,13025
"14229",206507,"WILMINGTON COLLEGE                                          ","2003-2004",26,"Volleyball",27544,27143,401,0,0,0,27544,27143,401,".","17",0,27132
"2555",167534,"QUINSIGAMOND COMMUNITY COLLEGE                              ","2003-2004",2,"Basketball",36482,36082,400,20841,20441,400,15641,15641,0,"21","16",14141,14141
"3935",206437,"WALSH UNIVERSITY                                            ","2003-2004",3,"All Track Combined",98449,98049,400,56637,56437,200,41812,41612,200,"40","40",19433,20023
"4141",161518,"SAINT JOSEPHS COLLEGE                                       ","2003-2004",6,"Field hocky",8763,8363,400,0,0,0,8763,8363,400,".","20",0,3708
"5539",161518,"SAINT JOSEPHS COLLEGE                                       ","2003-2004",8,"Golf",9203,8803,400,9203,8803,400,0,0,0,"15",".",5442,0
"6435",166683,"MASSACHUSETTS INSTITUTE OF TECHNOLOGY                       ","2003-2004",10,"Ice Hockey",93885,93485,400,47790,46340,1450,46095,47145,-1050,"25","23",19649,26820
"6637",211352,"CABRINI COLLEGE                                             ","2003-2004",11,"Lacrosse",67876,67476,400,38520,38120,400,29356,29356,0,"33","28",36602,20617
"8362",148335,"ROBERT MORRIS COLLEGE                                       ","2003-2004",15,"Soccer",839216,838816,400,251213,251213,0,588003,587603,400,"17","38",50127,134715
"9014",121691,"UNIVERSITY OF REDLANDS                                      ","2003-2004",16,"Softball",36454,36054,400,0,0,0,36454,36054,400,".","18",0,10454
"12565",161457,"UNIVERSITY OF NEW ENGLAND                                   ","2003-2004",25,"Track and Field, X-Country",16292,15892,400,8146,7946,200,8146,7946,200,"11","10",3096,3096
"12706",161518,"SAINT JOSEPHS COLLEGE                                       ","2003-2004",25,"Track and Field, X-Country",7813,7413,400,5110,4910,200,2703,2503,200,"14","4",2624,750
"14402",161518,"SAINT JOSEPHS COLLEGE                                       ","2003-2004",26,"Volleyball",13335,12935,400,0,0,0,13335,12935,400,".","13",0,8485
"14737",121901,"RIVERSIDE COMMUNITY COLLEGE                                 ","2003-2004",27,"Water Polo",13500,13100,400,6800,6600,200,6700,6500,200,"18","15",6200,6400
"15217",214643,"PENNSYLVANIA STATE UNIVERSITY-PENN STATE WILKES-BA          ","2003-2004",33,"Bowling",1400,1000,400,1400,1000,400,0,0,0,"10",".",700,0
"16345",199315,"PIEDMONT BAPTIST COLLEGE                                    ","2003-2004",39,"Total Participants",11070,10670,400,5350,5100,250,5720,5570,150,"30","14",24232,5220
"17342",148335,"ROBERT MORRIS COLLEGE                                       ","2003-2004",39,"Total Participants",2205456,2205056,400,726855,726855,0,1478601,1478201,400,"100","129",312915,455584
"8850",161457,"UNIVERSITY OF NEW ENGLAND                                   ","2003-2004",16,"Softball",23934,23535,399,0,0,0,23934,23535,399,".","17",0,10434
"12150",121886,"RIO HONDO COLLEGE                                           ","2003-2004",24,"Track and Field, Outdoor",20700,20301,399,7700,9801,-2101,13000,10500,2500,"7","11",2254,2503
"14730",110486,"CALIFORNIA STATE UNIVERSITY-BAKERSFIELD                     ","2003-2004",27,"Water Polo",106936,106537,399,0,0,0,106936,106537,399,".","17",0,17844
"12246",111461,"COLLEGE OF THE CANYONS                                      ","2003-2004",25,"Track and Field, X-Country",11894,11498,396,5947,7704,-1757,5947,3794,2153,"12","6",6600,3300
"15299",117274,"LASSEN COMMUNITY COLLEGE                                    ","2003-2004",35,"Rodeo",43351,42955,396,22654,22258,396,20697,20697,0,"6","4",5400,3600
"7647",168430,"WORCESTER STATE COLLEGE                                     ","2003-2004",15,"Soccer",37591,37196,395,20002,19532,470,17589,17664,-75,"23","19",19232,16664
"2806",151777,"MANCHESTER COLLEGE                                          ","2003-2004",2,"Basketball",133915,133521,394,74009,73878,131,59906,59643,263,"20","18",33500,21000
"14912",151777,"MANCHESTER COLLEGE                                          ","2003-2004",28,"Wrestling",53821,53427,394,53821,53427,394,0,0,0,"19",".",24890,0
"12924",177214,"DRURY UNIVERSITY                                            ","2003-2004",25,"Track and Field, X-Country",34932,34541,391,17466,17204,262,17466,17337,129,"11","8",16138,16271
"11033",239080,"MARIAN COLLEGE OF FOND DU LAC                               ","2003-2004",22,"Tennis",15241,14852,389,8345,8385,-40,6896,6467,429,"8","8",3482,3053
"6696",167260,"NICHOLS COLLEGE                                             ","2003-2004",11,"Lacrosse",41563,41175,388,20066,20133,-67,21497,21042,455,"29","13",14133,15042
"6276",174473,"NORTHLAND COMMUNITY AND TECHNICAL COLLEGE                   ","2003-2004",8,"Golf",4800,4413,387,4800,4413,387,0,0,0,"6","0",4400,0
"8675",179326,"SOUTHWEST BAPTIST UNIVERSITY                                ","2003-2004",16,"Softball",132176,131791,385,0,0,0,132176,131791,385,".","20",0,19538
"13219",149231,"SOUTHERN ILLINOIS UNIVERSITY-EDWARDSVILLE                   ","2003-2004",26,"Volleyball",153373,152990,383,0,0,0,153373,152990,383,".","12",0,31289
"11016",191719,"HUDSON VALLEY COMMUNITY COLLEGE                             ","2003-2004",22,"Tennis",5439,5059,380,0,0,0,5439,5059,380,".","7",0,1827
"14940",154101,"NORTHWESTERN COLLEGE                                        ","2003-2004",28,"Wrestling",106791,106412,379,106791,106412,379,0,0,0,"25",".",32517,0
"2793",223898,"CISCO JUNIOR COLLEGE                                        ","2003-2004",2,"Basketball",85631,85254,377,0,0,0,85631,85254,377,".","13",0,46754
"15187",234155,"VIRGINIA STATE UNIVERSITY                                   ","2003-2004",33,"Bowling",20935,20559,376,0,0,0,20935,20559,376,".","9",0,8377
"7754",203085,"HEIDELBERG COLLEGE                                          ","2003-2004",15,"Soccer",63333,62958,375,33325,32614,711,30008,30344,-336,"28","25",12939,10649
"8655",123299,"SHASTA COLLEGE                                              ","2003-2004",16,"Softball",39445,39070,375,0,0,0,39445,39070,375,".","15",0,19932
"15084",196200,"SUNY-POTSDAM                                                ","2003-2004",29,"Other Sports",7417,7044,373,0,0,0,7417,7044,373,".","15",0,4988
"13332",153524,"IOWA CENTRAL COMMUNITY COLLEGE                              ","2003-2004",26,"Volleyball",47818,47446,372,0,0,0,47818,47446,372,".","21",0,16631
"12256",127918,"REGIS UNIVERSITY                                            ","2003-2004",25,"Track and Field, X-Country",95112,94744,368,47556,44622,2934,47556,50122,-2566,"16","12",9831,9831
"6075",216931,"WILKES UNIVERSITY                                           ","2003-2004",8,"Golf",5089,4725,364,5089,4725,364,0,0,0,"15",".",2420,0
"10740",178341,"MISSOURI SOUTHERN STATE UNIVERSITY                          ","2003-2004",22,"Tennis",44749,44389,360,0,0,0,44749,44389,360,".","9",0,8959
"12795",125091,"VICTOR VALLEY COLLEGE                                       ","2003-2004",25,"Track and Field, X-Country",21242,20882,360,10621,10621,0,10621,10261,360,"11","5",3025,3025
"13241",115126,"GOLDEN WEST COLLEGE                                         ","2003-2004",26,"Volleyball",61259,60899,360,19957,20597,-640,41302,40302,1000,"15","15",8061,10763
"13839",156213,"ASBURY COLLEGE                                              ","2003-2004",26,"Volleyball",22501,22141,360,0,0,0,22501,22141,360,".","10",0,16806
"16118",125091,"VICTOR VALLEY COLLEGE                                       ","2003-2004",39,"Total Participants",289033,288673,360,146888,146888,0,142145,141785,360,"162","63",77139,73993
"16726",156213,"ASBURY COLLEGE                                              ","2003-2004",39,"Total Participants",75130,74770,360,28242,28242,0,46888,46528,360,"59","61",56414,59553
"15151",121619,"SANTA ANA COLLEGE                                           ","2003-2004",31,"Badminton",4500,4141,359,0,0,0,4500,4141,359,".","5",0,3121
"7967",217484,"UNIVERSITY OF RHODE ISLAND                                  ","2003-2004",15,"Soccer",993993,993636,357,511201,521680,-10479,482792,471956,10836,"30","27",105312,94051
"2038",216296,"THADDEUS STEVENS COLLEGE OF TECHNOLOGY                      ","2003-2004",2,"Basketball",26000,25645,355,26000,25645,355,0,0,0,"14",".",14819,0
"5686",239220,"MID-STATE TECHNICAL COLLEGE                                 ","2003-2004",8,"Golf",15217,14862,355,15217,14862,355,0,0,0,"3","0",8107,0
"2540",223524,"BROOKHAVEN COLLEGE                                          ","2003-2004",2,"Basketball",24490,24140,350,24490,24140,350,0,0,0,"18",".",15651,0
"3988",195809,"ST JOHN'S UNIVERSITY-NEW YORK                               ","2003-2004",5,"Fencing",298672,298322,350,175590,175415,175,123082,122907,175,"12","10",1115,1862
"9622",203535,"KENYON COLLEGE                                              ","2003-2004",16,"Softball",60829,60479,350,0,0,0,60829,60479,350,".","14",0,23713
"14995",123299,"SHASTA COLLEGE                                              ","2003-2004",28,"Wrestling",24114,23764,350,24114,23764,350,0,0,0,"14",".",11864,0
"4386",237066,"WHITWORTH COLLEGE                                           ","2003-2004",7,"Football",310262,309913,349,310262,309913,349,0,0,0,"92",".",89627,0
"1076",174075,"UNIVERSITY OF MINNESOTA-CROOKSTON                           ","2003-2004",1,"Baseball",67528,67181,347,67528,67181,347,0,0,0,"28",".",23440,0
"411",146825,"MACMURRAY COLLEGE                                           ","2003-2004",1,"Baseball",39825,39480,345,39825,39480,345,0,0,0,"37",".",15024,0
"9607",146825,"MACMURRAY COLLEGE                                           ","2003-2004",16,"Softball",45299,44954,345,0,0,0,45299,44954,345,".","20",0,22340
"2632",118930,"MISSION COLLEGE                                             ","2003-2004",2,"Basketball",32525,32184,341,0,0,0,32525,32184,341,".","12",0,9852
"8674",231581,"BRIDGEWATER COLLEGE                                         ","2003-2004",16,"Softball",56385,56044,341,0,0,0,56385,56044,341,".","22",0,24913
"6474",174075,"UNIVERSITY OF MINNESOTA-CROOKSTON                           ","2003-2004",10,"Ice Hockey",110931,110591,340,110931,110591,340,0,0,0,"30",".",59300,0
"9506",120342,"ORANGE COAST COLLEGE                                        ","2003-2004",16,"Softball",16747,16407,340,0,0,0,16747,16407,340,".","11",0,14270
"12212",184694,"FAIRLEIGH DICKINSON UNIVERSITY-COLLEGE AT FLORHAM           ","2003-2004",25,"Track and Field, X-Country",7826,7489,337,3913,3527,386,3913,3962,-49,"2","4",1487,1907
"715",162122,"COLLEGE OF SOUTHERN MARYLAND                                ","2003-2004",1,"Baseball",13944,13611,333,13944,13611,333,0,0,0,"22",".",7111,0
"2357",236188,"OLYMPIC COLLEGE                                             ","2003-2004",2,"Basketball",58400,58068,332,29450,29373,77,28950,28695,255,"11","9",10979,10309
"12200",133711,"FLAGLER COLLEGE                                             ","2003-2004",25,"Track and Field, X-Country",26190,25860,330,13290,13654,-364,12900,12206,694,"7","5",3364,2806
"132",151777,"MANCHESTER COLLEGE                                          ","2003-2004",1,"Baseball",53643,53315,328,53643,53315,328,0,0,0,"45",".",16200,0
"12440",140447,"MERCER UNIVERSITY                                           ","2003-2004",25,"Track and Field, X-Country",61590,61262,328,37790,37790,0,23800,23472,328,"7","9",6739,5472
"1135",181446,"NEBRASKA WESLEYAN UNIVERSITY                                ","2003-2004",1,"Baseball",35985,35658,327,35985,35658,327,0,0,0,"27",".",26580,0
"3990",197133,"VASSAR COLLEGE                                              ","2003-2004",5,"Fencing",51109,50783,326,24953,24640,313,26156,26143,13,"18","15",12379,13882
"14364",195304,"SARAH LAWRENCE COLLEGE                                      ","2003-2004",26,"Volleyball",10000,9675,325,0,0,0,10000,9675,325,".","10",0,4475
"1860",174473,"NORTHLAND COMMUNITY AND TECHNICAL COLLEGE                   ","2003-2004",2,"Basketball",29975,29656,319,14630,15932,-1302,15345,13724,1621,"12","13",15250,13267
"11926",190530,"CUNY BRONX COMMUNITY COLLEGE                                ","2003-2004",23,"Track and Field, Indoor",12300,11983,317,2802,2645,157,9498,9338,160,"4","15",1224,4603
"4122",166683,"MASSACHUSETTS INSTITUTE OF TECHNOLOGY                       ","2003-2004",6,"Field hocky",30875,30559,316,0,0,0,30875,30559,316,".","16",0,10086
"1756",219718,"BETHEL COLLEGE                                              ","2003-2004",2,"Basketball",156641,156326,315,77115,71185,5930,79526,85141,-5615,"15","20",34091,36312
"5967",217059,"YORK COLLEGE PENNSYLVANIA                                   ","2003-2004",8,"Golf",16345,16031,314,16345,16031,314,0,0,0,"10",".",5366,0
"12994",154800,"BUTLER COUNTY COMMUNITY COLLEGE                             ","2003-2004",26,"Volleyball",54246,53932,314,0,0,0,54246,53932,314,".","10",0,10341
"15446",154800,"BUTLER COUNTY COMMUNITY COLLEGE                             ","2003-2004",39,"Total Participants",674460,674146,314,310538,310538,0,363922,363608,314,"172","52",166716,96871
"15835",195304,"SARAH LAWRENCE COLLEGE                                      ","2003-2004",39,"Total Participants",63000,62686,314,9000,8179,821,54000,54507,-507,"18","53",8092,24790
"5760",153296,"ELLSWORTH COMMUNITY COLLEGE                                 ","2003-2004",8,"Golf",7314,7001,313,3040,3040,0,4274,3961,313,"7","3",1930,3211
"11825",213251,"JUNIATA COLLEGE                                             ","2003-2004",23,"Track and Field, Indoor",20527,20215,312,11280,11487,-207,9247,8728,519,"18","24",4550,1791
"3694",228343,"SOUTHWESTERN UNIVERSITY                                     ","2003-2004",3,"All Track Combined",94842,94531,311,48864,48708,156,45978,45823,155,"13","13",25735,22987
"7844",238616,"CONCORDIA UNIVERSITY-WISCONSIN                              ","2003-2004",15,"Soccer",70439,70130,309,41838,41529,309,28601,28601,0,"38","19",15500,10945
"2119",154022,"THE FRANCISCAN UNIVERSITY                                   ","2003-2004",2,"Basketball",33335,33027,308,17085,16777,308,16250,16250,0,"17","19",11000,11750
"7492",223898,"CISCO JUNIOR COLLEGE                                        ","2003-2004",15,"Soccer",52248,51948,300,0,0,0,52248,51948,300,".","25",0,16448
"9654",217475,"COMMUNITY COLLEGE OF RHODE ISLAND                           ","2003-2004",16,"Softball",6500,6200,300,0,0,0,6500,6200,300,".","17",0,5000
"9735",130226,"QUINNIPIAC UNIVERSITY                                       ","2003-2004",16,"Softball",370389,370089,300,0,0,0,370389,370089,300,".","17",0,73508
"11673",123299,"SHASTA COLLEGE                                              ","2003-2004",22,"Tennis",18424,18124,300,9187,9062,125,9237,9062,175,"5","7",2397,2397
"12816",166692,"MASSACHUSETTS MARITIME ACADEMY                              ","2003-2004",25,"Track and Field, X-Country",3000,2700,300,1500,1500,0,1500,1200,300,"10","10",1000,1000
"13390",223898,"CISCO JUNIOR COLLEGE                                        ","2003-2004",26,"Volleyball",35833,35533,300,0,0,0,35833,35533,300,".","12",0,16283
"13615",139144,"BERRY COLLEGE                                               ","2003-2004",26,"Volleyball",87718,87418,300,0,0,0,87718,87418,300,".","12",0,33000
"13699",224554,"TEXAS A &amp; M UNIVERSITY-COMMERCE                             ","2003-2004",26,"Volleyball",32300,32000,300,0,0,0,32300,32000,300,".","15",0,28326
"13973",212656,"GENEVA COLLEGE                                              ","2003-2004",26,"Volleyball",78321,78021,300,0,0,0,78321,78021,300,".","12",0,19513
"1809",162122,"COLLEGE OF SOUTHERN MARYLAND                                ","2003-2004",2,"Basketball",25720,25424,296,13600,13289,311,12120,12135,-15,"14","12",6789,5635
"10605",216278,"SUSQUEHANNA UNIVERSITY                                      ","2003-2004",19,"Swimming",31250,30954,296,15625,15477,148,15625,15477,148,"11","14",7340,7340
"15240",180692,"THE UNIVERSITY OF MONTANA-WESTERN                           ","2003-2004",34,"Equestrian",15841,15545,296,5000,5000,0,10841,10545,296,"3","17",3000,8329
"6613",130226,"QUINNIPIAC UNIVERSITY                                       ","2003-2004",11,"Lacrosse",796901,796606,295,429576,429381,195,367325,367225,100,"46","28",78878,55454
"11744",190044,"CLARKSON UNIVERSITY                                         ","2003-2004",22,"Tennis",44710,44415,295,22105,21810,295,22605,22605,0,"15","8",2233,5541
"14161",174473,"NORTHLAND COMMUNITY AND TECHNICAL COLLEGE                   ","2003-2004",26,"Volleyball",14143,13849,294,0,0,0,14143,13849,294,".","14",0,13745
"16686",210605,"COMMUNITY COLLEGE OF ALLEGHENY COUNTY                       ","2003-2004",39,"Total Participants",106210,105920,290,83498,83208,290,22712,22712,0,"157","77",89447,46285
"16373",185572,"MONMOUTH UNIVERSITY                                         ","2003-2004",39,"Total Participants",2525465,2525177,288,1105907,1116638,-10731,1419558,1408539,11019,"221","160",587469,369275
"11465",211352,"CABRINI COLLEGE                                             ","2003-2004",22,"Tennis",22437,22151,286,12450,12164,286,9987,9987,0,"8","14",11517,9641
"14206",199485,"ROCKINGHAM COMMUNITY COLLEGE                                ","2003-2004",26,"Volleyball",10207,9923,284,0,0,0,10207,9923,284,".","8",0,6424
"12629",161165,"HUSSON COLLEGE                                              ","2003-2004",25,"Track and Field, X-Country",5682,5399,283,2841,2840,1,2841,2559,282,"9","5",979,809
"5925",228343,"SOUTHWESTERN UNIVERSITY                                     ","2003-2004",8,"Golf",88561,88282,279,45608,45469,139,42953,42813,140,"7","4",21119,18237
"14939",201645,"CASE WESTERN RESERVE UNIVERSITY                             ","2003-2004",28,"Wrestling",57880,57604,276,57880,57604,276,0,0,0,"16",".",35823,0
"5206",211440,"CARNEGIE MELLON UNIVERSITY                                  ","2003-2004",8,"Golf",31575,31300,275,31575,31300,275,0,0,0,"9",".",19600,0
"9339",236887,"WALLA WALLA COMMUNITY COLLEGE                               ","2003-2004",16,"Softball",35630,35355,275,0,0,0,35630,35355,275,".","20",0,21955
"9531",206437,"WALSH UNIVERSITY                                            ","2003-2004",16,"Softball",30725,30450,275,0,0,0,30725,30450,275,".","19",0,12454
"13592",196200,"SUNY-POTSDAM                                                ","2003-2004",26,"Volleyball",53460,53185,275,0,0,0,53460,53185,275,".","15",0,28956
"11268",140696,"OGLETHORPE UNIVERSITY                                       ","2003-2004",22,"Tennis",6273,6000,273,3225,3000,225,3048,3000,48,"10","10",1700,1700
"6514",210605,"COMMUNITY COLLEGE OF ALLEGHENY COUNTY                       ","2003-2004",10,"Ice Hockey",10749,10479,270,10749,10479,270,0,0,0,"10",".",7500,0
"8561",186584,"SETON HALL UNIVERSITY                                       ","2003-2004",16,"Softball",600264,599997,267,0,0,0,600264,599997,267,".","21",0,109894
"7138",220613,"LEE UNIVERSITY                                              ","2003-2004",15,"Soccer",361552,361288,264,166395,164517,1878,195157,196771,-1614,"22","21",39670,35166
"12689",101435,"HUNTINGDON COLLEGE                                          ","2003-2004",25,"Track and Field, X-Country",5770,5506,264,5770,5506,264,0,0,0,"9",".",3456,0
"15750",146278,"JOHN WOOD COMMUNITY COLLEGE                                 ","2003-2004",39,"Total Participants",99475,99211,264,60543,61204,-661,38932,38007,925,"49","44",36681,34739
"4795",151777,"MANCHESTER COLLEGE                                          ","2003-2004",7,"Football",151243,150980,263,151243,150980,263,0,0,0,"59",".",46603,0
"8962",151777,"MANCHESTER COLLEGE                                          ","2003-2004",16,"Softball",43850,43587,263,0,0,0,43850,43587,263,".","14",0,13830
"4953",206941,"UNIVERSITY OF CENTRAL OKLAHOMA                              ","2003-2004",7,"Football",88107,87845,262,88107,87845,262,0,0,0,"115",".",82000,0
"5202",236753,"TACOMA COMMUNITY COLLEGE                                    ","2003-2004",8,"Golf",9655,9394,261,9050,7544,1506,605,1850,-1245,"6","1",5044,950
"5787",150066,"ANDERSON UNIVERSITY                                         ","2003-2004",8,"Golf",42926,42666,260,27592,26750,842,15334,15916,-582,"9","10",12555,5516
"1477",155812,"UNIVERSITY OF SAINT MARY                                    ","2003-2004",1,"Baseball",25207,24951,256,25207,24951,256,0,0,0,"32",".",12607,0
"5516",364016,"PARADISE VALLEY COMMUNITY COLLEGE                           ","2003-2004",8,"Golf",16068,15812,256,7980,8029,-49,8088,7783,305,"6","7",3743,3743
"14880",212115,"EAST STROUDSBURG UNIVERSITY OF PENNSYLVANIA                 ","2003-2004",28,"Wrestling",113415,113163,252,113415,113163,252,0,0,0,"23","0",21173,0
"1706",171137,"UNIVERSITY OF MICHIGAN-DEARBORN                             ","2003-2004",2,"Basketball",48091,47840,251,30823,30703,120,17268,17137,131,"13","17",14635,8224
"3591",199643,"SHAW UNIVERSITY                                             ","2003-2004",3,"All Track Combined",276089,275839,250,145536,145386,150,130553,130453,100,"55","42",30738,20165
"7318",199315,"PIEDMONT BAPTIST COLLEGE                                    ","2003-2004",15,"Soccer",5350,5100,250,5350,5100,250,0,0,0,"0","14",4850,0
"8080",193353,"MOUNT SAINT MARY COLLEGE                                    ","2003-2004",15,"Soccer",33598,33348,250,19526,19276,250,14072,14072,0,"21","16",16275,10960
"16255",193353,"MOUNT SAINT MARY COLLEGE                                    ","2003-2004",39,"Total Participants",121591,121341,250,57589,57339,250,64002,64002,0,"66","80",69967,79846
"934",110653,"UNIVERSITY OF CALIFORNIA-IRVINE                             ","2003-2004",1,"Baseball",789315,789066,249,789315,789066,249,0,0,0,"38",".",211789,0
"8182",206525,"WITTENBERG UNIVERSITY                                       ","2003-2004",15,"Soccer",89077,88828,249,52527,51857,670,36550,36971,-421,"31","25",10408,13955
"8964",192703,"MANHATTAN COLLEGE                                           ","2003-2004",16,"Softball",210717,210468,249,0,0,0,210717,210468,249,".","21",0,61302
"9710",239071,"MARANATHA BAPTIST BIBLE COLLEGE INC                         ","2003-2004",16,"Softball",9687,9440,247,0,0,0,9687,9440,247,".","12",0,6750
"10909",195304,"SARAH LAWRENCE COLLEGE                                      ","2003-2004",22,"Tennis",11000,10753,247,5000,5021,-21,6000,5732,268,"7","11",1571,1332
"13908",160977,"BATES COLLEGE                                               ","2003-2004",26,"Volleyball",59663,59416,247,0,0,0,59663,59416,247,".","13",0,24517
"2366",120342,"ORANGE COAST COLLEGE                                        ","2003-2004",2,"Basketball",76184,75939,245,38825,36600,2225,37359,39339,-1980,"17","16",27084,18912
"12572",240189,"UNIVERSITY OF WISCONSIN-WHITEWATER                          ","2003-2004",25,"Track and Field, X-Country",36459,36216,243,18660,16836,1824,17799,19380,-1581,"19","28",6153,7933
"14833",173638,"MINNESOTA WEST COMMUNITY AND TECHNICAL COLLEGE              ","2003-2004",28,"Wrestling",21872,21629,243,21872,21629,243,0,0,0,"9",".",10954,0
"11616",364016,"PARADISE VALLEY COMMUNITY COLLEGE                           ","2003-2004",22,"Tennis",13932,13691,241,7116,6949,167,6816,6742,74,"5","2",2579,2579
"14795",187134,"THE COLLEGE OF NEW JERSEY                                   ","2003-2004",28,"Wrestling",93278,93037,241,93278,93037,241,0,0,0,"24",".",19075,0
"10933",155210,"JOHNSON COUNTY COMMUNITY COLLEGE                            ","2003-2004",22,"Tennis",77874,77634,240,39150,38910,240,38724,38724,0,"7","6",7097,7097
"17047",224244,"DALLAS CHRISTIAN COLLEGE                                    ","2003-2004",39,"Total Participants",15000,14761,239,6500,6400,100,8500,8361,139,"38","21",16500,13000
"8005",192749,"MANHATTANVILLE COLLEGE                                      ","2003-2004",15,"Soccer",102058,101821,237,60010,58762,1248,42048,43059,-1011,"23","17",14754,11194
"13920",199962,"WINGATE UNIVERSITY                                          ","2003-2004",26,"Volleyball",23332,23095,237,0,0,0,23332,23095,237,".","13",0,19607
"7485",195003,"ROCHESTER INSTITUTE OF TECHNOLOGY                           ","2003-2004",15,"Soccer",77960,77724,236,40116,39998,118,37844,37726,118,"26","30",28166,27159
"7262",140447,"MERCER UNIVERSITY                                           ","2003-2004",15,"Soccer",144344,144111,233,73505,73505,0,70839,70606,233,"26","18",32774,37105
"5199",212197,"ELIZABETHTOWN COLLEGE                                       ","2003-2004",8,"Golf",8589,8359,230,8589,8359,230,0,0,0,"8",".",4459,0
"8008",139658,"EMORY UNIVERSITY                                            ","2003-2004",15,"Soccer",194749,194519,230,90629,88557,2072,104120,105962,-1842,"25","25",31627,46087
"12022",115001,"GLENDALE COMMUNITY COLLEGE                                  ","2003-2004",24,"Track and Field, Outdoor",27524,27294,230,16264,16149,115,11260,11145,115,"17","15",5594,2682
"3845",102377,"TUSKEGEE UNIVERSITY                                         ","2003-2004",3,"All Track Combined",208050,207822,228,111908,111294,614,96142,96528,-386,"22","21",9101,9672
"4204",217059,"YORK COLLEGE PENNSYLVANIA                                   ","2003-2004",6,"Field hocky",38690,38465,225,0,0,0,38690,38465,225,".","23",0,15855
"8920",181783,"WAYNE STATE COLLEGE                                         ","2003-2004",16,"Softball",75902,75678,224,0,0,0,75902,75678,224,".","17",0,21083
"7281",236753,"TACOMA COMMUNITY COLLEGE                                    ","2003-2004",15,"Soccer",21886,21663,223,10943,13537,-2594,10943,8126,2817,"23","14",7037,3626
"8384",125727,"WESTMONT COLLEGE                                            ","2003-2004",15,"Soccer",289539,289318,221,159403,158540,863,130136,130778,-642,"24","26",26677,26188
"12720",110486,"CALIFORNIA STATE UNIVERSITY-BAKERSFIELD                     ","2003-2004",25,"Track and Field, X-Country",25821,25600,221,0,0,0,25821,25600,221,".","38",0,5764
"722",196033,"SUNY COLLEGE OF AGRIC AND TECHN AT COBLESKILL               ","2003-2004",1,"Baseball",17399,17179,220,17399,17179,220,0,0,0,"21",".",15603,0
"5421",152318,"ROSE-HULMAN INSTITUTE OF TECHNOLOGY                         ","2003-2004",8,"Golf",31720,31500,220,18720,18500,220,13000,13000,0,"8","4",8720,8000
"2773",214379,"NORTHAMPTON COUNTY AREA COMMUNITY COLLEGE                   ","2003-2004",2,"Basketball",30506,30290,216,15141,14978,163,15365,15312,53,"14","13",7455,7035
"13242",144564,"DANVILLE AREA COMMUNITY COLLEGE                             ","2003-2004",26,"Volleyball",15427,15211,216,0,0,0,15427,15211,216,".","11",0,15210
"14615",237136,"APPALACHIAN BIBLE COLLEGE                                   ","2003-2004",26,"Volleyball",10405,10190,215,0,0,0,10405,10190,215,".","14",0,6440
"6236",226587,"MCMURRY UNIVERSITY                                          ","2003-2004",8,"Golf",57931,57717,214,30824,32215,-1391,27107,25502,1605,"10","5",15863,16270
"15766",144564,"DANVILLE AREA COMMUNITY COLLEGE                             ","2003-2004",39,"Total Participants",124391,124177,214,75170,75171,-1,49221,49006,215,"82","52",101159,71309
"6937",130697,"WESLEYAN UNIVERSITY                                         ","2003-2004",13,"Rowing",123867,123656,211,0,0,0,123867,123656,211,".","22",0,23564
"2213",228787,"THE UNIVERSITY OF TEXAS AT DALLAS                           ","2003-2004",2,"Basketball",55700,55490,210,27850,27640,210,27850,27850,0,"17","16",27000,27311
"12182",154022,"THE FRANCISCAN UNIVERSITY                                   ","2003-2004",25,"Track and Field, X-Country",11726,11516,210,5863,5758,105,5863,5758,105,"18","11",5000,5000
"12928",178059,"MARYVILLE UNIVERSITY OF SAINT LOUIS                         ","2003-2004",25,"Track and Field, X-Country",9499,9289,210,4886,4781,105,4613,4508,105,"6","10",3564,3584
"4262",196866,"UNION COLLEGE                                               ","2003-2004",6,"Field hocky",45288,45081,207,0,0,0,45288,45081,207,".","19",0,11064
"12043",123013,"SANTA ROSA JUNIOR COLLEGE                                   ","2003-2004",24,"Track and Field, Outdoor",63774,63568,206,37502,37399,103,26272,26169,103,"31","10",16844,5614
"2064",195304,"SARAH LAWRENCE COLLEGE                                      ","2003-2004",2,"Basketball",10000,9796,204,10000,9796,204,0,0,0,"9",".",5246,0
"4535",180692,"THE UNIVERSITY OF MONTANA-WESTERN                           ","2003-2004",7,"Football",342274,342071,203,342274,342071,203,0,0,0,"82",".",210641,0
"251",214643,"PENNSYLVANIA STATE UNIVERSITY-PENN STATE WILKES-BA          ","2003-2004",1,"Baseball",7000,6800,200,7000,6800,200,0,0,0,"16",".",2900,0
"282",214704,"PENNSYLVANIA STATE UNIVERSITY-PENN STATE BERKS              ","2003-2004",1,"Baseball",15135,14935,200,15135,14935,200,0,0,0,"18",".",6535,0
"521",153375,"GRAND VIEW COLLEGE                                          ","2003-2004",1,"Baseball",214460,214260,200,214460,214260,200,0,0,0,"40",".",35342,0
"5414",229780,"WAYLAND BAPTIST UNIVERSITY                                  ","2003-2004",8,"Golf",32000,31800,200,32000,31800,200,0,0,0,"7",".",19100,0
"6873",152318,"ROSE-HULMAN INSTITUTE OF TECHNOLOGY                         ","2003-2004",12,"Rifle",14270,14070,200,9270,9070,200,5000,5000,0,"10",".",7400,1940
"7434",174738,"ROCHESTER COMMUNITY AND TECHNICAL COLLEGE                   ","2003-2004",15,"Soccer",21815,21615,200,0,0,0,21815,21615,200,".","16",0,17615
"7732",107558,"UNIVERSITY OF THE OZARKS                                    ","2003-2004",15,"Soccer",107600,107400,200,63300,64200,-900,44300,43200,1100,"33","19",12750,12750
"8386",179308,"SAINT LOUIS COMMUNITY COLLEGE-FOREST PARK                   ","2003-2004",15,"Soccer",31521,31321,200,18526,18326,200,12995,12995,0,"22","15",833,833
"8951",223898,"CISCO JUNIOR COLLEGE                                        ","2003-2004",16,"Softball",37590,37390,200,0,0,0,37590,37390,200,".","18",0,18140
"10724",121901,"RIVERSIDE COMMUNITY COLLEGE                                 ","2003-2004",22,"Tennis",7400,7200,200,3700,3600,100,3700,3600,100,"10","8",2000,2000
"14097",217475,"COMMUNITY COLLEGE OF RHODE ISLAND                           ","2003-2004",26,"Volleyball",15000,14800,200,0,0,0,15000,14800,200,"0","9",0,12000
"15125",234669,"BELLEVUE COMMUNITY COLLEGE                                  ","2003-2004",29,"Other Sports",7200,7000,200,3600,3500,100,3600,3500,100,"5","3",500,500
"15705",153375,"GRAND VIEW COLLEGE                                          ","2003-2004",39,"Total Participants",908912,908712,200,411900,411700,200,497012,497012,0,"95","114",93760,126001
"14438",200253,"MINOT STATE UNIVERSITY                                      ","2003-2004",26,"Volleyball",25201,25004,197,0,0,0,25201,25004,197,".","16",0,16857
"11373",151777,"MANCHESTER COLLEGE                                          ","2003-2004",22,"Tennis",20110,19914,196,10155,10057,98,9955,9857,98,"7","11",4500,4300
"9563",174899,"THE COLLEGE OF SAINT SCHOLASTICA                            ","2003-2004",16,"Softball",100874,100682,192,0,0,0,100874,100682,192,".","15",0,43255
"14875",183974,"CENTENARY COLLEGE                                           ","2003-2004",28,"Wrestling",20897,20705,192,20897,20705,192,0,0,0,"17",".",12291,0
"6099",239716,"SAINT NORBERT COLLEGE                                       ","2003-2004",8,"Golf",41204,41013,191,21031,21031,0,20173,19982,191,"14","5",3072,1273
"15633",180416,"MONTANA TECH OF THE UNIVERSITY OF MONTANA                   ","2003-2004",39,"Total Participants",192324,192135,189,24117,24049,68,168207,168086,121,"123","43",110593,71155
"13361",183974,"CENTENARY COLLEGE                                           ","2003-2004",26,"Volleyball",16471,16283,188,0,0,0,16471,16283,188,".","13",0,9857
"12750",190530,"CUNY BRONX COMMUNITY COLLEGE                                ","2003-2004",25,"Track and Field, X-Country",3201,3014,187,0,0,0,3201,3014,187,".","7",0,711
"15179",191719,"HUDSON VALLEY COMMUNITY COLLEGE                             ","2003-2004",33,"Bowling",10982,10798,184,5491,5399,92,5491,5399,92,"8","5",3112,3110
"3410",230959,"MIDDLEBURY COLLEGE                                          ","2003-2004",2,"Basketball",145800,145618,182,80311,80311,0,65489,65307,182,"17","11",19442,16664
"11901",196033,"SUNY COLLEGE OF AGRIC AND TECHN AT COBLESKILL               ","2003-2004",23,"Track and Field, Indoor",11720,11538,182,5860,5769,91,5860,5769,91,"17","13",4182,4186
"11955",196033,"SUNY COLLEGE OF AGRIC AND TECHN AT COBLESKILL               ","2003-2004",24,"Track and Field, Outdoor",13254,13072,182,6627,6536,91,6627,6536,91,"19","10",4864,4870
"12137",230959,"MIDDLEBURY COLLEGE                                          ","2003-2004",24,"Track and Field, Outdoor",172046,171864,182,88535,87993,542,83511,83871,-360,"44","44",18571,14373
"5263",231554,"BLUEFIELD COLLEGE                                           ","2003-2004",8,"Golf",24111,23930,181,24111,23930,181,0,0,0,"11",".",5949,0
"877",190248,"CONCORDIA COLLEGE                                           ","2003-2004",1,"Baseball",46978,46798,180,46978,46798,180,0,0,0,"40",".",27541,0
"1292",206914,"CAMERON UNIVERSITY                                          ","2003-2004",1,"Baseball",21759,21579,180,21759,21579,180,0,0,0,"33",".",19875,0
"13074",231581,"BRIDGEWATER COLLEGE                                         ","2003-2004",26,"Volleyball",64525,64345,180,0,0,0,64525,64345,180,".","16",0,17128
"7398",163426,"MONTGOMERY COLLEGE                                          ","2003-2004",15,"Soccer",57331,57152,179,41445,41265,180,15886,15887,-1,"26","19",16711,7754
"11219",240417,"UNIVERSITY OF WISCONSIN-STOUT                               ","2003-2004",22,"Tennis",15294,15115,179,0,0,0,15294,15115,179,".","12",0,6120
"11615",157216,"LINDSEY WILSON COLLEGE                                      ","2003-2004",22,"Tennis",174107,173932,175,101919,101852,67,72188,72080,108,"7","7",3554,3240
"3343",148380,"ROCK VALLEY COLLEGE                                         ","2003-2004",2,"Basketball",14000,13826,174,14000,13826,174,0,0,0,"12",".",6913,0
"3736",172264,"SIENA HEIGHTS UNIVERSITY                                    ","2003-2004",3,"All Track Combined",40422,40248,174,19777,22736,-2959,20645,17512,3133,"37","33",14529,15083
"12719",199999,"WINSTON-SALEM STATE UNIVERSITY                              ","2003-2004",25,"Track and Field, X-Country",1800,1627,173,900,835,65,900,792,108,"8","8",670,674
"5460",130697,"WESLEYAN UNIVERSITY                                         ","2003-2004",8,"Golf",22401,22230,171,22401,22230,171,0,0,0,"11",".",6770,0
"15544",206914,"CAMERON UNIVERSITY                                          ","2003-2004",39,"Total Participants",135409,135238,171,75754,75583,171,59655,59655,0,"73","47",86334,78009
"10190",173665,"HAMLINE UNIVERSITY                                          ","2003-2004",18,"Swimming and Diving",30520,30350,170,15268,17243,-1975,15252,13107,2145,"6","20",8143,4311
"8892",236975,"WENATCHEE VALLEY COLLEGE                                    ","2003-2004",16,"Softball",37833,37665,168,0,0,0,37833,37665,168,".","19",0,37664
"8808",196015,"SUNY COLLEGE OF TECHNOLOGY AT CANTON                        ","2003-2004",16,"Softball",25097,24933,164,0,0,0,25097,24933,164,".","11",0,11212
"16656",104708,"GLENDALE COMMUNITY COLLEGE                                  ","2003-2004",39,"Total Participants",179521,179357,164,77856,88496,-10640,101665,90861,10804,"198","96",38498,24247
"8932",148380,"ROCK VALLEY COLLEGE                                         ","2003-2004",16,"Softball",9000,8837,163,0,0,0,9000,8837,163,".","12",0,4418
"12324",167376,"NORTHERN ESSEX COMMUNITY COLLEGE                            ","2003-2004",25,"Track and Field, X-Country",5128,4966,162,5128,4966,162,0,0,0,"2",".",2000,0
"2645",190044,"CLARKSON UNIVERSITY                                         ","2003-2004",2,"Basketball",143873,143713,160,86001,85162,839,57872,58551,-679,"15","9",31770,25352
"14025",216542,"VALLEY FORGE CHRISTIAN COLLEGE                              ","2003-2004",26,"Volleyball",8060,7901,159,0,0,0,8060,7901,159,"0","9",0,5651
"13950",216278,"SUSQUEHANNA UNIVERSITY                                      ","2003-2004",26,"Volleyball",20509,20351,158,0,0,0,20509,20351,158,"0","14",0,10738
"7860",174899,"THE COLLEGE OF SAINT SCHOLASTICA                            ","2003-2004",15,"Soccer",138928,138771,157,54069,54017,52,84859,84754,105,"30","27",25184,25184
"1740",180692,"THE UNIVERSITY OF MONTANA-WESTERN                           ","2003-2004",2,"Basketball",256808,256653,155,130501,130495,6,126307,126158,149,"26","25",102388,95398
"6545",195003,"ROCHESTER INSTITUTE OF TECHNOLOGY                           ","2003-2004",11,"Lacrosse",108376,108221,155,80982,80827,155,27394,27394,0,"41","23",38735,17386
"10826",153001,"BUENA VISTA UNIVERSITY                                      ","2003-2004",22,"Tennis",13480,13325,155,6535,6385,150,6945,6940,5,"8","9",2874,3218
"13948",123299,"SHASTA COLLEGE                                              ","2003-2004",26,"Volleyball",30365,30210,155,0,0,0,30365,30210,155,".","17",0,13067
"5054",114433,"FEATHER RIVER COMMUNITY COLLEGE DISTRICT                    ","2003-2004",7,"Football",100491,100337,154,100491,100337,154,0,0,0,"85",".",77196,0
"14134",217059,"YORK COLLEGE PENNSYLVANIA                                   ","2003-2004",26,"Volleyball",54582,54428,154,0,0,0,54582,54428,154,".","12",0,22098
"10511",184694,"FAIRLEIGH DICKINSON UNIVERSITY-COLLEGE AT FLORHAM           ","2003-2004",19,"Swimming",17186,17035,151,8593,7821,772,8593,9214,-621,"5","15",5061,6454
"9751",157863,"UNION COLLEGE                                               ","2003-2004",16,"Softball",120150,120000,150,0,0,0,120150,120000,150,".","14",0,12150
"12817",207306,"NORTHWESTERN OKLAHOMA STATE UNIVERSITY                      ","2003-2004",25,"Track and Field, X-Country",12638,12488,150,6319,6244,75,6319,6244,75,"3","5",667,667
"12889",237783,"SALEM INTERNATIONAL UNIVERSITY                              ","2003-2004",25,"Track and Field, X-Country",4380,4230,150,2190,2115,75,2190,2115,75,"5","3",1352,1352
"13457",199315,"PIEDMONT BAPTIST COLLEGE                                    ","2003-2004",26,"Volleyball",5720,5570,150,0,0,0,5720,5570,150,"18","0",0,5220
"10742",197911,"BARTON COLLEGE                                              ","2003-2004",22,"Tennis",114598,114450,148,57813,57813,0,56785,56637,148,"9","7",8340,8509
"7310",169080,"CALVIN COLLEGE                                              ","2003-2004",15,"Soccer",58679,58533,146,31138,32858,-1720,27541,25675,1866,"22","23",13941,11186
"12480",218414,"NEWBERRY COLLEGE                                            ","2003-2004",25,"Track and Field, X-Country",5089,4943,146,2838,2838,0,2251,2105,146,"6","4",2838,2104
"14495",130226,"QUINNIPIAC UNIVERSITY                                       ","2003-2004",26,"Volleyball",240973,240828,145,0,0,0,240973,240828,145,".","15",0,36750
"5632",180373,"MILES COMMUNITY COLLEGE                                     ","2003-2004",8,"Golf",30886,30742,144,30886,30742,144,0,0,0,"8",".",22682,0
"6058",169716,"UNIVERSITY OF DETROIT MERCY                                 ","2003-2004",8,"Golf",110696,110556,140,110696,110556,140,0,0,0,"10",".",16590,0
"16698",173735,"HIBBING COMMUNITY COLLEGE-A TECH AND COMM COLL              ","2003-2004",39,"Total Participants",94720,94580,140,43612,43572,40,51108,51008,100,"94","32",60112,36947
"14522",224244,"DALLAS CHRISTIAN COLLEGE                                    ","2003-2004",26,"Volleyball",8500,8361,139,0,0,0,8500,8361,139,"0","10",0,5000
"4154",187444,"WILLIAM PATERSON UNIVERSITY OF NEW JERSEY                   ","2003-2004",6,"Field hocky",58034,57896,138,0,0,0,58034,57896,138,".","24",0,18638
"4430",166683,"MASSACHUSETTS INSTITUTE OF TECHNOLOGY                       ","2003-2004",7,"Football",79732,79595,137,79732,79595,137,0,0,0,"44",".",26773,0
"5635",180416,"MONTANA TECH OF THE UNIVERSITY OF MONTANA                   ","2003-2004",8,"Golf",48235,48099,136,24117,24049,68,24118,24050,68,".","15",3350,3350
"7518",209506,"OREGON INSTITUTE OF TECHNOLOGY                              ","2003-2004",15,"Soccer",46550,46414,136,0,0,0,46550,46414,136,".","16",0,25362
"10914",196033,"SUNY COLLEGE OF AGRIC AND TECHN AT COBLESKILL               ","2003-2004",22,"Tennis",5690,5554,136,2726,2658,68,2964,2896,68,"8","5",1080,1220
"13613",190567,"CUNY CITY COLLEGE                                           ","2003-2004",26,"Volleyball",36369,36235,134,13615,13323,292,22754,22912,-158,"12","10",9290,18879
"8827",229027,"THE UNIVERSITY OF TEXAS AT SAN ANTONIO                      ","2003-2004",16,"Softball",340449,340317,132,0,0,0,340449,340317,132,".","18",0,60785
"381",215099,"PHILADELPHIA UNIVERSITY                                     ","2003-2004",1,"Baseball",132040,131910,130,132040,131910,130,0,0,0,"24",".",13160,0
"6729",196033,"SUNY COLLEGE OF AGRIC AND TECHN AT COBLESKILL               ","2003-2004",11,"Lacrosse",16208,16078,130,16208,16078,130,0,0,0,"20",".",14220,0
"7998",240189,"UNIVERSITY OF WISCONSIN-WHITEWATER                          ","2003-2004",15,"Soccer",78653,78523,130,39660,36824,2836,38993,41699,-2706,"24","25",18992,23368
"9523",201371,"BLUFFTON COLLEGE                                            ","2003-2004",16,"Softball",35363,35233,130,0,0,0,35363,35233,130,".","18",0,19745
"694",117690,"LOS ANGELES HARBOR COLLEGE                                  ","2003-2004",1,"Baseball",82598,82469,129,82598,82469,129,0,0,0,"32",".",26649,0
"12886",161226,"UNIVERSITY OF MAINE AT FARMINGTON                           ","2003-2004",25,"Track and Field, X-Country",7102,6973,129,4120,4018,102,2982,2955,27,"9","3",3262,2623
"10963",206437,"WALSH UNIVERSITY                                            ","2003-2004",22,"Tennis",41120,40992,128,22193,22065,128,18927,18927,0,"11","9",6924,8569
"13079",146825,"MACMURRAY COLLEGE                                           ","2003-2004",26,"Volleyball",12895,12767,128,0,0,0,12895,12767,128,"0","10",0,5788
"8241",190442,"CORNING COMMUNITY COLLEGE                                   ","2003-2004",15,"Soccer",15600,15474,126,7950,7913,37,7650,7561,89,"16","14",3413,3061
"12389",237358,"DAVIS AND ELKINS COLLEGE                                    ","2003-2004",25,"Track and Field, X-Country",23120,22995,125,11830,11705,125,11290,11290,0,"6","7",4234,3059
"5957",167260,"NICHOLS COLLEGE                                             ","2003-2004",8,"Golf",11314,11198,116,11314,11198,116,0,0,0,"15",".",8198,0
"13611",210234,"TREASURE VALLEY COMMUNITY COLLEGE                           ","2003-2004",26,"Volleyball",25983,25868,115,0,0,0,25983,25868,115,".","12",0,15000
"13221",197911,"BARTON COLLEGE                                              ","2003-2004",26,"Volleyball",73095,72984,111,0,0,0,73095,72984,111,"0","13",0,12672
"10729",218821,"SPARTANBURG METHODIST COLLEGE                               ","2003-2004",22,"Tennis",35403,35293,110,20140,20140,0,15263,15153,110,"11","8",7775,4342
"554",216278,"SUSQUEHANNA UNIVERSITY                                      ","2003-2004",1,"Baseball",49277,49168,109,49277,49168,109,0,0,0,"31",".",22271,0
"1528",234845,"CENTRALIA COLLEGE                                           ","2003-2004",1,"Baseball",49938,49831,107,49938,49831,107,0,0,0,"25",".",32298,0
"8865",114716,"FOOTHILL COLLEGE                                            ","2003-2004",16,"Softball",7350,7244,106,0,0,0,7350,7244,106,".","11",0,7144
"1653",113236,"CYPRESS COLLEGE                                             ","2003-2004",2,"Basketball",110939,110837,102,47611,51228,-3617,63328,59609,3719,"12","11",18668,26169
"14215",206941,"UNIVERSITY OF CENTRAL OKLAHOMA                              ","2003-2004",26,"Volleyball",14751,14650,101,0,0,0,14751,14650,101,".","12",0,12050
"14625",231059,"SAINT MICHAELS COLLEGE                                      ","2003-2004",26,"Volleyball",37517,37416,101,0,0,0,37517,37416,101,".","11",0,13613
"2263",217420,"RHODE ISLAND COLLEGE                                        ","2003-2004",2,"Basketball",134835,134735,100,70322,70322,0,64513,64413,100,"14","15",24322,16753
"4949",197045,"UTICA COLLEGE                                               ","2003-2004",7,"Football",234900,234800,100,234900,234800,100,0,0,0,"78",".",55500,0
"5614",178369,"MISSOURI VALLEY COLLEGE                                     ","2003-2004",8,"Golf",5600,5500,100,3200,3000,200,2400,2500,-100,"13","6",2500,1500
"6181",209056,"LEWIS &amp; CLARK COLLEGE                                       ","2003-2004",8,"Golf",34577,34477,100,13838,13763,75,20739,20714,25,"8","6",8091,9411
"7898",224244,"DALLAS CHRISTIAN COLLEGE                                    ","2003-2004",15,"Soccer",6500,6400,100,6500,6400,100,0,0,0,"18","0",4500,0
"8207",181093,"GRACE UNIVERSITY                                            ","2003-2004",15,"Soccer",29428,29328,100,29428,29328,100,0,0,0,"16",".",27228,0
"11954",165024,"BRIDGEWATER STATE COLLEGE                                   ","2003-2004",24,"Track and Field, Outdoor",8000,7900,100,4000,3950,50,4000,3950,50,"16","15",2975,2975
"13812",173735,"HIBBING COMMUNITY COLLEGE-A TECH AND COMM COLL              ","2003-2004",26,"Volleyball",31563,31463,100,0,0,0,31563,31463,100,".","10",0,11543
"14187",121691,"UNIVERSITY OF REDLANDS                                      ","2003-2004",26,"Volleyball",52733,52633,100,0,0,0,52733,52633,100,".","15",0,6125
"15067",190044,"CLARKSON UNIVERSITY                                         ","2003-2004",29,"Other Sports",39324,39224,100,31459,31379,80,7865,7845,20,"16","4",22830,5708
"7893",240471,"UNIVERSITY OF WISCONSIN-RIVER FALLS                         ","2003-2004",15,"Soccer",28570,28472,98,0,0,0,28570,28472,98,".","22",0,16738
"3852",195216,"ST LAWRENCE UNIVERSITY                                      ","2003-2004",3,"All Track Combined",194414,194321,93,97207,93658,3549,97207,100663,-3456,"87","95",28538,28538
"11123",238980,"LAKELAND COLLEGE                                            ","2003-2004",22,"Tennis",12369,12276,93,7223,7222,1,5146,5054,92,"12","10",3008,2054
"6622",233541,"SHENANDOAH UNIVERSITY                                       ","2003-2004",11,"Lacrosse",80188,80096,92,40509,43072,-2563,39679,37024,2655,"21","16",17532,15928
"14958",117274,"LASSEN COMMUNITY COLLEGE                                    ","2003-2004",28,"Wrestling",117365,117274,91,74009,74009,0,43356,43265,91,"39","17",34000,12000
"2296",165699,"ENDICOTT COLLEGE                                            ","2003-2004",2,"Basketball",102790,102700,90,57775,57685,90,45015,45015,0,"16","17",14200,14500
"9107",197911,"BARTON COLLEGE                                              ","2003-2004",16,"Softball",82811,82721,90,0,0,0,82811,82721,90,".","12",0,15234
"12879",165024,"BRIDGEWATER STATE COLLEGE                                   ","2003-2004",25,"Track and Field, X-Country",6000,5910,90,3000,2955,45,3000,2955,45,"8","12",2855,2855
"3385",190442,"CORNING COMMUNITY COLLEGE                                   ","2003-2004",2,"Basketball",33044,32956,88,17844,17958,-114,15200,14998,202,"13","11",8064,7748
"14992",238980,"LAKELAND COLLEGE                                            ","2003-2004",28,"Wrestling",26390,26302,88,26390,26302,88,0,0,0,"11",".",5343,0
"9086",217059,"YORK COLLEGE PENNSYLVANIA                                   ","2003-2004",16,"Softball",60195,60108,87,0,0,0,60195,60108,87,".","18",0,25232
"944",181020,"DOANE COLLEGE                                               ","2003-2004",1,"Baseball",120044,119958,86,120044,119958,86,0,0,0,"39",".",20276,0
"15331",180692,"THE UNIVERSITY OF MONTANA-WESTERN                           ","2003-2004",35,"Rodeo",146602,146516,86,73301,73288,13,73301,73228,73,"33","26",55413,55413
"5783",167899,"SPRINGFIELD COLLEGE                                         ","2003-2004",8,"Golf",4588,4503,85,4588,4503,85,0,0,0,"13",".",3665,0
"6053",210234,"TREASURE VALLEY COMMUNITY COLLEGE                           ","2003-2004",8,"Golf",16161,16076,85,8333,8332,1,7828,7744,84,"6","4",6000,4000
"13485",220613,"LEE UNIVERSITY                                              ","2003-2004",26,"Volleyball",154190,154105,85,0,0,0,154190,154105,85,".","11",0,34766
"4650",114716,"FOOTHILL COLLEGE                                            ","2003-2004",7,"Football",17284,17200,84,17284,17200,84,0,0,0,"50",".",16398,0
"271",239071,"MARANATHA BAPTIST BIBLE COLLEGE INC                         ","2003-2004",1,"Baseball",16784,16703,81,16784,16703,81,0,0,0,"17",".",9540,0
"5847",161226,"UNIVERSITY OF MAINE AT FARMINGTON                           ","2003-2004",8,"Golf",4775,4694,81,4775,4694,81,0,0,0,"8",".",3259,0
"9323",238980,"LAKELAND COLLEGE                                            ","2003-2004",16,"Softball",23213,23135,78,0,0,0,23213,23135,78,".","14",0,8867
"11326",156286,"BELLARMINE UNIVERSITY                                       ","2003-2004",22,"Tennis",63300,63223,77,35450,35439,11,27850,27784,66,"9","10",7115,3586
"4711",187444,"WILLIAM PATERSON UNIVERSITY OF NEW JERSEY                   ","2003-2004",7,"Football",193556,193480,76,193556,193480,76,0,0,0,"82",".",65889,0
"10546",110574,"CALIFORNIA STATE UNIVERSITY-HAYWARD                         ","2003-2004",19,"Swimming",86345,86270,75,0,0,0,86345,86270,75,".","14",0,27772
"12349",119164,"MT SAN ANTONIO COLLEGE                                      ","2003-2004",25,"Track and Field, X-Country",138743,138669,74,70664,70627,37,68079,68042,37,"23","16",3250,3250
"14077",215309,"UNIVERSITY OF PITTSBURGH-TITUSVILLE                         ","2003-2004",26,"Volleyball",21604,21530,74,0,0,0,21604,21530,74,".","11",0,1530
"6451",200314,"MINOT STATE UNIVERSITY-BOTTINEAU CAMPUS                     ","2003-2004",10,"Ice Hockey",48194,48121,73,48194,48121,73,0,0,0,"24",".",43980,0
"13619",214379,"NORTHAMPTON COUNTY AREA COMMUNITY COLLEGE                   ","2003-2004",26,"Volleyball",11550,11477,73,2100,1365,735,9450,10112,-662,"7","12",735,5565
"1810",218733,"SOUTH CAROLINA STATE UNIVERSITY                             ","2003-2004",2,"Basketball",976624,976553,71,493233,523603,-30370,483391,452950,30441,"20","15",127962,129223
"9258",157076,"KENTUCKY WESLEYAN COLLEGE                                   ","2003-2004",16,"Softball",57775,57705,70,0,0,0,57775,57705,70,".","17",0,11601
"16144",223524,"BROOKHAVEN COLLEGE                                          ","2003-2004",39,"Total Participants",65688,65618,70,40583,40324,259,25105,25294,-189,"69","23",43542,13734
"12755",140234,"LAGRANGE COLLEGE                                            ","2003-2004",25,"Track and Field, X-Country",13200,13138,62,6600,6569,31,6600,6569,31,"10","10",4600,4600
"14915",243133,"UNIVERSITY OF PUERTO RICO-BAYAMON                           ","2003-2004",28,"Wrestling",2000,1938,62,2000,1938,62,0,0,0,"18","0",337,0
"7051",237057,"WHITMAN COLLEGE                                             ","2003-2004",14,"Skiing",130264,130206,58,65132,65103,29,65132,65103,29,"10","20",44104,44104
"11256",215099,"PHILADELPHIA UNIVERSITY                                     ","2003-2004",22,"Tennis",100687,100630,57,50304,50004,300,50383,50626,-243,"10","11",3400,3400
"14706",216038,"SLIPPERY ROCK UNIVERSITY OF PENNSYLVANIA                    ","2003-2004",27,"Water Polo",65275,65218,57,27298,27384,-86,37977,37834,143,"14","17",10350,12423
"9755",152318,"ROSE-HULMAN INSTITUTE OF TECHNOLOGY                         ","2003-2004",16,"Softball",44056,44000,56,0,0,0,44056,44000,56,".","12",0,24050
"1240",228787,"THE UNIVERSITY OF TEXAS AT DALLAS                           ","2003-2004",1,"Baseball",29250,29195,55,29250,29195,55,0,0,0,"36",".",29137,0
"2277",149514,"TRINITY INTERNATIONAL UNIVERSITY                            ","2003-2004",2,"Basketball",407271,407217,54,247309,241104,6205,159962,166113,-6151,"16","12",30368,21138
"13313",180416,"MONTANA TECH OF THE UNIVERSITY OF MONTANA                   ","2003-2004",26,"Volleyball",144089,144036,53,0,0,0,144089,144036,53,"0","15",0,24744
"5906",145831,"ILLINOIS VALLEY COMMUNITY COLLEGE                           ","2003-2004",8,"Golf",3893,3842,51,3893,3842,51,0,0,0,"9",".",1,0
"5218",237358,"DAVIS AND ELKINS COLLEGE                                    ","2003-2004",8,"Golf",13065,13015,50,13065,13015,50,0,0,0,"5",".",8814,0
"10716",237358,"DAVIS AND ELKINS COLLEGE                                    ","2003-2004",22,"Tennis",15213,15163,50,10264,10214,50,4949,4949,0,"7","11",7081,2001
"10035",175421,"BELHAVEN COLLEGE                                            ","2003-2004",16,"Softball",102951,102903,48,0,0,0,102951,102903,48,".","15",0,19360
"9577",113980,"EL CAMINO COLLEGE                                           ","2003-2004",16,"Softball",23775,23732,43,0,0,0,23775,23732,43,".","14",0,10324
"1316",214379,"NORTHAMPTON COUNTY AREA COMMUNITY COLLEGE                   ","2003-2004",1,"Baseball",19427,19386,41,19427,19386,41,0,0,0,"20",".",8243,0
"783",173735,"HIBBING COMMUNITY COLLEGE-A TECH AND COMM COLL              ","2003-2004",1,"Baseball",34266,34226,40,34266,34226,40,0,0,0,"16",".",14346,0
"2272",229063,"TEXAS SOUTHERN UNIVERSITY                                   ","2003-2004",2,"Basketball",1083724,1083684,40,592667,592794,-127,491057,490890,167,"15","16",203876,166267
"5862",195234,"THE COLLEGE OF SAINT ROSE                                   ","2003-2004",8,"Golf",45196,45156,40,45196,45156,40,0,0,0,"8",".",10155,0
"9611",154013,"MOUNT MERCY COLLEGE                                         ","2003-2004",16,"Softball",15380,15340,40,0,0,0,15380,15340,40,".","9",0,13806
"12887",216296,"THADDEUS STEVENS COLLEGE OF TECHNOLOGY                      ","2003-2004",25,"Track and Field, X-Country",7850,7810,40,7850,7810,40,0,0,0,"1",".",4200,0
"9157",166391,"LASELL COLLEGE                                              ","2003-2004",16,"Softball",30534,30496,38,0,0,0,30534,30496,38,".","15",0,20061
"791",221519,"SEWANEE-THE UNIVERSITY OF THE SOUTH                         ","2003-2004",1,"Baseball",52671,52634,37,52671,52634,37,0,0,0,"20",".",26373,0
"3225",188526,"ALBANY COLLEGE OF PHARMACY                                  ","2003-2004",2,"Basketball",15300,15265,35,7000,6965,35,8300,8300,0,"12","11",6350,8210
"7320",153144,"COE COLLEGE                                                 ","2003-2004",15,"Soccer",44875,44840,35,20916,20916,0,23959,23924,35,"19","22",13956,13293
"9814",206941,"UNIVERSITY OF CENTRAL OKLAHOMA                              ","2003-2004",16,"Softball",15185,15150,35,0,0,0,15185,15150,35,".","26",0,11150
"8702",115001,"GLENDALE COMMUNITY COLLEGE                                  ","2003-2004",16,"Softball",16880,16846,34,0,0,0,16880,16846,34,".","13",0,5190
"10790",153278,"UNIVERSITY OF DUBUQUE                                       ","2003-2004",22,"Tennis",7170,7137,33,4765,4158,607,2405,2979,-574,"14","10",3067,1887
"2749",222822,"ANGELINA COLLEGE                                            ","2003-2004",2,"Basketball",348920,348890,30,191146,191146,0,157774,157744,30,"16","16",8700,5200
"5678",195030,"UNIVERSITY OF ROCHESTER                                     ","2003-2004",8,"Golf",26777,26747,30,26777,26747,30,0,0,0,"8",".",17201,0
"10965",219833,"CHRISTIAN BROTHERS UNIVERSITY                               ","2003-2004",22,"Tennis",5000,4972,28,2500,2457,43,2500,2515,-15,"7","7",2122,907
"6178",120342,"ORANGE COAST COLLEGE                                        ","2003-2004",8,"Golf",23713,23688,25,11749,11749,0,11964,11939,25,"8","7",11549,11443
"7200",147004,"MCHENRY COUNTY COLLEGE                                      ","2003-2004",15,"Soccer",28995,28970,25,28995,28970,25,0,0,0,"22",".",10918,0
"13076",192703,"MANHATTAN COLLEGE                                           ","2003-2004",26,"Volleyball",257935,257911,24,0,0,0,257935,257911,24,".","15",0,47727
"10340",173045,"AUGSBURG COLLEGE                                            ","2003-2004",18,"Swimming and Diving",17226,17206,20,0,0,0,17226,17206,20,".","7",0,9458
"12241",238980,"LAKELAND COLLEGE                                            ","2003-2004",25,"Track and Field, X-Country",3150,3130,20,1600,1565,35,1550,1565,-15,"4","4",565,565
"15123",210605,"COMMUNITY COLLEGE OF ALLEGHENY COUNTY                       ","2003-2004",29,"Other Sports",2000,1980,20,2000,1980,20,0,0,0,"18","0",1977,0
"11121",119164,"MT SAN ANTONIO COLLEGE                                      ","2003-2004",22,"Tennis",48001,47982,19,48001,47982,19,0,0,0,"9",".",3979,0
"14763",146427,"KNOX COLLEGE                                                ","2003-2004",28,"Wrestling",6393,6375,18,6393,6375,18,0,0,0,"11",".",3868,0
"3740",155201,"INDEPENDENCE COMMUNITY COLLEGE                              ","2003-2004",3,"All Track Combined",44878,44861,17,28850,28839,11,16028,16022,6,"18","10",11643,6469
"5153",180692,"THE UNIVERSITY OF MONTANA-WESTERN                           ","2003-2004",8,"Golf",37562,37546,16,18781,18773,8,18781,18773,8,"10","4",17598,17598
"11178",120342,"ORANGE COAST COLLEGE                                        ","2003-2004",22,"Tennis",47539,47523,16,23168,23558,-390,24371,23965,406,"10","8",23168,23371
"14971",199148,"UNIVERSITY OF NORTH CAROLINA AT GREENSBORO                  ","2003-2004",28,"Wrestling",243165,243151,14,243165,243151,14,0,0,0,"22",".",29687,0
"12542",127185,"FORT LEWIS COLLEGE                                          ","2003-2004",25,"Track and Field, X-Country",53096,53083,13,33842,33829,13,19254,19254,0,"11","10",7157,5383
"3586",168281,"WHEATON COLLEGE                                             ","2003-2004",3,"All Track Combined",193849,193839,10,98655,98655,0,95194,95184,10,"52","62",24097,16027
"5134",146278,"JOHN WOOD COMMUNITY COLLEGE                                 ","2003-2004",8,"Golf",11626,11616,10,11626,11616,10,0,0,0,"6",".",8642,0
"8412",232043,"EASTERN MENNONITE UNIVERSITY                                ","2003-2004",15,"Soccer",80635,80625,10,42443,42433,10,38192,38192,0,"21","17",1750,1750
"15136",141574,"UNIVERSITY OF HAWAII AT MANOA                               ","2003-2004",29,"Other Sports",55468,55458,10,19810,19818,-8,35658,35640,18,"10","19",14242,25634
"16064",168281,"WHEATON COLLEGE                                             ","2003-2004",39,"Total Participants",1100140,1100130,10,461323,461323,0,638817,638807,10,"187","207",209012,242520
"16379",232043,"EASTERN MENNONITE UNIVERSITY                                ","2003-2004",39,"Total Participants",333028,333018,10,166559,166549,10,166469,166469,0,"128","101",10284,11369
"16539",190637,"CUNY LEHMAN COLLEGE                                         ","2003-2004",39,"Total Participants",333354,333344,10,158915,158911,4,174439,174433,6,"87","84",65235,53893
"582",210234,"TREASURE VALLEY COMMUNITY COLLEGE                           ","2003-2004",1,"Baseball",36000,35992,8,36000,35992,8,0,0,0,"37",".",27000,0
"7749",212106,"DUQUESNE UNIVERSITY                                         ","2003-2004",15,"Soccer",811944,811937,7,387795,392260,-4465,424149,419677,4472,"24","26",61705,51235
"12915",364016,"PARADISE VALLEY COMMUNITY COLLEGE                           ","2003-2004",25,"Track and Field, X-Country",5942,5935,7,2971,2933,38,2971,3002,-31,"14","12",2914,2914
"3314",141237,"1TT-MCCONNELL COLLEGE                                       ","2003-2004",2,"Basketball",197648,197642,6,100669,100663,6,96979,96979,0,"14","10",20377,17183
"7117",150163,"BUTLER UNIVERSITY                                           ","2003-2004",15,"Soccer",659272,659266,6,347714,347714,0,311558,311552,6,"30","23",51022,39076
"15867",150163,"BUTLER UNIVERSITY                                           ","2003-2004",39,"Total Participants",3213091,3213085,6,1656949,1656949,0,1556142,1556136,6,"287","185",532556,328778
"5253",162122,"COLLEGE OF SOUTHERN MARYLAND                                ","2003-2004",8,"Golf",5936,5931,5,5936,5931,5,0,0,0,"5",".",2931,0
"5908",198507,"ELIZABETH CITY STATE UNIVERSITY                             ","2003-2004",8,"Golf",10384,10380,4,10384,10380,4,0,0,0,"8",".",10384,0
"332",167288,"MASSACHUSETTS COLLEGE OF LIBERAL ARTS                       ","2003-2004",1,"Baseball",57153,57150,3,57153,57150,3,0,0,0,"21",".",37702,0
"2031",168528,"ADRIAN COLLEGE                                              ","2003-2004",2,"Basketball",88818,88815,3,58505,58500,5,30313,30315,-2,"24","15",50700,30313
"4798",170301,"HOPE COLLEGE                                                ","2003-2004",7,"Football",245751,245748,3,245751,245748,3,0,0,0,"123",".",32574,0
"5332",157076,"KENTUCKY WESLEYAN COLLEGE                                   ","2003-2004",8,"Golf",35803,35800,3,35803,35800,3,0,0,0,"12",".",10124,0
"14080",147244,"MILLIKIN UNIVERSITY                                         ","2003-2004",26,"Volleyball",38528,38525,3,0,0,0,38528,38525,3,".","37",0,22682
"17214",147244,"MILLIKIN UNIVERSITY                                         ","2003-2004",39,"Total Participants",290426,290423,3,140923,140923,0,149503,149500,3,"357","228",162318,101571
"3829",203535,"KENYON COLLEGE                                              ","2003-2004",3,"All Track Combined",95731,95729,2,48373,48372,1,47358,47357,1,"42","54",19293,20142
"3958",192703,"MANHATTAN COLLEGE                                           ","2003-2004",3,"All Track Combined",864858,864856,2,427589,427588,1,437269,437268,1,"96","84",70426,58560
"5666",236896,"WALLA WALLA COLLEGE                                         ","2003-2004",8,"Golf",10887,10885,2,8165,8164,1,2722,2721,1,"7","1",6473,1030
"9781",237109,"YAKIMA VALLEY COMMUNITY COLLEGE                             ","2003-2004",16,"Softball",38409,38407,2,0,0,0,38409,38407,2,".","9",0,15977
"10668",190637,"CUNY LEHMAN COLLEGE                                         ","2003-2004",22,"Tennis",39064,39062,2,19231,19230,1,19833,19832,1,"9","8",2142,2743
"11106",148405,"ROCKFORD COLLEGE                                            ","2003-2004",22,"Tennis",13204,13202,2,5841,5840,1,7363,7362,1,"5","9",2559,1929
"11221",214379,"NORTHAMPTON COUNTY AREA COMMUNITY COLLEGE                   ","2003-2004",22,"Tennis",6930,6928,2,3465,3464,1,3465,3464,1,"4","4",1890,1890
"11762",130776,"WESTERN CONNECTICUT STATE UNIVERSITY                        ","2003-2004",22,"Tennis",27555,27553,2,14590,14588,2,12965,12965,0,"10","9",10198,8624
"14260",190637,"CUNY LEHMAN COLLEGE                                         ","2003-2004",26,"Volleyball",59206,59204,2,29576,29575,1,29630,29629,1,"9","8",6436,6791
"15076",147378,"MORAINE VALLEY COMMUNITY COLLEGE                            ","2003-2004",29,"Other Sports",8270,8268,2,4135,4134,1,4135,4134,1,"8","10",2589,2589
"15113",190637,"CUNY LEHMAN COLLEGE                                         ","2003-2004",29,"Other Sports",20035,20033,2,0,0,0,20035,20033,2,".","12",0,2945
"131",237950,"WEST VIRGINIA UNIVERSITY INSTITUTE OF TECHNOLOGY            ","2003-2004",1,"Baseball",31541,31540,1,31541,31540,1,0,0,0,"44",".",25892,0
"985",190637,"CUNY LEHMAN COLLEGE                                         ","2003-2004",1,"Baseball",40373,40372,1,40373,40372,1,0,0,0,"24",".",16216,0
"1356",159568,"LOUISIANA COLLEGE                                           ","2003-2004",1,"Baseball",79031,79030,1,79031,79030,1,0,0,0,"32",".",36835,0
"1399",203535,"KENYON COLLEGE                                              ","2003-2004",1,"Baseball",81643,81642,1,81643,81642,1,0,0,0,"18",".",41728,0
"1911",186034,"PASSAIC COUNTY COMMUNITY COLLEGE                            ","2003-2004",2,"Basketball",68567,68566,1,34301,34301,0,34266,34265,1,"11","7",25505,26192
"2079",190637,"CUNY LEHMAN COLLEGE                                         ","2003-2004",2,"Basketball",125715,125714,1,69421,69421,0,56294,56293,1,"15","9",19791,12618
"3512",190637,"CUNY LEHMAN COLLEGE                                         ","2003-2004",3,"All Track Combined",90993,90992,1,46035,46034,1,44958,44958,0,"13","20",14216,13324
"4052",211291,"BUCKNELL UNIVERSITY                                         ","2003-2004",6,"Field hocky",353779,353778,1,0,0,0,353779,353778,1,".","23",0,58985
"4241",161165,"HUSSON COLLEGE                                              ","2003-2004",6,"Field hocky",20193,20192,1,0,0,0,20193,20192,1,".","19",0,16074
"5252",204857,"OHIO UNIVERSITY-MAIN CAMPUS                                 ","2003-2004",8,"Golf",284733,284732,1,122209,122208,1,162524,162524,0,"11","9",39640,33274
"5288",150677,"GRACE COLLEGE AND THEOLOGICAL SEMINARY                      ","2003-2004",8,"Golf",14494,14493,1,14494,14493,1,0,0,0,"7",".",4322,0
"5697",199069,"MOUNT OLIVE COLLEGE                                         ","2003-2004",8,"Golf",95356,95355,1,49790,49790,0,45566,45565,1,"7","4",12928,8897
"6087",100654,"ALABAMA A &amp; M UNIVERSITY                                    ","2003-2004",8,"Golf",60847,60846,1,41245,41243,2,19602,19603,-1,"8","7",14844,9933
"6213",146366,"KASKASKIA COLLEGE                                           ","2003-2004",8,"Golf",21132,21131,1,21132,21131,1,0,0,0,"7",".",11945,0
"6536",204857,"OHIO UNIVERSITY-MAIN CAMPUS                                 ","2003-2004",11,"Lacrosse",339485,339484,1,0,0,0,339485,339484,1,".","26",0,51770
"6939",192819,"MARIST COLLEGE                                              ","2003-2004",13,"Rowing",316193,316192,1,134253,134252,1,181940,181940,0,"59","52",76984,109296
"7903",214069,"COLLEGE MISERICORDIA                                        ","2003-2004",15,"Soccer",21256,21255,1,8581,8580,1,12675,12675,0,"37","26",5304,1854
"7926",139904,"GEORGIA MILITARY COLLEGE-MAIN CAMPUS                        ","2003-2004",15,"Soccer",28269,28268,1,6537,6536,1,21732,21732,0,"21","15",5026,4296
"7985",186034,"PASSAIC COUNTY COMMUNITY COLLEGE                            ","2003-2004",15,"Soccer",15927,15926,1,15927,15926,1,0,0,0,"14",".",10149,0
"8218",236896,"WALLA WALLA COLLEGE                                         ","2003-2004",15,"Soccer",17204,17203,1,17204,17203,1,0,0,0,"21",".",12310,0
"8339",219295,"PRESENTATION COLLEGE                                        ","2003-2004",15,"Soccer",81496,81495,1,40647,40647,0,40849,40848,1,"14","12",15893,15831
"8600",190637,"CUNY LEHMAN COLLEGE                                         ","2003-2004",16,"Softball",34604,34603,1,0,0,0,34604,34603,1,".","17",0,9178
"9566",100654,"ALABAMA A &amp; M UNIVERSITY                                    ","2003-2004",16,"Softball",182238,182237,1,0,0,0,182238,182237,1,".","14",0,71063
"10305",211291,"BUCKNELL UNIVERSITY                                         ","2003-2004",18,"Swimming and Diving",679832,679831,1,298508,298507,1,381324,381324,0,"26","33",48249,58933
"10611",153001,"BUENA VISTA UNIVERSITY                                      ","2003-2004",19,"Swimming",35870,35869,1,17629,17629,0,18241,18240,1,"9","12",7071,7613
"10623",190637,"CUNY LEHMAN COLLEGE                                         ","2003-2004",19,"Swimming",49079,49078,1,23700,23700,0,25379,25378,1,"17","10",6434,6294
"11366",100654,"ALABAMA A &amp; M UNIVERSITY                                    ","2003-2004",22,"Tennis",119256,119255,1,60451,60451,0,58805,58804,1,"6","5",7208,8862
"13139",192819,"MARIST COLLEGE                                              ","2003-2004",26,"Volleyball",193095,193094,1,0,0,0,193095,193094,1,".","14",0,26021
"13436",199281,"UNIVERSITY OF NORTH CAROLINA AT PEMBROKE                    ","2003-2004",26,"Volleyball",23997,23996,1,0,0,0,23997,23996,1,".","9",0,20756
"15311",229504,"VERNON COLLEGE                                              ","2003-2004",35,"Rodeo",104703,104702,1,104703,104702,1,0,0,0,"24",".",66712,0
"15553",186034,"PASSAIC COUNTY COMMUNITY COLLEGE                            ","2003-2004",39,"Total Participants",15927,15926,1,15927,15926,1,0,0,0,"25","7",35654,26192
"15981",139904,"GEORGIA MILITARY COLLEGE-MAIN CAMPUS                        ","2003-2004",39,"Total Participants",39716,39715,1,15600,15599,1,24116,24116,0,"105","21",100502,4859
"16024",219295,"PRESENTATION COLLEGE                                        ","2003-2004",39,"Total Participants",183891,183890,1,78709,78709,0,105182,105181,1,"46","51",61342,63516
"16052",229504,"VERNON COLLEGE                                              ","2003-2004",39,"Total Participants",329926,329925,1,177099,177098,1,152827,152827,0,"57","29",92642,49513
"16778",237950,"WEST VIRGINIA UNIVERSITY INSTITUTE OF TECHNOLOGY            ","2003-2004",39,"Total Participants",68259,68258,1,40949,40948,1,27310,27310,0,"156","56",116589,48231
"10",112190,"CITY COLLEGE OF SAN FRANCISCO                               ","2003-2004",1,"Baseball",16732,16732,0,16732,16732,0,0,0,0,"30",".",6376,0
"14",197294,"SUNY WESTCHESTER COMMMUNITY COLLEGE                         ","2003-2004",1,"Baseball",21104,21104,0,21104,21104,0,0,0,0,"24",".",7540,0
"19",213400,"LANCASTER BIBLE COLLEGE                                     ","2003-2004",1,"Baseball",10354,10354,0,10354,10354,0,0,0,0,"14",".",8439,0
"20",112260,"CLAREMONT MCKENNA COLLEGE                                   ","2003-2004",1,"Baseball",99146,99146,0,99146,99146,0,0,0,0,"31",".",28071,0
"21",165015,"BRANDEIS UNIVERSITY                                         ","2003-2004",1,"Baseball",123918,123918,0,123918,123918,0,0,0,0,"31",".",55423,0
"31",143288,"BLACKBURN COLLEGE                                           ","2003-2004",1,"Baseball",39622,39622,0,39622,39622,0,0,0,0,"19",".",21705,0
"36",112686,"COMPTON COMMUNITY COLLEGE                                   ","2003-2004",1,"Baseball",19000,19000,0,19000,19000,0,0,0,0,"40",".",10000,0
"38",213525,"LEHIGH CARBON COMMUNITY COLLEGE                             ","2003-2004",1,"Baseball",4000,4000,0,4000,4000,0,0,0,0,"12",".",840,0
"40",167905,"SPRINGFIELD TECHNICAL COMMUNITY COLLEGE                     ","2003-2004",1,"Baseball",13525,13525,0,13525,13525,0,0,0,0,"22",".",7525,0
"48",165112,"BUNKER HILL COMMUNITY COLLEGE                               ","2003-2004",1,"Baseball",19300,19300,0,19300,19300,0,0,0,0,"12",".",5368,0
"53",105428,"PHOENIX COLLEGE                                             ","2003-2004",1,"Baseball",79160,79160,0,79160,79160,0,0,0,0,"25",".",21460,0
"54",165334,"CLARK UNIVERSITY                                            ","2003-2004",1,"Baseball",36377,36377,0,36377,36377,0,0,0,0,"27",".",10805,0
"55",100760,"CENTRAL ALABAMA COMMUNITY COLLEGE                           ","2003-2004",1,"Baseball",78268,78268,0,78268,78268,0,0,0,0,"31",".",31279,0
"60",213598,"LINCOLN UNIVERSITY                                          ","2003-2004",1,"Baseball",7000,7000,0,7000,7000,0,0,0,0,"20",".",5000,0
"65",118718,"MERCED COLLEGE                                              ","2003-2004",1,"Baseball",19924,19924,0,19924,19924,0,0,0,0,"27",".",14224,0
"67",150163,"BUTLER UNIVERSITY                                           ","2003-2004",1,"Baseball",385354,385354,0,385354,385354,0,0,0,0,"30",".",47202,0
"70",219091,"DAKOTA WESLEYAN UNIVERSITY                                  ","2003-2004",1,"Baseball",132066,132066,0,132066,132066,0,0,0,0,"32",".",40715,0
"73",191533,"HARTWICK COLLEGE                                            ","2003-2004",1,"Baseball",33691,33691,0,33691,33691,0,0,0,0,"26",".",12841,0
"75",126748,"COLORADO NORTHWESTERN COMMUNITY COLLEGE                     ","2003-2004",1,"Baseball",132916,132916,0,132916,132916,0,0,0,0,"30",".",57034,0
"76",165574,"DEAN COLLEGE                                                ","2003-2004",1,"Baseball",39426,39426,0,39426,39426,0,0,0,0,"16",".",14626,0
"79",100937,"BIRMINGHAM SOUTHERN COLLEGE                                 ","2003-2004",1,"Baseball",705437,705437,0,705437,705437,0,0,0,0,"32",".",74865,0
"81",213659,"LUZERNE COUNTY COMMUNITY COLLEGE                            ","2003-2004",1,"Baseball",13000,13000,0,13000,13000,0,0,0,0,"18",".",9200,0
"94",165662,"EMERSON COLLEGE                                             ","2003-2004",1,"Baseball",14632,14632,0,14632,14632,0,0,0,0,"19",".",10653,0
"105",181853,"YORK COLLEGE                                                ","2003-2004",1,"Baseball",35420,35420,0,35420,35420,0,0,0,0,"24",".",15473,0
"107",168227,"WENTWORTH INSTITUTE OF TECHNOLOGY                           ","2003-2004",1,"Baseball",24405,24405,0,24405,24405,0,0,0,0,"23",".",11975,0
"108",101189,"FAULKNER UNIVERSITY                                         ","2003-2004",1,"Baseball",411182,411182,0,411182,411182,0,0,0,0,"33",".",110597,0
"110",150534,"UNIVERSITY OF EVANSVILLE                                    ","2003-2004",1,"Baseball",546772,546772,0,546772,546772,0,0,0,0,"37",".",123150,0
"112",237899,"WEST VIRGINIA STATE COLLEGE                                 ","2003-2004",1,"Baseball",110136,110136,0,110136,110136,0,0,0,0,"50",".",33027,0
"113",213826,"MARYWOOD UNIVERSITY                                         ","2003-2004",1,"Baseball",26343,26343,0,26343,26343,0,0,0,0,"19",".",14233,0
"130",140447,"MERCER UNIVERSITY                                           ","2003-2004",1,"Baseball",212921,212921,0,212921,212921,0,0,0,0,"35",".",61454,0
"133",229355,"TYLER JUNIOR COLLEGE                                        ","2003-2004",1,"Baseball",112993,112993,0,112993,112993,0,0,0,0,"37",".",45032,0
"137",101435,"HUNTINGDON COLLEGE                                          ","2003-2004",1,"Baseball",121209,121209,0,121209,121209,0,0,0,0,"31",".",48497,0
"138",213996,"MESSIAH COLLEGE                                             ","2003-2004",1,"Baseball",36605,36605,0,36605,36605,0,0,0,0,"25",".",26514,0
"141",229504,"VERNON COLLEGE                                              ","2003-2004",1,"Baseball",72396,72396,0,72396,72396,0,0,0,0,"33",".",25930,0
"147",101480,"JACKSONVILLE STATE UNIVERSITY                               ","2003-2004",1,"Baseball",414843,414843,0,414843,414843,0,0,0,0,"34",".",414842,0
"155",106467,"ARKANSAS TECH UNIVERSITY                                    ","2003-2004",1,"Baseball",164556,164556,0,164556,164556,0,0,0,0,"32",".",35899,0
"156",366395,"SUFFOLK COUNTY COMMUNITY COLLEGE                            ","2003-2004",1,"Baseball",34223,34223,0,34223,34223,0,0,0,0,"25",".",15650,0
"158",101499,"JEFFERSON DAVIS COMMUNITY COLLEGE                           ","2003-2004",1,"Baseball",96818,96818,0,96818,96818,0,0,0,0,"26",".",20000,0
"159",166027,"HARVARD UNIVERSITY                                          ","2003-2004",1,"Baseball",302258,302258,0,302258,302258,0,0,0,0,"74",".",130832,0
"160",140720,"PAINE COLLEGE                                               ","2003-2004",1,"Baseball",102140,102140,0,102140,102140,0,0,0,0,"24",".",26510,0
"163",101505,"JEFFERSON STATE COMMUNITY COLLEGE                           ","2003-2004",1,"Baseball",209279,209279,0,209279,209279,0,0,0,0,"27",".",63207,0
"165",214069,"COLLEGE MISERICORDIA                                        ","2003-2004",1,"Baseball",18878,18878,0,18878,18878,0,0,0,0,"25",".",6479,0
"167",196185,"SUNY COLLEGE AT ONEONTA                                     ","2003-2004",1,"Baseball",89505,89505,0,89505,89505,0,0,0,0,"24",".",15478,0
"168",174491,"NORTHWESTERN COLLEGE                                        ","2003-2004",1,"Baseball",31658,31658,0,31658,31658,0,0,0,0,"26",".",19833,0
"171",157058,"KENTUCKY STATE UNIVERSITY                                   ","2003-2004",1,"Baseball",44000,44000,0,44000,44000,0,0,0,0,"14",".",30000,0
"172",229841,"WHARTON COUNTY JUNIOR COLLEGE                               ","2003-2004",1,"Baseball",50817,50817,0,50817,50817,0,0,0,0,"28",".",29385,0
"174",222053,"VOLUNTEER STATE COMMUNITY COLLEGE                           ","2003-2004",1,"Baseball",181064,181064,0,181064,181064,0,0,0,0,"32",".",34802,0
"176",229887,"WILEY COLLEGE                                               ","2003-2004",1,"Baseball",48939,48939,0,48939,48939,0,0,0,0,"13",".",8880,0
"178",101602,"LURLEEN B WALLACE COMMUNITY COLLEGE-ANDALUSIA CAMPUS        ","2003-2004",1,"Baseball",144772,144772,0,144772,144772,0,0,0,0,"26",".",30625,0
"179",166124,"COLLEGE OF THE HOLY CROSS                                   ","2003-2004",1,"Baseball",100321,100321,0,100321,100321,0,0,0,0,"30",".",69633,0
"184",238333,"BELOIT COLLEGE                                              ","2003-2004",1,"Baseball",24737,24737,0,24737,24737,0,0,0,0,"29",".",24737,0
"185",128258,"TRINIDAD STATE JUNIOR COLLEGE                               ","2003-2004",1,"Baseball",87088,87088,0,87088,87088,0,0,0,0,"29",".",39355,0
"186",174738,"ROCHESTER COMMUNITY AND TECHNICAL COLLEGE                   ","2003-2004",1,"Baseball",31044,31044,0,31044,31044,0,0,0,0,"24",".",16427,0
"188",219790,"BRYAN COLLEGE                                               ","2003-2004",1,"Baseball",37434,37434,0,37434,37434,0,0,0,0,"18",".",36701,0
"189",206862,"SOUTHERN NAZARENE UNIVERSITY                                ","2003-2004",1,"Baseball",223197,223197,0,223197,223197,0,0,0,0,"30",".",36083,0
"190",192022,"JEFFERSON COMMUNITY COLLEGE                                 ","2003-2004",1,"Baseball",23800,23800,0,23800,23800,0,0,0,0,"23",".",10700,0
"196",182865,"HESSER COLLEGE                                              ","2003-2004",1,"Baseball",8589,8589,0,8589,8589,0,0,0,0,"12",".",2589,0
"198",192192,"KEUKA COLLEGE                                               ","2003-2004",1,"Baseball",25900,25900,0,25900,25900,0,0,0,0,"28",".",14900,0
"199",101709,"UNIVERSITY OF MONTEVALLO                                    ","2003-2004",1,"Baseball",141571,141571,0,141571,141571,0,0,0,0,"29",".",63990,0
"202",238458,"CARROLL COLLEGE                                             ","2003-2004",1,"Baseball",22848,22848,0,22848,22848,0,0,0,0,"24",".",5400,0
"206",101736,"NORTHWEST SHOALS COMMUNITY COLLEGE-MUSCLE SHOALS            ","2003-2004",1,"Baseball",34559,34559,0,34559,34559,0,0,0,0,"25",".",22100,0
"211",214272,"NEUMANN COLLEGE                                             ","2003-2004",1,"Baseball",42269,42269,0,42269,42269,0,0,0,0,"27",".",34470,0
"213",140997,"SOUTH GEORGIA COLLEGE                                       ","2003-2004",1,"Baseball",70028,70028,0,70028,70028,0,0,0,0,"25",".",29600,0
"215",101879,"UNIVERSITY OF NORTH ALABAMA                                 ","2003-2004",1,"Baseball",281306,281306,0,281306,281306,0,0,0,0,"33",".",45665,0
"216",196237,"SUNY COLLEGE AT OLD WESTBURY                                ","2003-2004",1,"Baseball",10000,10000,0,10000,10000,0,0,0,0,"25",".",7500,0
"224",238616,"CONCORDIA UNIVERSITY-WISCONSIN                              ","2003-2004",1,"Baseball",22045,22045,0,22045,22045,0,0,0,0,"34",".",12150,0
"225",101949,"ALABAMA SOUTHERN COMMUNITY COLLEGE                          ","2003-2004",1,"Baseball",100054,100054,0,100054,100054,0,0,0,0,"24",".",71224,0
"226",107512,"OUACHITA BAPTIST UNIVERSITY                                 ","2003-2004",1,"Baseball",196330,196330,0,196330,196330,0,0,0,0,"26",".",40313,0
"229",102030,"BISHOP STATE COMMUNITY COLLEGE                              ","2003-2004",1,"Baseball",58482,58482,0,58482,58482,0,0,0,0,"27",".",58482,0
"244",214625,"PENNSYLVANIA STATE UNIV-PENN STATE NEW KENSINGTON           ","2003-2004",1,"Baseball",12495,12495,0,12495,12495,0,0,0,0,"14",".",7936,0
"253",167729,"SALEM STATE COLLEGE                                         ","2003-2004",1,"Baseball",22746,22746,0,22746,22746,0,0,0,0,"24",".",12446,0
"254",141361,"YOUNG HARRIS COLLEGE                                        ","2003-2004",1,"Baseball",277172,277172,0,277172,277172,0,0,0,0,"37",".",74299,0
"255",239017,"LAWRENCE UNIVERSITY                                         ","2003-2004",1,"Baseball",65315,65315,0,65315,65315,0,0,0,0,"22",".",31955,0
"264",116439,"IRVINE VALLEY COLLEGE                                       ","2003-2004",1,"Baseball",49604,49604,0,49604,49604,0,0,0,0,"30",".",22000,0
"265",129242,"FAIRFIELD UNIVERSITY                                        ","2003-2004",1,"Baseball",200400,200400,0,200400,200400,0,0,0,0,"32",".",44432,0
"268",207281,"NORTHERN OKLAHOMA COLLEGE                                   ","2003-2004",1,"Baseball",90995,90995,0,90995,90995,0,0,0,0,"35",".",32954,0
"269",169248,"CENTRAL MICHIGAN UNIVERSITY                                 ","2003-2004",1,"Baseball",474087,474087,0,474087,474087,0,0,0,0,"39",".",99396,0
"274",141574,"UNIVERSITY OF HAWAII AT MANOA                               ","2003-2004",1,"Baseball",828098,828098,0,828098,828098,0,0,0,0,"34",".",233843,0
"287",166823,"MASSASOIT COMMUNITY COLLEGE                                 ","2003-2004",1,"Baseball",37445,37445,0,37445,37445,0,0,0,0,"20",".",25196,0
"290",141644,"HAWAII PACIFIC UNIVERSITY                                   ","2003-2004",1,"Baseball",360618,360618,0,360618,360618,0,0,0,0,"18",".",124600,0
"291",193016,"MERCY COLLEGE-MAIN CAMPUS                                   ","2003-2004",1,"Baseball",24500,24500,0,24500,24500,0,0,0,0,"21",".",10000,0
"300",193283,"MOHAWK VALLEY COMMUNITY COLLEGE-UTICA BRANCH                ","2003-2004",1,"Baseball",23284,23284,0,23284,23284,0,0,0,0,"27",".",13338,0
"301",214759,"PENNSYLVANIA STATE UNIVERSITY-PENN STATE FAYETTE            ","2003-2004",1,"Baseball",25785,25785,0,25785,25785,0,0,0,0,"15",".",6600,0
"304",117274,"LASSEN COMMUNITY COLLEGE                                    ","2003-2004",1,"Baseball",79301,79301,0,79301,79301,0,0,0,0,"48",".",30000,0
"305",214768,"PENNSYLVANIA STATE UNIVERSITY-PENN STATE HAZLETON           ","2003-2004",1,"Baseball",5100,5100,0,5100,5100,0,0,0,0,"15",".",3000,0
"306",230931,"LYNDON STATE COLLEGE                                        ","2003-2004",1,"Baseball",14236,14236,0,14236,14236,0,0,0,0,"20",".",7623,0
"315",183877,"BURLINGTON COUNTY COLLEGE                                   ","2003-2004",1,"Baseball",9325,9325,0,9325,9325,0,0,0,0,"24",".",44952,0
"319",233912,"VIRGINIA INTERMONT COLLEGE                                  ","2003-2004",1,"Baseball",29600,29600,0,29600,29600,0,0,0,0,"24",".",26612,0
"330",104160,"ARIZONA WESTERN COLLEGE                                     ","2003-2004",1,"Baseball",120729,120729,0,120729,120729,0,0,0,0,"22",".",45301,0
"334",158477,"CENTENARY COLLEGE OF LOUISIANA                              ","2003-2004",1,"Baseball",653197,653197,0,653197,653197,0,0,0,0,"35",".",149696,0
"335",117706,"LOS ANGELES PIERCE COLLEGE                                  ","2003-2004",1,"Baseball",35721,35721,0,35721,35721,0,0,0,0,"27",".",18017,0
"340",193353,"MOUNT SAINT MARY COLLEGE                                    ","2003-2004",1,"Baseball",27786,27786,0,27786,27786,0,0,0,0,"21",".",23835,0
"341",167358,"NORTHEASTERN UNIVERSITY                                     ","2003-2004",1,"Baseball",376700,376700,0,376700,376700,0,0,0,0,"28",".",34077,0
"343",216852,"WIDENER UNIVERSITY-MAIN CAMPUS                              ","2003-2004",1,"Baseball",30292,30292,0,30292,30292,0,0,0,0,"26",".",15102,0
"345",158662,"DELGADO COMMUNITY COLLEGE                                   ","2003-2004",1,"Baseball",134279,134279,0,134279,134279,0,0,0,0,"45",".",99279,0
"351",175652,"EAST MISSISSIPPI COMMUNITY COLLEGE                          ","2003-2004",1,"Baseball",64215,64215,0,64215,64215,0,0,0,0,"30",".",19929,0
"356",104425,"COCHISE COLLEGE                                             ","2003-2004",1,"Baseball",58150,58150,0,58150,58150,0,0,0,0,"24",".",29603,0
"357",130493,"SOUTHERN CONNECTICUT STATE UNIVERSITY                       ","2003-2004",1,"Baseball",190508,190508,0,190508,190508,0,0,0,0,"28",".",57164,0
"358",152567,"TRI-STATE UNIVERSITY                                        ","2003-2004",1,"Baseball",73064,73064,0,73064,73064,0,0,0,0,"43",".",15456,0
"361",104577,"EASTERN ARIZONA COLLEGE                                     ","2003-2004",1,"Baseball",114437,114437,0,114437,114437,0,0,0,0,"29",".",50098,0
"363",231086,"SOUTHERN VERMONT COLLEGE                                    ","2003-2004",1,"Baseball",16830,16830,0,16830,16830,0,0,0,0,"18",".",4127,0
"365",207722,"UNIVERSITY OF SCIENCE AND ARTS OF OKLAHOMA                  ","2003-2004",1,"Baseball",51594,51594,0,51594,51594,0,0,0,0,"38",".",28994,0
"369",130590,"TRINITY COLLEGE                                             ","2003-2004",1,"Baseball",94811,94811,0,94811,94811,0,0,0,0,"30",".",25260,0
"379",159416,"LOUISIANA STATE UNIVERSITY-SHREVEPORT                       ","2003-2004",1,"Baseball",239156,239156,0,239156,239156,0,0,0,0,"35",".",174156,0
"383",175856,"JACKSON STATE UNIVERSITY                                    ","2003-2004",1,"Baseball",238259,238259,0,238259,238259,0,0,0,0,"26",".",70872,0
"384",104717,"GRAND CANYON UNIVERSITY                                     ","2003-2004",1,"Baseball",436546,436546,0,436546,436546,0,0,0,0,"44",".",111990,0
"385",217156,"BROWN UNIVERSITY                                            ","2003-2004",1,"Baseball",182844,182844,0,182844,182844,0,0,0,0,"25",".",59114,0
"392",105154,"MESA COMMUNITY COLLEGE                                      ","2003-2004",1,"Baseball",32000,32000,0,32000,32000,0,0,0,0,"25",".",21400,0
"394",175883,"JONES COUNTY JUNIOR COLLEGE                                 ","2003-2004",1,"Baseball",122447,122447,0,122447,122447,0,0,0,0,"30",".",45981,0
"403",243586,"PONTIFICAL CATHOLIC UNIV OF PUERTO RICO-MAYAGUEZ            ","2003-2004",1,"Baseball",5429,5429,0,5429,5429,0,0,0,0,"16",".",2087,0
"407",184791,"GLOUCESTER COUNTY COLLEGE                                   ","2003-2004",1,"Baseball",54027,54027,0,54027,54027,0,0,0,0,"23",".",54027,0
"408",193973,"NIAGARA UNIVERSITY                                          ","2003-2004",1,"Baseball",292146,292146,0,292146,292146,0,0,0,0,"31",".",72229,0
"417",217235,"JOHNSON &amp; WALES UNIVERSITY                                  ","2003-2004",1,"Baseball",64858,64858,0,64858,64858,0,0,0,0,"23",".",52797,0
"420",176008,"MISSISSIPPI DELTA COMMUNITY COLLEGE                         ","2003-2004",1,"Baseball",88223,88223,0,88223,88223,0,0,0,0,"26",".",33299,0
"422",221485,"SOUTHWEST TENNESSEE COMMUNITY COLLEGE                       ","2003-2004",1,"Baseball",225938,225938,0,225938,225938,0,0,0,0,"34",".",66762,0
"427",144050,"UNIVERSITY OF CHICAGO                                       ","2003-2004",1,"Baseball",119123,119123,0,119123,119123,0,0,0,0,"24",".",45521,0
"439",105747,"SCOTTSDALE COMMUNITY COLLEGE                                ","2003-2004",1,"Baseball",26578,26578,0,26578,26578,0,0,0,0,"30",".",14600,0
"442",217420,"RHODE ISLAND COLLEGE                                        ","2003-2004",1,"Baseball",75428,75428,0,75428,75428,0,0,0,0,"31",".",52834,0
"443",130934,"DELAWARE STATE UNIVERSITY                                   ","2003-2004",1,"Baseball",224130,224130,0,224130,224130,0,0,0,0,"24",".",53918,0
"444",122658,"SAN JOAQUIN DELTA COLLEGE                                   ","2003-2004",1,"Baseball",35194,35194,0,35194,35194,0,0,0,0,"33",".",17532,0
"449",105792,"SOUTH MOUNTAIN COMMUNITY COLLEGE                            ","2003-2004",1,"Baseball",20688,20688,0,20688,20688,0,0,0,0,"30",".",10990,0
"450",135717,"MIAMI DADE COLLEGE                                          ","2003-2004",1,"Baseball",276775,276775,0,276775,276775,0,0,0,0,"23",".",21725,0
"451",168148,"TUFTS UNIVERSITY                                            ","2003-2004",1,"Baseball",59412,59412,0,59412,59412,0,0,0,0,"21",".",15600,0
"452",232025,"EMORY AND HENRY COLLEGE                                     ","2003-2004",1,"Baseball",15371,15371,0,15371,15371,0,0,0,0,"27",".",15252,0
"458",144564,"DANVILLE AREA COMMUNITY COLLEGE                             ","2003-2004",1,"Baseball",30357,30357,0,30357,30357,0,0,0,0,"23",".",30356,0
"459",106148,"YAVAPAI COLLEGE                                             ","2003-2004",1,"Baseball",195138,195138,0,195138,195138,0,0,0,0,"26",".",45285,0
"463",232043,"EASTERN MENNONITE UNIVERSITY                                ","2003-2004",1,"Baseball",42014,42014,0,42014,42014,0,0,0,0,"20",".",2650,0
"470",202523,"DENISON UNIVERSITY                                          ","2003-2004",1,"Baseball",100237,100237,0,100237,100237,0,0,0,0,"31",".",50406,0
"472",199643,"SHAW UNIVERSITY                                             ","2003-2004",1,"Baseball",158141,158141,0,158141,158141,0,0,0,0,"21",".",24226,0
"474",131098,"WESLEY COLLEGE                                              ","2003-2004",1,"Baseball",34448,34448,0,34448,34448,0,0,0,0,"24",".",22800,0
"479",215770,"SAINT JOSEPHS UNIVERSITY                                    ","2003-2004",1,"Baseball",328179,328179,0,328179,328179,0,0,0,0,"33",".",121672,0
"482",122791,"COLLEGE OF SAN MATEO                                        ","2003-2004",1,"Baseball",45144,45144,0,45144,45144,0,0,0,0,"31",".",14827,0
"490",215798,"SAINT VINCENT COLLEGE                                       ","2003-2004",1,"Baseball",191819,191819,0,191819,191819,0,0,0,0,"31",".",35251,0
"491",176239,"PEARL RIVER COMMUNITY COLLEGE                               ","2003-2004",1,"Baseball",115073,115073,0,115073,115073,0,0,0,0,"35",".",30387,0
"507",168281,"WHEATON COLLEGE                                             ","2003-2004",1,"Baseball",109810,109810,0,109810,109810,0,0,0,0,"32",".",57142,0
"514",195003,"ROCHESTER INSTITUTE OF TECHNOLOGY                           ","2003-2004",1,"Baseball",38996,38996,0,38996,38996,0,0,0,0,"25",".",28235,0
"515",199926,"WILKES COMMUNITY COLLEGE                                    ","2003-2004",1,"Baseball",38204,38204,0,38204,38204,0,0,0,0,"28",".",1364,0
"523",144971,"EUREKA COLLEGE                                              ","2003-2004",1,"Baseball",18813,18813,0,18813,18813,0,0,0,0,"16",".",11313,0
"524",120254,"OCCIDENTAL COLLEGE                                          ","2003-2004",1,"Baseball",97826,97826,0,97826,97826,0,0,0,0,"24",".",27106,0
"526",156745,"GEORGETOWN COLLEGE                                          ","2003-2004",1,"Baseball",116531,116531,0,116531,116531,0,0,0,0,"40",".",22441,0
"528",106485,"UNIVERSITY OF ARKANSAS AT MONTICELLO                        ","2003-2004",1,"Baseball",106834,106834,0,106834,106834,0,0,0,0,"34",".",30796,0
"537",176628,"AVILA UNIVERSITY                                            ","2003-2004",1,"Baseball",185308,185308,0,185308,185308,0,0,0,0,"38",".",54112,0
"539",217776,"SOUTHERN WESLEYAN UNIVERSITY                                ","2003-2004",1,"Baseball",121453,121453,0,121453,121453,0,0,0,0,"24",".",33198,0
"553",155070,"BARCLAY COLLEGE                                             ","2003-2004",1,"Baseball",2225,2225,0,2225,2225,0,0,0,0,"18",".",1225,0
"559",195173,"ST FRANCIS COLLEGE                                          ","2003-2004",1,"Baseball",167784,167784,0,167784,167784,0,0,0,0,"28",".",49728,0
"562",222822,"ANGELINA COLLEGE                                            ","2003-2004",1,"Baseball",178023,178023,0,178023,178023,0,0,0,0,"26",".",5000,0
"566",137281,"SAINT JOHNS RIVER COMMUNITY COLLEGE                         ","2003-2004",1,"Baseball",80309,80309,0,80309,80309,0,0,0,0,"23",".",32485,0
"569",176965,"CENTRAL MISSOURI STATE UNIVERSITY                           ","2003-2004",1,"Baseball",398892,398892,0,398892,398892,0,0,0,0,"34",".",128861,0
"570",107080,"HENDRIX COLLEGE                                             ","2003-2004",1,"Baseball",69600,69600,0,69600,69600,0,0,0,0,"13",".",32500,0
"574",186432,"SAINT PETERS COLLEGE                                        ","2003-2004",1,"Baseball",255071,255071,0,255071,255071,0,0,0,0,"27",".",50991,0
"578",200217,"UNIVERSITY OF MARY                                          ","2003-2004",1,"Baseball",183433,183433,0,183433,183433,0,0,0,0,"37",".",34834,0
"581",145646,"ILLINOIS WESLEYAN UNIVERSITY                                ","2003-2004",1,"Baseball",76081,76081,0,76081,76081,0,0,0,0,"34",".",28390,0
"586",107460,"NORTH ARKANSAS COLLEGE                                      ","2003-2004",1,"Baseball",25584,25584,0,25584,25584,0,0,0,0,"37",".",8389,0
"588",216339,"TEMPLE UNIVERSITY                                           ","2003-2004",1,"Baseball",345577,345577,0,345577,345577,0,0,0,0,"42",".",92964,0
"592",145682,"ILLINOIS CENTRAL COLLEGE                                    ","2003-2004",1,"Baseball",85085,85085,0,85085,85085,0,0,0,0,"34",".",29397,0
"600",145691,"ILLINOIS COLLEGE                                            ","2003-2004",1,"Baseball",62630,62630,0,62630,62630,0,0,0,0,"35",".",32022,0
"602",121044,"PASADENA CITY COLLEGE                                       ","2003-2004",1,"Baseball",26430,26430,0,26430,26430,0,0,0,0,"26",".",4000,0
"604",123554,"SAINT MARYS COLLEGE OF CALIFORNIA                           ","2003-2004",1,"Baseball",572200,572200,0,572200,572200,0,0,0,0,"36",".",83962,0
"607",186867,"STEVENS INSTITUTE OF TECHNOLOGY                             ","2003-2004",1,"Baseball",92855,92855,0,92855,92855,0,0,0,0,"19",".",39473,0
"608",177339,"EVANGEL UNIVERSITY                                          ","2003-2004",1,"Baseball",219462,219462,0,219462,219462,0,0,0,0,"30",".",36700,0
"613",190619,"CUNY KINGSBOROUGH COMMUNITY COLLEGE                         ","2003-2004",1,"Baseball",17526,17526,0,17526,17526,0,0,0,0,"22",".",10556,0
"614",195322,"SCHENECTADY COUNTY COMMUNITY COLLEGE                        ","2003-2004",1,"Baseball",36490,36490,0,36490,36490,0,0,0,0,"18",".",23750,0
"615",132851,"CENTRAL FLORIDA COMMUNITY COLLEGE                           ","2003-2004",1,"Baseball",158250,158250,0,158250,158250,0,0,0,0,"27",".",26350,0
"616",146612,"LEWIS UNIVERSITY                                            ","2003-2004",1,"Baseball",308654,308654,0,308654,308654,0,0,0,0,"40",".",97723,0
"619",195474,"SIENA COLLEGE                                               ","2003-2004",1,"Baseball",420922,420922,0,420922,420922,0,0,0,0,"26",".",156333,0
"624",242671,"INTER AMERICAN UNIV OF PUERTO RICO-CENTRAL OFFICE           ","2003-2004",1,"Baseball",54955,54955,0,54955,54955,0,0,0,0,"22",".",15800,0
"629",187134,"THE COLLEGE OF NEW JERSEY                                   ","2003-2004",1,"Baseball",91569,91569,0,91569,91569,0,0,0,0,"41",".",17579,0
"632",155292,"KANSAS CITY KANSAS COMMUNITY COLLEGE                        ","2003-2004",1,"Baseball",89900,89900,0,89900,89900,0,0,0,0,"23",".",31900,0
"633",214689,"PENNSYLVANIA STATE UNIVERSITY-PENN STATE ALTOONA            ","2003-2004",1,"Baseball",42822,42822,0,42822,42822,0,0,0,0,"30",".",30602,0
"639",173045,"AUGSBURG COLLEGE                                            ","2003-2004",1,"Baseball",53411,53411,0,53411,53411,0,0,0,0,"34",".",39998,0
"645",210605,"COMMUNITY COLLEGE OF ALLEGHENY COUNTY                       ","2003-2004",1,"Baseball",44471,44471,0,44471,44471,0,0,0,0,"61",".",30720,0
"646",200572,"VALLEY CITY STATE UNIVERSITY                                ","2003-2004",1,"Baseball",27604,27604,0,27604,27604,0,0,0,0,"24",".",20980,0
"653",154013,"MOUNT MERCY COLLEGE                                         ","2003-2004",1,"Baseball",18370,18370,0,18370,18370,0,0,0,0,"35",".",16857,0
"658",173124,"BEMIDJI STATE UNIVERSITY                                    ","2003-2004",1,"Baseball",67608,67608,0,67608,67608,0,0,0,0,"40",".",25101,0
"666",124113,"TAFT COLLEGE                                                ","2003-2004",1,"Baseball",22955,22955,0,22955,22955,0,0,0,0,"25",".",15924,0
"681",110051,"BETHANY COLLEGE OF THE ASSEMBLIES OF GOD                    ","2003-2004",1,"Baseball",152813,152813,0,152813,152813,0,0,0,0,"16",".",19053,0
"696",133702,"FLORIDA COMMUNITY COLLEGE AT JACKSONVILLE                   ","2003-2004",1,"Baseball",213937,213937,0,213937,213937,0,0,0,0,"28",".",102860,0
"699",154235,"SAINT AMBROSE UNIVERSITY                                    ","2003-2004",1,"Baseball",194481,194481,0,194481,194481,0,0,0,0,"40",".",18849,0
"704",146472,"COLLEGE OF LAKE COUNTY                                      ","2003-2004",1,"Baseball",21264,21264,0,21264,21264,0,0,0,0,"20",".",16114,0
"705",149532,"TRITON COLLEGE                                              ","2003-2004",1,"Baseball",38708,38708,0,38708,38708,0,0,0,0,"25",".",16691,0
"707",237109,"YAKIMA VALLEY COMMUNITY COLLEGE                             ","2003-2004",1,"Baseball",52765,52765,0,52765,52765,0,0,0,0,"25",".",28045,0
"709",204857,"OHIO UNIVERSITY-MAIN CAMPUS                                 ","2003-2004",1,"Baseball",457328,457328,0,457328,457328,0,0,0,0,"35",".",78887,0
"717",170055,"GRAND RAPIDS COMMUNITY COLLEGE                              ","2003-2004",1,"Baseball",89638,89638,0,89638,89638,0,0,0,0,"32",".",30600,0
"720",243212,"UNIVERSITY OF PUERTO RICO-PONCE                             ","2003-2004",1,"Baseball",23150,23150,0,23150,23150,0,0,0,0,"20",".",6620,0
"723",146506,"LAKE LAND COLLEGE                                           ","2003-2004",1,"Baseball",60384,60384,0,60384,60384,0,0,0,0,"28",".",23032,0
"728",110404,"CALIFORNIA INSTITUTE OF TECHNOLOGY                          ","2003-2004",1,"Baseball",38211,38211,0,38211,38211,0,0,0,0,"15",".",3854,0
"729",146603,"LEWIS AND CLARK COMMUNITY COLLEGE                           ","2003-2004",1,"Baseball",54304,54304,0,54304,54304,0,0,0,0,"31",".",17125,0
"733",154493,"UPPER IOWA UNIVERSITY                                       ","2003-2004",1,"Baseball",175164,175164,0,175164,175164,0,0,0,0,"39",".",66936,0
"735",196042,"FARMINGDALE STATE UNIVERSITY OF NEW YORK                    ","2003-2004",1,"Baseball",33500,33500,0,33500,33500,0,0,0,0,"26",".",18000,0
"736",162283,"COPPIN STATE COLLEGE                                        ","2003-2004",1,"Baseball",137009,137009,0,137009,137009,0,0,0,0,"19",".",39034,0
"741",234155,"VIRGINIA STATE UNIVERSITY                                   ","2003-2004",1,"Baseball",69456,69456,0,69456,69456,0,0,0,0,"21",".",25469,0
"743",162557,"FREDERICK COMMUNITY COLLEGE                                 ","2003-2004",1,"Baseball",11581,11581,0,11581,11581,0,0,0,0,"22",".",3515,0
"753",201858,"CINCINNATI BIBLE COLLEGE AND SEMINARY                       ","2003-2004",1,"Baseball",3797,3797,0,3797,3797,0,0,0,0,"14",".",3297,0
"754",205203,"UNIVERSITY OF RIO GRANDE                                    ","2003-2004",1,"Baseball",74364,74364,0,74364,74364,0,0,0,0,"56",".",16466,0
"758",243577,"UNIVERSIDAD POLITECNICA DE PUERTO RICO                      ","2003-2004",1,"Baseball",14000,14000,0,14000,14000,0,0,0,0,"20",".",1500,0
"759",215947,"SETON HILL UNIVERSITY                                       ","2003-2004",1,"Baseball",78009,78009,0,78009,78009,0,0,0,0,"40",".",39000,0
"760",234173,"VIRGINIA WESLEYAN COLLEGE                                   ","2003-2004",1,"Baseball",60507,60507,0,60507,60507,0,0,0,0,"33",".",21007,0
"761",126289,"ARAPAHOE COMMUNITY COLLEGE                                  ","2003-2004",1,"Baseball",88157,88157,0,88157,88157,0,0,0,0,"27",".",42376,0
"774",243601,"UNIVERSIDAD DEL TURABO                                      ","2003-2004",1,"Baseball",19892,19892,0,19892,19892,0,0,0,0,"19",".",6648,0
"778",154642,"ALLEN COUNTY COMMUNITY COLLEGE                              ","2003-2004",1,"Baseball",41946,41946,0,41946,41946,0,0,0,0,"26",".",23166,0
"780",189547,"BROOME COMMUNITY COLLEGE                                    ","2003-2004",1,"Baseball",16186,16186,0,16186,16186,0,0,0,0,"16",".",11225,0
"784",178624,"NORTHWEST MISSOURI STATE UNIVERSITY                         ","2003-2004",1,"Baseball",171839,171839,0,171839,171839,0,0,0,0,"37",".",20053,0
"785",162706,"HARFORD COMMUNITY COLLEGE                                   ","2003-2004",1,"Baseball",19829,19829,0,19829,19829,0,0,0,0,"18",".",3827,0
"789",156082,"WASHBURN UNIVERSITY OF TOPEKA                               ","2003-2004",1,"Baseball",33498,33498,0,33498,33498,0,0,0,0,"39",".",29842,0
"790",170657,"LANSING COMMUNITY COLLEGE                                   ","2003-2004",1,"Baseball",63621,63621,0,63621,63621,0,0,0,0,"25",".",24948,0
"801",178721,"PARK UNIVERSITY                                             ","2003-2004",1,"Baseball",142438,142438,0,142438,142438,0,0,0,0,"27",".",28351,0
"802",135160,"LAKE CITY COMMUNITY COLLEGE                                 ","2003-2004",1,"Baseball",183237,183237,0,183237,183237,0,0,0,0,"21",".",116109,0
"803",185509,"MERCER COUNTY COMMUNITY COLLEGE                             ","2003-2004",1,"Baseball",14000,14000,0,14000,14000,0,0,0,0,"25",".",14000,0
"805",147244,"MILLIKIN UNIVERSITY                                         ","2003-2004",1,"Baseball",31050,31050,0,31050,31050,0,0,0,0,"44",".",16870,0
"809",110538,"CALIFORNIA STATE UNIVERSITY-CHICO                           ","2003-2004",1,"Baseball",404924,404924,0,404924,404924,0,0,0,0,"35",".",168091,0
"813",170967,"ROCHESTER COLLEGE                                           ","2003-2004",1,"Baseball",54820,54820,0,54820,54820,0,0,0,0,"22",".",18770,0
"816",206437,"WALSH UNIVERSITY                                            ","2003-2004",1,"Baseball",53061,53061,0,53061,53061,0,0,0,0,"42",".",19239,0
"820",196121,"SUNY COLLEGE AT BROCKPORT                                   ","2003-2004",1,"Baseball",42797,42797,0,42797,42797,0,0,0,0,"24",".",24070,0
"829",147378,"MORAINE VALLEY COMMUNITY COLLEGE                            ","2003-2004",1,"Baseball",21872,21872,0,21872,21872,0,0,0,0,"25",".",14529,0
"830",136145,"NORTH FLORIDA COMMUNITY COLLEGE                             ","2003-2004",1,"Baseball",152156,152156,0,152156,152156,0,0,0,0,"24",".",35702,0
"834",204024,"MIAMI UNIVERSITY-OXFORD                                     ","2003-2004",1,"Baseball",617512,617512,0,617512,617512,0,0,0,0,"36",".",125462,0
"838",226806,"MIDLAND COLLEGE                                             ","2003-2004",1,"Baseball",169119,169119,0,169119,169119,0,0,0,0,"26",".",40451,0
"842",141237,"1TT-MCCONNELL COLLEGE                                       ","2003-2004",1,"Baseball",110116,110116,0,110116,110116,0,0,0,0,"20",".",36861,0
"845",154855,"CENTRAL CHRISTIAN COLLEGE OF KANSAS                         ","2003-2004",1,"Baseball",24988,24988,0,24988,24988,0,0,0,0,"23",".",15030,0
"848",251260,"SOUTHERN UNION STATE COMMUNITY COLLEGE                      ","2003-2004",1,"Baseball",237060,237060,0,237060,237060,0,0,0,0,"45",".",76021,0
"850",127389,"LAMAR COMMUNITY COLLEGE                                     ","2003-2004",1,"Baseball",166617,166617,0,166617,166617,0,0,0,0,"28",".",51144,0
"863",150668,"GOSHEN COLLEGE                                              ","2003-2004",1,"Baseball",78299,78299,0,78299,78299,0,0,0,0,"18",".",30988,0
"869",164447,"AMERICAN INTERNATIONAL COLLEGE                              ","2003-2004",1,"Baseball",43481,43481,0,43481,43481,0,0,0,0,"23",".",38506,0
"872",366252,"PENNSYLVANIA COLLEGE OF TECHNOLOGY                          ","2003-2004",1,"Baseball",32592,32592,0,32592,32592,0,0,0,0,"24",".",21456,0
"874",136358,"PALM BEACH COMMUNITY COLLEGE                                ","2003-2004",1,"Baseball",83967,83967,0,83967,83967,0,0,0,0,"24",".",37441,0
"879",154952,"COWLEY COUNTY COMMUNITY COLLEGE                             ","2003-2004",1,"Baseball",81637,81637,0,81637,81637,0,0,0,0,"24",".",30585,0
"884",203368,"JOHN CARROLL UNIVERSITY                                     ","2003-2004",1,"Baseball",42999,42999,0,42999,42999,0,0,0,0,"32",".",12194,0
"893",147800,"OAKTON COMMUNITY COLLEGE                                    ","2003-2004",1,"Baseball",11840,11840,0,11840,11840,0,0,0,0,"28",".",11839,0
"896",179715,"NORTH CENTRAL MISSOURI COLLEGE                              ","2003-2004",1,"Baseball",38425,38425,0,38425,38425,0,0,0,0,"21",".",14173,0
"899",227386,"PANOLA COLLEGE                                              ","2003-2004",1,"Baseball",187470,187470,0,187470,187470,0,0,0,0,"26",".",18000,0
"906",163851,"SALISBURY UNIVERSITY                                        ","2003-2004",1,"Baseball",27948,27948,0,27948,27948,0,0,0,0,"31",".",13318,0
"917",155414,"KANSAS WESLEYAN UNIVERSITY                                  ","2003-2004",1,"Baseball",47320,47320,0,47320,47320,0,0,0,0,"29",".",23163,0
"921",173160,"BETHEL COLLEGE                                              ","2003-2004",1,"Baseball",77428,77428,0,77428,77428,0,0,0,0,"34",".",47702,0
"926",227687,"RANGER COLLEGE                                              ","2003-2004",1,"Baseball",153819,153819,0,153819,153819,0,0,0,0,"29",".",13531,0
"933",155098,"FORT SCOTT COMMUNITY COLLEGE                                ","2003-2004",1,"Baseball",106078,106078,0,106078,106078,0,0,0,0,"36",".",22530,0
"935",203775,"MALONE COLLEGE                                              ","2003-2004",1,"Baseball",238947,238947,0,238947,238947,0,0,0,0,"27",".",76619,0
"936",137315,"SOUTH FLORIDA COMMUNITY COLLEGE                             ","2003-2004",1,"Baseball",157895,157895,0,157895,157895,0,0,0,0,"23",".",41739,0
"940",183026,"SOUTHERN NEW HAMPSHIRE UNIVERSITY                           ","2003-2004",1,"Baseball",237719,237719,0,237719,237719,0,0,0,0,"27",".",84866,0
"942",148335,"ROBERT MORRIS COLLEGE                                       ","2003-2004",1,"Baseball",327622,327622,0,327622,327622,0,0,0,0,"32",".",53346,0
"949",192439,"LONG ISLAND UNIVERSITY-BROOKLYN CAMPUS                      ","2003-2004",1,"Baseball",373339,373339,0,373339,373339,0,0,0,0,"22",".",92348,0
"959",157359,"MID-CONTINENT COLLEGE                                       ","2003-2004",1,"Baseball",166609,166609,0,166609,166609,0,0,0,0,"24",".",19773,0
"960",200253,"MINOT STATE UNIVERSITY                                      ","2003-2004",1,"Baseball",27525,27525,0,27525,27525,0,0,0,0,"33",".",21666,0
"966",196291,"SUNY MARITIME COLLEGE                                       ","2003-2004",1,"Baseball",28683,28683,0,28683,28683,0,0,0,0,"28",".",20683,0
"970",204185,"MOUNT UNION COLLEGE                                         ","2003-2004",1,"Baseball",64575,64575,0,64575,64575,0,0,0,0,"48",".",22805,0
"972",174899,"THE COLLEGE OF SAINT SCHOLASTICA                            ","2003-2004",1,"Baseball",108017,108017,0,108017,108017,0,0,0,0,"32",".",47170,0
"973",166647,"MASSACHUSETTS BAY COMMUNITY COLLEGE                         ","2003-2004",1,"Baseball",14893,14893,0,14893,14893,0,0,0,0,"21",".",7893,0
"988",148627,"SAINT XAVIER UNIVERSITY                                     ","2003-2004",1,"Baseball",136301,136301,0,136301,136301,0,0,0,0,"24",".",53801,0
"989",183099,"NEW HAMPSHIRE TECHNICAL INSTITUTE                           ","2003-2004",1,"Baseball",8000,8000,0,8000,8000,0,0,0,0,"18",".",4500,0
"996",157535,"PIKEVILLE COLLEGE                                           ","2003-2004",1,"Baseball",52031,52031,0,52031,52031,0,0,0,0,"25",".",21009,0
"999",172963,"ANOKA-RAMSEY COMMUNITY COLLEGE-COON RAPIDS CAMPUS           ","2003-2004",1,"Baseball",17660,17660,0,17660,17660,0,0,0,0,"18",".",7411,0
"1002",148672,"SAUK VALLEY COMMUNITY COLLEGE                               ","2003-2004",1,"Baseball",41309,41309,0,41309,41309,0,0,0,0,"19",".",12919,0
"1007",129525,"UNIVERSITY OF HARTFORD                                      ","2003-2004",1,"Baseball",431225,431225,0,431225,431225,0,0,0,0,"28",".",86346,0
"1014",133492,"ECKERD COLLEGE                                              ","2003-2004",1,"Baseball",286191,286191,0,286191,286191,0,0,0,0,"28",".",46217,0
"1020",183743,"BERGEN COMMUNITY COLLEGE                                    ","2003-2004",1,"Baseball",22480,22480,0,22480,22480,0,0,0,0,"26",".",14000,0
"1022",220473,"JOHNSON BIBLE COLLEGE                                       ","2003-2004",1,"Baseball",11610,11610,0,11610,11610,0,0,0,0,"15",".",3874,0
"1025",117247,"LANEY COLLEGE                                               ","2003-2004",1,"Baseball",36238,36238,0,36238,36238,0,0,0,0,"30",".",36210,0
"1027",157818,"TRANSYLVANIA UNIVERSITY                                     ","2003-2004",1,"Baseball",88778,88778,0,88778,88778,0,0,0,0,"20",".",37587,0
"1028",111887,"CERRITOS COLLEGE                                            ","2003-2004",1,"Baseball",60498,60498,0,60498,60498,0,0,0,0,"25",".",9318,0
"1037",180984,"CONCORDIA UNIVERSITY                                        ","2003-2004",1,"Baseball",72974,72974,0,72974,72974,0,0,0,0,"25",".",13200,0
"1041",111896,"CERRO COSO COMMUNITY COLLEGE                                ","2003-2004",1,"Baseball",66146,66146,0,66146,66146,0,0,0,0,"22",".",39566,0
"1042",130891,"DELAWARE TECHNICAL AND COMMUNITY COLLEGE-OWENS              ","2003-2004",1,"Baseball",115560,115560,0,115560,115560,0,0,0,0,"26",".",28080,0
"1044",111920,"CHABOT COLLEGE                                              ","2003-2004",1,"Baseball",4700,4700,0,4700,4700,0,0,0,0,"40",".",8120,0
"1049",149365,"SOUTH SUBURBAN COLLEGE                                      ","2003-2004",1,"Baseball",42000,42000,0,42000,42000,0,0,0,0,"27",".",32471,0
"1050",183910,"CALDWELL COLLEGE                                            ","2003-2004",1,"Baseball",127813,127813,0,127813,127813,0,0,0,0,"22",".",42194,0
"1053",173203,"CENTRAL LAKES COLLEGE-BRAINERD                              ","2003-2004",1,"Baseball",14730,14730,0,14730,14730,0,0,0,0,"20",".",7908,0
"1055",149505,"TRINITY CHRISTIAN COLLEGE                                   ","2003-2004",1,"Baseball",36500,36500,0,36500,36500,0,0,0,0,"16",".",24100,0
"1059",138947,"CLARK ATLANTA UNIVERSITY                                    ","2003-2004",1,"Baseball",103000,103000,0,103000,103000,0,0,0,0,"12",".",40000,0
"1060",173258,"CARLETON COLLEGE                                            ","2003-2004",1,"Baseball",44780,44780,0,44780,44780,0,0,0,0,"20",".",19047,0
"1063",190770,"DOWLING COLLEGE                                             ","2003-2004",1,"Baseball",267129,267129,0,267129,267129,0,0,0,0,"25",".",76453,0
"1064",130253,"SACRED HEART UNIVERSITY                                     ","2003-2004",1,"Baseball",282180,282180,0,282180,282180,0,0,0,0,"54",".",75311,0
"1070",197133,"VASSAR COLLEGE                                              ","2003-2004",1,"Baseball",64582,64582,0,64582,64582,0,0,0,0,"25",".",23314,0
"1072",213358,"LA ROCHE COLLEGE                                            ","2003-2004",1,"Baseball",19537,19537,0,19537,19537,0,0,0,0,"27",".",10750,0
"1074",125499,"WEST VALLEY COLLEGE                                         ","2003-2004",1,"Baseball",24400,24400,0,24400,24400,0,0,0,0,"25",".",4000,0
"1079",181127,"HASTINGS COLLEGE                                            ","2003-2004",1,"Baseball",534824,534824,0,534824,534824,0,0,0,0,"70",".",25573,0
"1083",130396,"GATEWAY COMMUNITY COLLEGE                                   ","2003-2004",1,"Baseball",14000,14000,0,14000,14000,0,0,0,0,"16",".",4950,0
"1084",182005,"COMMUNITY COLLEGE OF SOUTHERN NEVADA                        ","2003-2004",1,"Baseball",250000,250000,0,250000,250000,0,0,0,0,"24",".",130000,0
"1085",139205,"BREWTON-PARKER COLLEGE                                      ","2003-2004",1,"Baseball",235357,235357,0,235357,235357,0,0,0,0,"24",".",64617,0
"1087",204909,"OHIO WESLEYAN UNIVERSITY                                    ","2003-2004",1,"Baseball",117853,117853,0,117853,117853,0,0,0,0,"32",".",41884,0
"1089",212832,"GWYNEDD MERCY COLLEGE                                       ","2003-2004",1,"Baseball",26560,26560,0,26560,26560,0,0,0,0,"32",".",16560,0
"1096",175810,"HOLMES COMMUNITY COLLEGE                                    ","2003-2004",1,"Baseball",89739,89739,0,89739,89739,0,0,0,0,"24",".",42082,0
"1101",227146,"NAVARRO COLLEGE                                             ","2003-2004",1,"Baseball",181488,181488,0,181488,181488,0,0,0,0,"26",".",31951,0
"1109",153311,"EASTERN IOWA COMMUNITY COLLEGE DISTRICT                     ","2003-2004",1,"Baseball",70968,70968,0,70968,70968,0,0,0,0,"23",".",18431,0
"1110",149842,"WILLIAM RAINEY HARPER COLLEGE                               ","2003-2004",1,"Baseball",49050,49050,0,49050,49050,0,0,0,0,"23",".",35903,0
"1111",156541,"CUMBERLAND COLLEGE                                          ","2003-2004",1,"Baseball",237497,237497,0,237497,237497,0,0,0,0,"28",".",14196,0
"1114",173638,"MINNESOTA WEST COMMUNITY AND TECHNICAL COLLEGE              ","2003-2004",1,"Baseball",15572,15572,0,15572,15572,0,0,0,0,"19",".",8164,0
"1115",176354,"SOUTHWEST MISSISSIPPI COMMUNITY COLLEGE                     ","2003-2004",1,"Baseball",221957,221957,0,221957,221957,0,0,0,0,"25",".",39056,0
"1131",131450,"GALLAUDET UNIVERSITY                                        ","2003-2004",1,"Baseball",22884,22884,0,22884,22884,0,0,0,0,"19",".",18384,0
"1133",130776,"WESTERN CONNECTICUT STATE UNIVERSITY                        ","2003-2004",1,"Baseball",116084,116084,0,116084,116084,0,0,0,0,"30",".",26579,0
"1139",189459,"BRIARCLIFFE COLLEGE                                         ","2003-2004",1,"Baseball",283920,283920,0,283920,283920,0,0,0,0,"21",".",96240,0
"1140",122436,"UNIVERSITY OF SAN DIEGO                                     ","2003-2004",1,"Baseball",761892,761892,0,761892,761892,0,0,0,0,"30",".",159560,0
"1142",201973,"CLARK STATE COMMUNITY COLLEGE                               ","2003-2004",1,"Baseball",26558,26558,0,26558,26558,0,0,0,0,"15",".",12183,0
"1143",113096,"COSUMNES RIVER COLLEGE                                      ","2003-2004",1,"Baseball",33425,33425,0,33425,33425,0,0,0,0,"24",".",32850,0
"1144",206817,"BACONE COLLEGE                                              ","2003-2004",1,"Baseball",285000,285000,0,285000,285000,0,0,0,0,"27",".",44191,0
"1145",209612,"PACIFIC UNIVERSITY                                          ","2003-2004",1,"Baseball",71635,71635,0,71635,71635,0,0,0,0,"26",".",56428,0
"1146",221397,"ROANE STATE COMMUNITY COLLEGE                               ","2003-2004",1,"Baseball",77185,77185,0,77185,77185,0,0,0,0,"26",".",19238,0
"1161",181534,"PERU STATE COLLEGE                                          ","2003-2004",1,"Baseball",71326,71326,0,71326,71326,0,0,0,0,"33",".",9988,0
"1170",154712,"BENEDICTINE COLLEGE                                         ","2003-2004",1,"Baseball",452318,452318,0,452318,452318,0,0,0,0,"62",".",38679,0
"1171",237640,"OHIO VALLEY COLLEGE                                         ","2003-2004",1,"Baseball",92142,92142,0,92142,92142,0,0,0,0,"37",".",12104,0
"1174",150172,"CALUMET COLLEGE OF SAINT JOSEPH                             ","2003-2004",1,"Baseball",41355,41355,0,41355,41355,0,0,0,0,"34",".",24555,0
"1182",219198,"MOUNT MARTY COLLEGE                                         ","2003-2004",1,"Baseball",98622,98622,0,98622,98622,0,0,0,0,"24",".",19595,0
"1202",123527,"SAN BERNARDINO VALLEY COLLEGE                               ","2003-2004",1,"Baseball",20353,20353,0,20353,20353,0,0,0,0,"21",".",13453,0
"1211",190600,"CUNY JOHN JAY COLLEGE CRIMINAL JUSTICE                      ","2003-2004",1,"Baseball",47427,47427,0,47427,47427,0,0,0,0,"24",".",35422,0
"1218",183080,"PLYMOUTH STATE UNIVERSITY                                   ","2003-2004",1,"Baseball",102489,102489,0,102489,102489,0,0,0,0,"24",".",35938,0
"1219",113856,"EAST LOS ANGELES COLLEGE                                    ","2003-2004",1,"Baseball",10300,10300,0,10300,10300,0,0,0,0,"28",".",4914,0
"1222",198835,"LENOIR-RHYNE COLLEGE                                        ","2003-2004",1,"Baseball",271010,271010,0,271010,271010,0,0,0,0,"51",".",104092,0
"1228",227191,"NORTH LAKE COLLEGE                                          ","2003-2004",1,"Baseball",77884,77884,0,77884,77884,0,0,0,0,"24",".",30000,0
"1230",207847,"SOUTHEASTERN OKLAHOMA STATE UNIVERSITY                      ","2003-2004",1,"Baseball",101403,101403,0,101403,101403,0,0,0,0,"30",".",21832,0
"1231",127565,"METROPOLITAN STATE COLLEGE OF DENVER                        ","2003-2004",1,"Baseball",210572,210572,0,210572,210572,0,0,0,0,"35",".",51368,0
"1233",220978,"MIDDLE TENNESSEE STATE UNIVERSITY                           ","2003-2004",1,"Baseball",440468,440468,0,440468,440468,0,0,0,0,"38",".",161177,0
"1234",122375,"SAN DIEGO MESA COLLEGE                                      ","2003-2004",1,"Baseball",28357,28357,0,28357,28357,0,0,0,0,"27",".",10435,0
"1241",221953,"TUSCULUM COLLEGE                                            ","2003-2004",1,"Baseball",261833,261833,0,261833,261833,0,0,0,0,"51",".",63793,0
"1243",192819,"MARIST COLLEGE                                              ","2003-2004",1,"Baseball",394538,394538,0,394538,394538,0,0,0,0,"33",".",113065,0
"1244",204264,"MUSKINGUM COLLEGE                                           ","2003-2004",1,"Baseball",30326,30326,0,30326,30326,0,0,0,0,"38",".",30032,0
"1249",136473,"PENSACOLA JUNIOR COLLEGE                                    ","2003-2004",1,"Baseball",161844,161844,0,161844,161844,0,0,0,0,"25",".",42000,0
"1255",175236,"RIDGEWATER COLLEGE                                          ","2003-2004",1,"Baseball",26734,26734,0,26734,26734,0,0,0,0,"24",".",12700,0
"1259",186283,"RIDER UNIVERSITY                                            ","2003-2004",1,"Baseball",445457,445457,0,445457,445457,0,0,0,0,"39",".",82437,0
"1261",136950,"ROLLINS COLLEGE                                             ","2003-2004",1,"Baseball",474085,474085,0,474085,474085,0,0,0,0,"37",".",110044,0
"1268",217475,"COMMUNITY COLLEGE OF RHODE ISLAND                           ","2003-2004",1,"Baseball",28000,28000,0,28000,28000,0,0,0,0,"16",".",22400,0
"1286",153533,"IOWA LAKES COMMUNITY COLLEGE                                ","2003-2004",1,"Baseball",57531,57531,0,57531,57531,0,0,0,0,"25",".",17235,0
"1291",208646,"EASTERN OREGON UNIVERSITY                                   ","2003-2004",1,"Baseball",74920,74920,0,74920,74920,0,0,0,0,"37",".",31506,0
"1294",243179,"UNIVERSITY OF PUERTO RICO-HUMACAO                           ","2003-2004",1,"Baseball",10247,10247,0,10247,10247,0,0,0,0,"20",".",7267,0
"1297",154101,"NORTHWESTERN COLLEGE                                        ","2003-2004",1,"Baseball",80707,80707,0,80707,80707,0,0,0,0,"25",".",25764,0
"1302",210155,"SOUTHWESTERN OREGON COMMUNITY COLLEGE                       ","2003-2004",1,"Baseball",60321,60321,0,60321,60321,0,0,0,0,"15",".",38901,0
"1307",174914,"UNIVERSITY OF ST THOMAS                                     ","2003-2004",1,"Baseball",95842,95842,0,95842,95842,0,0,0,0,"54",".",49403,0
"1315",115296,"GROSSMONT COLLEGE                                           ","2003-2004",1,"Baseball",51522,51522,0,51522,51522,0,0,0,0,"30",".",22517,0
"1317",177144,"CULVER-STOCKTON COLLEGE                                     ","2003-2004",1,"Baseball",92079,92079,0,92079,92079,0,0,0,0,"44",".",60188,0
"1318",184205,"CUMBERLAND COUNTY COLLEGE                                   ","2003-2004",1,"Baseball",29920,29920,0,29920,29920,0,0,0,0,"18",".",12270,0
"1320",190840,"DUTCHESS COMMUNITY COLLEGE                                  ","2003-2004",1,"Baseball",16000,16000,0,16000,16000,0,0,0,0,"20",".",7000,0
"1324",154800,"BUTLER COUNTY COMMUNITY COLLEGE                             ","2003-2004",1,"Baseball",181876,181876,0,181876,181876,0,0,0,0,"31",".",29737,0
"1331",186645,"RARITAN VALLEY COMMUNITY COLLEGE                            ","2003-2004",1,"Baseball",15792,15792,0,15792,15792,0,0,0,0,"10",".",5960,0
"1333",132693,"BREVARD COMMUNITY COLLEGE-COCOA CAMPUS                      ","2003-2004",1,"Baseball",63000,63000,0,63000,63000,0,0,0,0,"23",".",12000,0
"1335",155195,"HUTCHINSON COMMUNITY COLLEGE                                ","2003-2004",1,"Baseball",73810,73810,0,73810,73810,0,0,0,0,"28",".",22500,0
"1341",168786,"AQUINAS COLLEGE                                             ","2003-2004",1,"Baseball",44000,44000,0,44000,44000,0,0,0,0,"34",".",43996,0
"1357",225575,"HUSTON-TILLOTSON COLLEGE                                    ","2003-2004",1,"Baseball",34998,34998,0,34998,34998,0,0,0,0,"26",".",17048,0
"1363",177551,"HARRIS-STOWE STATE COLLEGE                                  ","2003-2004",1,"Baseball",42344,42344,0,42344,42344,0,0,0,0,"18",".",11091,0
"1370",205443,"SHAWNEE STATE UNIVERSITY                                    ","2003-2004",1,"Baseball",54919,54919,0,54919,54919,0,0,0,0,"26",".",31639,0
"1371",166133,"HOLYOKE COMMUNITY COLLEGE                                   ","2003-2004",1,"Baseball",9000,9000,0,9000,9000,0,0,0,0,"14",".",2600,0
"1376",161004,"BOWDOIN COLLEGE                                             ","2003-2004",1,"Baseball",64266,64266,0,64266,64266,0,0,0,0,"33",".",20274,0
"1378",190664,"CUNY QUEENS COLLEGE                                         ","2003-2004",1,"Baseball",64631,64631,0,64631,64631,0,0,0,0,"28",".",18741,0
"1391",138691,"DARTON COLLEGE                                              ","2003-2004",1,"Baseball",120532,120532,0,120532,120532,0,0,0,0,"35",".",20628,0
"1395",133553,"EMBRY RIDDLE AERONAUTICAL UNIVERSITY-DAYTONA BEACH          ","2003-2004",1,"Baseball",331806,331806,0,331806,331806,0,0,0,0,"23",".",303448,0
"1396",161563,"THOMAS COLLEGE                                              ","2003-2004",1,"Baseball",57001,57001,0,57001,57001,0,0,0,0,"34",".",48998,0
"1403",189705,"CANISIUS COLLEGE                                            ","2003-2004",1,"Baseball",190270,190270,0,190270,190270,0,0,0,0,"29",".",57593,0
"1404",200226,"MAYVILLE STATE UNIVERSITY                                   ","2003-2004",1,"Baseball",53305,53305,0,53305,53305,0,0,0,0,"31",".",51394,0
"1408",133021,"CHIPOLA COLLEGE                                             ","2003-2004",1,"Baseball",177673,177673,0,177673,177673,0,0,0,0,"22",".",36665,0
"1415",125091,"VICTOR VALLEY COLLEGE                                       ","2003-2004",1,"Baseball",31860,31860,0,31860,31860,0,0,0,0,"21",".",6932,0
"1418",126775,"COLORADO SCHOOL OF MINES                                    ","2003-2004",1,"Baseball",96243,96243,0,96243,96243,0,0,0,0,"33",".",47744,0
"1436",214801,"PENNSYLVANIA STATE UNIVERSITY-PENN STATE ABINGTON           ","2003-2004",1,"Baseball",15636,15636,0,15636,15636,0,0,0,0,"20",".",7545,0
"1438",218724,"COASTAL CAROLINA UNIVERSITY                                 ","2003-2004",1,"Baseball",541971,541971,0,541971,541971,0,0,0,0,"39",".",139501,0
"1439",212674,"GETTYSBURG COLLEGE                                          ","2003-2004",1,"Baseball",64888,64888,0,64888,64888,0,0,0,0,"27",".",16338,0
"1440",133809,"FLORIDA COLLEGE                                             ","2003-2004",1,"Baseball",155234,155234,0,155234,155234,0,0,0,0,"25",".",34966,0
"1449",218539,"PRESBYTERIAN COLLEGE                                        ","2003-2004",1,"Baseball",280258,280258,0,280258,280258,0,0,0,0,"42",".",92939,0
"1450",193478,"NASSAU COMMUNITY COLLEGE                                    ","2003-2004",1,"Baseball",27270,27270,0,27270,27270,0,0,0,0,"24",".",14335,0
"1452",154378,"SOUTHEASTERN COMMUNITY COLLEGE                              ","2003-2004",1,"Baseball",72124,72124,0,72124,72124,0,0,0,0,"30",".",35312,0
"1458",202134,"CLEVELAND STATE UNIVERSITY                                  ","2003-2004",1,"Baseball",323131,323131,0,323131,323131,0,0,0,0,"38",".",72268,0
"1466",210669,"ALLEGHENY COLLEGE                                           ","2003-2004",1,"Baseball",74727,74727,0,74727,74727,0,0,0,0,"31",".",39186,0
"1474",161077,"CENTRAL MAINE COMMUNITY COLLEGE                             ","2003-2004",1,"Baseball",11000,11000,0,11000,11000,0,0,0,0,"17",".",10000,0
"1476",188465,"GLOBE INSTITUTE OF TECHNOLOGY                               ","2003-2004",1,"Baseball",133392,133392,0,133392,133392,0,0,0,0,"17",".",77034,0
"1481",137476,"SAINT THOMAS UNIVERSITY                                     ","2003-2004",1,"Baseball",243690,243690,0,243690,243690,0,0,0,0,"48",".",43200,0
"1485",187198,"UNION COUNTY COLLEGE                                        ","2003-2004",1,"Baseball",39000,39000,0,39000,39000,0,0,0,0,"18",".",25000,0
"1488",136400,"PASCO-HERNANDO COMMUNITY COLLEGE                            ","2003-2004",1,"Baseball",111073,111073,0,111073,111073,0,0,0,0,"19",".",10032,0
"1498",212911,"HAVERFORD COLLEGE                                           ","2003-2004",1,"Baseball",28488,28488,0,28488,28488,0,0,0,0,"32",".",25472,0
"1500",138868,"ATLANTA CHRISTIAN COLLEGE                                   ","2003-2004",1,"Baseball",14600,14600,0,14600,14600,0,0,0,0,"18",".",14500,0
"1518",119067,"MONTEREY PENINSULA COLLEGE                                  ","2003-2004",1,"Baseball",30358,30358,0,30358,30358,0,0,0,0,"25",".",18325,0
"1523",183938,"CAMDEN COUNTY COLLEGE                                       ","2003-2004",1,"Baseball",55369,55369,0,55369,55369,0,0,0,0,"19",".",15280,0
"1524",161864,"BALTIMORE CITY COMMUNITY COLLEGE                            ","2003-2004",1,"Baseball",29850,29850,0,29850,29850,0,0,0,0,"15",".",19850,0
"1525",185536,"MIDDLESEX COUNTY COLLEGE                                    ","2003-2004",1,"Baseball",26477,26477,0,26477,26477,0,0,0,0,"26",".",13391,0
"1529",226471,"UNIVERSITY OF MARY HARDIN-BAYLOR                            ","2003-2004",1,"Baseball",96055,96055,0,96055,96055,0,0,0,0,"34",".",41162,0
"1532",166638,"UNIVERSITY OF MASSACHUSETTS-BOSTON                          ","2003-2004",1,"Baseball",45144,45144,0,45144,45144,0,0,0,0,"22",".",32278,0
"1538",218399,"MORRIS COLLEGE                                              ","2003-2004",1,"Baseball",28718,28718,0,28718,28718,0,0,0,0,"11",".",23050,0
"1539",237932,"WEST LIBERTY STATE COLLEGE                                  ","2003-2004",1,"Baseball",47599,47599,0,47599,47599,0,0,0,0,"25",".",8698,0
"1541",235103,"EDMONDS COMMUNITY COLLEGE                                   ","2003-2004",1,"Baseball",31258,31258,0,31258,31258,0,0,0,0,"22",".",16177,0
"1545",223922,"CLARENDON COLLEGE                                           ","2003-2004",1,"Baseball",94580,94580,0,94580,94580,0,0,0,0,"35",".",32480,0
"1552",136233,"OKALOOSA-WALTON COMMUNITY COLLEGE                           ","2003-2004",1,"Baseball",30370,30370,0,30370,30370,0,0,0,0,"21",".",10000,0
"1553",133386,"DAYTONA BEACH COMMUNITY COLLEGE                             ","2003-2004",1,"Baseball",32433,32433,0,32433,32433,0,0,0,0,"25",".",28997,0
"1554",177418,"FONTBONNE UNIVERSITY                                        ","2003-2004",1,"Baseball",26908,26908,0,26908,26908,0,0,0,0,"19",".",15068,0
"1561",123509,"SKYLINE COLLEGE                                             ","2003-2004",1,"Baseball",25731,25731,0,25731,25731,0,0,0,0,"28",".",25732,0
"1563",218061,"FRANCIS MARION UNIVERSITY                                   ","2003-2004",1,"Baseball",169848,169848,0,169848,169848,0,0,0,0,"35",".",32561,0
"1569",135391,"MANATEE COMMUNITY COLLEGE                                   ","2003-2004",1,"Baseball",130812,130812,0,130812,130812,0,0,0,0,"25",".",67088,0
"1571",210775,"ALVERNIA COLLEGE                                            ","2003-2004",1,"Baseball",21791,21791,0,21791,21791,0,0,0,0,"27",".",11236,0
"1580",137759,"TALLAHASSEE COMMUNITY COLLEGE                               ","2003-2004",1,"Baseball",191167,191167,0,191167,191167,0,0,0,0,"24",".",51702,0
"1582",219295,"PRESENTATION COLLEGE                                        ","2003-2004",1,"Baseball",24834,24834,0,24834,24834,0,0,0,0,"11",".",13342,0
"1586",134343,"GULF COAST COMMUNITY COLLEGE                                ","2003-2004",1,"Baseball",199333,199333,0,199333,199333,0,0,0,0,"22",".",36389,0
"1588",222983,"AUSTIN COLLEGE                                              ","2003-2004",1,"Baseball",63163,63163,0,63163,63163,0,0,0,0,"29",".",28080,0
"1595",102030,"BISHOP STATE COMMUNITY COLLEGE                              ","2003-2004",2,"Basketball",77976,77976,0,38988,38988,0,38988,38988,0,"18","18",38988,38988
"1601",157535,"PIKEVILLE COLLEGE                                           ","2003-2004",2,"Basketball",269380,269380,0,162711,162711,0,106669,106669,0,"22","15",66703,43838
"1603",155186,"HIGHLAND COMMUNITY COLLEGE                                  ","2003-2004",2,"Basketball",145835,145835,0,77981,77981,0,67854,67854,0,"16","13",29744,28723
"1605",165662,"EMERSON COLLEGE                                             ","2003-2004",2,"Basketball",130578,130578,0,45884,45884,0,84694,84694,0,"9","8",7719,7533
"1608",175652,"EAST MISSISSIPPI COMMUNITY COLLEGE                          ","2003-2004",2,"Basketball",117884,117884,0,51509,51509,0,66375,66375,0,"15","15",11476,9409
"1609",143288,"BLACKBURN COLLEGE                                           ","2003-2004",2,"Basketball",80772,80772,0,37407,37407,0,43365,43365,0,"16","11",15240,15933
"1612",104717,"GRAND CANYON UNIVERSITY                                     ","2003-2004",2,"Basketball",608176,608176,0,315839,315839,0,292337,292337,0,"11","12",54017,66106
"1616",232043,"EASTERN MENNONITE UNIVERSITY                                ","2003-2004",2,"Basketball",144731,144731,0,73793,73793,0,70938,70938,0,"14","9",3750,5625
"1617",168227,"WENTWORTH INSTITUTE OF TECHNOLOGY                           ","2003-2004",2,"Basketball",149864,149864,0,83403,83403,0,66461,66461,0,"15","10",18383,14458
"1618",101480,"JACKSONVILLE STATE UNIVERSITY                               ","2003-2004",2,"Basketball",1029775,1029775,0,531530,531530,0,498245,498245,0,"18","16",531529,498244
"1624",243577,"UNIVERSIDAD POLITECNICA DE PUERTO RICO                      ","2003-2004",2,"Basketball",12000,12000,0,12000,12000,0,0,0,0,"12",".",1000,0
"1627",168607,"ALPENA COMMUNITY COLLEGE                                    ","2003-2004",2,"Basketball",67059,67059,0,33606,33606,0,33453,33453,0,"13","10",21413,21260
"1635",194028,"NORTH COUNTRY COMMUNITY COLLEGE                             ","2003-2004",2,"Basketball",54565,54565,0,35081,35081,0,19484,19484,0,"12","9",21420,6116
"1641",213525,"LEHIGH CARBON COMMUNITY COLLEGE                             ","2003-2004",2,"Basketball",9500,9500,0,5000,5000,0,4500,4500,0,"15","8",960,160
"1642",230931,"LYNDON STATE COLLEGE                                        ","2003-2004",2,"Basketball",36537,36537,0,21949,21949,0,14588,14588,0,"14","11",10286,10688
"1645",199315,"PIEDMONT BAPTIST COLLEGE                                    ","2003-2004",2,"Basketball",23732,23732,0,23732,23732,0,0,0,0,"12","0",19382,0
"1648",219091,"DAKOTA WESLEYAN UNIVERSITY                                  ","2003-2004",2,"Basketball",304011,304011,0,160773,160773,0,143238,143238,0,"29","21",36954,38425
"1651",196565,"TOMPKINS-CORTLAND COMMUNITY COLLEGE                         ","2003-2004",2,"Basketball",31055,31055,0,15615,15615,0,15440,15440,0,"13","11",10100,9970
"1654",128258,"TRINIDAD STATE JUNIOR COLLEGE                               ","2003-2004",2,"Basketball",79510,79510,0,79510,79510,0,0,0,0,"11",".",39802,0
"1657",251260,"SOUTHERN UNION STATE COMMUNITY COLLEGE                      ","2003-2004",2,"Basketball",213353,213353,0,124456,124456,0,88897,88897,0,"14","14",39990,28220
"1659",219790,"BRYAN COLLEGE                                               ","2003-2004",2,"Basketball",50167,50167,0,25278,25278,0,24889,24889,0,"14","13",23608,23482
"1663",243212,"UNIVERSITY OF PUERTO RICO-PONCE                             ","2003-2004",2,"Basketball",23735,23735,0,13345,13345,0,10390,10390,0,"13","10",1885,1600
"1665",116439,"IRVINE VALLEY COLLEGE                                       ","2003-2004",2,"Basketball",77278,77278,0,39810,39810,0,37468,37468,0,"13","11",13571,12808
"1672",198233,"CATAWBA VALLEY COMMUNITY COLLEGE                            ","2003-2004",2,"Basketball",9018,9018,0,9018,9018,0,0,0,0,"10",".",9010,0
"1684",145682,"ILLINOIS CENTRAL COLLEGE                                    ","2003-2004",2,"Basketball",184633,184633,0,90325,90325,0,94308,94308,0,"16","10",27591,30060
"1690",199926,"WILKES COMMUNITY COLLEGE                                    ","2003-2004",2,"Basketball",32690,32690,0,13662,13662,0,19028,19028,0,"13","9",1051,2114
"1696",101499,"JEFFERSON DAVIS COMMUNITY COLLEGE                           ","2003-2004",2,"Basketball",58063,58063,0,58063,58063,0,0,0,0,"10",".",13500,0
"1697",100937,"BIRMINGHAM SOUTHERN COLLEGE                                 ","2003-2004",2,"Basketball",1612239,1612239,0,921770,921770,0,690469,690469,0,"16","15",113903,85703
"1698",132693,"BREVARD COMMUNITY COLLEGE-COCOA CAMPUS                      ","2003-2004",2,"Basketball",137690,137690,0,67100,67100,0,70590,70590,0,"12","11",11100,11950
"1701",155195,"HUTCHINSON COMMUNITY COLLEGE                                ","2003-2004",2,"Basketball",201266,201266,0,122913,122913,0,78353,78353,0,"12","13",57650,40860
"1702",214625,"PENNSYLVANIA STATE UNIV-PENN STATE NEW KENSINGTON           ","2003-2004",2,"Basketball",21518,21518,0,21518,21518,0,0,0,0,"8",".",19888,0
"1707",222053,"VOLUNTEER STATE COMMUNITY COLLEGE                           ","2003-2004",2,"Basketball",182951,182951,0,97381,97381,0,85570,85570,0,"16","14",26843,24599
"1708",169521,"DELTA COLLEGE                                               ","2003-2004",2,"Basketball",33938,33938,0,15721,15721,0,18217,18217,0,"11","8",7721,10217
"1709",228431,"STEPHEN F AUSTIN STATE UNIVERSITY                           ","2003-2004",2,"Basketball",1072209,1072209,0,541475,541475,0,530734,530734,0,"14","14",88825,98074
"1711",206817,"BACONE COLLEGE                                              ","2003-2004",2,"Basketball",490000,490000,0,280000,280000,0,210000,210000,0,"18","15",29361,28222
"1712",239017,"LAWRENCE UNIVERSITY                                         ","2003-2004",2,"Basketball",162607,162607,0,76467,76467,0,86140,86140,0,"18","16",38217,33890
"1719",213400,"LANCASTER BIBLE COLLEGE                                     ","2003-2004",2,"Basketball",40498,40498,0,21634,21634,0,18864,18864,0,"14","8",17119,15264
"1721",144050,"UNIVERSITY OF CHICAGO                                       ","2003-2004",2,"Basketball",336392,336392,0,176613,176613,0,159779,159779,0,"17","12",68833,60214
"1724",207281,"NORTHERN OKLAHOMA COLLEGE                                   ","2003-2004",2,"Basketball",197611,197611,0,113308,113308,0,84303,84303,0,"35","34",30476,40010
"1726",161484,"NORTHERN MAINE TECHNICAL COLLEGE                            ","2003-2004",2,"Basketball",11953,11953,0,10314,10314,0,1639,1639,0,"12","10",6792,767
"1746",168148,"TUFTS UNIVERSITY                                            ","2003-2004",2,"Basketball",103918,103918,0,58478,58478,0,45440,45440,0,"15","13",17700,16800
"1751",107141,"JOHN BROWN UNIVERSITY                                       ","2003-2004",2,"Basketball",657840,657840,0,333791,333791,0,324049,324049,0,"14","14",34128,30881
"1760",164447,"AMERICAN INTERNATIONAL COLLEGE                              ","2003-2004",2,"Basketball",122920,122920,0,61460,61460,0,61460,61460,0,"11","13",48876,51680
"1763",162760,"HOOD COLLEGE                                                ","2003-2004",2,"Basketball",64481,64481,0,43904,43904,0,20577,20577,0,"10","14",37407,14077
"1771",191533,"HARTWICK COLLEGE                                            ","2003-2004",2,"Basketball",199946,199946,0,95300,95300,0,104646,104646,0,"11","13",15757,17380
"1773",106467,"ARKANSAS TECH UNIVERSITY                                    ","2003-2004",2,"Basketball",613265,613265,0,256342,256342,0,356923,356923,0,"14","13",31452,71828
"1788",198835,"LENOIR-RHYNE COLLEGE                                        ","2003-2004",2,"Basketball",499020,499020,0,220325,220325,0,278695,278695,0,"15","18",128305,129858
"1792",117706,"LOS ANGELES PIERCE COLLEGE                                  ","2003-2004",2,"Basketball",80702,80702,0,40842,40842,0,39860,39860,0,"20","15",11375,13435
"1797",146472,"COLLEGE OF LAKE COUNTY                                      ","2003-2004",2,"Basketball",41544,41544,0,22668,22668,0,18876,18876,0,"15","11",17353,13561
"1805",181853,"YORK COLLEGE                                                ","2003-2004",2,"Basketball",61820,61820,0,30461,30461,0,31359,31359,0,"14","13",10909,10935
"1817",190725,"DAEMEN COLLEGE                                              ","2003-2004",2,"Basketball",381142,381142,0,213137,213137,0,168005,168005,0,"15","12",41051,41051
"1819",139250,"COASTAL GEORGIA COMMUNITY COLLEGE                           ","2003-2004",2,"Basketball",93973,93973,0,93973,93973,0,0,0,0,"12",".",89307,0
"1829",113096,"COSUMNES RIVER COLLEGE                                      ","2003-2004",2,"Basketball",35575,35575,0,13775,13775,0,21800,21800,0,"14","10",13400,21425
"1833",243346,"UNIVERSIDAD DEL ESTE                                        ","2003-2004",2,"Basketball",47507,47507,0,21492,21492,0,26015,26015,0,"12","12",17292,21815
"1834",150668,"GOSHEN COLLEGE                                              ","2003-2004",2,"Basketball",220265,220265,0,125844,125844,0,94421,94421,0,"14","11",24284,20148
"1841",175856,"JACKSON STATE UNIVERSITY                                    ","2003-2004",2,"Basketball",1009635,1009635,0,496610,496610,0,513025,513025,0,"15","17",244787,157557
"1843",122375,"SAN DIEGO MESA COLLEGE                                      ","2003-2004",2,"Basketball",49319,49319,0,23415,23415,0,25904,25904,0,"17","12",8187,8069
"1846",155292,"KANSAS CITY KANSAS COMMUNITY COLLEGE                        ","2003-2004",2,"Basketball",122400,122400,0,61200,61200,0,61200,61200,0,"11","10",26200,26200
"1853",154952,"COWLEY COUNTY COMMUNITY COLLEGE                             ","2003-2004",2,"Basketball",196572,196572,0,106701,106701,0,89871,89871,0,"16","16",27073,25871
"1858",112686,"COMPTON COMMUNITY COLLEGE                                   ","2003-2004",2,"Basketball",38000,38000,0,19000,19000,0,19000,19000,0,"15","15",10000,10000
"1869",196042,"FARMINGDALE STATE UNIVERSITY OF NEW YORK                    ","2003-2004",2,"Basketball",76100,76100,0,39800,39800,0,36300,36300,0,"22","14",24300,22800
"1871",101879,"UNIVERSITY OF NORTH ALABAMA                                 ","2003-2004",2,"Basketball",496404,496404,0,279134,279134,0,217270,217270,0,"18","11",31664,35282
"1878",243665,"UNIVERSITY OF THE VIRGIN ISLANDS                            ","2003-2004",2,"Basketball",1e+05,1e+05,0,40500,40500,0,59500,59500,0,"15","16",31000,43000
"1893",144157,"CITY COLLEGES OF CHICAGO-KENNEDY-KING COLLEGE               ","2003-2004",2,"Basketball",93683,93683,0,45167,45167,0,48516,48516,0,"16","13",33397,36016
"1900",130934,"DELAWARE STATE UNIVERSITY                                   ","2003-2004",2,"Basketball",1286655,1286655,0,755333,755333,0,531322,531322,0,"18","14",200861,123236
"1912",190770,"DOWLING COLLEGE                                             ","2003-2004",2,"Basketball",356024,356024,0,161682,161682,0,194342,194342,0,"13","11",31482,26476
"1924",101949,"ALABAMA SOUTHERN COMMUNITY COLLEGE                          ","2003-2004",2,"Basketball",167619,167619,0,87914,87914,0,79705,79705,0,"16","18",58464,54622
"1926",193399,"COLLEGE OF MOUNT SAINT VINCENT                              ","2003-2004",2,"Basketball",51135,51135,0,26665,26665,0,24470,24470,0,"14","10",15000,15000
"1931",226806,"MIDLAND COLLEGE                                             ","2003-2004",2,"Basketball",342032,342032,0,169920,169920,0,172112,172112,0,"14","11",33780,39502
"1933",130396,"GATEWAY COMMUNITY COLLEGE                                   ","2003-2004",2,"Basketball",35000,35000,0,19000,19000,0,16000,16000,0,"12","12",6360,6360
"1940",247834,"COLLIN COUNTY COMMUNITY COLLEGE DISTRICT                    ","2003-2004",2,"Basketball",160540,160540,0,91422,91422,0,69118,69118,0,"12","14",31226,30988
"1948",135717,"MIAMI DADE COLLEGE                                          ","2003-2004",2,"Basketball",328471,328471,0,164676,164676,0,163795,163795,0,"14","14",18333,16402
"1955",195474,"SIENA COLLEGE                                               ","2003-2004",2,"Basketball",2153189,2153189,0,1158553,1158553,0,994636,994636,0,"14","15",753781,343124
"1970",122977,"SANTA MONICA COLLEGE                                        ","2003-2004",2,"Basketball",62634,62634,0,31146,31146,0,31488,31488,0,"15","12",13146,13587
"1971",155900,"SOUTHWESTERN COLLEGE                                        ","2003-2004",2,"Basketball",163148,163148,0,83874,83874,0,79274,79274,0,"17","21",49747,43177
"1973",215947,"SETON HILL UNIVERSITY                                       ","2003-2004",2,"Basketball",171776,171776,0,103478,103478,0,68298,68298,0,"19","17",34000,32000
"1988",205966,"SOUTHERN STATE COMMUNITY COLLEGE                            ","2003-2004",2,"Basketball",37152,37152,0,18702,18702,0,18450,18450,0,"7","8",11702,11450
"1989",167987,"UNIVERSITY OF MASSACHUSETTS-DARTMOUTH                       ","2003-2004",2,"Basketball",123812,123812,0,76535,76535,0,47277,47277,0,"15","14",27829,20243
"1994",157058,"KENTUCKY STATE UNIVERSITY                                   ","2003-2004",2,"Basketball",402500,402500,0,201500,201500,0,201000,201000,0,"12","12",56500,56000
"1995",176628,"AVILA UNIVERSITY                                            ","2003-2004",2,"Basketball",310222,310222,0,174323,174323,0,135899,135899,0,"32","23",28164,25865
"1996",209612,"PACIFIC UNIVERSITY                                          ","2003-2004",2,"Basketball",140690,140690,0,74931,74931,0,65759,65759,0,"14","13",34445,30795
"2000",166124,"COLLEGE OF THE HOLY CROSS                                   ","2003-2004",2,"Basketball",2302184,2302184,0,1263623,1263623,0,1038561,1038561,0,"14","13",222281,196595
"2003",198084,"BRUNSWICK COMMUNITY COLLEGE                                 ","2003-2004",2,"Basketball",20117,20117,0,14112,14112,0,6005,6005,0,"13","10",11762,6005
"2004",170657,"LANSING COMMUNITY COLLEGE                                   ","2003-2004",2,"Basketball",131173,131173,0,82845,82845,0,48328,48328,0,"15","15",13684,15255
"2006",238333,"BELOIT COLLEGE                                              ","2003-2004",2,"Basketball",41594,41594,0,23282,23282,0,18312,18312,0,"14","12",23282,18312
"2017",130916,"DELAWARE TECHNICAL &amp; COMM COLL-STANTON-WILMINGTON           ","2003-2004",2,"Basketball",17744,17744,0,17744,17744,0,0,0,0,"11",".",11596,0
"2021",101709,"UNIVERSITY OF MONTEVALLO                                    ","2003-2004",2,"Basketball",335159,335159,0,188424,188424,0,146735,146735,0,"14","16",82044,41518
"2024",238458,"CARROLL COLLEGE                                             ","2003-2004",2,"Basketball",93494,93494,0,45709,45709,0,47785,47785,0,"17","16",20598,14787
"2029",107080,"HENDRIX COLLEGE                                             ","2003-2004",2,"Basketball",144700,144700,0,55600,55600,0,89100,89100,0,"14","15",28600,33100
"2032",219198,"MOUNT MARTY COLLEGE                                         ","2003-2004",2,"Basketball",270056,270056,0,137113,137113,0,132943,132943,0,"28","20",24223,24765
"2039",145646,"ILLINOIS WESLEYAN UNIVERSITY                                ","2003-2004",2,"Basketball",225006,225006,0,128159,128159,0,96847,96847,0,"15","17",37155,27165
"2047",136145,"NORTH FLORIDA COMMUNITY COLLEGE                             ","2003-2004",2,"Basketball",93216,93216,0,0,0,0,93216,93216,0,".","16",0,26812
"2062",190600,"CUNY JOHN JAY COLLEGE CRIMINAL JUSTICE                      ","2003-2004",2,"Basketball",59641,59641,0,35534,35534,0,24107,24107,0,"13","13",23261,15713
"2063",192466,"SOUTHAMPTON COLLEGE OF LONG ISLAND UNIVERSITY               ","2003-2004",2,"Basketball",365609,365609,0,187416,187416,0,178193,178193,0,"13","10",21394,19609
"2069",199768,"SURRY COMMUNITY COLLEGE                                     ","2003-2004",2,"Basketball",8010,8010,0,8010,8010,0,0,0,0,"10",".",6106,0
"2071",190619,"CUNY KINGSBOROUGH COMMUNITY COLLEGE                         ","2003-2004",2,"Basketball",33410,33410,0,17985,17985,0,15425,15425,0,"18","16",10838,10700
"2072",195322,"SCHENECTADY COUNTY COMMUNITY COLLEGE                        ","2003-2004",2,"Basketball",26491,26491,0,12727,12727,0,13764,13764,0,"13","6",12700,13600
"2081",242671,"INTER AMERICAN UNIV OF PUERTO RICO-CENTRAL OFFICE           ","2003-2004",2,"Basketball",68047,68047,0,44076,44076,0,23971,23971,0,"13","11",9420,9911
"2086",110714,"UNIVERSITY OF CALIFORNIA-SANTA CRUZ                         ","2003-2004",2,"Basketball",76276,76276,0,35761,35761,0,40515,40515,0,"12","14",23439,20564
"2088",136358,"PALM BEACH COMMUNITY COLLEGE                                ","2003-2004",2,"Basketball",187488,187488,0,83132,83132,0,104356,104356,0,"14","14",26318,21543
"2092",105154,"MESA COMMUNITY COLLEGE                                      ","2003-2004",2,"Basketball",128000,128000,0,66000,66000,0,62000,62000,0,"15","15",17200,18200
"2094",172963,"ANOKA-RAMSEY COMMUNITY COLLEGE-COON RAPIDS CAMPUS           ","2003-2004",2,"Basketball",40743,40743,0,19532,19532,0,21211,21211,0,"8","11",10274,11882
"2100",175157,"VERMILION COMMUNITY COLLEGE                                 ","2003-2004",2,"Basketball",39624,39624,0,26410,26410,0,13214,13214,0,"16","8",6120,301
"2104",136516,"POLK COMMUNITY COLLEGE                                      ","2003-2004",2,"Basketball",102277,102277,0,102277,102277,0,0,0,0,"14",".",62416,0
"2114",129774,"MITCHELL COLLEGE                                            ","2003-2004",2,"Basketball",132446,132446,0,73022,73022,0,59424,59424,0,"19","12",19076,22977
"2118",173124,"BEMIDJI STATE UNIVERSITY                                    ","2003-2004",2,"Basketball",402119,402119,0,195830,195830,0,206289,206289,0,"15","14",58186,53351
"2127",214768,"PENNSYLVANIA STATE UNIVERSITY-PENN STATE HAZLETON           ","2003-2004",2,"Basketball",20800,20800,0,10200,10200,0,10600,10600,0,"12","12",7200,8100
"2136",153533,"IOWA LAKES COMMUNITY COLLEGE                                ","2003-2004",2,"Basketball",117102,117102,0,59897,59897,0,57205,57205,0,"15","13",18208,18173
"2152",104160,"ARIZONA WESTERN COLLEGE                                     ","2003-2004",2,"Basketball",197776,197776,0,103983,103983,0,93793,93793,0,"14","14",44802,36167
"2154",183026,"SOUTHERN NEW HAMPSHIRE UNIVERSITY                           ","2003-2004",2,"Basketball",931009,931009,0,499355,499355,0,431654,431654,0,"12","13",102197,44244
"2158",130253,"SACRED HEART UNIVERSITY                                     ","2003-2004",2,"Basketball",1324567,1324567,0,685736,685736,0,638831,638831,0,"14","15",99324,86379
"2165",214801,"PENNSYLVANIA STATE UNIVERSITY-PENN STATE ABINGTON           ","2003-2004",2,"Basketball",40353,40353,0,24418,24418,0,15935,15935,0,"12","9",15488,8230
"2167",218724,"COASTAL CAROLINA UNIVERSITY                                 ","2003-2004",2,"Basketball",1112807,1112807,0,612015,612015,0,500792,500792,0,"16","14",172875,87544
"2173",181127,"HASTINGS COLLEGE                                            ","2003-2004",2,"Basketball",563852,563852,0,303577,303577,0,260275,260275,0,"29","20",27769,28625
"2179",215770,"SAINT JOSEPHS UNIVERSITY                                    ","2003-2004",2,"Basketball",4118680,4118680,0,2730454,2730454,0,1388226,1388226,0,"17","14",1296347,508990
"2188",231086,"SOUTHERN VERMONT COLLEGE                                    ","2003-2004",2,"Basketball",57014,57014,0,36818,36818,0,20196,20196,0,"15","10",23910,7541
"2189",110404,"CALIFORNIA INSTITUTE OF TECHNOLOGY                          ","2003-2004",2,"Basketball",93059,93059,0,51584,51584,0,41475,41475,0,"16","8",19378,11080
"2193",213385,"LAFAYETTE COLLEGE                                           ","2003-2004",2,"Basketball",1747823,1747823,0,937725,937725,0,810098,810098,0,"17","27",116401,80466
"2200",159416,"LOUISIANA STATE UNIVERSITY-SHREVEPORT                       ","2003-2004",2,"Basketball",345488,345488,0,173307,173307,0,172181,172181,0,"15","15",119307,114181
"2202",191126,"FASHION INSTITUTE OF TECHNOLOGY                             ","2003-2004",2,"Basketball",58932,58932,0,30713,30713,0,28219,28219,0,"13","15",19535,17040
"2225",195544,"SAINT JOSEPHS COLLEGE-MAIN CAMPUS                           ","2003-2004",2,"Basketball",123974,123974,0,60791,60791,0,63183,63183,0,"15","15",52000,52000
"2228",178448,"MOBERLY AREA COMMUNITY COLLEGE                              ","2003-2004",2,"Basketball",329703,329703,0,182936,182936,0,146767,146767,0,"15","11",26976,17745
"2237",201973,"CLARK STATE COMMUNITY COLLEGE                               ","2003-2004",2,"Basketball",68472,68472,0,33506,33506,0,34966,34966,0,"12","10",18211,15316
"2240",202134,"CLEVELAND STATE UNIVERSITY                                  ","2003-2004",2,"Basketball",1800954,1800954,0,1063622,1063622,0,737332,737332,0,"15","16",201060,129336
"2258",181534,"PERU STATE COLLEGE                                          ","2003-2004",2,"Basketball",157740,157740,0,79799,79799,0,77941,77941,0,"14","15",11787,12901
"2261",178721,"PARK UNIVERSITY                                             ","2003-2004",2,"Basketball",381759,381759,0,199779,199779,0,181980,181980,0,"19","12",40221,28646
"2262",208646,"EASTERN OREGON UNIVERSITY                                   ","2003-2004",2,"Basketball",180109,180109,0,113032,113032,0,67077,67077,0,"21","13",31876,27558
"2264",147244,"MILLIKIN UNIVERSITY                                         ","2003-2004",2,"Basketball",159749,159749,0,90856,90856,0,68893,68893,0,"22","26",23918,24158
"2267",213659,"LUZERNE COUNTY COMMUNITY COLLEGE                            ","2003-2004",2,"Basketball",32000,32000,0,16000,16000,0,16000,16000,0,"16","12",10100,10100
"2268",150172,"CALUMET COLLEGE OF SAINT JOSEPH                             ","2003-2004",2,"Basketball",60000,60000,0,30000,30000,0,30000,30000,0,"14","10",28238,23106
"2269",170842,"MARYGROVE COLLEGE                                           ","2003-2004",2,"Basketball",49925,49925,0,28120,28120,0,21805,21805,0,"14","9",20000,13000
"2280",163046,"LOYOLA COLLEGE IN MARYLAND                                  ","2003-2004",2,"Basketball",2015757,2015757,0,1050510,1050510,0,965247,965247,0,"11","12",129552,116799
"2313",176239,"PEARL RIVER COMMUNITY COLLEGE                               ","2003-2004",2,"Basketball",218997,218997,0,118495,118495,0,100502,100502,0,"15","13",28147,31040
"2316",227146,"NAVARRO COLLEGE                                             ","2003-2004",2,"Basketball",159807,159807,0,159807,159807,0,0,0,0,"16",".",19820,0
"2317",162283,"COPPIN STATE COLLEGE                                        ","2003-2004",2,"Basketball",970655,970655,0,449682,449682,0,520973,520973,0,"16","15",72021,75060
"2320",229355,"TYLER JUNIOR COLLEGE                                        ","2003-2004",2,"Basketball",356377,356377,0,179571,179571,0,176806,176806,0,"13","12",40168,32597
"2325",213996,"MESSIAH COLLEGE                                             ","2003-2004",2,"Basketball",180670,180670,0,87061,87061,0,93609,93609,0,"15","12",26645,23642
"2327",127565,"METROPOLITAN STATE COLLEGE OF DENVER                        ","2003-2004",2,"Basketball",714642,714642,0,434047,434047,0,280595,280595,0,"13","13",70453,62338
"2329",112260,"CLAREMONT MCKENNA COLLEGE                                   ","2003-2004",2,"Basketball",168700,168700,0,78623,78623,0,90077,90077,0,"15","13",28632,14851
"2331",150677,"GRACE COLLEGE AND THEOLOGICAL SEMINARY                      ","2003-2004",2,"Basketball",326975,326975,0,196207,196207,0,130768,130768,0,"16","16",36318,32516
"2332",366252,"PENNSYLVANIA COLLEGE OF TECHNOLOGY                          ","2003-2004",2,"Basketball",44904,44904,0,22452,22452,0,22452,22452,0,"12","10",6300,6300
"2342",203368,"JOHN CARROLL UNIVERSITY                                     ","2003-2004",2,"Basketball",201325,201325,0,125065,125065,0,76260,76260,0,"20","16",51931,30735
"2348",161004,"BOWDOIN COLLEGE                                             ","2003-2004",2,"Basketball",192748,192748,0,103563,103563,0,89185,89185,0,"17","15",14612,43344
"2349",212160,"EDINBORO UNIVERSITY OF PENNSYLVANIA                         ","2003-2004",2,"Basketball",474422,474422,0,268267,268267,0,206155,206155,0,"14","14",45105,52317
"2351",147800,"OAKTON COMMUNITY COLLEGE                                    ","2003-2004",2,"Basketball",10581,10581,0,5387,5387,0,5194,5194,0,"13","10",5386,5193
"2352",214069,"COLLEGE MISERICORDIA                                        ","2003-2004",2,"Basketball",33827,33827,0,17351,17351,0,16476,16476,0,"20","15",3531,4805
"2353",196185,"SUNY COLLEGE AT ONEONTA                                     ","2003-2004",2,"Basketball",172791,172791,0,88291,88291,0,84500,84500,0,"19","19",12864,14673
"2365",198552,"FORSYTH TECHNICAL COMMUNITY COLLEGE                         ","2003-2004",2,"Basketball",12310,12310,0,12310,12310,0,0,0,0,"10",".",7510,0
"2376",155070,"BARCLAY COLLEGE                                             ","2003-2004",2,"Basketball",8340,8340,0,4170,4170,0,4170,4170,0,"13","13",2645,2645
"2383",166133,"HOLYOKE COMMUNITY COLLEGE                                   ","2003-2004",2,"Basketball",30000,30000,0,15000,15000,0,15000,15000,0,"11","15",5600,5600
"2386",206914,"CAMERON UNIVERSITY                                          ","2003-2004",2,"Basketball",88431,88431,0,33909,33909,0,54522,54522,0,"18","14",25561,38500
"2392",222983,"AUSTIN COLLEGE                                              ","2003-2004",2,"Basketball",131138,131138,0,61151,61151,0,69987,69987,0,"15","17",27864,35756
"2393",203775,"MALONE COLLEGE                                              ","2003-2004",2,"Basketball",362595,362595,0,202449,202449,0,160146,160146,0,"12","13",49366,40266
"2396",214272,"NEUMANN COLLEGE                                             ","2003-2004",2,"Basketball",66248,66248,0,33299,33299,0,32949,32949,0,"16","15",25500,25150
"2398",232025,"EMORY AND HENRY COLLEGE                                     ","2003-2004",2,"Basketball",127080,127080,0,64810,64810,0,62270,62270,0,"15","12",24523,19715
"2402",200217,"UNIVERSITY OF MARY                                          ","2003-2004",2,"Basketball",290036,290036,0,166493,166493,0,123543,123543,0,"31","20",43594,40211
"2408",107460,"NORTH ARKANSAS COLLEGE                                      ","2003-2004",2,"Basketball",107524,107524,0,51086,51086,0,56438,56438,0,"13","17",14254,12298
"2410",128902,"CONNECTICUT COLLEGE                                         ","2003-2004",2,"Basketball",181514,181514,0,92481,92481,0,89033,89033,0,"15","10",23679,22028
"2412",238616,"CONCORDIA UNIVERSITY-WISCONSIN                              ","2003-2004",2,"Basketball",37096,37096,0,17220,17220,0,19876,19876,0,"32","22",14045,14585
"2417",123527,"SAN BERNARDINO VALLEY COLLEGE                               ","2003-2004",2,"Basketball",45401,45401,0,23192,23192,0,22209,22209,0,"10","10",16292,15308
"2422",213826,"MARYWOOD UNIVERSITY                                         ","2003-2004",2,"Basketball",39449,39449,0,19531,19531,0,19918,19918,0,"13","10",11478,10576
"2431",151360,"INDIANA UNIVERSITY-NORTHWEST                                ","2003-2004",2,"Basketball",45318,45318,0,26006,26006,0,19312,19312,0,"15","14",18006,15312
"2441",174914,"UNIVERSITY OF ST THOMAS                                     ","2003-2004",2,"Basketball",137044,137044,0,59182,59182,0,77862,77862,0,"27","26",21995,31063
"2449",137953,"TRINITY BAPTIST COLLEGE                                     ","2003-2004",2,"Basketball",6800,6800,0,6800,6800,0,0,0,0,"15",".",4900,0
"2454",214689,"PENNSYLVANIA STATE UNIVERSITY-PENN STATE ALTOONA            ","2003-2004",2,"Basketball",88117,88117,0,61323,61323,0,26794,26794,0,"20","12",11184,13071
"2459",215114,"PHILADELPHIA BIBLICAL UNIVERSITY-LANGHORNE                  ","2003-2004",2,"Basketball",46810,46810,0,19742,19742,0,27068,27068,0,"11","13",14317,21088
"2464",200484,"TRINITY BIBLE COLLEGE                                       ","2003-2004",2,"Basketball",73840,73840,0,39581,39581,0,34259,34259,0,"9","8",16509,15006
"2472",133492,"ECKERD COLLEGE                                              ","2003-2004",2,"Basketball",486167,486167,0,320397,320397,0,165770,165770,0,"16","12",59100,23563
"2475",136950,"ROLLINS COLLEGE                                             ","2003-2004",2,"Basketball",869389,869389,0,481354,481354,0,388035,388035,0,"14","15",65448,46085
"2481",227386,"PANOLA COLLEGE                                              ","2003-2004",2,"Basketball",257678,257678,0,135747,135747,0,121931,121931,0,"14","15",9126,12000
"2488",193283,"MOHAWK VALLEY COMMUNITY COLLEGE-UTICA BRANCH                ","2003-2004",2,"Basketball",48393,48393,0,23277,23277,0,25116,25116,0,"14","14",11844,13216
"2489",214759,"PENNSYLVANIA STATE UNIVERSITY-PENN STATE FAYETTE            ","2003-2004",2,"Basketball",24875,24875,0,24875,24875,0,0,0,0,"8",".",5900,0
"2497",155414,"KANSAS WESLEYAN UNIVERSITY                                  ","2003-2004",2,"Basketball",132017,132017,0,84168,84168,0,47849,47849,0,"31","18",25846,18228
"2504",110051,"BETHANY COLLEGE OF THE ASSEMBLIES OF GOD                    ","2003-2004",2,"Basketball",252531,252531,0,139960,139960,0,112571,112571,0,"13","11",21853,23921
"2508",183910,"CALDWELL COLLEGE                                            ","2003-2004",2,"Basketball",246645,246645,0,142025,142025,0,104620,104620,0,"12","11",22596,17827
"2524",158477,"CENTENARY COLLEGE OF LOUISIANA                              ","2003-2004",2,"Basketball",1434034,1434034,0,738354,738354,0,695680,695680,0,"13","13",172682,160766
"2525",125471,"WEST LOS ANGELES COLLEGE                                    ","2003-2004",2,"Basketball",45865,45865,0,23229,23229,0,22636,22636,0,"13","13",4761,7535
"2530",237109,"YAKIMA VALLEY COMMUNITY COLLEGE                             ","2003-2004",2,"Basketball",77266,77266,0,34556,34556,0,42710,42710,0,"16","13",22632,27700
"2532",158662,"DELGADO COMMUNITY COLLEGE                                   ","2003-2004",2,"Basketball",197950,197950,0,95121,95121,0,102829,102829,0,"18","18",60121,57829
"2547",152567,"TRI-STATE UNIVERSITY                                        ","2003-2004",2,"Basketball",136148,136148,0,82103,82103,0,54045,54045,0,"20","16",18036,10353
"2551",207722,"UNIVERSITY OF SCIENCE AND ARTS OF OKLAHOMA                  ","2003-2004",2,"Basketball",131317,131317,0,68780,68780,0,62537,62537,0,"14","15",27255,25362
"2567",197294,"SUNY WESTCHESTER COMMMUNITY COLLEGE                         ","2003-2004",2,"Basketball",33728,33728,0,21052,21052,0,12676,12676,0,"14","9",7700,3860
"2572",225575,"HUSTON-TILLOTSON COLLEGE                                    ","2003-2004",2,"Basketball",103186,103186,0,64142,64142,0,39044,39044,0,"7","15",28617,27044
"2591",243586,"PONTIFICAL CATHOLIC UNIV OF PUERTO RICO-MAYAGUEZ            ","2003-2004",2,"Basketball",5090,5090,0,5090,5090,0,0,0,0,"15",".",1957,0
"2594",184791,"GLOUCESTER COUNTY COLLEGE                                   ","2003-2004",2,"Basketball",38190,38190,0,24990,24990,0,13200,13200,0,"14","10",24990,13200
"2598",122436,"UNIVERSITY OF SAN DIEGO                                     ","2003-2004",2,"Basketball",2023064,2023064,0,1228334,1228334,0,794730,794730,0,"16","12",232089,103910
"2604",126669,"COLORADO CHRISTIAN UNIVERSITY                               ","2003-2004",2,"Basketball",437612,437612,0,270375,270375,0,167237,167237,0,"16","10",33504,23720
"2607",176008,"MISSISSIPPI DELTA COMMUNITY COLLEGE                         ","2003-2004",2,"Basketball",125690,125690,0,59914,59914,0,65776,65776,0,"13","13",20261,22952
"2608",162706,"HARFORD COMMUNITY COLLEGE                                   ","2003-2004",2,"Basketball",41391,41391,0,20167,20167,0,21224,21224,0,"8","7",2913,3079
"2613",156082,"WASHBURN UNIVERSITY OF TOPEKA                               ","2003-2004",2,"Basketball",153432,153432,0,81522,81522,0,71910,71910,0,"16","16",56452,55379
"2616",118718,"MERCED COLLEGE                                              ","2003-2004",2,"Basketball",34554,34554,0,15736,15736,0,18818,18818,0,"16","15",9686,13743
"2628",237640,"OHIO VALLEY COLLEGE                                         ","2003-2004",2,"Basketball",270451,270451,0,141119,141119,0,129332,129332,0,"13","13",20108,15482
"2637",105792,"SOUTH MOUNTAIN COMMUNITY COLLEGE                            ","2003-2004",2,"Basketball",37737,37737,0,18758,18758,0,18979,18979,0,"12","12",9401,9622
"2657",200226,"MAYVILLE STATE UNIVERSITY                                   ","2003-2004",2,"Basketball",62692,62692,0,29996,29996,0,32696,32696,0,"19","14",28900,32067
"2659",198756,"JOHNSON C SMITH UNIVERSITY                                  ","2003-2004",2,"Basketball",539563,539563,0,247889,247889,0,291674,291674,0,"15","12",33857,42549
"2660",235103,"EDMONDS COMMUNITY COLLEGE                                   ","2003-2004",2,"Basketball",35724,35724,0,16136,16136,0,19588,19588,0,"12","10",9089,9089
"2662",160630,"SOUTHERN UNIVERSITY AT NEW ORLEANS                          ","2003-2004",2,"Basketball",236000,236000,0,118000,118000,0,118000,118000,0,"15","15",88358,88358
"2676",215798,"SAINT VINCENT COLLEGE                                       ","2003-2004",2,"Basketball",602210,602210,0,359865,359865,0,242345,242345,0,"13","14",66420,48733
"2677",113856,"EAST LOS ANGELES COLLEGE                                    ","2003-2004",2,"Basketball",56590,56590,0,25954,25954,0,30636,30636,0,"13","12",5669,5669
"2695",168281,"WHEATON COLLEGE                                             ","2003-2004",2,"Basketball",146578,146578,0,84140,84140,0,62438,62438,0,"14","12",33097,22177
"2699",221953,"TUSCULUM COLLEGE                                            ","2003-2004",2,"Basketball",493036,493036,0,241879,241879,0,251157,251157,0,"15","15",25662,24411
"2710",120254,"OCCIDENTAL COLLEGE                                          ","2003-2004",2,"Basketball",144934,144934,0,116491,116491,0,28443,28443,0,"17","11",27951,13443
"2735",240596,"EASTERN WYOMING COLLEGE                                     ","2003-2004",2,"Basketball",109763,109763,0,109763,109763,0,0,0,0,"16",".",38579,0
"2736",176789,"CALVARY BIBLE COLLEGE AND THEOLOGICAL SEMINARY              ","2003-2004",2,"Basketball",39326,39326,0,20743,20743,0,18583,18583,0,"8","8",7953,7953
"2744",111896,"CERRO COSO COMMUNITY COLLEGE                                ","2003-2004",2,"Basketball",51666,51666,0,0,0,0,51666,51666,0,".","10",0,32388
"2746",161138,"EASTERN MAINE COMMUNITY COLLEGE                             ","2003-2004",2,"Basketball",9500,9500,0,5300,5300,0,4200,4200,0,"10","8",5000,4000
"2750",227687,"RANGER COLLEGE                                              ","2003-2004",2,"Basketball",152141,152141,0,80158,80158,0,71983,71983,0,"14","13",9437,8551
"2755",232706,"MARYMOUNT UNIVERSITY                                        ","2003-2004",2,"Basketball",83963,83963,0,33735,33735,0,50228,50228,0,"15","15",25355,22829
"2759",101736,"NORTHWEST SHOALS COMMUNITY COLLEGE-MUSCLE SHOALS            ","2003-2004",2,"Basketball",59625,59625,0,29660,29660,0,29965,29965,0,"12","16",20700,20200
"2762",186432,"SAINT PETERS COLLEGE                                        ","2003-2004",2,"Basketball",1223497,1223497,0,655222,655222,0,568275,568275,0,"13","13",115119,74833
"2768",241100,"AMERICAN UNIVERSITY OF PUERTO RICO                          ","2003-2004",2,"Basketball",142289,142289,0,93042,93042,0,49247,49247,0,"12","10",17971,17314
"2776",212674,"GETTYSBURG COLLEGE                                          ","2003-2004",2,"Basketball",145843,145843,0,77236,77236,0,68607,68607,0,"17","13",21468,14452
"2788",186645,"RARITAN VALLEY COMMUNITY COLLEGE                            ","2003-2004",2,"Basketball",27622,27622,0,13361,13361,0,14261,14261,0,"10","15",2030,4920
"2791",121044,"PASADENA CITY COLLEGE                                       ","2003-2004",2,"Basketball",105720,105720,0,74004,74004,0,31716,31716,0,"15","14",3500,3500
"2797",137759,"TALLAHASSEE COMMUNITY COLLEGE                               ","2003-2004",2,"Basketball",377667,377667,0,197873,197873,0,179794,179794,0,"14","15",40994,36583
"2799",223922,"CLARENDON COLLEGE                                           ","2003-2004",2,"Basketball",101774,101774,0,53448,53448,0,48326,48326,0,"23","22",17222,20933
"2800",212878,"HARRISBURG AREA COMMUNITY COLLEGE-HARRISBURG                ","2003-2004",2,"Basketball",20427,20427,0,10855,10855,0,9572,9572,0,"12","8",6955,5672
"2803",193584,"NAZARETH COLLEGE OF ROCHESTER                               ","2003-2004",2,"Basketball",132971,132971,0,72151,72151,0,60820,60820,0,"20","31",36482,34503
"2807",241836,"ELECTRONIC DATA PROCESSING COL OF PR INC-SAN SBSTN          ","2003-2004",2,"Basketball",1700,1700,0,1700,1700,0,0,0,0,"12","0",200,0
"2812",183099,"NEW HAMPSHIRE TECHNICAL INSTITUTE                           ","2003-2004",2,"Basketball",21000,21000,0,11000,11000,0,10000,10000,0,"16","13",5500,4500
"2815",196051,"MORRISVILLE STATE COLLEGE                                   ","2003-2004",2,"Basketball",66714,66714,0,34135,34135,0,32579,32579,0,"14","13",23719,22163
"2816",196477,"TECHNICAL CAREER INSTITUTES                                 ","2003-2004",2,"Basketball",87000,87000,0,47000,47000,0,40000,40000,0,"15","15",38000,31000
"2819",108667,"COLLEGE OF ALAMEDA                                          ","2003-2004",2,"Basketball",37561,37561,0,37561,37561,0,0,0,0,"13",".",13451,0
"2830",129525,"UNIVERSITY OF HARTFORD                                      ","2003-2004",2,"Basketball",1865640,1865640,0,962422,962422,0,903218,903218,0,"14","14",160396,130028
"2833",200572,"VALLEY CITY STATE UNIVERSITY                                ","2003-2004",2,"Basketball",103770,103770,0,53316,53316,0,50454,50454,0,"14","16",21789,21722
"2836",187198,"UNION COUNTY COLLEGE                                        ","2003-2004",2,"Basketball",70000,70000,0,32000,32000,0,38000,38000,0,"10","16",18000,24000
"2842",243601,"UNIVERSIDAD DEL TURABO                                      ","2003-2004",2,"Basketball",66377,66377,0,41348,41348,0,25029,25029,0,"14","9",4023,2674
"2843",183743,"BERGEN COMMUNITY COLLEGE                                    ","2003-2004",2,"Basketball",45775,45775,0,22750,22750,0,23025,23025,0,"18","10",15000,15000
"2854",166948,"MOUNT IDA COLLEGE                                           ","2003-2004",2,"Basketball",60512,60512,0,27590,27590,0,32922,32922,0,"15","14",24590,24422
"2859",189705,"CANISIUS COLLEGE                                            ","2003-2004",2,"Basketball",1863513,1863513,0,1034888,1034888,0,828625,828625,0,"15","13",172717,117456
"2864",173160,"BETHEL COLLEGE                                              ","2003-2004",2,"Basketball",141784,141784,0,75248,75248,0,66536,66536,0,"28","17",22848,19159
"2871",149365,"SOUTH SUBURBAN COLLEGE                                      ","2003-2004",2,"Basketball",53600,53600,0,28300,28300,0,25300,25300,0,"15","12",14610,15778
"2872",243179,"UNIVERSITY OF PUERTO RICO-HUMACAO                           ","2003-2004",2,"Basketball",17834,17834,0,8917,8917,0,8917,8917,0,"15","15",3605,3605
"2877",138868,"ATLANTA CHRISTIAN COLLEGE                                   ","2003-2004",2,"Basketball",30900,30900,0,13500,13500,0,17400,17400,0,"15","10",13400,17300
"2883",133702,"FLORIDA COMMUNITY COLLEGE AT JACKSONVILLE                   ","2003-2004",2,"Basketball",289213,289213,0,151014,151014,0,138199,138199,0,"16","15",60804,57466
"2884",161864,"BALTIMORE CITY COMMUNITY COLLEGE                            ","2003-2004",2,"Basketball",59700,59700,0,29850,29850,0,29850,29850,0,"12","11",19850,19850
"2897",133809,"FLORIDA COLLEGE                                             ","2003-2004",2,"Basketball",78463,78463,0,78463,78463,0,0,0,0,"10",".",30388,0
"2898",119067,"MONTEREY PENINSULA COLLEGE                                  ","2003-2004",2,"Basketball",41022,41022,0,28951,28951,0,12071,12071,0,"13","11",12792,2156
"2902",202523,"DENISON UNIVERSITY                                          ","2003-2004",2,"Basketball",164159,164159,0,89408,89408,0,74751,74751,0,"12","15",25656,28725
"2906",150534,"UNIVERSITY OF EVANSVILLE                                    ","2003-2004",2,"Basketball",2228198,2228198,0,1347779,1347779,0,880419,880419,0,"15","15",346760,169317
"2908",130493,"SOUTHERN CONNECTICUT STATE UNIVERSITY                       ","2003-2004",2,"Basketball",299291,299291,0,158789,158789,0,140502,140502,0,"15","11",61023,53420
"2913",196291,"SUNY MARITIME COLLEGE                                       ","2003-2004",2,"Basketball",56185,56185,0,30015,30015,0,26170,26170,0,"15","15",17015,15170
"2914",104577,"EASTERN ARIZONA COLLEGE                                     ","2003-2004",2,"Basketball",248992,248992,0,139654,139654,0,109338,109338,0,"18","11",51316,43728
"2920",130590,"TRINITY COLLEGE                                             ","2003-2004",2,"Basketball",186229,186229,0,106980,106980,0,79249,79249,0,"14","12",17864,17964
"2926",146612,"LEWIS UNIVERSITY                                            ","2003-2004",2,"Basketball",619662,619662,0,320555,320555,0,299107,299107,0,"16","16",43184,45515
"2928",177418,"FONTBONNE UNIVERSITY                                        ","2003-2004",2,"Basketball",53876,53876,0,26828,26828,0,27048,27048,0,"17","14",19603,12940
"2930",162557,"FREDERICK COMMUNITY COLLEGE                                 ","2003-2004",2,"Basketball",26554,26554,0,14039,14039,0,12515,12515,0,"12","8",3140,3065
"2933",188465,"GLOBE INSTITUTE OF TECHNOLOGY                               ","2003-2004",2,"Basketball",191373,191373,0,105217,105217,0,86156,86156,0,"12","9",68055,55174
"2935",156541,"CUMBERLAND COLLEGE                                          ","2003-2004",2,"Basketball",585381,585381,0,295538,295538,0,289843,289843,0,"13","11",20397,17875
"2942",129242,"FAIRFIELD UNIVERSITY                                        ","2003-2004",2,"Basketball",2608381,2608381,0,1248838,1248838,0,1359543,1359543,0,"13","15",263769,261820
"2944",126182,"ADAMS STATE COLLEGE                                         ","2003-2004",2,"Basketball",296223,296223,0,152536,152536,0,143687,143687,0,"15","14",23788,23788
"2945",133021,"CHIPOLA COLLEGE                                             ","2003-2004",2,"Basketball",464309,464309,0,263988,263988,0,200321,200321,0,"16","11",75490,30509
"2946",192819,"MARIST COLLEGE                                              ","2003-2004",2,"Basketball",2227627,2227627,0,1274396,1274396,0,953231,953231,0,"17","19",171661,177822
"2949",234173,"VIRGINIA WESLEYAN COLLEGE                                   ","2003-2004",2,"Basketball",108247,108247,0,64271,64271,0,43976,43976,0,"16","13",22271,13476
"2965",210669,"ALLEGHENY COLLEGE                                           ","2003-2004",2,"Basketball",155306,155306,0,82624,82624,0,72682,72682,0,"15","16",27603,27322
"2969",221397,"ROANE STATE COMMUNITY COLLEGE                               ","2003-2004",2,"Basketball",150736,150736,0,95242,95242,0,55494,55494,0,"10","14",14698,16265
"2970",226152,"TEXAS A &amp; M INTERNATIONAL UNIVERSITY                        ","2003-2004",2,"Basketball",175100,175100,0,91800,91800,0,83300,83300,0,"12","12",42800,34300
"2971",178624,"NORTHWEST MISSOURI STATE UNIVERSITY                         ","2003-2004",2,"Basketball",544091,544091,0,300129,300129,0,243962,243962,0,"16","16",24108,10803
"2973",101602,"LURLEEN B WALLACE COMMUNITY COLLEGE-ANDALUSIA CAMPUS        ","2003-2004",2,"Basketball",264592,264592,0,132296,132296,0,132296,132296,0,"16","16",27375,27375
"2974",232609,"LYNCHBURG COLLEGE                                           ","2003-2004",2,"Basketball",149997,149997,0,70916,70916,0,79081,79081,0,"21","16",22802,26006
"2988",230047,"BRIGHAM YOUNG UNIVERSITY-HAWAII CAMPUS                      ","2003-2004",2,"Basketball",114800,114800,0,114800,114800,0,0,0,0,"14",".",114300,0
"2992",154712,"BENEDICTINE COLLEGE                                         ","2003-2004",2,"Basketball",381810,381810,0,214432,214432,0,167378,167378,0,"22","17",20631,34937
"2996",110538,"CALIFORNIA STATE UNIVERSITY-CHICO                           ","2003-2004",2,"Basketball",471112,471112,0,236262,236262,0,234850,234850,0,"22","15",48782,49846
"3007",196121,"SUNY COLLEGE AT BROCKPORT                                   ","2003-2004",2,"Basketball",85563,85563,0,53168,53168,0,32395,32395,0,"16","14",27474,23424
"3016",147378,"MORAINE VALLEY COMMUNITY COLLEGE                            ","2003-2004",2,"Basketball",55875,55875,0,34215,34215,0,21660,21660,0,"21","13",20866,13753
"3029",237899,"WEST VIRGINIA STATE COLLEGE                                 ","2003-2004",2,"Basketball",263178,263178,0,150177,150177,0,113001,113001,0,"20","19",36079,29915
"3034",214829,"PENNSYLVANIA STATE UNIVERSITY-PENN STATE YORK               ","2003-2004",2,"Basketball",28156,28156,0,15808,15808,0,12348,12348,0,"10","12",14695,10828
"3046",183080,"PLYMOUTH STATE UNIVERSITY                                   ","2003-2004",2,"Basketball",155045,155045,0,82458,82458,0,72587,72587,0,"18","15",36432,30841
"3073",366395,"SUFFOLK COUNTY COMMUNITY COLLEGE                            ","2003-2004",2,"Basketball",52737,52737,0,30943,30943,0,21794,21794,0,"16","10",15270,10322
"3079",236133,"NORTHWEST COLLEGE OF THE ASSEMBLIES OF GOD                  ","2003-2004",2,"Basketball",326716,326716,0,168128,168128,0,158588,158588,0,"11","11",29441,26545
"3082",106485,"UNIVERSITY OF ARKANSAS AT MONTICELLO                        ","2003-2004",2,"Basketball",307165,307165,0,198407,198407,0,108758,108758,0,"18","10",71801,27935
"3088",193016,"MERCY COLLEGE-MAIN CAMPUS                                   ","2003-2004",2,"Basketball",44000,44000,0,22000,22000,0,22000,22000,0,"12","11",10000,10000
"3089",141644,"HAWAII PACIFIC UNIVERSITY                                   ","2003-2004",2,"Basketball",490451,490451,0,490451,490451,0,0,0,0,"12",".",174556,0
"3093",163851,"SALISBURY UNIVERSITY                                        ","2003-2004",2,"Basketball",60742,60742,0,30371,30371,0,30371,30371,0,"15","15",14119,16420
"3110",183877,"BURLINGTON COUNTY COLLEGE                                   ","2003-2004",2,"Basketball",6225,6225,0,6225,6225,0,0,0,0,"12","0",4308,0
"3112",195173,"ST FRANCIS COLLEGE                                          ","2003-2004",2,"Basketball",861403,861403,0,417578,417578,0,443825,443825,0,"14","14",57543,59090
"3114",165574,"DEAN COLLEGE                                                ","2003-2004",2,"Basketball",75262,75262,0,36260,36260,0,39002,39002,0,"13","12",12400,7202
"3117",137281,"SAINT JOHNS RIVER COMMUNITY COLLEGE                         ","2003-2004",2,"Basketball",69233,69233,0,69233,69233,0,0,0,0,"13",".",27035,0
"3121",176965,"CENTRAL MISSOURI STATE UNIVERSITY                           ","2003-2004",2,"Basketball",868785,868785,0,518957,518957,0,349828,349828,0,"16","13",87735,35604
"3123",190549,"CUNY BROOKLYN COLLEGE                                       ","2003-2004",2,"Basketball",56404,56404,0,28646,28646,0,27758,27758,0,"14","14",12615,13921
"3127",210155,"SOUTHWESTERN OREGON COMMUNITY COLLEGE                       ","2003-2004",2,"Basketball",113107,113107,0,66690,66690,0,46417,46417,0,"17","15",46586,27993
"3136",192439,"LONG ISLAND UNIVERSITY-BROOKLYN CAMPUS                      ","2003-2004",2,"Basketball",1651490,1651490,0,808769,808769,0,842721,842721,0,"13","14",156746,187477
"3143",216339,"TEMPLE UNIVERSITY                                           ","2003-2004",2,"Basketball",4621470,4621470,0,2916619,2916619,0,1704851,1704851,0,"13","17",565518,359550
"3144",214810,"PENNSYLVANIA STATE UNIVERSITY-PENN STATE SCHUYLKIL          ","2003-2004",2,"Basketball",6000,6000,0,6000,6000,0,0,0,0,"15",".",6000,0
"3153",204909,"OHIO WESLEYAN UNIVERSITY                                    ","2003-2004",2,"Basketball",204961,204961,0,98091,98091,0,106870,106870,0,"21","16",33666,33757
"3156",184481,"ESSEX COUNTY COLLEGE                                        ","2003-2004",2,"Basketball",160636,160636,0,83174,83174,0,77462,77462,0,"14","12",16006,17518
"3158",172635,"WAYNE COUNTY COMMUNITY COLLEGE DISTRICT                     ","2003-2004",2,"Basketball",80000,80000,0,40000,40000,0,40000,40000,0,"14","14",20000,20000
"3161",139311,"CLAYTON COLLEGE AND STATE UNIVERSITY                        ","2003-2004",2,"Basketball",450695,450695,0,249406,249406,0,201289,201289,0,"13","14",166871,145359
"3169",212911,"HAVERFORD COLLEGE                                           ","2003-2004",2,"Basketball",56357,56357,0,30265,30265,0,26092,26092,0,"15","11",25344,20980
"3173",105428,"PHOENIX COLLEGE                                             ","2003-2004",2,"Basketball",99200,99200,0,28750,28750,0,70450,70450,0,"16","13",11950,11950
"3174",138691,"DARTON COLLEGE                                              ","2003-2004",2,"Basketball",46034,46034,0,0,0,0,46034,46034,0,".","9",0,12675
"3176",149842,"WILLIAM RAINEY HARPER COLLEGE                               ","2003-2004",2,"Basketball",53033,53033,0,29976,29976,0,23057,23057,0,"32","12",16160,8568
"3179",220978,"MIDDLE TENNESSEE STATE UNIVERSITY                           ","2003-2004",2,"Basketball",1668521,1668521,0,923394,923394,0,745127,745127,0,"18","15",214626,224402
"3180",159568,"LOUISIANA COLLEGE                                           ","2003-2004",2,"Basketball",191642,191642,0,108532,108532,0,83110,83110,0,"17","16",33598,28418
"3181",190646,"CUNY MEDGAR EVERS COLLEGE                                   ","2003-2004",2,"Basketball",35100,35100,0,18700,18700,0,16400,16400,0,"18","12",17500,15800
"3188",177551,"HARRIS-STOWE STATE COLLEGE                                  ","2003-2004",2,"Basketball",111838,111838,0,57548,57548,0,54290,54290,0,"16","12",15610,15263
"3189",190248,"CONCORDIA COLLEGE                                           ","2003-2004",2,"Basketball",38468,38468,0,22815,22815,0,15653,15653,0,"14","13",11479,9758
"3194",201195,"BALDWIN-WALLACE COLLEGE                                     ","2003-2004",2,"Basketball",291636,291636,0,176528,176528,0,115108,115108,0,"19","23",46074,40269
"3196",204468,"NOTRE DAME COLLEGE                                          ","2003-2004",2,"Basketball",123062,123062,0,65800,65800,0,57262,57262,0,"14","12",34800,34308
"3197",166027,"HARVARD UNIVERSITY                                          ","2003-2004",2,"Basketball",972280,972280,0,468439,468439,0,503841,503841,0,"33","35",102383,140125
"3200",133386,"DAYTONA BEACH COMMUNITY COLLEGE                             ","2003-2004",2,"Basketball",138509,138509,0,98025,98025,0,40484,40484,0,"14","16",38943,35968
"3205",166823,"MASSASOIT COMMUNITY COLLEGE                                 ","2003-2004",2,"Basketball",19113,19113,0,13574,13574,0,5539,5539,0,"13","7",4854,1438
"3214",160904,"XAVIER UNIVERSITY OF LOUISIANA                              ","2003-2004",2,"Basketball",1075189,1075189,0,484557,484557,0,590632,590632,0,"13","16",77100,118137
"3217",124113,"TAFT COLLEGE                                                ","2003-2004",2,"Basketball",14925,14925,0,0,0,0,14925,14925,0,"0","9",0,7690
"3223",184205,"CUMBERLAND COUNTY COLLEGE                                   ","2003-2004",2,"Basketball",53052,53052,0,26526,26526,0,26526,26526,0,"13","11",11034,11034
"3228",101189,"FAULKNER UNIVERSITY                                         ","2003-2004",2,"Basketball",370243,370243,0,370243,370243,0,0,0,0,"19",".",85247,0
"3235",182865,"HESSER COLLEGE                                              ","2003-2004",2,"Basketball",40167,40167,0,17822,17822,0,22345,22345,0,"15","10",5472,5345
"3236",125091,"VICTOR VALLEY COLLEGE                                       ","2003-2004",2,"Basketball",72015,72015,0,36995,36995,0,35020,35020,0,"11","9",13954,13273
"3247",173258,"CARLETON COLLEGE                                            ","2003-2004",2,"Basketball",191514,191514,0,98092,98092,0,93422,93422,0,"16","11",22423,20069
"3258",149532,"TRITON COLLEGE                                              ","2003-2004",2,"Basketball",49814,49814,0,26331,26331,0,23483,23483,0,"12","11",11076,8935
"3260",170037,"CORNERSTONE UNIVERSITY                                      ","2003-2004",2,"Basketball",170943,170943,0,102628,102628,0,68315,68315,0,"26","13",41435,34302
"3262",198251,"CENTRAL CAROLINA COMMUNITY COLLEGE                          ","2003-2004",2,"Basketball",17500,17500,0,17500,17500,0,0,0,0,"14",".",14450,0
"3267",123509,"SKYLINE COLLEGE                                             ","2003-2004",2,"Basketball",11465,11465,0,11465,11465,0,0,0,0,"14",".",11466,0
"3270",131098,"WESLEY COLLEGE                                              ","2003-2004",2,"Basketball",77141,77141,0,38375,38375,0,38766,38766,0,"16","12",22325,22050
"3281",127389,"LAMAR COMMUNITY COLLEGE                                     ","2003-2004",2,"Basketball",135035,135035,0,135035,135035,0,0,0,0,"20",".",30218,0
"3283",194578,"PRATT INSTITUTE-MAIN                                        ","2003-2004",2,"Basketball",13766,13766,0,13766,13766,0,0,0,0,"13","0",1716,0
"3287",154493,"UPPER IOWA UNIVERSITY                                       ","2003-2004",2,"Basketball",234433,234433,0,126940,126940,0,107493,107493,0,"17","15",37876,27830
"3288",166647,"MASSACHUSETTS BAY COMMUNITY COLLEGE                         ","2003-2004",2,"Basketball",30798,30798,0,21121,21121,0,9677,9677,0,"18","7",12621,4927
"3292",138947,"CLARK ATLANTA UNIVERSITY                                    ","2003-2004",2,"Basketball",436000,436000,0,218000,218000,0,218000,218000,0,"14","14",1e+05,1e+05
"3295",165334,"CLARK UNIVERSITY                                            ","2003-2004",2,"Basketball",200256,200256,0,109616,109616,0,90640,90640,0,"19","17",16788,21543
"3302",165015,"BRANDEIS UNIVERSITY                                         ","2003-2004",2,"Basketball",255703,255703,0,129379,129379,0,126324,126324,0,"12","13",47379,49438
"3307",210605,"COMMUNITY COLLEGE OF ALLEGHENY COUNTY                       ","2003-2004",2,"Basketball",59000,59000,0,29500,29500,0,29500,29500,0,"27","24",25700,25500
"3312",161572,"UNITY COLLEGE                                               ","2003-2004",2,"Basketball",16500,16500,0,9000,9000,0,7500,7500,0,"9","13",5000,4500
"3315",118772,"MERRITT COLLEGE                                             ","2003-2004",2,"Basketball",45649,45649,0,22125,22125,0,23524,23524,0,"13","15",8283,8682
"3326",193973,"NIAGARA UNIVERSITY                                          ","2003-2004",2,"Basketball",1659370,1659370,0,956061,956061,0,703309,703309,0,"14","13",140037,87999
"3335",132851,"CENTRAL FLORIDA COMMUNITY COLLEGE                           ","2003-2004",2,"Basketball",429630,429630,0,212565,212565,0,217065,217065,0,"14","15",24350,25250
"3337",173735,"HIBBING COMMUNITY COLLEGE-A TECH AND COMM COLL              ","2003-2004",2,"Basketball",61988,61988,0,35352,35352,0,26636,26636,0,"14","9",15433,13880
"3348",126775,"COLORADO SCHOOL OF MINES                                    ","2003-2004",2,"Basketball",529130,529130,0,341590,341590,0,187540,187540,0,"16","14",57225,39562
"3354",218539,"PRESBYTERIAN COLLEGE                                        ","2003-2004",2,"Basketball",710099,710099,0,386812,386812,0,323287,323287,0,"14","13",38417,29797
"3355",193478,"NASSAU COMMUNITY COLLEGE                                    ","2003-2004",2,"Basketball",51323,51323,0,29092,29092,0,22231,22231,0,"12","10",11540,9881
"3356",145691,"ILLINOIS COLLEGE                                            ","2003-2004",2,"Basketball",141317,141317,0,78877,78877,0,62440,62440,0,"32","25",32925,29967
"3365",226471,"UNIVERSITY OF MARY HARDIN-BAYLOR                            ","2003-2004",2,"Basketball",240391,240391,0,123817,123817,0,116574,116574,0,"13","12",28874,31776
"3382",213358,"LA ROCHE COLLEGE                                            ","2003-2004",2,"Basketball",51143,51143,0,26664,26664,0,24479,24479,0,"13","11",14179,11993
"3393",169248,"CENTRAL MICHIGAN UNIVERSITY                                 ","2003-2004",2,"Basketball",1493554,1493554,0,871447,871447,0,622107,622107,0,"20","14",134221,92647
"3398",185509,"MERCER COUNTY COMMUNITY COLLEGE                             ","2003-2004",2,"Basketball",28000,28000,0,14000,14000,0,14000,14000,0,"15","12",13995,13992
"3402",126748,"COLORADO NORTHWESTERN COMMUNITY COLLEGE                     ","2003-2004",2,"Basketball",266465,266465,0,169931,169931,0,96534,96534,0,"16","9",57035,35191
"3403",190664,"CUNY QUEENS COLLEGE                                         ","2003-2004",2,"Basketball",281376,281376,0,153666,153666,0,127710,127710,0,"13","14",15877,13466
"3405",218061,"FRANCIS MARION UNIVERSITY                                   ","2003-2004",2,"Basketball",395229,395229,0,193896,193896,0,201333,201333,0,"15","11",45797,27490
"3414",117104,"LIFE PACIFIC COLLEGE                                        ","2003-2004",2,"Basketball",15500,15500,0,15500,15500,0,0,0,0,"12",".",15360,0
"3421",133553,"EMBRY RIDDLE AERONAUTICAL UNIVERSITY-DAYTONA BEACH          ","2003-2004",2,"Basketball",372667,372667,0,372667,372667,0,0,0,0,"14",".",323085,0
"3423",183938,"CAMDEN COUNTY COLLEGE                                       ","2003-2004",2,"Basketball",47429,47429,0,47429,47429,0,0,0,0,"14",".",7340,0
"3428",190655,"CUNY NEW YORK CITY COLLEGE OF TECHNOLOGY                    ","2003-2004",2,"Basketball",39382,39382,0,21221,21221,0,18161,18161,0,"12","12",21220,18160
"3431",136400,"PASCO-HERNANDO COMMUNITY COLLEGE                            ","2003-2004",2,"Basketball",114434,114434,0,114434,114434,0,0,0,0,"13",".",10275,0
"3435",139205,"BREWTON-PARKER COLLEGE                                      ","2003-2004",2,"Basketball",376949,376949,0,206320,206320,0,170629,170629,0,"16","15",43780,37534
"3438",231077,"COLLEGE OF ST JOSEPH                                        ","2003-2004",2,"Basketball",148825,148825,0,83370,83370,0,65455,65455,0,"11","10",79122,61198
"3441",186283,"RIDER UNIVERSITY                                            ","2003-2004",2,"Basketball",2159749,2159749,0,1121206,1121206,0,1038543,1038543,0,"13","15",138942,124411
"3443",212832,"GWYNEDD MERCY COLLEGE                                       ","2003-2004",2,"Basketball",39448,39448,0,17989,17989,0,21459,21459,0,"15","15",11989,11459
"3447",170587,"KIRTLAND COMMUNITY COLLEGE                                  ","2003-2004",2,"Basketball",123236,123236,0,63704,63704,0,59532,59532,0,"15","12",43699,44598
"3460",240505,"CASPER COLLEGE                                              ","2003-2004",2,"Basketball",348306,348306,0,191210,191210,0,157096,157096,0,"14","15",34415,26253
"3467",111887,"CERRITOS COLLEGE                                            ","2003-2004",2,"Basketball",93957,93957,0,45236,45236,0,48721,48721,0,"17","12",6100,6980
"3469",134343,"GULF COAST COMMUNITY COLLEGE                                ","2003-2004",2,"Basketball",462626,462626,0,185851,185851,0,276775,276775,0,"12","16",46640,46640
"3470",135391,"MANATEE COMMUNITY COLLEGE                                   ","2003-2004",2,"Basketball",81128,81128,0,81128,81128,0,0,0,0,"13",".",40982,0
"3475",161077,"CENTRAL MAINE COMMUNITY COLLEGE                             ","2003-2004",2,"Basketball",28000,28000,0,12000,12000,0,16000,16000,0,"12","12",11800,15000
"3478",186867,"STEVENS INSTITUTE OF TECHNOLOGY                             ","2003-2004",2,"Basketball",207975,207975,0,111544,111544,0,96431,96431,0,"16","11",26420,27373
"3482",196237,"SUNY COLLEGE AT OLD WESTBURY                                ","2003-2004",2,"Basketball",35550,35550,0,17775,17775,0,17775,17775,0,"18","18",7500,7500
"3483",217235,"JOHNSON &amp; WALES UNIVERSITY                                  ","2003-2004",2,"Basketball",73161,73161,0,35626,35626,0,37535,37535,0,"17","16",30822,24485
"3485",136233,"OKALOOSA-WALTON COMMUNITY COLLEGE                           ","2003-2004",2,"Basketball",68411,68411,0,34370,34370,0,34041,34041,0,"12","14",10000,10000
"3486",193308,"MONROE COLLEGE-MAIN CAMPUS                                  ","2003-2004",2,"Basketball",557735,557735,0,461581,461581,0,96154,96154,0,"13","13",155616,67457
"3488",227191,"NORTH LAKE COLLEGE                                          ","2003-2004",2,"Basketball",78311,78311,0,78311,78311,0,0,0,0,"15",".",18000,0
"3491",185536,"MIDDLESEX COUNTY COLLEGE                                    ","2003-2004",2,"Basketball",42740,42740,0,21370,21370,0,21370,21370,0,"14","8",6249,4333
"3500",193900,"NEW YORK UNIVERSITY                                         ","2003-2004",3,"All Track Combined",399736,399736,0,186363,186363,0,213373,213373,0,"70","97",116553,141651
"3509",200217,"UNIVERSITY OF MARY                                          ","2003-2004",3,"All Track Combined",660912,660912,0,330456,330456,0,330456,330456,0,"48","47",89087,89087
"3513",181534,"PERU STATE COLLEGE                                          ","2003-2004",3,"All Track Combined",29756,29756,0,0,0,0,29756,29756,0,".","7",0,4059
"3521",126182,"ADAMS STATE COLLEGE                                         ","2003-2004",3,"All Track Combined",394238,394238,0,183847,183847,0,210391,210391,0,"48","37",19607,19607
"3528",105154,"MESA COMMUNITY COLLEGE                                      ","2003-2004",3,"All Track Combined",88000,88000,0,44000,44000,0,44000,44000,0,"32","28",16100,16100
"3529",101480,"JACKSONVILLE STATE UNIVERSITY                               ","2003-2004",3,"All Track Combined",253595,253595,0,69284,69284,0,184311,184311,0,"6","28",69283,184310
"3530",238458,"CARROLL COLLEGE                                             ","2003-2004",3,"All Track Combined",106068,106068,0,53034,53034,0,53034,53034,0,"53","63",15182,15182
"3537",196121,"SUNY COLLEGE AT BROCKPORT                                   ","2003-2004",3,"All Track Combined",46452,46452,0,23226,23226,0,23226,23226,0,"85","73",22744,22744
"3550",205203,"UNIVERSITY OF RIO GRANDE                                    ","2003-2004",3,"All Track Combined",79131,79131,0,41400,41400,0,37731,37731,0,"14","18",8472,11471
"3556",181127,"HASTINGS COLLEGE                                            ","2003-2004",3,"All Track Combined",495172,495172,0,265811,265811,0,229361,229361,0,"33","22",24511,24511
"3567",112686,"COMPTON COMMUNITY COLLEGE                                   ","2003-2004",3,"All Track Combined",9500,9500,0,4750,4750,0,4750,4750,0,"10","5",1750,1750
"3569",210739,"DESALES UNIVERSITY                                          ","2003-2004",3,"All Track Combined",108946,108946,0,72335,72335,0,36611,36611,0,"42","18",34911,24174
"3570",165671,"EMMANUEL COLLEGE                                            ","2003-2004",3,"All Track Combined",65507,65507,0,27364,27364,0,38143,38143,0,"33","46",4419,6160
"3576",173124,"BEMIDJI STATE UNIVERSITY                                    ","2003-2004",3,"All Track Combined",199148,199148,0,95864,95864,0,103284,103284,0,"32","38",35454,24577
"3585",243346,"UNIVERSIDAD DEL ESTE                                        ","2003-2004",3,"All Track Combined",100164,100164,0,71459,71459,0,28705,28705,0,"25","13",65459,22705
"3588",190646,"CUNY MEDGAR EVERS COLLEGE                                   ","2003-2004",3,"All Track Combined",30500,30500,0,13500,13500,0,17000,17000,0,"17","18",13400,16900
"3590",118718,"MERCED COLLEGE                                              ","2003-2004",3,"All Track Combined",14344,14344,0,10431,10431,0,3913,3913,0,"19",".",5931,2213
"3595",169248,"CENTRAL MICHIGAN UNIVERSITY                                 ","2003-2004",3,"All Track Combined",788882,788882,0,369898,369898,0,418984,418984,0,"108","108",52224,46398
"3602",161004,"BOWDOIN COLLEGE                                             ","2003-2004",3,"All Track Combined",274287,274287,0,135993,135993,0,138294,138294,0,"51","28",21656,19941
"3608",147800,"OAKTON COMMUNITY COLLEGE                                    ","2003-2004",3,"All Track Combined",350,350,0,203,203,0,147,147,0,"2","1",202,146
"3621",175856,"JACKSON STATE UNIVERSITY                                    ","2003-2004",3,"All Track Combined",366023,366023,0,190568,190568,0,175455,175455,0,"30","26",63459,48961
"3624",181853,"YORK COLLEGE                                                ","2003-2004",3,"All Track Combined",15106,15106,0,7553,7553,0,7553,7553,0,"38",".",7370,3832
"3630",216339,"TEMPLE UNIVERSITY                                           ","2003-2004",3,"All Track Combined",572895,572895,0,166191,166191,0,406704,406704,0,"23","22",29950,32369
"3634",178721,"PARK UNIVERSITY                                             ","2003-2004",3,"All Track Combined",208278,208278,0,88612,88612,0,119666,119666,0,"14","16",13557,16550
"3640",145691,"ILLINOIS COLLEGE                                            ","2003-2004",3,"All Track Combined",60224,60224,0,30411,30411,0,29813,29813,0,"36","19",14133,13535
"3643",227687,"RANGER COLLEGE                                              ","2003-2004",3,"All Track Combined",74919,74919,0,0,0,0,74919,74919,0,".","8",0,1605
"3647",140818,"PIEDMONT COLLEGE                                            ","2003-2004",3,"All Track Combined",9808,9808,0,4754,4754,0,5054,5054,0,"9","9",3411,3772
"3650",154642,"ALLEN COUNTY COMMUNITY COLLEGE                              ","2003-2004",3,"All Track Combined",29877,29877,0,22083,22083,0,7794,7794,0,"12","5",12766,5920
"3654",138947,"CLARK ATLANTA UNIVERSITY                                    ","2003-2004",3,"All Track Combined",168000,168000,0,84000,84000,0,84000,84000,0,"36","36",50000,50000
"3673",165015,"BRANDEIS UNIVERSITY                                         ","2003-2004",3,"All Track Combined",180926,180926,0,90463,90463,0,90463,90463,0,"29","20",45026,45026
"3674",243212,"UNIVERSITY OF PUERTO RICO-PONCE                             ","2003-2004",3,"All Track Combined",42096,42096,0,22430,22430,0,19666,19666,0,"20","16",4820,3856
"3676",237899,"WEST VIRGINIA STATE COLLEGE                                 ","2003-2004",3,"All Track Combined",36910,36910,0,17834,17834,0,19076,19076,0,"21","26",12146,12453
"3683",184481,"ESSEX COUNTY COLLEGE                                        ","2003-2004",3,"All Track Combined",194666,194666,0,73693,73693,0,120973,120973,0,"8","17",27546,54553
"3687",194578,"PRATT INSTITUTE-MAIN                                        ","2003-2004",3,"All Track Combined",10636,10636,0,5318,5318,0,5318,5318,0,"12","12",792,792
"3689",186283,"RIDER UNIVERSITY                                            ","2003-2004",3,"All Track Combined",639564,639564,0,322742,322742,0,316822,316822,0,"41","36",48782,42885
"3691",130590,"TRINITY COLLEGE                                             ","2003-2004",3,"All Track Combined",130335,130335,0,63791,63791,0,66544,66544,0,"61","52",20069,22828
"3695",218399,"MORRIS COLLEGE                                              ","2003-2004",3,"All Track Combined",46478,46478,0,23239,23239,0,23239,23239,0,"13","22",17571,17571
"3701",242671,"INTER AMERICAN UNIV OF PUERTO RICO-CENTRAL OFFICE           ","2003-2004",3,"All Track Combined",385577,385577,0,225538,225538,0,160039,160039,0,"28","19",56053,55963
"3704",220978,"MIDDLE TENNESSEE STATE UNIVERSITY                           ","2003-2004",3,"All Track Combined",868521,868521,0,428085,428085,0,440436,440436,0,"69","54",84034,79118
"3709",117274,"LASSEN COMMUNITY COLLEGE                                    ","2003-2004",3,"All Track Combined",49402,49402,0,24701,24701,0,24701,24701,0,"19","2",5750,5750
"3714",154952,"COWLEY COUNTY COMMUNITY COLLEGE                             ","2003-2004",3,"All Track Combined",109682,109682,0,54841,54841,0,54841,54841,0,"30","30",21341,21341
"3725",120254,"OCCIDENTAL COLLEGE                                          ","2003-2004",3,"All Track Combined",168281,168281,0,86018,86018,0,82263,82263,0,"45","40",33183,29427
"3728",203775,"MALONE COLLEGE                                              ","2003-2004",3,"All Track Combined",516330,516330,0,244940,244940,0,271390,271390,0,"53","59",67025,67025
"3734",193584,"NAZARETH COLLEGE OF ROCHESTER                               ","2003-2004",3,"All Track Combined",121568,121568,0,60784,60784,0,60784,60784,0,"30","42",43410,43410
"3739",162283,"COPPIN STATE COLLEGE                                        ","2003-2004",3,"All Track Combined",364504,364504,0,195743,195743,0,168761,168761,0,"44","49",35864,36592
"3742",178624,"NORTHWEST MISSOURI STATE UNIVERSITY                         ","2003-2004",3,"All Track Combined",353805,353805,0,177751,177751,0,176054,176054,0,"47","31",15590,17547
"3745",212674,"GETTYSBURG COLLEGE                                          ","2003-2004",3,"All Track Combined",160501,160501,0,80250,80250,0,80251,80251,0,"77","95",27042,27042
"3748",160621,"SOUTHERN UNIVERSITY AND A &amp; M COLLEGE                       ","2003-2004",3,"All Track Combined",114766,114766,0,57383,57383,0,57383,57383,0,"32","24",1851,1851
"3762",152567,"TRI-STATE UNIVERSITY                                        ","2003-2004",3,"All Track Combined",91239,91239,0,51343,51343,0,39896,39896,0,"26","8",6993,2996
"3763",147244,"MILLIKIN UNIVERSITY                                         ","2003-2004",3,"All Track Combined",59925,59925,0,29829,29829,0,30096,30096,0,"74","81",16965,16158
"3764",155195,"HUTCHINSON COMMUNITY COLLEGE                                ","2003-2004",3,"All Track Combined",123222,123222,0,66971,66971,0,56251,56251,0,"33","25",6471,4787
"3765",208646,"EASTERN OREGON UNIVERSITY                                   ","2003-2004",3,"All Track Combined",116866,116866,0,58433,58433,0,58433,58433,0,"57","34",24923,24923
"3773",206817,"BACONE COLLEGE                                              ","2003-2004",3,"All Track Combined",213000,213000,0,181000,180000,1000,32000,33000,-1000,"19","9",11356,11356
"3774",193016,"MERCY COLLEGE-MAIN CAMPUS                                   ","2003-2004",3,"All Track Combined",24500,24500,0,12000,12000,0,12500,12500,0,"16","16",3500,4000
"3776",100663,"UNIVERSITY OF ALABAMA AT BIRMINGHAM                         ","2003-2004",3,"All Track Combined",470007,470007,0,0,0,0,470007,470007,0,".","89",0,89261
"3778",183743,"BERGEN COMMUNITY COLLEGE                                    ","2003-2004",3,"All Track Combined",16610,16610,0,8305,8305,0,8305,8305,0,"25","16",7500,7500
"3781",105428,"PHOENIX COLLEGE                                             ","2003-2004",3,"All Track Combined",52200,52200,0,29250,29250,0,22950,22950,0,"26","10",5250,5250
"3787",217156,"BROWN UNIVERSITY                                            ","2003-2004",3,"All Track Combined",543044,543044,0,271522,271522,0,271522,271522,0,"116","152",85825,85825
"3793",212832,"GWYNEDD MERCY COLLEGE                                       ","2003-2004",3,"All Track Combined",32400,32400,0,16200,16200,0,16200,16200,0,"14","14",7224,7224
"3797",177551,"HARRIS-STOWE STATE COLLEGE                                  ","2003-2004",3,"All Track Combined",28686,28686,0,13663,13663,0,15023,15023,0,"4","2",7608,7608
"3817",210669,"ALLEGHENY COLLEGE                                           ","2003-2004",3,"All Track Combined",137988,137988,0,68994,68994,0,68994,68994,0,"105","71",33384,33384
"3822",228431,"STEPHEN F AUSTIN STATE UNIVERSITY                           ","2003-2004",3,"All Track Combined",568696,568696,0,254777,254777,0,313919,313919,0,"84","73",57408,65292
"3827",221519,"SEWANEE-THE UNIVERSITY OF THE SOUTH                         ","2003-2004",3,"All Track Combined",241485,241485,0,121030,121030,0,120455,120455,0,"43","35",27971,27396
"3828",238333,"BELOIT COLLEGE                                              ","2003-2004",3,"All Track Combined",41041,41041,0,21197,21197,0,19844,19844,0,"47","44",21197,19844
"3837",173160,"BETHEL COLLEGE                                              ","2003-2004",3,"All Track Combined",122701,122701,0,73120,73120,0,49581,49581,0,"112","79",40544,15010
"3844",154712,"BENEDICTINE COLLEGE                                         ","2003-2004",3,"All Track Combined",143413,143413,0,67682,67682,0,75731,75731,0,"42","50",17595,17595
"3849",154101,"NORTHWESTERN COLLEGE                                        ","2003-2004",3,"All Track Combined",161806,161806,0,75379,75379,0,86427,86427,0,"33","34",18960,19535
"3851",155098,"FORT SCOTT COMMUNITY COLLEGE                                ","2003-2004",3,"All Track Combined",23594,23594,0,13476,13476,0,10118,10118,0,"15","5",4412,2942
"3859",219198,"MOUNT MARTY COLLEGE                                         ","2003-2004",3,"All Track Combined",116879,116879,0,49384,49384,0,67495,67495,0,"23","22",10284,10284
"3861",166027,"HARVARD UNIVERSITY                                          ","2003-2004",3,"All Track Combined",677556,677556,0,344328,344328,0,333228,333228,0,"118","133",125163,119349
"3866",167358,"NORTHEASTERN UNIVERSITY                                     ","2003-2004",3,"All Track Combined",951122,951122,0,392122,392122,0,559000,559000,0,"35","37",28816,28817
"3867",218724,"COASTAL CAROLINA UNIVERSITY                                 ","2003-2004",3,"All Track Combined",746707,746707,0,340255,340255,0,406452,406452,0,"45","29",64126,67092
"3870",155292,"KANSAS CITY KANSAS COMMUNITY COLLEGE                        ","2003-2004",3,"All Track Combined",130000,130000,0,65000,65000,0,65000,65000,0,"13","8",27000,27000
"3872",413723,"CASCADE COLLEGE                                             ","2003-2004",3,"All Track Combined",24711,24711,0,12356,13900,-1544,12355,10811,1544,"9","7",3770,2932
"3873",180984,"CONCORDIA UNIVERSITY                                        ","2003-2004",3,"All Track Combined",214668,214668,0,110554,110554,0,104114,104114,0,"55","46",14135,14168
"3882",215770,"SAINT JOSEPHS UNIVERSITY                                    ","2003-2004",3,"All Track Combined",927107,927107,0,448383,448383,0,478724,478724,0,"37","34",102640,100244
"3891",177339,"EVANGEL UNIVERSITY                                          ","2003-2004",3,"All Track Combined",92747,92747,0,44579,44579,0,48168,48168,0,"12","13",13000,14470
"3917",195003,"ROCHESTER INSTITUTE OF TECHNOLOGY                           ","2003-2004",3,"All Track Combined",69412,69412,0,34706,34706,0,34706,34706,0,"54","21",26404,26404
"3918",206862,"SOUTHERN NAZARENE UNIVERSITY                                ","2003-2004",3,"All Track Combined",234756,234756,0,117378,117378,0,117378,117378,0,"39","30",11428,11428
"3919",133492,"ECKERD COLLEGE                                              ","2003-2004",3,"All Track Combined",16526,16526,0,0,0,0,16526,16526,0,".","7",0,4411
"3920",192819,"MARIST COLLEGE                                              ","2003-2004",3,"All Track Combined",310607,310607,0,137422,137422,0,173185,173185,0,"109","74",30416,27088
"3926",163851,"SALISBURY UNIVERSITY                                        ","2003-2004",3,"All Track Combined",39858,39858,0,19929,19929,0,19929,19929,0,"45","35",14444,14444
"3930",204909,"OHIO WESLEYAN UNIVERSITY                                    ","2003-2004",3,"All Track Combined",136383,136383,0,68192,68192,0,68191,68191,0,"30","34",22161,22161
"3931",236133,"NORTHWEST COLLEGE OF THE ASSEMBLIES OF GOD                  ","2003-2004",3,"All Track Combined",197588,197588,0,7312,7312,0,190276,190276,0,"2","13",2929,38073
"3938",156541,"CUMBERLAND COLLEGE                                          ","2003-2004",3,"All Track Combined",317029,317029,0,200721,200721,0,116308,116308,0,"16","15",9104,16500
"3939",190619,"CUNY KINGSBOROUGH COMMUNITY COLLEGE                         ","2003-2004",3,"All Track Combined",19572,19572,0,19572,19572,0,0,0,0,"21",".",15572,0
"3941",202523,"DENISON UNIVERSITY                                          ","2003-2004",3,"All Track Combined",169330,169330,0,84075,84075,0,85255,85255,0,"35","38",15505,16796
"3945",160630,"SOUTHERN UNIVERSITY AT NEW ORLEANS                          ","2003-2004",3,"All Track Combined",235998,235998,0,117999,117999,0,117999,117999,0,"7","3",88358,88358
"3948",211291,"BUCKNELL UNIVERSITY                                         ","2003-2004",3,"All Track Combined",1231948,1231948,0,418198,418198,0,813750,813750,0,"169","178",106828,111356
"3949",155414,"KANSAS WESLEYAN UNIVERSITY                                  ","2003-2004",3,"All Track Combined",49966,49966,0,24983,24983,0,24983,24983,0,"11","15",7840,7840
"3960",130934,"DELAWARE STATE UNIVERSITY                                   ","2003-2004",3,"All Track Combined",436182,436182,0,251466,251466,0,184716,184716,0,"30","20",107163,43383
"3974",229063,"TEXAS SOUTHERN UNIVERSITY                                   ","2003-2004",3,"All Track Combined",481657,481657,0,173286,173286,0,308371,308371,0,"27","27",85525,174985
"3975",156213,"ASBURY COLLEGE                                              ","2003-2004",3,"All Track Combined",2895,2895,0,1592,1592,0,1303,1303,0,"5","9",1194,1194
"3978",190664,"CUNY QUEENS COLLEGE                                         ","2003-2004",5,"Fencing",11561,11561,0,0,0,0,11561,11561,0,".","7",0,1761
"3980",163976,"ST JOHN'S COLLEGE                                           ","2003-2004",5,"Fencing",4000,4000,0,2000,2000,0,2000,2000,0,"6","6",1000,1000
"3981",216339,"TEMPLE UNIVERSITY                                           ","2003-2004",5,"Fencing",240091,240091,0,0,0,0,240091,240091,0,".","15",0,41837
"3982",186867,"STEVENS INSTITUTE OF TECHNOLOGY                             ","2003-2004",5,"Fencing",141137,141137,0,39120,39120,0,102017,102017,0,"19","20",27620,28370
"3985",239017,"LAWRENCE UNIVERSITY                                         ","2003-2004",5,"Fencing",17132,17132,0,8566,8566,0,8566,8566,0,"19",".",6166,6166
"3987",165015,"BRANDEIS UNIVERSITY                                         ","2003-2004",5,"Fencing",79482,79482,0,39741,39741,0,39741,39741,0,"15","15",20434,20434
"3993",217156,"BROWN UNIVERSITY                                            ","2003-2004",5,"Fencing",60502,60502,0,30250,30250,0,30252,30252,0,"14","23",12609,12609
"3994",212911,"HAVERFORD COLLEGE                                           ","2003-2004",5,"Fencing",19030,19030,0,9615,9615,0,9415,9415,0,"20","13",9232,9032
"3996",166027,"HARVARD UNIVERSITY                                          ","2003-2004",5,"Fencing",158175,158175,0,80517,80517,0,77658,77658,0,"13","14",20238,17222
"4000",130253,"SACRED HEART UNIVERSITY                                     ","2003-2004",5,"Fencing",49268,49268,0,19237,19237,0,30031,30031,0,"10","9",4080,4022
"4005",193900,"NEW YORK UNIVERSITY                                         ","2003-2004",5,"Fencing",158752,158752,0,85063,85063,0,73689,73689,0,"24","21",50286,38912
"4008",202134,"CLEVELAND STATE UNIVERSITY                                  ","2003-2004",5,"Fencing",31512,31512,0,15715,15715,0,15797,15797,0,"9","12",13691,12831
"4017",168148,"TUFTS UNIVERSITY                                            ","2003-2004",5,"Fencing",28841,28841,0,0,0,0,28841,28841,0,".","13",0,8800
"4019",110404,"CALIFORNIA INSTITUTE OF TECHNOLOGY                          ","2003-2004",5,"Fencing",18668,18668,0,9334,9334,0,9334,9334,0,"19","6",4258,4258
"4022",221519,"SEWANEE-THE UNIVERSITY OF THE SOUTH                         ","2003-2004",6,"Field hocky",49796,49796,0,0,0,0,49796,49796,0,".","16",0,23145
"4023",204909,"OHIO WESLEYAN UNIVERSITY                                    ","2003-2004",6,"Field hocky",58596,58596,0,0,0,0,58596,58596,0,".","15",0,16389
"4025",212832,"GWYNEDD MERCY COLLEGE                                       ","2003-2004",6,"Field hocky",15230,15230,0,0,0,0,15230,15230,0,".","12",0,8230
"4029",211352,"CABRINI COLLEGE                                             ","2003-2004",6,"Field hocky",10768,10768,0,0,0,0,10768,10768,0,".","26",0,10560
"4031",215114,"PHILADELPHIA BIBLICAL UNIVERSITY-LANGHORNE                  ","2003-2004",6,"Field hocky",12784,12784,0,0,0,0,12784,12784,0,".","19",0,8429
"4033",204857,"OHIO UNIVERSITY-MAIN CAMPUS                                 ","2003-2004",6,"Field hocky",396683,396683,0,0,0,0,396683,396683,0,".","22",0,41460
"4036",202523,"DENISON UNIVERSITY                                          ","2003-2004",6,"Field hocky",57320,57320,0,0,0,0,57320,57320,0,".","24",0,25272
"4038",196121,"SUNY COLLEGE AT BROCKPORT                                   ","2003-2004",6,"Field hocky",17426,17426,0,0,0,0,17426,17426,0,".","25",0,16715
"4041",215770,"SAINT JOSEPHS UNIVERSITY                                    ","2003-2004",6,"Field hocky",300147,300147,0,0,0,0,300147,300147,0,".","22",0,59694
"4045",212911,"HAVERFORD COLLEGE                                           ","2003-2004",6,"Field hocky",23114,23114,0,0,0,0,23114,23114,0,".","16",0,22699
"4053",130493,"SOUTHERN CONNECTICUT STATE UNIVERSITY                       ","2003-2004",6,"Field hocky",72116,72116,0,0,0,0,72116,72116,0,".","23",0,59525
"4057",195474,"SIENA COLLEGE                                               ","2003-2004",6,"Field hocky",99123,99123,0,0,0,0,99123,99123,0,".","21",0,33137
"4059",204024,"MIAMI UNIVERSITY-OXFORD                                     ","2003-2004",6,"Field hocky",395290,395290,0,0,0,0,395290,395290,0,".","20",0,38932
"4064",129242,"FAIRFIELD UNIVERSITY                                        ","2003-2004",6,"Field hocky",160401,160401,0,0,0,0,160401,160401,0,".","21",0,24174
"4066",167729,"SALEM STATE COLLEGE                                         ","2003-2004",6,"Field hocky",15807,15807,0,0,0,0,15807,15807,0,".","20",0,8307
"4071",130253,"SACRED HEART UNIVERSITY                                     ","2003-2004",6,"Field hocky",207686,207686,0,0,0,0,207686,207686,0,".","21",0,33160
"4074",234173,"VIRGINIA WESLEYAN COLLEGE                                   ","2003-2004",6,"Field hocky",35766,35766,0,0,0,0,35766,35766,0,".","24",0,10740
"4075",213826,"MARYWOOD UNIVERSITY                                         ","2003-2004",6,"Field hocky",13234,13234,0,0,0,0,13234,13234,0,".","17",0,8323
"4084",212674,"GETTYSBURG COLLEGE                                          ","2003-2004",6,"Field hocky",67965,67965,0,0,0,0,67965,67965,0,".","26",0,13749
"4090",183080,"PLYMOUTH STATE UNIVERSITY                                   ","2003-2004",6,"Field hocky",37703,37703,0,0,0,0,37703,37703,0,".","19",0,18392
"4091",162760,"HOOD COLLEGE                                                ","2003-2004",6,"Field hocky",14411,14411,0,0,0,0,14411,14411,0,".","9",0,7911
"4092",215947,"SETON HILL UNIVERSITY                                       ","2003-2004",6,"Field hocky",76231,76231,0,0,0,0,76231,76231,0,".","17",0,17500
"4103",164447,"AMERICAN INTERNATIONAL COLLEGE                              ","2003-2004",6,"Field hocky",22549,22549,0,0,0,0,22549,22549,0,".","15",0,20849
"4106",167987,"UNIVERSITY OF MASSACHUSETTS-DARTMOUTH                       ","2003-2004",6,"Field hocky",36717,36717,0,0,0,0,36717,36717,0,".","22",0,13017
"4107",193584,"NAZARETH COLLEGE OF ROCHESTER                               ","2003-2004",6,"Field hocky",34476,34476,0,0,0,0,34476,34476,0,".","29",0,23539
"4109",161563,"THOMAS COLLEGE                                              ","2003-2004",6,"Field hocky",9812,9812,0,0,0,0,9812,9812,0,".","15",0,4862
"4113",131098,"WESLEY COLLEGE                                              ","2003-2004",6,"Field hocky",48404,48404,0,0,0,0,48404,48404,0,".","24",0,17350
"4114",165699,"ENDICOTT COLLEGE                                            ","2003-2004",6,"Field hocky",40212,40212,0,0,0,0,40212,40212,0,".","23",0,12800
"4120",128902,"CONNECTICUT COLLEGE                                         ","2003-2004",6,"Field hocky",65684,65684,0,0,0,0,65684,65684,0,".","20",0,11259
"4121",217156,"BROWN UNIVERSITY                                            ","2003-2004",6,"Field hocky",222077,222077,0,0,0,0,222077,222077,0,".","27",0,33181
"4128",196185,"SUNY COLLEGE AT ONEONTA                                     ","2003-2004",6,"Field hocky",76901,76901,0,0,0,0,76901,76901,0,".","22",0,11274
"4137",191533,"HARTWICK COLLEGE                                            ","2003-2004",6,"Field hocky",134163,134163,0,0,0,0,134163,134163,0,".","21",0,16741
"4138",168281,"WHEATON COLLEGE                                             ","2003-2004",6,"Field hocky",58375,58375,0,0,0,0,58375,58375,0,".","17",0,16855
"4140",186283,"RIDER UNIVERSITY                                            ","2003-2004",6,"Field hocky",208822,208822,0,0,0,0,208822,208822,0,".","19",0,31545
"4149",197133,"VASSAR COLLEGE                                              ","2003-2004",6,"Field hocky",51174,51174,0,0,0,0,51174,51174,0,".","19",0,18013
"4160",196051,"MORRISVILLE STATE COLLEGE                                   ","2003-2004",6,"Field hocky",18038,18038,0,0,0,0,18038,18038,0,".","15",0,10522
"4161",166124,"COLLEGE OF THE HOLY CROSS                                   ","2003-2004",6,"Field hocky",434693,434693,0,0,0,0,434693,434693,0,".","22",0,78561
"4171",210775,"ALVERNIA COLLEGE                                            ","2003-2004",6,"Field hocky",19670,19670,0,0,0,0,19670,19670,0,".","17",0,10132
"4174",163851,"SALISBURY UNIVERSITY                                        ","2003-2004",6,"Field hocky",25050,25050,0,0,0,0,25050,25050,0,".","29",0,9632
"4175",167358,"NORTHEASTERN UNIVERSITY                                     ","2003-2004",6,"Field hocky",753183,753183,0,0,0,0,753183,753183,0,".","26",0,49925
"4176",130590,"TRINITY COLLEGE                                             ","2003-2004",6,"Field hocky",71354,71354,0,0,0,0,71354,71354,0,".","20",0,13860
"4177",168148,"TUFTS UNIVERSITY                                            ","2003-2004",6,"Field hocky",44049,44049,0,0,0,0,44049,44049,0,".","22",0,9450
"4182",214069,"COLLEGE MISERICORDIA                                        ","2003-2004",6,"Field hocky",11631,11631,0,0,0,0,11631,11631,0,".","19",0,3448
"4186",232043,"EASTERN MENNONITE UNIVERSITY                                ","2003-2004",6,"Field hocky",19390,19390,0,0,0,0,19390,19390,0,".","15",0,2000
"4187",169248,"CENTRAL MICHIGAN UNIVERSITY                                 ","2003-2004",6,"Field hocky",415411,415411,0,0,0,0,415411,415411,0,".","20",0,47915
"4190",216852,"WIDENER UNIVERSITY-MAIN CAMPUS                              ","2003-2004",6,"Field hocky",31056,31056,0,0,0,0,31056,31056,0,".","30",0,8189
"4194",157818,"TRANSYLVANIA UNIVERSITY                                     ","2003-2004",6,"Field hocky",41576,41576,0,0,0,0,41576,41576,0,".","11",0,19032
"4195",213996,"MESSIAH COLLEGE                                             ","2003-2004",6,"Field hocky",62067,62067,0,0,0,0,62067,62067,0,".","31",0,29203
"4207",216339,"TEMPLE UNIVERSITY                                           ","2003-2004",6,"Field hocky",428909,428909,0,0,0,0,428909,428909,0,".","23",0,64203
"4212",165334,"CLARK UNIVERSITY                                            ","2003-2004",6,"Field hocky",45310,45310,0,0,0,0,45310,45310,0,".","19",0,11553
"4221",166027,"HARVARD UNIVERSITY                                          ","2003-2004",6,"Field hocky",266451,266451,0,0,0,0,266451,266451,0,".","49",0,82164
"4224",161457,"UNIVERSITY OF NEW ENGLAND                                   ","2003-2004",6,"Field hocky",22902,22902,0,0,0,0,22902,22902,0,".","24",0,13189
"4229",214272,"NEUMANN COLLEGE                                             ","2003-2004",6,"Field hocky",20599,20599,0,0,0,0,20599,20599,0,".","22",0,12800
"4231",203535,"KENYON COLLEGE                                              ","2003-2004",6,"Field hocky",42427,42427,0,0,0,0,42427,42427,0,".","28",0,17069
"4250",161004,"BOWDOIN COLLEGE                                             ","2003-2004",6,"Field hocky",86280,86280,0,0,0,0,86280,86280,0,".","21",0,13840
"4265",181534,"PERU STATE COLLEGE                                          ","2003-2004",7,"Football",262548,262548,0,262548,262548,0,0,0,0,"73",".",44891,0
"4274",105154,"MESA COMMUNITY COLLEGE                                      ","2003-2004",7,"Football",113000,113000,0,113000,113000,0,0,0,0,"85",".",54000,0
"4305",155186,"HIGHLAND COMMUNITY COLLEGE                                  ","2003-2004",7,"Football",294162,294162,0,294162,294162,0,0,0,0,"85",".",86956,0
"4306",130253,"SACRED HEART UNIVERSITY                                     ","2003-2004",7,"Football",866762,866762,0,866762,866762,0,0,0,0,"104",".",136618,0
"4310",145646,"ILLINOIS WESLEYAN UNIVERSITY                                ","2003-2004",7,"Football",167764,167764,0,167764,167764,0,0,0,0,"97",".",37570,0
"4327",155900,"SOUTHWESTERN COLLEGE                                        ","2003-2004",7,"Football",145972,145972,0,145972,145972,0,0,0,0,"58",".",48955,0
"4343",143288,"BLACKBURN COLLEGE                                           ","2003-2004",7,"Football",138202,138202,0,138202,138202,0,0,0,0,"53",".",39057,0
"4345",173258,"CARLETON COLLEGE                                            ","2003-2004",7,"Football",209549,209549,0,209549,209549,0,0,0,0,"53",".",60697,0
"4351",105428,"PHOENIX COLLEGE                                             ","2003-2004",7,"Football",115200,115200,0,115200,115200,0,0,0,0,"55",".",39200,0
"4352",106467,"ARKANSAS TECH UNIVERSITY                                    ","2003-2004",7,"Football",710785,710785,0,710785,710785,0,0,0,0,"141",".",93324,0
"4356",112686,"COMPTON COMMUNITY COLLEGE                                   ","2003-2004",7,"Football",73000,73000,0,73000,73000,0,0,0,0,"105",".",55000,0
"4362",144050,"UNIVERSITY OF CHICAGO                                       ","2003-2004",7,"Football",343422,343422,0,343422,343422,0,0,0,0,"58",".",149932,0
"4363",219091,"DAKOTA WESLEYAN UNIVERSITY                                  ","2003-2004",7,"Football",244567,244567,0,244567,244567,0,0,0,0,"90",".",47775,0
"4365",176008,"MISSISSIPPI DELTA COMMUNITY COLLEGE                         ","2003-2004",7,"Football",192668,192668,0,192668,192668,0,0,0,0,"55",".",52885,0
"4367",203368,"JOHN CARROLL UNIVERSITY                                     ","2003-2004",7,"Football",389042,389042,0,389042,389042,0,0,0,0,"175",".",64796,0
"4369",213385,"LAFAYETTE COLLEGE                                           ","2003-2004",7,"Football",2461679,2461679,0,2461679,2461679,0,0,0,0,"93",".",217597,0
"4373",125091,"VICTOR VALLEY COLLEGE                                       ","2003-2004",7,"Football",77372,77372,0,77372,77372,0,0,0,0,"59",".",20472,0
"4374",155195,"HUTCHINSON COMMUNITY COLLEGE                                ","2003-2004",7,"Football",187517,187517,0,187517,187517,0,0,0,0,"55",".",28971,0
"4379",176628,"AVILA UNIVERSITY                                            ","2003-2004",7,"Football",611243,611243,0,611243,611243,0,0,0,0,"101",".",53493,0
"4390",101879,"UNIVERSITY OF NORTH ALABAMA                                 ","2003-2004",7,"Football",973141,973141,0,973141,973141,0,0,0,0,"121",".",163760,0
"4391",125471,"WEST LOS ANGELES COLLEGE                                    ","2003-2004",7,"Football",57507,57507,0,57507,57507,0,0,0,0,"52",".",27925,0
"4393",167358,"NORTHEASTERN UNIVERSITY                                     ","2003-2004",7,"Football",2857096,2857096,0,2857096,2857096,0,0,0,0,"85",".",246888,0
"4398",122977,"SANTA MONICA COLLEGE                                        ","2003-2004",7,"Football",50675,50675,0,50675,50675,0,0,0,0,"63",".",16675,0
"4404",150163,"BUTLER UNIVERSITY                                           ","2003-2004",7,"Football",346066,346066,0,346066,346066,0,0,0,0,"65",".",99803,0
"4406",175652,"EAST MISSISSIPPI COMMUNITY COLLEGE                          ","2003-2004",7,"Football",240362,240362,0,240362,240362,0,0,0,0,"55",".",46040,0
"4429",117247,"LANEY COLLEGE                                               ","2003-2004",7,"Football",79705,79705,0,79705,79705,0,0,0,0,"67",".",79663,0
"4433",175856,"JACKSON STATE UNIVERSITY                                    ","2003-2004",7,"Football",1511835,1511835,0,1511835,1511835,0,0,0,0,"84",".",480780,0
"4435",220978,"MIDDLE TENNESSEE STATE UNIVERSITY                           ","2003-2004",7,"Football",4107458,4107458,0,4107458,4107458,0,0,0,0,"125",".",641543,0
"4454",147244,"MILLIKIN UNIVERSITY                                         ","2003-2004",7,"Football",171517,171517,0,171517,171517,0,0,0,0,"124",".",65470,0
"4496",120254,"OCCIDENTAL COLLEGE                                          ","2003-2004",7,"Football",357672,357672,0,357672,357672,0,0,0,0,"76",".",105637,0
"4505",157058,"KENTUCKY STATE UNIVERSITY                                   ","2003-2004",7,"Football",539000,539000,0,539000,539000,0,0,0,0,"75",".",106000,0
"4521",181127,"HASTINGS COLLEGE                                            ","2003-2004",7,"Football",1189627,1189627,0,1189627,1189627,0,0,0,0,"151",".",85102,0
"4523",125499,"WEST VALLEY COLLEGE                                         ","2003-2004",7,"Football",66196,66196,0,66196,66196,0,0,0,0,"76",".",12160,0
"4524",216339,"TEMPLE UNIVERSITY                                           ","2003-2004",7,"Football",7982744,7982744,0,7982744,7982744,0,0,0,0,"125",".",1486080,0
"4527",202523,"DENISON UNIVERSITY                                          ","2003-2004",7,"Football",145053,145053,0,145053,145053,0,0,0,0,"82",".",50430,0
"4532",121044,"PASADENA CITY COLLEGE                                       ","2003-2004",7,"Football",123164,123164,0,123164,123164,0,0,0,0,"75",".",15000,0
"4534",154712,"BENEDICTINE COLLEGE                                         ","2003-2004",7,"Football",1324044,1324044,0,1324044,1324044,0,0,0,0,"196",".",75360,0
"4538",123554,"SAINT MARYS COLLEGE OF CALIFORNIA                           ","2003-2004",7,"Football",1207559,1207559,0,1207559,1207559,0,0,0,0,"83",".",264727,0
"4540",222983,"AUSTIN COLLEGE                                              ","2003-2004",7,"Football",214926,214926,0,214926,214926,0,0,0,0,"73",".",69445,0
"4543",227146,"NAVARRO COLLEGE                                             ","2003-2004",7,"Football",385377,385377,0,385377,385377,0,0,0,0,"85",".",39452,0
"4548",229355,"TYLER JUNIOR COLLEGE                                        ","2003-2004",7,"Football",411507,411507,0,411507,411507,0,0,0,0,"80",".",83514,0
"4550",195474,"SIENA COLLEGE                                               ","2003-2004",7,"Football",257210,257210,0,257210,257210,0,0,0,0,"86",".",252878,0
"4555",149842,"WILLIAM RAINEY HARPER COLLEGE                               ","2003-2004",7,"Football",88374,88374,0,88374,88374,0,0,0,0,"92",".",47104,0
"4556",101435,"HUNTINGDON COLLEGE                                          ","2003-2004",7,"Football",360648,360648,0,360648,360648,0,0,0,0,"70",".",157540,0
"4558",212674,"GETTYSBURG COLLEGE                                          ","2003-2004",7,"Football",197741,197741,0,197741,197741,0,0,0,0,"92",".",44428,0
"4559",196051,"MORRISVILLE STATE COLLEGE                                   ","2003-2004",7,"Football",134215,134215,0,134215,134215,0,0,0,0,"99",".",100965,0
"4560",164447,"AMERICAN INTERNATIONAL COLLEGE                              ","2003-2004",7,"Football",125888,125888,0,125888,125888,0,0,0,0,"90",".",122885,0
"4561",157535,"PIKEVILLE COLLEGE                                           ","2003-2004",7,"Football",232834,232834,0,232834,232834,0,0,0,0,"61",".",82950,0
"4565",126182,"ADAMS STATE COLLEGE                                         ","2003-2004",7,"Football",448597,448597,0,448597,448597,0,0,0,0,"137",".",76288,0
"4567",215947,"SETON HILL UNIVERSITY                                       ","2003-2004",7,"Football",238100,238100,0,238100,238100,0,0,0,0,"31",".",60000,0
"4568",117733,"LOS ANGELES VALLEY COLLEGE                                  ","2003-2004",7,"Football",92990,92990,0,92990,92990,0,0,0,0,"75",".",36684,0
"4578",200572,"VALLEY CITY STATE UNIVERSITY                                ","2003-2004",7,"Football",116175,116175,0,116175,116175,0,0,0,0,"88",".",35176,0
"4579",161004,"BOWDOIN COLLEGE                                             ","2003-2004",7,"Football",369469,369469,0,369469,369469,0,0,0,0,"75",".",27423,0
"4586",122436,"UNIVERSITY OF SAN DIEGO                                     ","2003-2004",7,"Football",638234,638234,0,638234,638234,0,0,0,0,"91",".",327341,0
"4591",173124,"BEMIDJI STATE UNIVERSITY                                    ","2003-2004",7,"Football",385048,385048,0,385048,385048,0,0,0,0,"110",".",103678,0
"4597",178624,"NORTHWEST MISSOURI STATE UNIVERSITY                         ","2003-2004",7,"Football",830194,830194,0,830194,830194,0,0,0,0,"122",".",25601,0
"4598",159568,"LOUISIANA COLLEGE                                           ","2003-2004",7,"Football",375396,375396,0,375396,375396,0,0,0,0,"85",".",92156,0
"4603",166124,"COLLEGE OF THE HOLY CROSS                                   ","2003-2004",7,"Football",2938306,2938306,0,2938306,2938306,0,0,0,0,"106",".",358537,0
"4605",118718,"MERCED COLLEGE                                              ","2003-2004",7,"Football",42090,42090,0,42090,42090,0,0,0,0,"65",".",25810,0
"4607",155414,"KANSAS WESLEYAN UNIVERSITY                                  ","2003-2004",7,"Football",189425,189425,0,189425,189425,0,0,0,0,"86",".",55967,0
"4610",237899,"WEST VIRGINIA STATE COLLEGE                                 ","2003-2004",7,"Football",415949,415949,0,415949,415949,0,0,0,0,"103",".",123600,0
"4613",201195,"BALDWIN-WALLACE COLLEGE                                     ","2003-2004",7,"Football",475684,475684,0,475684,475684,0,0,0,0,"165",".",132774,0
"4623",226471,"UNIVERSITY OF MARY HARDIN-BAYLOR                            ","2003-2004",7,"Football",450838,450838,0,450838,450838,0,0,0,0,"123",".",93017,0
"4624",167987,"UNIVERSITY OF MASSACHUSETTS-DARTMOUTH                       ","2003-2004",7,"Football",89867,89867,0,89867,89867,0,0,0,0,"70",".",38762,0
"4626",168148,"TUFTS UNIVERSITY                                            ","2003-2004",7,"Football",163548,163548,0,163548,163548,0,0,0,0,"73",".",32300,0
"4632",196121,"SUNY COLLEGE AT BROCKPORT                                   ","2003-2004",7,"Football",180736,180736,0,180736,180736,0,0,0,0,"100",".",67889,0
"4634",232025,"EMORY AND HENRY COLLEGE                                     ","2003-2004",7,"Football",337472,337472,0,337472,337472,0,0,0,0,"105",".",76744,0
"4641",119067,"MONTEREY PENINSULA COLLEGE                                  ","2003-2004",7,"Football",67640,67640,0,67640,67640,0,0,0,0,"44",".",38368,0
"4646",198756,"JOHNSON C SMITH UNIVERSITY                                  ","2003-2004",7,"Football",483747,483747,0,483747,483747,0,0,0,0,"51",".",96490,0
"4656",191533,"HARTWICK COLLEGE                                            ","2003-2004",7,"Football",277106,277106,0,277106,277106,0,0,0,0,"105",".",46754,0
"4658",104577,"EASTERN ARIZONA COLLEGE                                     ","2003-2004",7,"Football",460452,460452,0,460452,460452,0,0,0,0,"85",".",189350,0
"4671",239017,"LAWRENCE UNIVERSITY                                         ","2003-2004",7,"Football",102837,102837,0,102837,102837,0,0,0,0,"49",".",47237,0
"4681",122375,"SAN DIEGO MESA COLLEGE                                      ","2003-2004",7,"Football",72494,72494,0,72494,72494,0,0,0,0,"87",".",22001,0
"4687",221953,"TUSCULUM COLLEGE                                            ","2003-2004",7,"Football",1024563,1024563,0,1024563,1024563,0,0,0,0,"116",".",110722,0
"4703",212160,"EDINBORO UNIVERSITY OF PENNSYLVANIA                         ","2003-2004",7,"Football",631759,631759,0,631759,631759,0,0,0,0,"90",".",86587,0
"4704",106485,"UNIVERSITY OF ARKANSAS AT MONTICELLO                        ","2003-2004",7,"Football",516561,516561,0,516561,516561,0,0,0,0,"83",".",68989,0
"4716",228431,"STEPHEN F AUSTIN STATE UNIVERSITY                           ","2003-2004",7,"Football",1644681,1644681,0,1644681,1644681,0,0,0,0,"101",".",278985,0
"4734",208646,"EASTERN OREGON UNIVERSITY                                   ","2003-2004",7,"Football",312306,312306,0,312306,312306,0,0,0,0,"94",".",101651,0
"4737",165574,"DEAN COLLEGE                                                ","2003-2004",7,"Football",145865,145865,0,145865,145865,0,0,0,0,"66",".",37907,0
"4741",227687,"RANGER COLLEGE                                              ","2003-2004",7,"Football",247596,247596,0,247596,247596,0,0,0,0,"65",".",19975,0
"4742",126775,"COLORADO SCHOOL OF MINES                                    ","2003-2004",7,"Football",608981,608981,0,608981,608981,0,0,0,0,"92",".",116082,0
"4743",176965,"CENTRAL MISSOURI STATE UNIVERSITY                           ","2003-2004",7,"Football",1201743,1201743,0,1201743,1201743,0,0,0,0,"100",".",152180,0
"4751",138947,"CLARK ATLANTA UNIVERSITY                                    ","2003-2004",7,"Football",554000,554000,0,554000,554000,0,0,0,0,"45",".",3e+05,0
"4758",117715,"LOS ANGELES SOUTHWEST COLLEGE                               ","2003-2004",7,"Football",56172,56172,0,56172,56172,0,0,0,0,"55",".",40000,0
"4761",218724,"COASTAL CAROLINA UNIVERSITY                                 ","2003-2004",7,"Football",1447799,1447799,0,1447799,1447799,0,0,0,0,"120",".",292547,0
"4785",113856,"EAST LOS ANGELES COLLEGE                                    ","2003-2004",7,"Football",34817,34817,0,34817,34817,0,0,0,0,"60",".",4251,0
"4808",200226,"MAYVILLE STATE UNIVERSITY                                   ","2003-2004",7,"Football",41547,41547,0,41547,41547,0,0,0,0,"44",".",40169,0
"4831",210669,"ALLEGHENY COLLEGE                                           ","2003-2004",7,"Football",263200,263200,0,263200,263200,0,0,0,0,"115",".",62490,0
"4835",174914,"UNIVERSITY OF ST THOMAS                                     ","2003-2004",7,"Football",275033,275033,0,275033,275033,0,0,0,0,"98",".",107198,0
"4836",173735,"HIBBING COMMUNITY COLLEGE-A TECH AND COMM COLL              ","2003-2004",7,"Football",38685,38685,0,38685,38685,0,0,0,0,"59",".",25835,0
"4864",238458,"CARROLL COLLEGE                                             ","2003-2004",7,"Football",146192,146192,0,146192,146192,0,0,0,0,"72",".",26738,0
"4867",168528,"ADRIAN COLLEGE                                              ","2003-2004",7,"Football",185675,185675,0,185675,185675,0,0,0,0,"115",".",159407,0
"4869",186432,"SAINT PETERS COLLEGE                                        ","2003-2004",7,"Football",369599,369599,0,369599,369599,0,0,0,0,"76",".",232965,0
"4891",123527,"SAN BERNARDINO VALLEY COLLEGE                               ","2003-2004",7,"Football",83573,83573,0,83573,83573,0,0,0,0,"64",".",62789,0
"4901",145691,"ILLINOIS COLLEGE                                            ","2003-2004",7,"Football",181529,181529,0,181529,181529,0,0,0,0,"65",".",61815,0
"4908",176239,"PEARL RIVER COMMUNITY COLLEGE                               ","2003-2004",7,"Football",333808,333808,0,333808,333808,0,0,0,0,"61",".",90717,0
"4912",183080,"PLYMOUTH STATE UNIVERSITY                                   ","2003-2004",7,"Football",171724,171724,0,171724,171724,0,0,0,0,"80",".",59062,0
"4921",111887,"CERRITOS COLLEGE                                            ","2003-2004",7,"Football",107927,107927,0,107927,107927,0,0,0,0,"105",".",8500,0
"4930",112260,"CLAREMONT MCKENNA COLLEGE                                   ","2003-2004",7,"Football",226938,226938,0,226938,226938,0,0,0,0,"69",".",79432,0
"4934",192819,"MARIST COLLEGE                                              ","2003-2004",7,"Football",391019,391019,0,391019,391019,0,0,0,0,"110",".",99815,0
"4937",169248,"CENTRAL MICHIGAN UNIVERSITY                                 ","2003-2004",7,"Football",3282746,3282746,0,3282746,3282746,0,0,0,0,"111",".",315849,0
"4941",204909,"OHIO WESLEYAN UNIVERSITY                                    ","2003-2004",7,"Football",154477,154477,0,154477,154477,0,0,0,0,"71",".",65628,0
"4959",200217,"UNIVERSITY OF MARY                                          ","2003-2004",7,"Football",504242,504242,0,504242,504242,0,0,0,0,"103",".",91979,0
"4963",238333,"BELOIT COLLEGE                                              ","2003-2004",7,"Football",23868,23868,0,23868,23868,0,0,0,0,"39",".",23868,0
"4964",166948,"MOUNT IDA COLLEGE                                           ","2003-2004",7,"Football",92490,92490,0,92490,92490,0,0,0,0,"70",".",71490,0
"4970",152567,"TRI-STATE UNIVERSITY                                        ","2003-2004",7,"Football",270063,270063,0,270063,270063,0,0,0,0,"65",".",52301,0
"4972",173203,"CENTRAL LAKES COLLEGE-BRAINERD                              ","2003-2004",7,"Football",32811,32811,0,32811,32811,0,0,0,0,"32",".",15074,0
"4975",173160,"BETHEL COLLEGE                                              ","2003-2004",7,"Football",345262,345262,0,345262,345262,0,0,0,0,"108",".",172152,0
"4992",230597,"SNOW COLLEGE                                                ","2003-2004",7,"Football",99000,99000,0,99000,99000,0,0,0,0,"98",".",89000,0
"4994",104160,"ARIZONA WESTERN COLLEGE                                     ","2003-2004",7,"Football",312036,312036,0,312036,312036,0,0,0,0,"75",".",79626,0
"4997",130493,"SOUTHERN CONNECTICUT STATE UNIVERSITY                       ","2003-2004",7,"Football",241181,241181,0,241181,241181,0,0,0,0,"88",".",126523,0
"5005",156082,"WASHBURN UNIVERSITY OF TOPEKA                               ","2003-2004",7,"Football",135974,135974,0,135974,135974,0,0,0,0,"94",".",99102,0
"5009",193478,"NASSAU COMMUNITY COLLEGE                                    ","2003-2004",7,"Football",111729,111729,0,111729,111729,0,0,0,0,"93",".",56775,0
"5012",130934,"DELAWARE STATE UNIVERSITY                                   ","2003-2004",7,"Football",1391837,1391837,0,1391837,1391837,0,0,0,0,"79",".",243686,0
"5019",131098,"WESLEY COLLEGE                                              ","2003-2004",7,"Football",140622,140622,0,140622,140622,0,0,0,0,"114",".",85850,0
"5023",218539,"PRESBYTERIAN COLLEGE                                        ","2003-2004",7,"Football",1101477,1101477,0,1101477,1101477,0,0,0,0,"103",".",82045,0
"5034",198835,"LENOIR-RHYNE COLLEGE                                        ","2003-2004",7,"Football",910069,910069,0,910069,910069,0,0,0,0,"98",".",392976,0
"5039",207847,"SOUTHEASTERN OKLAHOMA STATE UNIVERSITY                      ","2003-2004",7,"Football",429933,429933,0,429933,429933,0,0,0,0,"111",".",66517,0
"5044",156541,"CUMBERLAND COLLEGE                                          ","2003-2004",7,"Football",659474,659474,0,659474,659474,0,0,0,0,"67",".",42411,0
"5049",163851,"SALISBURY UNIVERSITY                                        ","2003-2004",7,"Football",135456,135456,0,135456,135456,0,0,0,0,"105",".",34063,0
"5051",101480,"JACKSONVILLE STATE UNIVERSITY                               ","2003-2004",7,"Football",1786481,1786481,0,1786481,1786481,0,0,0,0,"115",".",1786480,0
"5060",154493,"UPPER IOWA UNIVERSITY                                       ","2003-2004",7,"Football",389032,389032,0,389032,389032,0,0,0,0,"113",".",88559,0
"5067",203775,"MALONE COLLEGE                                              ","2003-2004",7,"Football",640034,640034,0,640034,640034,0,0,0,0,"99",".",161034,0
"5069",166027,"HARVARD UNIVERSITY                                          ","2003-2004",7,"Football",1847794,1847794,0,1847794,1847794,0,0,0,0,"112",".",200669,0
"5106",105154,"MESA COMMUNITY COLLEGE                                      ","2003-2004",8,"Golf",16000,16000,0,8000,8000,0,8000,8000,0,"10","10",3900,3900
"5110",175883,"JONES COUNTY JUNIOR COLLEGE                                 ","2003-2004",8,"Golf",26807,26807,0,26807,26807,0,0,0,0,"8",".",7185,0
"5114",174914,"UNIVERSITY OF ST THOMAS                                     ","2003-2004",8,"Golf",64674,64674,0,35022,35022,0,29652,29652,0,"13","11",21350,17380
"5116",173124,"BEMIDJI STATE UNIVERSITY                                    ","2003-2004",8,"Golf",40903,40903,0,25193,25193,0,15710,15710,0,"14","2",15306,9710
"5121",181534,"PERU STATE COLLEGE                                          ","2003-2004",8,"Golf",23310,23310,0,0,0,0,23310,23310,0,".","5",0,5116
"5142",219091,"DAKOTA WESLEYAN UNIVERSITY                                  ","2003-2004",8,"Golf",80764,80764,0,34131,34131,0,46633,46633,0,"13","10",5959,16028
"5149",213525,"LEHIGH CARBON COMMUNITY COLLEGE                             ","2003-2004",8,"Golf",3730,3730,0,3357,3357,0,373,373,0,"9","1",1350,150
"5150",399212,"SANTIAGO CANYON COLLEGE                                     ","2003-2004",8,"Golf",49176,49176,0,25491,25491,0,23685,23685,0,"11","6",4491,2685
"5151",125091,"VICTOR VALLEY COLLEGE                                       ","2003-2004",8,"Golf",17433,17433,0,17433,17433,0,0,0,0,"6",".",4907,0
"5152",183910,"CALDWELL COLLEGE                                            ","2003-2004",8,"Golf",27212,27212,0,27212,27212,0,0,0,0,"8",".",1155,0
"5154",161484,"NORTHERN MAINE TECHNICAL COLLEGE                            ","2003-2004",8,"Golf",4610,4610,0,4610,4610,0,0,0,0,"6","0",2936,0
"5157",130253,"SACRED HEART UNIVERSITY                                     ","2003-2004",8,"Golf",163436,163436,0,88286,88286,0,75150,75150,0,"6","7",16623,7937
"5174",157818,"TRANSYLVANIA UNIVERSITY                                     ","2003-2004",8,"Golf",40304,40304,0,24375,24375,0,15929,15929,0,"9","7",13389,10383
"5176",170055,"GRAND RAPIDS COMMUNITY COLLEGE                              ","2003-2004",8,"Golf",12847,12847,0,12847,12847,0,0,0,0,"8",".",4325,0
"5179",157535,"PIKEVILLE COLLEGE                                           ","2003-2004",8,"Golf",19528,19528,0,14321,14321,0,5207,5207,0,"11","4",14320,5206
"5180",366252,"PENNSYLVANIA COLLEGE OF TECHNOLOGY                          ","2003-2004",8,"Golf",7034,7034,0,3517,3517,0,3517,3517,0,"10",".",4280,0
"5184",143288,"BLACKBURN COLLEGE                                           ","2003-2004",8,"Golf",15641,15641,0,15641,15641,0,0,0,0,"12",".",12514,0
"5186",139311,"CLAYTON COLLEGE AND STATE UNIVERSITY                        ","2003-2004",8,"Golf",41707,41707,0,41707,41707,0,0,0,0,"7",".",27106,0
"5187",181127,"HASTINGS COLLEGE                                            ","2003-2004",8,"Golf",156483,156483,0,99414,99414,0,57069,57069,0,"17","9",6659,6319
"5189",229355,"TYLER JUNIOR COLLEGE                                        ","2003-2004",8,"Golf",119787,119787,0,55136,55136,0,64651,64651,0,"11","9",19809,17250
"5194",155900,"SOUTHWESTERN COLLEGE                                        ","2003-2004",8,"Golf",38963,38963,0,19494,19494,0,19469,19469,0,"11","7",16239,15861
"5198",193016,"MERCY COLLEGE-MAIN CAMPUS                                   ","2003-2004",8,"Golf",7000,7000,0,7000,7000,0,0,0,0,"5","0",2500,0
"5205",110714,"UNIVERSITY OF CALIFORNIA-SANTA CRUZ                         ","2003-2004",8,"Golf",31759,31759,0,0,0,0,31759,31759,0,".","8",0,16353
"5209",240596,"EASTERN WYOMING COLLEGE                                     ","2003-2004",8,"Golf",15084,15084,0,15084,15084,0,0,0,0,"7",".",7693,0
"5215",150163,"BUTLER UNIVERSITY                                           ","2003-2004",8,"Golf",178530,178530,0,98372,98372,0,80158,80158,0,"10","13",17418,13961
"5219",181853,"YORK COLLEGE                                                ","2003-2004",8,"Golf",24620,24620,0,12310,12310,0,12310,12310,0,"13",".",8505,3780
"5223",217420,"RHODE ISLAND COLLEGE                                        ","2003-2004",8,"Golf",5902,5902,0,5902,5902,0,0,0,0,"5",".",520,0
"5233",189547,"BROOME COMMUNITY COLLEGE                                    ","2003-2004",8,"Golf",9351,9351,0,9351,9351,0,0,0,0,"6",".",4941,0
"5234",206914,"CAMERON UNIVERSITY                                          ","2003-2004",8,"Golf",39461,39461,0,39461,39461,0,0,0,0,"13",".",28649,0
"5236",173258,"CARLETON COLLEGE                                            ","2003-2004",8,"Golf",34666,34666,0,16089,16089,0,18577,18577,0,"6","5",6284,8943
"5241",163046,"LOYOLA COLLEGE IN MARYLAND                                  ","2003-2004",8,"Golf",163529,163529,0,163529,163529,0,0,0,0,"9",".",67748,0
"5246",175856,"JACKSON STATE UNIVERSITY                                    ","2003-2004",8,"Golf",221962,221962,0,118235,118235,0,103727,103727,0,"10","6",30285,54590
"5251",190840,"DUTCHESS COMMUNITY COLLEGE                                  ","2003-2004",8,"Golf",3000,3000,0,3000,3000,0,0,0,0,"8",".",1500,0
"5262",165574,"DEAN COLLEGE                                                ","2003-2004",8,"Golf",6604,6604,0,6604,6604,0,0,0,0,"5",".",4104,0
"5264",190664,"CUNY QUEENS COLLEGE                                         ","2003-2004",8,"Golf",49927,49927,0,49927,49927,0,0,0,0,"7",".",4682,0
"5265",155195,"HUTCHINSON COMMUNITY COLLEGE                                ","2003-2004",8,"Golf",33736,33736,0,33736,33736,0,0,0,0,"7",".",4323,0
"5271",168786,"AQUINAS COLLEGE                                             ","2003-2004",8,"Golf",16000,16000,0,8000,8000,0,8000,8000,0,"10","9",10000,9000
"5272",165112,"BUNKER HILL COMMUNITY COLLEGE                               ","2003-2004",8,"Golf",3300,3300,0,3300,3300,0,0,0,0,"1",".",177,0
"5273",154642,"ALLEN COUNTY COMMUNITY COLLEGE                              ","2003-2004",8,"Golf",14636,14636,0,14636,14636,0,0,0,0,"9",".",10277,0
"5281",162557,"FREDERICK COMMUNITY COLLEGE                                 ","2003-2004",8,"Golf",3034,3034,0,3034,3034,0,0,0,0,"6",".",1068,0
"5292",129242,"FAIRFIELD UNIVERSITY                                        ","2003-2004",8,"Golf",64113,64113,0,37496,37496,0,26617,26617,0,"13","11",26049,14623
"5296",215947,"SETON HILL UNIVERSITY                                       ","2003-2004",8,"Golf",69243,69243,0,57009,57009,0,12234,12234,0,"19","12",10700,9000
"5297",175652,"EAST MISSISSIPPI COMMUNITY COLLEGE                          ","2003-2004",8,"Golf",12158,12158,0,12158,12158,0,0,0,0,"6",".",7595,0
"5302",366395,"SUFFOLK COUNTY COMMUNITY COLLEGE                            ","2003-2004",8,"Golf",8474,8474,0,8474,8474,0,0,0,0,"8",".",4248,0
"5303",101709,"UNIVERSITY OF MONTEVALLO                                    ","2003-2004",8,"Golf",107360,107360,0,55787,55787,0,51573,51573,0,"10","5",16901,16307
"5305",214704,"PENNSYLVANIA STATE UNIVERSITY-PENN STATE BERKS              ","2003-2004",8,"Golf",7157,7157,0,7157,7157,0,0,0,0,"9",".",3557,0
"5307",187198,"UNION COUNTY COLLEGE                                        ","2003-2004",8,"Golf",13500,13500,0,13500,13500,0,0,0,0,"6",".",8000,0
"5308",127389,"LAMAR COMMUNITY COLLEGE                                     ","2003-2004",8,"Golf",37574,37574,0,37574,37574,0,0,0,0,"8",".",6052,0
"5311",136950,"ROLLINS COLLEGE                                             ","2003-2004",8,"Golf",382012,382012,0,153250,153250,0,228762,228762,0,"13","8",25542,40592
"5314",237950,"WEST VIRGINIA UNIVERSITY INSTITUTE OF TECHNOLOGY            ","2003-2004",8,"Golf",6614,6614,0,6614,6614,0,0,0,0,"7",".",4892,0
"5317",193584,"NAZARETH COLLEGE OF ROCHESTER                               ","2003-2004",8,"Golf",21480,21480,0,11610,11610,0,9870,9870,0,"8","6",8635,7020
"5322",228431,"STEPHEN F AUSTIN STATE UNIVERSITY                           ","2003-2004",8,"Golf",101824,101824,0,101824,101824,0,0,0,0,"12",".",26872,0
"5328",168227,"WENTWORTH INSTITUTE OF TECHNOLOGY                           ","2003-2004",8,"Golf",10263,10263,0,10263,10263,0,0,0,0,"7",".",5753,0
"5337",215114,"PHILADELPHIA BIBLICAL UNIVERSITY-LANGHORNE                  ","2003-2004",8,"Golf",3784,3784,0,3784,3784,0,0,0,0,"6",".",3784,0
"5339",240471,"UNIVERSITY OF WISCONSIN-RIVER FALLS                         ","2003-2004",8,"Golf",15585,15585,0,0,0,0,15585,15585,0,".","8",0,7168
"5343",129525,"UNIVERSITY OF HARTFORD                                      ","2003-2004",8,"Golf",302682,302682,0,151044,151044,0,151638,151638,0,"8","6",19123,20480
"5347",232706,"MARYMOUNT UNIVERSITY                                        ","2003-2004",8,"Golf",5541,5541,0,5541,5541,0,0,0,0,"6",".",4622,0
"5353",174491,"NORTHWESTERN COLLEGE                                        ","2003-2004",8,"Golf",5778,5778,0,5778,5778,0,0,0,0,"7",".",4444,0
"5354",157058,"KENTUCKY STATE UNIVERSITY                                   ","2003-2004",8,"Golf",13300,13300,0,13300,13300,0,0,0,0,"6",".",7300,0
"5357",122436,"UNIVERSITY OF SAN DIEGO                                     ","2003-2004",8,"Golf",204594,204594,0,204594,204594,0,0,0,0,"11",".",57446,0
"5358",183026,"SOUTHERN NEW HAMPSHIRE UNIVERSITY                           ","2003-2004",8,"Golf",35660,35660,0,35660,35660,0,0,0,0,"7",".",21169,0
"5360",148335,"ROBERT MORRIS COLLEGE                                       ","2003-2004",8,"Golf",155903,155903,0,55334,55334,0,100569,100569,0,"6","4",23309,23854
"5361",144564,"DANVILLE AREA COMMUNITY COLLEGE                             ","2003-2004",8,"Golf",17058,17058,0,17058,17058,0,0,0,0,"10",".",17057,0
"5362",211981,"DELAWARE VALLEY COLLEGE                                     ","2003-2004",8,"Golf",10100,10100,0,10100,10100,0,0,0,0,"12","0",5250,0
"5363",190044,"CLARKSON UNIVERSITY                                         ","2003-2004",8,"Golf",31016,31016,0,31016,31016,0,0,0,0,"16",".",9983,0
"5368",220181,"FISK UNIVERSITY                                             ","2003-2004",8,"Golf",3000,3000,0,3000,3000,0,0,0,0,"5",".",2500,0
"5380",175157,"VERMILION COMMUNITY COLLEGE                                 ","2003-2004",8,"Golf",1305,1305,0,1305,1305,0,0,0,0,"5",".",1,0
"5384",203368,"JOHN CARROLL UNIVERSITY                                     ","2003-2004",8,"Golf",64228,64228,0,38020,38020,0,26208,26208,0,"10","10",7925,6953
"5388",110404,"CALIFORNIA INSTITUTE OF TECHNOLOGY                          ","2003-2004",8,"Golf",13881,13881,0,13881,13881,0,0,0,0,"6",".",3657,0
"5398",146612,"LEWIS UNIVERSITY                                            ","2003-2004",8,"Golf",88691,88691,0,55217,55217,0,33474,33474,0,"9","5",9482,7239
"5400",198835,"LENOIR-RHYNE COLLEGE                                        ","2003-2004",8,"Golf",130878,130878,0,65822,65822,0,65056,65056,0,"4","10",36822,38056
"5407",155210,"JOHNSON COUNTY COMMUNITY COLLEGE                            ","2003-2004",8,"Golf",45901,45901,0,45901,45901,0,0,0,0,"10",".",13273,0
"5411",176354,"SOUTHWEST MISSISSIPPI COMMUNITY COLLEGE                     ","2003-2004",8,"Golf",4083,4083,0,4083,4083,0,0,0,0,"2",".",1366,0
"5420",127185,"FORT LEWIS COLLEGE                                          ","2003-2004",8,"Golf",29198,29198,0,29198,29198,0,0,0,0,"11",".",11439,0
"5429",161004,"BOWDOIN COLLEGE                                             ","2003-2004",8,"Golf",40725,40725,0,19957,19957,0,20768,20768,0,"17","6",1126,2240
"5433",214069,"COLLEGE MISERICORDIA                                        ","2003-2004",8,"Golf",3557,3557,0,3557,3557,0,0,0,0,"11",".",1865,0
"5434",140447,"MERCER UNIVERSITY                                           ","2003-2004",8,"Golf",87224,87224,0,46090,46090,0,41134,41134,0,"9","8",14903,14230
"5440",210669,"ALLEGHENY COLLEGE                                           ","2003-2004",8,"Golf",40302,40302,0,40302,40302,0,0,0,0,"14","0",19417,0
"5441",230898,"GREEN MOUNTAIN COLLEGE                                      ","2003-2004",8,"Golf",15994,15994,0,15994,15994,0,0,0,0,"5",".",694,0
"5443",162706,"HARFORD COMMUNITY COLLEGE                                   ","2003-2004",8,"Golf",8201,8201,0,4100,4100,0,4101,4101,0,"5","0",549,549
"5444",202134,"CLEVELAND STATE UNIVERSITY                                  ","2003-2004",8,"Golf",231474,231474,0,116700,116700,0,114774,114774,0,"12","6",21226,21809
"5446",105428,"PHOENIX COLLEGE                                             ","2003-2004",8,"Golf",27200,27200,0,13300,13300,0,13900,13900,0,"8","6",6500,6500
"5447",173735,"HIBBING COMMUNITY COLLEGE-A TECH AND COMM COLL              ","2003-2004",8,"Golf",9346,9346,0,9346,9346,0,0,0,0,"5","0",4498,0
"5448",104717,"GRAND CANYON UNIVERSITY                                     ","2003-2004",8,"Golf",192147,192147,0,94712,94712,0,97435,97435,0,"15","6",45704,36416
"5449",220978,"MIDDLE TENNESSEE STATE UNIVERSITY                           ","2003-2004",8,"Golf",367140,367140,0,175056,175056,0,192084,192084,0,"12","8",55241,40812
"5455",189705,"CANISIUS COLLEGE                                            ","2003-2004",8,"Golf",44398,44398,0,44398,44398,0,0,0,0,"9",".",23511,0
"5456",139904,"GEORGIA MILITARY COLLEGE-MAIN CAMPUS                        ","2003-2004",8,"Golf",4104,4104,0,4104,4104,0,0,0,0,"7",".",1539,0
"5459",193900,"NEW YORK UNIVERSITY                                         ","2003-2004",8,"Golf",83502,83502,0,83502,83502,0,0,0,0,"10",".",47712,0
"5472",226471,"UNIVERSITY OF MARY HARDIN-BAYLOR                            ","2003-2004",8,"Golf",103646,103646,0,54164,54164,0,49482,49482,0,"8","9",22850,20531
"5476",209612,"PACIFIC UNIVERSITY                                          ","2003-2004",8,"Golf",26531,26531,0,13213,13213,0,13318,13318,0,"8","8",7238,8010
"5478",214272,"NEUMANN COLLEGE                                             ","2003-2004",8,"Golf",23499,23499,0,23499,23499,0,0,0,0,"10",".",15700,0
"5480",206437,"WALSH UNIVERSITY                                            ","2003-2004",8,"Golf",44029,44029,0,22063,22063,0,21966,21966,0,"14","6",10745,9268
"5482",186432,"SAINT PETERS COLLEGE                                        ","2003-2004",8,"Golf",95323,95323,0,95323,95323,0,0,0,0,"7",".",15425,0
"5484",146472,"COLLEGE OF LAKE COUNTY                                      ","2003-2004",8,"Golf",13814,13814,0,6907,6907,0,6907,6907,0,"8",".",5702,5702
"5486",181020,"DOANE COLLEGE                                               ","2003-2004",8,"Golf",29652,29652,0,14645,14645,0,15007,15007,0,"9","8",6435,4497
"5489",170037,"CORNERSTONE UNIVERSITY                                      ","2003-2004",8,"Golf",25454,25454,0,25454,25454,0,0,0,0,"7",".",14058,0
"5492",214810,"PENNSYLVANIA STATE UNIVERSITY-PENN STATE SCHUYLKIL          ","2003-2004",8,"Golf",1000,1000,0,1000,1000,0,0,0,0,"8",".",1000,0
"5496",216339,"TEMPLE UNIVERSITY                                           ","2003-2004",8,"Golf",89045,89045,0,89045,89045,0,0,0,0,"7",".",23537,0
"5497",198756,"JOHNSON C SMITH UNIVERSITY                                  ","2003-2004",8,"Golf",31144,31144,0,15822,15822,0,15322,15322,0,"5","5",7483,7483
"5499",204024,"MIAMI UNIVERSITY-OXFORD                                     ","2003-2004",8,"Golf",241657,241657,0,241657,241657,0,0,0,0,"13",".",44642,0
"5500",226806,"MIDLAND COLLEGE                                             ","2003-2004",8,"Golf",66377,66377,0,66377,66377,0,0,0,0,"12",".",16383,0
"5501",106467,"ARKANSAS TECH UNIVERSITY                                    ","2003-2004",8,"Golf",99798,99798,0,47213,47213,0,52585,52585,0,"12","13",12392,7573
"5505",168607,"ALPENA COMMUNITY COLLEGE                                    ","2003-2004",8,"Golf",15122,15122,0,15122,15122,0,0,0,0,"6",".",7029,0
"5508",146603,"LEWIS AND CLARK COMMUNITY COLLEGE                           ","2003-2004",8,"Golf",46669,46669,0,46669,46669,0,0,0,0,"8",".",9490,0
"5512",237932,"WEST LIBERTY STATE COLLEGE                                  ","2003-2004",8,"Golf",39165,39165,0,26166,26166,0,12999,12999,0,"11","8",8620,2488
"5513",215798,"SAINT VINCENT COLLEGE                                       ","2003-2004",8,"Golf",60327,60327,0,41846,41846,0,18481,18481,0,"8","5",12521,7155
"5519",214643,"PENNSYLVANIA STATE UNIVERSITY-PENN STATE WILKES-BA          ","2003-2004",8,"Golf",6000,6000,0,6000,6000,0,0,0,0,"8",".",2700,0
"5522",151777,"MANCHESTER COLLEGE                                          ","2003-2004",8,"Golf",21420,21420,0,10710,10710,0,10710,10710,0,"11","10",6800,6800
"5525",239017,"LAWRENCE UNIVERSITY                                         ","2003-2004",8,"Golf",23591,23591,0,23591,23591,0,0,0,0,"8",".",17191,0
"5534",163426,"MONTGOMERY COLLEGE                                          ","2003-2004",8,"Golf",9911,9911,0,9911,9911,0,0,0,0,"7",".",6336,0
"5535",187134,"THE COLLEGE OF NEW JERSEY                                   ","2003-2004",8,"Golf",17383,17383,0,17383,17383,0,0,0,0,"11",".",11952,0
"5537",165015,"BRANDEIS UNIVERSITY                                         ","2003-2004",8,"Golf",25182,25182,0,25182,25182,0,0,0,0,"9",".",7910,0
"5540",154952,"COWLEY COUNTY COMMUNITY COLLEGE                             ","2003-2004",8,"Golf",32156,32156,0,32156,32156,0,0,0,0,"8",".",12156,0
"5542",178721,"PARK UNIVERSITY                                             ","2003-2004",8,"Golf",33055,33055,0,0,0,0,33055,33055,0,".","3",0,6018
"5543",230737,"UTAH VALLEY STATE COLLEGE                                   ","2003-2004",8,"Golf",96145,96145,0,96145,96145,0,0,0,0,"14",".",23008,0
"5549",120254,"OCCIDENTAL COLLEGE                                          ","2003-2004",8,"Golf",12290,12290,0,12290,12290,0,0,0,0,"9",".",6040,0
"5552",133492,"ECKERD COLLEGE                                              ","2003-2004",8,"Golf",47825,47825,0,47825,47825,0,0,0,0,"14",".",17424,0
"5561",183743,"BERGEN COMMUNITY COLLEGE                                    ","2003-2004",8,"Golf",14625,14625,0,14625,14625,0,0,0,0,"7",".",12000,0
"5565",123217,"COLLEGE OF THE SEQUOIAS                                     ","2003-2004",8,"Golf",22640,22640,0,11275,11275,0,11365,11365,0,"7","6",2725,3425
"5569",238333,"BELOIT COLLEGE                                              ","2003-2004",8,"Golf",8982,8982,0,3992,3992,0,4990,4990,0,"8","10",3992,4990
"5575",166124,"COLLEGE OF THE HOLY CROSS                                   ","2003-2004",8,"Golf",52231,52231,0,31984,31984,0,20247,20247,0,"12","12",18708,9355
"5578",130891,"DELAWARE TECHNICAL AND COMMUNITY COLLEGE-OWENS              ","2003-2004",8,"Golf",16700,16700,0,8350,8350,0,8350,8350,0,"6","4",3000,2000
"5597",219198,"MOUNT MARTY COLLEGE                                         ","2003-2004",8,"Golf",4706,4706,0,3103,3103,0,1603,1603,0,"7","2",800,800
"5598",158477,"CENTENARY COLLEGE OF LOUISIANA                              ","2003-2004",8,"Golf",227450,227450,0,151722,151722,0,75728,75728,0,"9","6",26630,14803
"5601",132471,"BARRY UNIVERSITY                                            ","2003-2004",8,"Golf",173085,173085,0,81300,81300,0,91785,91785,0,"10","8",45200,46185
"5608",154235,"SAINT AMBROSE UNIVERSITY                                    ","2003-2004",8,"Golf",142185,142185,0,106626,106626,0,35559,35559,0,"28","12",7922,6963
"5618",212674,"GETTYSBURG COLLEGE                                          ","2003-2004",8,"Golf",87909,87909,0,53928,53928,0,33981,33981,0,"12","8",7436,4932
"5619",107512,"OUACHITA BAPTIST UNIVERSITY                                 ","2003-2004",8,"Golf",62951,62951,0,62951,62951,0,0,0,0,"19",".",15522,0
"5620",177144,"CULVER-STOCKTON COLLEGE                                     ","2003-2004",8,"Golf",44684,44684,0,38444,38444,0,6240,6240,0,"14","6",12121,1904
"5626",215770,"SAINT JOSEPHS UNIVERSITY                                    ","2003-2004",8,"Golf",122467,122467,0,122467,122467,0,0,0,0,"11",".",51173,0
"5627",217518,"ROGER WILLIAMS UNIVERSITY                                   ","2003-2004",8,"Golf",15007,15007,0,15007,15007,0,0,0,0,"10",".",4480,0
"5634",218061,"FRANCIS MARION UNIVERSITY                                   ","2003-2004",8,"Golf",84961,84961,0,84961,84961,0,0,0,0,"9",".",25207,0
"5640",175810,"HOLMES COMMUNITY COLLEGE                                    ","2003-2004",8,"Golf",12749,12749,0,12749,12749,0,0,0,0,"3",".",4900,0
"5641",148584,"UNIVERSITY OF ST FRANCIS                                    ","2003-2004",8,"Golf",123027,123027,0,79582,79582,0,43445,43445,0,"14","6",9082,3098
"5646",197294,"SUNY WESTCHESTER COMMMUNITY COLLEGE                         ","2003-2004",8,"Golf",7964,7964,0,6964,6964,0,1000,1000,0,"5","1",3200,500
"5651",159568,"LOUISIANA COLLEGE                                           ","2003-2004",8,"Golf",19639,19639,0,19639,19639,0,0,0,0,"12",".",4694,0
"5655",164447,"AMERICAN INTERNATIONAL COLLEGE                              ","2003-2004",8,"Golf",9450,9450,0,9450,9450,0,0,0,0,"7",".",6700,0
"5657",214689,"PENNSYLVANIA STATE UNIVERSITY-PENN STATE ALTOONA            ","2003-2004",8,"Golf",11247,11247,0,11247,11247,0,0,0,0,"9",".",5156,0
"5659",204264,"MUSKINGUM COLLEGE                                           ","2003-2004",8,"Golf",11259,11259,0,5707,5707,0,5552,5552,0,"14","7",5553,5486
"5695",121691,"UNIVERSITY OF REDLANDS                                      ","2003-2004",8,"Golf",70458,70458,0,70458,70458,0,0,0,0,"18",".",61556,0
"5701",153533,"IOWA LAKES COMMUNITY COLLEGE                                ","2003-2004",8,"Golf",19920,19920,0,13944,13944,0,5976,5976,0,"7","3",3954,3954
"5704",173045,"AUGSBURG COLLEGE                                            ","2003-2004",8,"Golf",54658,54658,0,37848,37848,0,16810,16810,0,"16","8",20857,10872
"5705",173160,"BETHEL COLLEGE                                              ","2003-2004",8,"Golf",9740,9740,0,9740,9740,0,0,0,0,"12",".",5028,0
"5706",166133,"HOLYOKE COMMUNITY COLLEGE                                   ","2003-2004",8,"Golf",4000,4000,0,2000,2000,0,2000,2000,0,"7",".",500,500
"5709",237640,"OHIO VALLEY COLLEGE                                         ","2003-2004",8,"Golf",61323,61323,0,61323,61323,0,0,0,0,"10",".",10671,0
"5710",191533,"HARTWICK COLLEGE                                            ","2003-2004",8,"Golf",5271,5271,0,5271,5271,0,0,0,0,"8",".",3784,0
"5713",126775,"COLORADO SCHOOL OF MINES                                    ","2003-2004",8,"Golf",23742,23742,0,23742,23742,0,0,0,0,"9",".",13742,0
"5715",101736,"NORTHWEST SHOALS COMMUNITY COLLEGE-MUSCLE SHOALS            ","2003-2004",8,"Golf",17007,17007,0,17007,17007,0,0,0,0,"9",".",15000,0
"5731",214801,"PENNSYLVANIA STATE UNIVERSITY-PENN STATE ABINGTON           ","2003-2004",8,"Golf",6954,6954,0,6954,6954,0,0,0,0,"3",".",2040,0
"5734",147378,"MORAINE VALLEY COMMUNITY COLLEGE                            ","2003-2004",8,"Golf",11255,11255,0,11255,11255,0,0,0,0,"8",".",8155,0
"5736",198303,"CHOWAN COLLEGE                                              ","2003-2004",8,"Golf",15527,15527,0,15527,15527,0,0,0,0,"7",".",10427,0
"5738",218724,"COASTAL CAROLINA UNIVERSITY                                 ","2003-2004",8,"Golf",429195,429195,0,217879,217879,0,211316,211316,0,"12","8",91543,78921
"5744",111920,"CHABOT COLLEGE                                              ","2003-2004",8,"Golf",2000,2000,0,2000,2000,0,0,0,0,"12",".",3768,0
"5748",145691,"ILLINOIS COLLEGE                                            ","2003-2004",8,"Golf",30272,30272,0,9049,9049,0,21223,21223,0,"13","7",5749,6236
"5757",177339,"EVANGEL UNIVERSITY                                          ","2003-2004",8,"Golf",61443,61443,0,30700,30700,0,30743,30743,0,"12","5",13700,10950
"5759",176239,"PEARL RIVER COMMUNITY COLLEGE                               ","2003-2004",8,"Golf",12830,12830,0,12830,12830,0,0,0,0,"6",".",6596,0
"5769",195474,"SIENA COLLEGE                                               ","2003-2004",8,"Golf",206655,206655,0,99725,99725,0,106930,106930,0,"10","8",39518,43500
"5779",116439,"IRVINE VALLEY COLLEGE                                       ","2003-2004",8,"Golf",39249,39249,0,17355,17355,0,21894,21894,0,"8","5",7725,4782
"5786",205443,"SHAWNEE STATE UNIVERSITY                                    ","2003-2004",8,"Golf",28394,28394,0,28394,28394,0,0,0,0,"6",".",16114,0
"5789",234173,"VIRGINIA WESLEYAN COLLEGE                                   ","2003-2004",8,"Golf",17296,17296,0,17296,17296,0,0,0,0,"11",".",7296,0
"5794",210605,"COMMUNITY COLLEGE OF ALLEGHENY COUNTY                       ","2003-2004",8,"Golf",17147,17147,0,17147,17147,0,0,0,0,"19",".",16300,0
"5797",186283,"RIDER UNIVERSITY                                            ","2003-2004",8,"Golf",69507,69507,0,69507,69507,0,0,0,0,"17",".",22355,0
"5801",129774,"MITCHELL COLLEGE                                            ","2003-2004",8,"Golf",5555,5555,0,5555,5555,0,0,0,0,"6",".",2279,0
"5808",100760,"CENTRAL ALABAMA COMMUNITY COLLEGE                           ","2003-2004",8,"Golf",55778,55778,0,55778,55778,0,0,0,0,"11",".",15664,0
"5814",210739,"DESALES UNIVERSITY                                          ","2003-2004",8,"Golf",11687,11687,0,11687,11687,0,0,0,0,"7",".",3887,0
"5822",155414,"KANSAS WESLEYAN UNIVERSITY                                  ","2003-2004",8,"Golf",25614,25614,0,25614,25614,0,0,0,0,"14","0",13684,0
"5827",190725,"DAEMEN COLLEGE                                              ","2003-2004",8,"Golf",42493,42493,0,42493,42493,0,0,0,0,"7",".",12051,0
"5831",196200,"SUNY-POTSDAM                                                ","2003-2004",8,"Golf",34585,34585,0,34585,34585,0,0,0,0,"11",".",7292,0
"5836",175573,"COPIAH-LINCOLN COMMUNITY COLLEGE                            ","2003-2004",8,"Golf",8144,8144,0,8144,8144,0,0,0,0,"4",".",2363,0
"5839",200192,"LAKE REGION STATE COLLEGE                                   ","2003-2004",8,"Golf",2575,2575,0,2575,2575,0,0,0,0,"7",".",775,0
"5842",213668,"LYCOMING COLLEGE                                            ","2003-2004",8,"Golf",6408,6408,0,6408,6408,0,0,0,0,"11",".",4631,0
"5849",145646,"ILLINOIS WESLEYAN UNIVERSITY                                ","2003-2004",8,"Golf",38911,38911,0,19516,19516,0,19395,19395,0,"12","11",12294,14793
"5853",213358,"LA ROCHE COLLEGE                                            ","2003-2004",8,"Golf",19129,19129,0,19129,19129,0,0,0,0,"8",".",10026,0
"5855",137476,"SAINT THOMAS UNIVERSITY                                     ","2003-2004",8,"Golf",62400,62400,0,62400,62400,0,0,0,0,"12",".",11000,0
"5860",216852,"WIDENER UNIVERSITY-MAIN CAMPUS                              ","2003-2004",8,"Golf",6738,6738,0,6738,6738,0,0,0,0,"12",".",6578,0
"5863",145682,"ILLINOIS CENTRAL COLLEGE                                    ","2003-2004",8,"Golf",38147,38147,0,38147,38147,0,0,0,0,"7",".",18010,0
"5865",202523,"DENISON UNIVERSITY                                          ","2003-2004",8,"Golf",45867,45867,0,45867,45867,0,0,0,0,"11",".",24343,0
"5869",165699,"ENDICOTT COLLEGE                                            ","2003-2004",8,"Golf",11155,11155,0,11155,11155,0,0,0,0,"11",".",5100,0
"5873",172635,"WAYNE COUNTY COMMUNITY COLLEGE DISTRICT                     ","2003-2004",8,"Golf",25000,25000,0,25000,25000,0,0,0,0,"6","0",12000,0
"5875",212832,"GWYNEDD MERCY COLLEGE                                       ","2003-2004",8,"Golf",6208,6208,0,6208,6208,0,0,0,0,"8",".",3208,0
"5876",151360,"INDIANA UNIVERSITY-NORTHWEST                                ","2003-2004",8,"Golf",8950,8950,0,4475,4475,0,4475,4475,0,"10","4",3225,3225
"5882",196042,"FARMINGDALE STATE UNIVERSITY OF NEW YORK                    ","2003-2004",8,"Golf",23500,23500,0,23500,23500,0,0,0,0,"12",".",11500,0
"5887",234155,"VIRGINIA STATE UNIVERSITY                                   ","2003-2004",8,"Golf",22987,22987,0,22987,22987,0,0,0,0,"7",".",8302,0
"5891",203085,"HEIDELBERG COLLEGE                                          ","2003-2004",8,"Golf",20506,20506,0,20506,20506,0,0,0,0,"10",".",9966,0
"5892",153311,"EASTERN IOWA COMMUNITY COLLEGE DISTRICT                     ","2003-2004",8,"Golf",50540,50540,0,25270,25270,0,25270,25270,0,"13","8",15850,15850
"5894",156541,"CUMBERLAND COLLEGE                                          ","2003-2004",8,"Golf",164607,164607,0,93705,93705,0,70902,70902,0,"15","7",26790,17003
"5904",101480,"JACKSONVILLE STATE UNIVERSITY                               ","2003-2004",8,"Golf",288867,288867,0,130878,130878,0,157989,157989,0,"14","8",130877,157988
"5912",148672,"SAUK VALLEY COMMUNITY COLLEGE                               ","2003-2004",8,"Golf",18941,18941,0,18941,18941,0,0,0,0,"7",".",7460,0
"5915",144971,"EUREKA COLLEGE                                              ","2003-2004",8,"Golf",17195,17195,0,17195,17195,0,0,0,0,"6",".",4294,0
"5919",193973,"NIAGARA UNIVERSITY                                          ","2003-2004",8,"Golf",40517,40517,0,40517,40517,0,0,0,0,"8",".",20563,0
"5920",167987,"UNIVERSITY OF MASSACHUSETTS-DARTMOUTH                       ","2003-2004",8,"Golf",13039,13039,0,13039,13039,0,0,0,0,"14",".",5218,0
"5930",138691,"DARTON COLLEGE                                              ","2003-2004",8,"Golf",22855,22855,0,22855,22855,0,0,0,0,"10",".",13340,0
"5931",226152,"TEXAS A &amp; M INTERNATIONAL UNIVERSITY                        ","2003-2004",8,"Golf",36700,36700,0,18350,18350,0,18350,18350,0,"10","6",16600,16600
"5932",217235,"JOHNSON &amp; WALES UNIVERSITY                                  ","2003-2004",8,"Golf",13683,13683,0,13678,13678,0,5,5,0,"18",".",8241,1
"5939",161563,"THOMAS COLLEGE                                              ","2003-2004",8,"Golf",6437,6437,0,6437,6437,0,0,0,0,"10",".",4037,0
"5943",197133,"VASSAR COLLEGE                                              ","2003-2004",8,"Golf",62951,62951,0,0,0,0,62951,62951,0,".","7",0,14222
"5954",170806,"MADONNA UNIVERSITY                                          ","2003-2004",8,"Golf",47720,47720,0,23860,23860,0,23860,23860,0,"5","4",6350,6526
"5955",100937,"BIRMINGHAM SOUTHERN COLLEGE                                 ","2003-2004",8,"Golf",420249,420249,0,182244,182244,0,238005,238005,0,"14","7",23343,23343
"5956",185536,"MIDDLESEX COUNTY COLLEGE                                    ","2003-2004",8,"Golf",10275,10275,0,10275,10275,0,0,0,0,"7","0",3120,0
"5961",221740,"THE UNIVERSITY OF TENNESSEE-CHATTANOOGA                     ","2003-2004",8,"Golf",59011,59011,0,59011,59011,0,0,0,0,"10",".",33775,0
"5962",195216,"ST LAWRENCE UNIVERSITY                                      ","2003-2004",8,"Golf",67824,67824,0,33912,33912,0,33912,33912,0,"15","7",8028,8028
"5963",210155,"SOUTHWESTERN OREGON COMMUNITY COLLEGE                       ","2003-2004",8,"Golf",3004,3004,0,3004,3004,0,0,0,0,"5",".",3003,0
"5966",167288,"MASSACHUSETTS COLLEGE OF LIBERAL ARTS                       ","2003-2004",8,"Golf",8462,8462,0,8462,8462,0,0,0,0,"6",".",4462,0
"5971",168148,"TUFTS UNIVERSITY                                            ","2003-2004",8,"Golf",33551,33551,0,33551,33551,0,0,0,0,"11",".",8700,0
"5976",160621,"SOUTHERN UNIVERSITY AND A &amp; M COLLEGE                       ","2003-2004",8,"Golf",32464,32464,0,16232,16232,0,16232,16232,0,"6","6",1249,1249
"5978",119067,"MONTEREY PENINSULA COLLEGE                                  ","2003-2004",8,"Golf",14323,14323,0,14323,14323,0,0,0,0,"13",".",6799,0
"5982",170657,"LANSING COMMUNITY COLLEGE                                   ","2003-2004",8,"Golf",19534,19534,0,19534,19534,0,0,0,0,"7",".",6659,0
"5988",219295,"PRESENTATION COLLEGE                                        ","2003-2004",8,"Golf",13228,13228,0,13228,13228,0,0,0,0,"7",".",2289,0
"5989",153922,"MARSHALLTOWN COMMUNITY COLLEGE                              ","2003-2004",8,"Golf",9598,9598,0,9598,9598,0,0,0,0,"10",".",6388,0
"5992",186645,"RARITAN VALLEY COMMUNITY COLLEGE                            ","2003-2004",8,"Golf",6913,6913,0,6913,6913,0,0,0,0,"7",".",5852,0
"5995",175786,"HINDS COMMUNITY COLLEGE                                     ","2003-2004",8,"Golf",18748,18748,0,18748,18748,0,0,0,0,"10",".",5899,0
"5997",211291,"BUCKNELL UNIVERSITY                                         ","2003-2004",8,"Golf",100396,100396,0,50179,50179,0,50217,50217,0,"10","10",33872,27859
"5998",214625,"PENNSYLVANIA STATE UNIV-PENN STATE NEW KENSINGTON           ","2003-2004",8,"Golf",5721,5721,0,5721,5721,0,0,0,0,"10",".",4346,0
"6002",130590,"TRINITY COLLEGE                                             ","2003-2004",8,"Golf",13528,13528,0,13528,13528,0,0,0,0,"12",".",6528,0
"6014",194824,"RENSSELAER POLYTECHNIC INSTITUTE                            ","2003-2004",8,"Golf",10755,10755,0,10755,10755,0,0,0,0,"8",".",5900,0
"6017",170301,"HOPE COLLEGE                                                ","2003-2004",8,"Golf",29725,29725,0,14903,14903,0,14822,14822,0,"10","10",6817,6089
"6019",101435,"HUNTINGDON COLLEGE                                          ","2003-2004",8,"Golf",128644,128644,0,128644,128644,0,0,0,0,"11",".",37360,0
"6022",232609,"LYNCHBURG COLLEGE                                           ","2003-2004",8,"Golf",17755,17755,0,17755,17755,0,0,0,0,"7","0",8956,0
"6024",217156,"BROWN UNIVERSITY                                            ","2003-2004",8,"Golf",93012,93012,0,43823,43823,0,49189,49189,0,"10","7",18860,18860
"6033",204909,"OHIO WESLEYAN UNIVERSITY                                    ","2003-2004",8,"Golf",46719,46719,0,46719,46719,0,0,0,0,"14",".",20364,0
"6034",104577,"EASTERN ARIZONA COLLEGE                                     ","2003-2004",8,"Golf",15874,15874,0,15874,15874,0,0,0,0,"6",".",12836,0
"6035",111188,"CALIFORNIA MARITIME ACADEMY                                 ","2003-2004",8,"Golf",1800,1800,0,1800,1800,0,0,0,0,"5",".",1215,0
"6040",147800,"OAKTON COMMUNITY COLLEGE                                    ","2003-2004",8,"Golf",4396,4396,0,4396,4396,0,0,0,0,"5",".",4395,0
"6044",175236,"RIDGEWATER COLLEGE                                          ","2003-2004",8,"Golf",9386,9386,0,9386,9386,0,0,0,0,"8",".",3300,0
"6047",115126,"GOLDEN WEST COLLEGE                                         ","2003-2004",8,"Golf",54188,54188,0,29788,29788,0,24400,24400,0,"10","5",3368,2181
"6050",126669,"COLORADO CHRISTIAN UNIVERSITY                               ","2003-2004",8,"Golf",21656,21656,0,21656,21656,0,0,0,0,"8",".",5472,0
"6052",200217,"UNIVERSITY OF MARY                                          ","2003-2004",8,"Golf",50330,50330,0,25165,25165,0,25165,25165,0,"15","7",2997,2997
"6056",203535,"KENYON COLLEGE                                              ","2003-2004",8,"Golf",16106,16106,0,16106,16106,0,0,0,0,"11",".",9869,0
"6059",133553,"EMBRY RIDDLE AERONAUTICAL UNIVERSITY-DAYTONA BEACH          ","2003-2004",8,"Golf",214676,214676,0,104612,104612,0,110064,110064,0,"11","6",103412,108864
"6062",206491,"WILBERFORCE UNIVERSITY                                      ","2003-2004",8,"Golf",5540,5540,0,2770,2770,0,2770,2770,0,"3","3",2050,2050
"6067",206862,"SOUTHERN NAZARENE UNIVERSITY                                ","2003-2004",8,"Golf",192953,192953,0,96096,96096,0,96857,96857,0,"9","6",12254,15396
"6068",218539,"PRESBYTERIAN COLLEGE                                        ","2003-2004",8,"Golf",107896,107896,0,107896,107896,0,0,0,0,"13",".",30991,0
"6069",150534,"UNIVERSITY OF EVANSVILLE                                    ","2003-2004",8,"Golf",153004,153004,0,78697,78697,0,74307,74307,0,"12","8",20305,26304
"6072",201195,"BALDWIN-WALLACE COLLEGE                                     ","2003-2004",8,"Golf",81597,81597,0,46769,46769,0,34828,34828,0,"10","9",23713,22562
"6076",154855,"CENTRAL CHRISTIAN COLLEGE OF KANSAS                         ","2003-2004",8,"Golf",12367,12367,0,7302,7302,0,5065,5065,0,"4","2",5968,3722
"6077",176947,"CENTRAL METHODIST COLLEGE                                   ","2003-2004",8,"Golf",4847,4847,0,4847,4847,0,0,0,0,"11",".",3307,0
"6078",213659,"LUZERNE COUNTY COMMUNITY COLLEGE                            ","2003-2004",8,"Golf",7500,7500,0,7500,7500,0,0,0,0,"7",".",5000,0
"6081",176965,"CENTRAL MISSOURI STATE UNIVERSITY                           ","2003-2004",8,"Golf",84695,84695,0,84695,84695,0,0,0,0,"19",".",24746,0
"6082",222983,"AUSTIN COLLEGE                                              ","2003-2004",8,"Golf",305,305,0,305,305,0,0,0,0,"1",".",305,0
"6084",190770,"DOWLING COLLEGE                                             ","2003-2004",8,"Golf",42352,42352,0,42352,42352,0,0,0,0,"8",".",12393,0
"6089",177418,"FONTBONNE UNIVERSITY                                        ","2003-2004",8,"Golf",6111,6111,0,6111,6111,0,0,0,0,"7",".",3766,0
"6090",167729,"SALEM STATE COLLEGE                                         ","2003-2004",8,"Golf",20136,20136,0,20136,20136,0,0,0,0,"7","0",12036,0
"6091",232025,"EMORY AND HENRY COLLEGE                                     ","2003-2004",8,"Golf",5071,5071,0,5071,5071,0,0,0,0,"10",".",5070,0
"6093",150668,"GOSHEN COLLEGE                                              ","2003-2004",8,"Golf",16929,16929,0,16929,16929,0,0,0,0,"6",".",7954,0
"6104",137032,"SAINT LEO UNIVERSITY                                        ","2003-2004",8,"Golf",43456,43456,0,20565,20565,0,22891,22891,0,"11","7",15089,16739
"6107",180522,"MONTANA STATE UNIVERSITY-NORTHERN                           ","2003-2004",8,"Golf",14379,14379,0,0,0,0,14379,14379,0,".","6",0,8595
"6111",135160,"LAKE CITY COMMUNITY COLLEGE                                 ","2003-2004",8,"Golf",8582,8582,0,0,0,0,8582,8582,0,".","4",0,5891
"6116",154378,"SOUTHEASTERN COMMUNITY COLLEGE                              ","2003-2004",8,"Golf",9948,9948,0,4974,4974,0,4974,4974,0,"2","4",3279,3329
"6120",161299,"MAINE MARITIME ACADEMY                                      ","2003-2004",8,"Golf",8133,8133,0,8133,8133,0,0,0,0,"10",".",4519,0
"6129",183938,"CAMDEN COUNTY COLLEGE                                       ","2003-2004",8,"Golf",37967,37967,0,37967,37967,0,0,0,0,"10",".",3798,0
"6135",192439,"LONG ISLAND UNIVERSITY-BROOKLYN CAMPUS                      ","2003-2004",8,"Golf",334814,334814,0,177152,177152,0,157662,157662,0,"6","5",40933,31546
"6138",213996,"MESSIAH COLLEGE                                             ","2003-2004",8,"Golf",13760,13760,0,13760,13760,0,0,0,0,"10",".",9664,0
"6139",156082,"WASHBURN UNIVERSITY OF TOPEKA                               ","2003-2004",8,"Golf",19356,19356,0,19356,19356,0,0,0,0,"13",".",18766,0
"6145",147244,"MILLIKIN UNIVERSITY                                         ","2003-2004",8,"Golf",28437,28437,0,17792,17792,0,10645,10645,0,"22","7",4918,6245
"6146",112260,"CLAREMONT MCKENNA COLLEGE                                   ","2003-2004",8,"Golf",27960,27960,0,27960,27960,0,0,0,0,"10",".",16018,0
"6148",210775,"ALVERNIA COLLEGE                                            ","2003-2004",8,"Golf",6149,6149,0,6149,6149,0,0,0,0,"9",".",1831,0
"6153",110051,"BETHANY COLLEGE OF THE ASSEMBLIES OF GOD                    ","2003-2004",8,"Golf",23440,23440,0,23440,23440,0,0,0,0,"4",".",5790,0
"6155",196033,"SUNY COLLEGE OF AGRIC AND TECHN AT COBLESKILL               ","2003-2004",8,"Golf",7308,7308,0,3654,3654,0,3654,3654,0,"10","0",2070,0
"6159",167905,"SPRINGFIELD TECHNICAL COMMUNITY COLLEGE                     ","2003-2004",8,"Golf",4300,4300,0,2150,2150,0,2150,2150,0,"10",".",650,650
"6160",105747,"SCOTTSDALE COMMUNITY COLLEGE                                ","2003-2004",8,"Golf",54763,54763,0,46845,46845,0,7918,7918,0,"9","8",6427,3070
"6162",106485,"UNIVERSITY OF ARKANSAS AT MONTICELLO                        ","2003-2004",8,"Golf",6966,6966,0,6966,6966,0,0,0,0,"8",".",3535,0
"6166",203775,"MALONE COLLEGE                                              ","2003-2004",8,"Golf",163398,163398,0,118110,118110,0,45288,45288,0,"13","7",56065,13958
"6168",197045,"UTICA COLLEGE                                               ","2003-2004",8,"Golf",7250,7250,0,7250,7250,0,0,0,0,"9",".",3400,0
"6174",123554,"SAINT MARYS COLLEGE OF CALIFORNIA                           ","2003-2004",8,"Golf",144675,144675,0,144675,144675,0,0,0,0,"9",".",42366,0
"6184",107080,"HENDRIX COLLEGE                                             ","2003-2004",8,"Golf",17800,17800,0,8900,8900,0,8900,8900,0,"6","4",3900,3900
"6185",152567,"TRI-STATE UNIVERSITY                                        ","2003-2004",8,"Golf",36444,36444,0,24003,24003,0,12441,12441,0,"19","2",6222,1597
"6188",122658,"SAN JOAQUIN DELTA COLLEGE                                   ","2003-2004",8,"Golf",15064,15064,0,15064,15064,0,0,0,0,"12",".",5388,0
"6189",155292,"KANSAS CITY KANSAS COMMUNITY COLLEGE                        ","2003-2004",8,"Golf",21600,21600,0,21600,21600,0,0,0,0,"9",".",17100,0
"6203",234845,"CENTRALIA COLLEGE                                           ","2003-2004",8,"Golf",8985,8985,0,0,0,0,8985,8985,0,"0","4",0,5165
"6208",154493,"UPPER IOWA UNIVERSITY                                       ","2003-2004",8,"Golf",51162,51162,0,30525,30525,0,20637,20637,0,"10","2",8707,2887
"6211",193478,"NASSAU COMMUNITY COLLEGE                                    ","2003-2004",8,"Golf",21532,21532,0,21532,21532,0,0,0,0,"7",".",13626,0
"6215",133386,"DAYTONA BEACH COMMUNITY COLLEGE                             ","2003-2004",8,"Golf",60356,60356,0,0,0,0,60356,60356,0,"0","6",0,16886
"6217",101879,"UNIVERSITY OF NORTH ALABAMA                                 ","2003-2004",8,"Golf",103762,103762,0,103762,103762,0,0,0,0,"14",".",30836,0
"6218",141167,"THOMAS UNIVERSITY                                           ","2003-2004",8,"Golf",15397,15397,0,15397,15397,0,0,0,0,"5",".",6392,0
"6219",143215,"SOUTHWESTERN ILLINOIS COLLEGE                               ","2003-2004",8,"Golf",27123,27123,0,27123,27123,0,0,0,0,"8",".",7417,0
"6224",217776,"SOUTHERN WESLEYAN UNIVERSITY                                ","2003-2004",8,"Golf",60962,60962,0,60962,60962,0,0,0,0,"7",".",17462,0
"6225",183877,"BURLINGTON COUNTY COLLEGE                                   ","2003-2004",8,"Golf",4525,4525,0,4525,4525,0,0,0,0,"6","0",2520,0
"6226",154101,"NORTHWESTERN COLLEGE                                        ","2003-2004",8,"Golf",43106,43106,0,22669,22669,0,20437,20437,0,"13","10",10019,5532
"6232",161138,"EASTERN MAINE COMMUNITY COLLEGE                             ","2003-2004",8,"Golf",4200,4200,0,4200,4200,0,0,0,0,"8",".",4000,0
"6237",131098,"WESLEY COLLEGE                                              ","2003-2004",8,"Golf",13606,13606,0,6803,6803,0,6803,6803,0,"11",".",5696,3204
"6241",180984,"CONCORDIA UNIVERSITY                                        ","2003-2004",8,"Golf",67652,67652,0,32649,32649,0,35003,35003,0,"6","5",3996,4000
"6251",154712,"BENEDICTINE COLLEGE                                         ","2003-2004",8,"Golf",31724,31724,0,18971,18971,0,12753,12753,0,"16","5",2968,3530
"6263",193283,"MOHAWK VALLEY COMMUNITY COLLEGE-UTICA BRANCH                ","2003-2004",8,"Golf",9783,9783,0,9783,9783,0,0,0,0,"8",".",3480,0
"6264",166027,"HARVARD UNIVERSITY                                          ","2003-2004",8,"Golf",176153,176153,0,84809,84809,0,91344,91344,0,"10","7",32489,32328
"6266",110538,"CALIFORNIA STATE UNIVERSITY-CHICO                           ","2003-2004",8,"Golf",163427,163427,0,98942,98942,0,64485,64485,0,"12","12",37190,20199
"6285",156745,"GEORGETOWN COLLEGE                                          ","2003-2004",8,"Golf",23850,23850,0,9578,9578,0,14272,14272,0,"17","5",4928,4772
"6287",173203,"CENTRAL LAKES COLLEGE-BRAINERD                              ","2003-2004",8,"Golf",12578,12578,0,6298,6298,0,6280,6280,0,"6","6",2409,1919
"6289",221953,"TUSCULUM COLLEGE                                            ","2003-2004",8,"Golf",141711,141711,0,76205,76205,0,65506,65506,0,"15","9",40249,23911
"6291",238458,"CARROLL COLLEGE                                             ","2003-2004",8,"Golf",17881,17881,0,8884,8884,0,8997,8997,0,"10","10",4000,5539
"6295",138868,"ATLANTA CHRISTIAN COLLEGE                                   ","2003-2004",8,"Golf",6800,6800,0,6800,6800,0,0,0,0,"5",".",6700,0
"6312",196121,"SUNY COLLEGE AT BROCKPORT                                   ","2003-2004",9,"Gymnastics",22299,22299,0,0,0,0,22299,22299,0,".","20",0,12080
"6313",169248,"CENTRAL MICHIGAN UNIVERSITY                                 ","2003-2004",9,"Gymnastics",459496,459496,0,0,0,0,459496,459496,0,".","14",0,42816
"6315",158477,"CENTENARY COLLEGE OF LOUISIANA                              ","2003-2004",9,"Gymnastics",255467,255467,0,0,0,0,255467,255467,0,"0","12",0,39485
"6328",217156,"BROWN UNIVERSITY                                            ","2003-2004",9,"Gymnastics",99666,99666,0,0,0,0,99666,99666,0,".","18",0,33351
"6360",130493,"SOUTHERN CONNECTICUT STATE UNIVERSITY                       ","2003-2004",9,"Gymnastics",167957,167957,0,32552,32552,0,135405,135405,0,"9","23",22386,29741
"6363",216339,"TEMPLE UNIVERSITY                                           ","2003-2004",9,"Gymnastics",549595,549595,0,295516,295516,0,254079,254079,0,"26","20",60092,46491
"6380",217420,"RHODE ISLAND COLLEGE                                        ","2003-2004",9,"Gymnastics",22294,22294,0,0,0,0,22294,22294,0,".","13",0,7714
"6388",217156,"BROWN UNIVERSITY                                            ","2003-2004",10,"Ice Hockey",789954,789954,0,443337,443337,0,346617,346617,0,"26","25",135307,79254
"6389",173124,"BEMIDJI STATE UNIVERSITY                                    ","2003-2004",10,"Ice Hockey",1191099,1191099,0,684143,684143,0,506956,506956,0,"25","25",342293,261969
"6407",183026,"SOUTHERN NEW HAMPSHIRE UNIVERSITY                           ","2003-2004",10,"Ice Hockey",97794,97794,0,97794,97794,0,0,0,0,"30",".",49634,0
"6410",166124,"COLLEGE OF THE HOLY CROSS                                   ","2003-2004",10,"Ice Hockey",675006,675006,0,572604,572604,0,102402,102402,0,"28","18",158892,25948
"6412",168148,"TUFTS UNIVERSITY                                            ","2003-2004",10,"Ice Hockey",76666,76666,0,76666,76666,0,0,0,0,"25",".",45500,0
"6413",196051,"MORRISVILLE STATE COLLEGE                                   ","2003-2004",10,"Ice Hockey",68109,68109,0,68109,68109,0,0,0,0,"25",".",61141,0
"6415",168227,"WENTWORTH INSTITUTE OF TECHNOLOGY                           ","2003-2004",10,"Ice Hockey",117125,117125,0,117125,117125,0,0,0,0,"28",".",53137,0
"6416",164447,"AMERICAN INTERNATIONAL COLLEGE                              ","2003-2004",10,"Ice Hockey",136849,136849,0,136849,136849,0,0,0,0,"23",".",93333,0
"6417",173160,"BETHEL COLLEGE                                              ","2003-2004",10,"Ice Hockey",259140,259140,0,178840,178840,0,80300,80300,0,"48","20",128016,54220
"6419",167987,"UNIVERSITY OF MASSACHUSETTS-DARTMOUTH                       ","2003-2004",10,"Ice Hockey",82350,82350,0,82350,82350,0,0,0,0,"30",".",40238,0
"6423",130590,"TRINITY COLLEGE                                             ","2003-2004",10,"Ice Hockey",206485,206485,0,125722,125722,0,80763,80763,0,"31","18",71207,50760
"6427",130253,"SACRED HEART UNIVERSITY                                     ","2003-2004",10,"Ice Hockey",741469,741469,0,606396,606396,0,135073,135073,0,"61","20",176410,82269
"6437",189705,"CANISIUS COLLEGE                                            ","2003-2004",10,"Ice Hockey",410338,410338,0,410338,410338,0,0,0,0,"30",".",105443,0
"6440",193283,"MOHAWK VALLEY COMMUNITY COLLEGE-UTICA BRANCH                ","2003-2004",10,"Ice Hockey",29931,29931,0,29931,29931,0,0,0,0,"21",".",17178,0
"6443",161484,"NORTHERN MAINE TECHNICAL COLLEGE                            ","2003-2004",10,"Ice Hockey",7037,7037,0,6333,6333,0,704,704,0,"20","0",2219,246
"6447",183080,"PLYMOUTH STATE UNIVERSITY                                   ","2003-2004",10,"Ice Hockey",61162,61162,0,61162,61162,0,0,0,0,"29",".",45825,0
"6452",196121,"SUNY COLLEGE AT BROCKPORT                                   ","2003-2004",10,"Ice Hockey",45204,45204,0,45204,45204,0,0,0,0,"26",".",43052,0
"6458",174914,"UNIVERSITY OF ST THOMAS                                     ","2003-2004",10,"Ice Hockey",231938,231938,0,151669,151669,0,80269,80269,0,"31","26",97770,61624
"6467",214272,"NEUMANN COLLEGE                                             ","2003-2004",10,"Ice Hockey",137998,137998,0,73999,73999,0,63999,63999,0,"32","25",66200,56200
"6475",193973,"NIAGARA UNIVERSITY                                          ","2003-2004",10,"Ice Hockey",1696192,1696192,0,942067,942067,0,754125,754125,0,"29","26",175962,101023
"6486",166027,"HARVARD UNIVERSITY                                          ","2003-2004",10,"Ice Hockey",1219554,1219554,0,752030,752030,0,467524,467524,0,"53","45",210411,148782
"6492",128902,"CONNECTICUT COLLEGE                                         ","2003-2004",10,"Ice Hockey",208832,208832,0,115321,115321,0,93511,93511,0,"27","19",39681,34437
"6499",217235,"JOHNSON &amp; WALES UNIVERSITY                                  ","2003-2004",10,"Ice Hockey",68194,68194,0,68194,68194,0,0,0,0,"28",".",55684,0
"6501",194028,"NORTH COUNTRY COMMUNITY COLLEGE                             ","2003-2004",10,"Ice Hockey",92608,92608,0,59006,59006,0,33602,33602,0,"16","14",25162,15553
"6502",168430,"WORCESTER STATE COLLEGE                                     ","2003-2004",10,"Ice Hockey",54706,54706,0,54706,54706,0,0,0,0,"28",".",50706,0
"6506",161004,"BOWDOIN COLLEGE                                             ","2003-2004",10,"Ice Hockey",310578,310578,0,136402,136402,0,174176,174176,0,"33","20",24661,25905
"6516",125471,"WEST LOS ANGELES COLLEGE                                    ","2003-2004",10,"Ice Hockey",119324,119324,0,0,0,0,119324,119324,0,".","17",0,81224
"6524",174899,"THE COLLEGE OF SAINT SCHOLASTICA                            ","2003-2004",10,"Ice Hockey",134640,134640,0,134640,134640,0,0,0,0,"25",".",83700,0
"6530",239017,"LAWRENCE UNIVERSITY                                         ","2003-2004",10,"Ice Hockey",103291,103291,0,103291,103291,0,0,0,0,"30",".",75291,0
"6533",121691,"UNIVERSITY OF REDLANDS                                      ","2003-2004",11,"Lacrosse",77014,77014,0,0,0,0,77014,77014,0,".","21",0,40019
"6534",204909,"OHIO WESLEYAN UNIVERSITY                                    ","2003-2004",11,"Lacrosse",143649,143649,0,92100,92100,0,51549,51549,0,"33","24",44822,13823
"6535",196291,"SUNY MARITIME COLLEGE                                       ","2003-2004",11,"Lacrosse",27585,27585,0,27585,27585,0,0,0,0,"28",".",17585,0
"6541",123554,"SAINT MARYS COLLEGE OF CALIFORNIA                           ","2003-2004",11,"Lacrosse",112086,112086,0,0,0,0,112086,112086,0,".","20",0,46712
"6542",211291,"BUCKNELL UNIVERSITY                                         ","2003-2004",11,"Lacrosse",499031,499031,0,239022,239022,0,260009,260009,0,"34","29",38430,61365
"6543",193584,"NAZARETH COLLEGE OF ROCHESTER                               ","2003-2004",11,"Lacrosse",138396,138396,0,87809,87809,0,50587,50587,0,"42","24",62735,35200
"6552",130493,"SOUTHERN CONNECTICUT STATE UNIVERSITY                       ","2003-2004",11,"Lacrosse",50260,50260,0,0,0,0,50260,50260,0,".","22",0,21225
"6556",187134,"THE COLLEGE OF NEW JERSEY                                   ","2003-2004",11,"Lacrosse",85778,85778,0,0,0,0,85778,85778,0,".","20",0,19317
"6558",167987,"UNIVERSITY OF MASSACHUSETTS-DARTMOUTH                       ","2003-2004",11,"Lacrosse",71371,71371,0,27464,27464,0,43907,43907,0,"33","19",14953,20461
"6559",129242,"FAIRFIELD UNIVERSITY                                        ","2003-2004",11,"Lacrosse",787852,787852,0,585844,585844,0,202008,202008,0,"33","24",103854,56167
"6565",193478,"NASSAU COMMUNITY COLLEGE                                    ","2003-2004",11,"Lacrosse",68043,68043,0,45669,45669,0,22374,22374,0,"32","25",25753,14024
"6568",191533,"HARTWICK COLLEGE                                            ","2003-2004",11,"Lacrosse",198643,198643,0,121483,121483,0,77160,77160,0,"46","20",33168,18144
"6583",189705,"CANISIUS COLLEGE                                            ","2003-2004",11,"Lacrosse",225416,225416,0,147028,147028,0,78388,78388,0,"29","19",42479,24642
"6591",130590,"TRINITY COLLEGE                                             ","2003-2004",11,"Lacrosse",142834,142834,0,74454,74454,0,68380,68380,0,"41","19",15088,14364
"6594",216852,"WIDENER UNIVERSITY-MAIN CAMPUS                              ","2003-2004",11,"Lacrosse",80151,80151,0,52903,52903,0,27248,27248,0,"28","17",21773,8720
"6599",166027,"HARVARD UNIVERSITY                                          ","2003-2004",11,"Lacrosse",520422,520422,0,292500,292500,0,227922,227922,0,"53","61",109716,58295
"6610",192466,"SOUTHAMPTON COLLEGE OF LONG ISLAND UNIVERSITY               ","2003-2004",11,"Lacrosse",206274,206274,0,206274,206274,0,0,0,0,"26",".",17883,0
"6623",165662,"EMERSON COLLEGE                                             ","2003-2004",11,"Lacrosse",21455,21455,0,11371,11371,0,10084,10084,0,"19","12",3538,915
"6626",195474,"SIENA COLLEGE                                               ","2003-2004",11,"Lacrosse",211675,211675,0,131457,131457,0,80218,80218,0,"33","20",61103,40393
"6630",189459,"BRIARCLIFFE COLLEGE                                         ","2003-2004",11,"Lacrosse",229840,229840,0,229840,229840,0,0,0,0,"17","0",39100,0
"6631",213400,"LANCASTER BIBLE COLLEGE                                     ","2003-2004",11,"Lacrosse",9233,9233,0,0,0,0,9233,9233,0,".","17",0,7023
"6633",112260,"CLAREMONT MCKENNA COLLEGE                                   ","2003-2004",11,"Lacrosse",72016,72016,0,0,0,0,72016,72016,0,".","21",0,31147
"6636",196051,"MORRISVILLE STATE COLLEGE                                   ","2003-2004",11,"Lacrosse",38283,38283,0,21083,21083,0,17200,17200,0,"21","16",18316,14434
"6640",168227,"WENTWORTH INSTITUTE OF TECHNOLOGY                           ","2003-2004",11,"Lacrosse",26145,26145,0,26145,26145,0,0,0,0,"25",".",13165,0
"6647",234173,"VIRGINIA WESLEYAN COLLEGE                                   ","2003-2004",11,"Lacrosse",88770,88770,0,54913,54913,0,33857,33857,0,"36","19",16507,8832
"6649",129525,"UNIVERSITY OF HARTFORD                                      ","2003-2004",11,"Lacrosse",310826,310826,0,310826,310826,0,0,0,0,"22",".",42056,0
"6650",212832,"GWYNEDD MERCY COLLEGE                                       ","2003-2004",11,"Lacrosse",14110,14110,0,0,0,0,14110,14110,0,".","18",0,7110
"6658",230898,"GREEN MOUNTAIN COLLEGE                                      ","2003-2004",11,"Lacrosse",41631,41631,0,41631,41631,0,0,0,0,"20",".",16631,0
"6664",129774,"MITCHELL COLLEGE                                            ","2003-2004",11,"Lacrosse",36726,36726,0,36726,36726,0,0,0,0,"11",".",6484,0
"6667",163046,"LOYOLA COLLEGE IN MARYLAND                                  ","2003-2004",11,"Lacrosse",1795085,1795085,0,1022960,1022960,0,772125,772125,0,"39","28",179912,122021
"6668",165334,"CLARK UNIVERSITY                                            ","2003-2004",11,"Lacrosse",38630,38630,0,38630,38630,0,0,0,0,"21",".",8027,0
"6675",164447,"AMERICAN INTERNATIONAL COLLEGE                              ","2003-2004",11,"Lacrosse",45386,45386,0,23808,23808,0,21578,21578,0,"25","18",19500,20028
"6677",162760,"HOOD COLLEGE                                                ","2003-2004",11,"Lacrosse",14280,14280,0,0,0,0,14280,14280,0,".","10",0,7771
"6691",215770,"SAINT JOSEPHS UNIVERSITY                                    ","2003-2004",11,"Lacrosse",337554,337554,0,151205,151205,0,186349,186349,0,"32","25",52939,56173
"6694",186867,"STEVENS INSTITUTE OF TECHNOLOGY                             ","2003-2004",11,"Lacrosse",251254,251254,0,156713,156713,0,94541,94541,0,"32","18",52975,30072
"6703",210669,"ALLEGHENY COLLEGE                                           ","2003-2004",11,"Lacrosse",47323,47323,0,0,0,0,47323,47323,0,"0","19",0,25019
"6704",183026,"SOUTHERN NEW HAMPSHIRE UNIVERSITY                           ","2003-2004",11,"Lacrosse",194641,194641,0,145089,145089,0,49552,49552,0,"31","16",46910,16652
"6705",190770,"DOWLING COLLEGE                                             ","2003-2004",11,"Lacrosse",294239,294239,0,294239,294239,0,0,0,0,"33",".",50377,0
"6706",214272,"NEUMANN COLLEGE                                             ","2003-2004",11,"Lacrosse",44598,44598,0,24799,24799,0,19799,19799,0,"20","19",17000,12000
"6711",162706,"HARFORD COMMUNITY COLLEGE                                   ","2003-2004",11,"Lacrosse",47196,47196,0,24413,24413,0,22783,22783,0,"19","18",9650,4928
"6712",213996,"MESSIAH COLLEGE                                             ","2003-2004",11,"Lacrosse",81294,81294,0,50788,50788,0,30506,30506,0,"27","21",25509,21821
"6717",128902,"CONNECTICUT COLLEGE                                         ","2003-2004",11,"Lacrosse",156505,156505,0,81911,81911,0,74594,74594,0,"32","20",19471,20866
"6726",166638,"UNIVERSITY OF MASSACHUSETTS-BOSTON                          ","2003-2004",11,"Lacrosse",34580,34580,0,34580,34580,0,0,0,0,"19",".",20719,0
"6727",215947,"SETON HILL UNIVERSITY                                       ","2003-2004",11,"Lacrosse",228940,228940,0,114470,114470,0,114470,114470,0,"15","15",43400,43400
"6733",130776,"WESTERN CONNECTICUT STATE UNIVERSITY                        ","2003-2004",11,"Lacrosse",187025,187025,0,106200,106200,0,80825,80825,0,"25","18",13300,16580
"6740",183080,"PLYMOUTH STATE UNIVERSITY                                   ","2003-2004",11,"Lacrosse",115741,115741,0,50504,50504,0,65237,65237,0,"26","22",17865,32739
"6741",196042,"FARMINGDALE STATE UNIVERSITY OF NEW YORK                    ","2003-2004",11,"Lacrosse",34500,34500,0,34500,34500,0,0,0,0,"30",".",19000,0
"6742",196185,"SUNY COLLEGE AT ONEONTA                                     ","2003-2004",11,"Lacrosse",165700,165700,0,88372,88372,0,77328,77328,0,"35","25",22136,14501
"6746",212911,"HAVERFORD COLLEGE                                           ","2003-2004",11,"Lacrosse",46860,46860,0,33876,33876,0,12984,12984,0,"28","24",28393,12427
"6747",189547,"BROOME COMMUNITY COLLEGE                                    ","2003-2004",11,"Lacrosse",14085,14085,0,14085,14085,0,0,0,0,"21",".",10085,0
"6751",202523,"DENISON UNIVERSITY                                          ","2003-2004",11,"Lacrosse",223339,223339,0,142755,142755,0,80584,80584,0,"40","19",78480,41819
"6754",210739,"DESALES UNIVERSITY                                          ","2003-2004",11,"Lacrosse",48660,48660,0,48660,48660,0,0,0,0,"23",".",24791,0
"6757",166124,"COLLEGE OF THE HOLY CROSS                                   ","2003-2004",11,"Lacrosse",372758,372758,0,133744,133744,0,239014,239014,0,"34","24",48305,44184
"6759",168281,"WHEATON COLLEGE                                             ","2003-2004",11,"Lacrosse",142774,142774,0,64152,64152,0,78622,78622,0,"36","21",26426,38042
"6761",217156,"BROWN UNIVERSITY                                            ","2003-2004",11,"Lacrosse",502619,502619,0,298825,298825,0,203794,203794,0,"35","33",37351,41036
"6763",192819,"MARIST COLLEGE                                              ","2003-2004",11,"Lacrosse",336551,336551,0,166201,166199,2,170350,170352,-2,"39","21",67419,62893
"6765",210775,"ALVERNIA COLLEGE                                            ","2003-2004",11,"Lacrosse",40568,40568,0,20949,20949,0,19619,19619,0,"19","22",10244,10864
"6768",193973,"NIAGARA UNIVERSITY                                          ","2003-2004",11,"Lacrosse",123998,123998,0,0,0,0,123998,123998,0,".","25",0,25880
"6775",217420,"RHODE ISLAND COLLEGE                                        ","2003-2004",11,"Lacrosse",47058,47058,0,0,0,0,47058,47058,0,".","17",0,6533
"6776",161004,"BOWDOIN COLLEGE                                             ","2003-2004",11,"Lacrosse",193596,193596,0,101603,101603,0,91993,91993,0,"38","23",13926,16272
"6777",130253,"SACRED HEART UNIVERSITY                                     ","2003-2004",11,"Lacrosse",643423,643423,0,414256,414256,0,229167,229167,0,"69","31",80459,37448
"6778",232706,"MARYMOUNT UNIVERSITY                                        ","2003-2004",11,"Lacrosse",76065,76065,0,45852,45852,0,30213,30213,0,"24","21",39125,22920
"6788",168148,"TUFTS UNIVERSITY                                            ","2003-2004",11,"Lacrosse",86751,86751,0,41952,41952,0,44799,44799,0,"39","20",16850,9200
"6789",230913,"JOHNSON STATE COLLEGE                                       ","2003-2004",11,"Lacrosse",11791,11791,0,11791,11791,0,0,0,0,"14",".",9100,0
"6792",196121,"SUNY COLLEGE AT BROCKPORT                                   ","2003-2004",11,"Lacrosse",62086,62086,0,39352,39352,0,22734,22734,0,"38","23",22235,20230
"6799",193399,"COLLEGE OF MOUNT SAINT VINCENT                              ","2003-2004",11,"Lacrosse",0,0,0,0,0,0,0,0,0,"14","13",11000,11000
"6806",131098,"WESLEY COLLEGE                                              ","2003-2004",11,"Lacrosse",61425,61425,0,29345,29345,0,32080,32080,0,"26","11",18950,13125
"6815",165574,"DEAN COLLEGE                                                ","2003-2004",11,"Lacrosse",30550,30550,0,30550,30550,0,0,0,0,"18",".",4650,0
"6817",150163,"BUTLER UNIVERSITY                                           ","2003-2004",11,"Lacrosse",367025,367025,0,367025,367025,0,0,0,0,"40",".",63973,0
"6821",163851,"SALISBURY UNIVERSITY                                        ","2003-2004",11,"Lacrosse",58599,58599,0,37230,37230,0,21369,21369,0,"46","29",19709,9604
"6822",215798,"SAINT VINCENT COLLEGE                                       ","2003-2004",11,"Lacrosse",254030,254030,0,147300,147300,0,106730,106730,0,"28","30",48083,24669
"6835",212674,"GETTYSBURG COLLEGE                                          ","2003-2004",11,"Lacrosse",199007,199007,0,122442,122442,0,76565,76565,0,"44","27",29804,15433
"6839",193283,"MOHAWK VALLEY COMMUNITY COLLEGE-UTICA BRANCH                ","2003-2004",11,"Lacrosse",18233,18233,0,18233,18233,0,0,0,0,"22",".",10164,0
"6840",192439,"LONG ISLAND UNIVERSITY-BROOKLYN CAMPUS                      ","2003-2004",11,"Lacrosse",323792,323792,0,0,0,0,323792,323792,0,".","19",0,62257
"6844",100663,"UNIVERSITY OF ALABAMA AT BIRMINGHAM                         ","2003-2004",12,"Rifle",27696,27696,0,0,0,0,27696,27696,0,".","5",0,2892
"6846",168227,"WENTWORTH INSTITUTE OF TECHNOLOGY                           ","2003-2004",12,"Rifle",11410,11410,0,5705,5705,0,5705,5705,0,"5","4",2900,2900
"6848",100937,"BIRMINGHAM SOUTHERN COLLEGE                                 ","2003-2004",12,"Rifle",109346,109346,0,0,0,0,109346,109346,0,".","8",0,9425
"6854",101480,"JACKSONVILLE STATE UNIVERSITY                               ","2003-2004",12,"Rifle",85991,85991,0,85991,85991,0,0,0,0,"11",".",85990,0
"6859",140447,"MERCER UNIVERSITY                                           ","2003-2004",12,"Rifle",11341,11341,0,11341,11341,0,0,0,0,"6","0",7865,0
"6874",190600,"CUNY JOHN JAY COLLEGE CRIMINAL JUSTICE                      ","2003-2004",12,"Rifle",15720,15720,0,11161,11161,0,4559,4559,0,"14",".",2918,1192
"6877",196291,"SUNY MARITIME COLLEGE                                       ","2003-2004",12,"Rifle",9355,9355,0,9355,9355,0,0,0,0,"8",".",5355,0
"6881",167358,"NORTHEASTERN UNIVERSITY                                     ","2003-2004",13,"Rowing",937903,937903,0,311178,311178,0,626725,626725,0,"36","58",34942,31921
"6883",130590,"TRINITY COLLEGE                                             ","2003-2004",13,"Rowing",185036,185036,0,105262,105262,0,79774,79774,0,"33","43",25773,28767
"6889",129242,"FAIRFIELD UNIVERSITY                                        ","2003-2004",13,"Rowing",191216,191216,0,0,0,0,191216,191216,0,".","42",0,64877
"6898",166692,"MASSACHUSETTS MARITIME ACADEMY                              ","2003-2004",13,"Rowing",15000,15000,0,7000,7500,-500,8000,7500,500,"41","21",4000,4000
"6910",216339,"TEMPLE UNIVERSITY                                           ","2003-2004",13,"Rowing",602805,602805,0,290093,290093,0,312712,312712,0,"34","41",87611,46667
"6919",130253,"SACRED HEART UNIVERSITY                                     ","2003-2004",13,"Rowing",74128,74128,0,0,0,0,74128,74128,0,".","23",0,47842
"6922",168148,"TUFTS UNIVERSITY                                            ","2003-2004",13,"Rowing",106982,106982,0,38486,38486,0,68496,68496,0,"72","106",17250,21250
"6923",190770,"DOWLING COLLEGE                                             ","2003-2004",13,"Rowing",339586,339586,0,207143,207143,0,132443,132443,0,"18","14",28230,28230
"6925",166124,"COLLEGE OF THE HOLY CROSS                                   ","2003-2004",13,"Rowing",251670,251670,0,120354,120354,0,131316,131316,0,"54","69",40273,33405
"6934",128902,"CONNECTICUT COLLEGE                                         ","2003-2004",13,"Rowing",182995,182995,0,92851,92851,0,90144,90144,0,"13","31",13638,24734
"6944",211291,"BUCKNELL UNIVERSITY                                         ","2003-2004",13,"Rowing",197221,197221,0,0,0,0,197221,197221,0,".","39",0,80258
"6953",165334,"CLARK UNIVERSITY                                            ","2003-2004",13,"Rowing",42229,42229,0,13091,13091,0,29138,29138,0,"9","20",5138,11435
"6963",196291,"SUNY MARITIME COLLEGE                                       ","2003-2004",13,"Rowing",30000,30000,0,24000,24000,0,6000,6000,0,"23","5",20000,1000
"6983",163046,"LOYOLA COLLEGE IN MARYLAND                                  ","2003-2004",13,"Rowing",111508,111508,0,41396,41396,0,70112,70112,0,"19","24",25887,25887
"6986",122436,"UNIVERSITY OF SAN DIEGO                                     ","2003-2004",13,"Rowing",330498,330498,0,115148,115148,0,215350,215350,0,"13","67",44282,52962
"6996",215770,"SAINT JOSEPHS UNIVERSITY                                    ","2003-2004",13,"Rowing",459014,459014,0,212715,212715,0,246299,246299,0,"49","36",78510,119079
"7006",163976,"ST JOHN'S COLLEGE                                           ","2003-2004",13,"Rowing",5000,5000,0,2500,2500,0,2500,2500,0,"20","20",2250,2250
"7014",166027,"HARVARD UNIVERSITY                                          ","2003-2004",13,"Rowing",1307431,1307431,0,716652,716652,0,590779,590779,0,"126","95",240916,230327
"7023",183080,"PLYMOUTH STATE UNIVERSITY                                   ","2003-2004",14,"Skiing",73857,73857,0,36508,36508,0,37349,37349,0,"14","12",14030,14673
"7036",166027,"HARVARD UNIVERSITY                                          ","2003-2004",14,"Skiing",145207,145207,0,72604,72604,0,72603,72603,0,"9","7",38217,38217
"7039",161004,"BOWDOIN COLLEGE                                             ","2003-2004",14,"Skiing",53917,53917,0,26726,26726,0,27191,27191,0,"6","3",7695,8383
"7040",136950,"ROLLINS COLLEGE                                             ","2003-2004",14,"Skiing",49118,49118,0,24559,24559,0,24559,24559,0,"6","5",8004,8004
"7041",161086,"COLBY COLLEGE                                               ","2003-2004",14,"Skiing",83612,83612,0,42612,42612,0,41000,41000,0,"18","15",41266,40236
"7058",196051,"MORRISVILLE STATE COLLEGE                                   ","2003-2004",14,"Skiing",20592,20592,0,10296,10296,0,10296,10296,0,"9","2",6142,6142
"7071",161457,"UNIVERSITY OF NEW ENGLAND                                   ","2003-2004",15,"Soccer",55465,55465,0,29094,29094,0,26371,26371,0,"20","23",12970,10247
"7078",216339,"TEMPLE UNIVERSITY                                           ","2003-2004",15,"Soccer",655075,655075,0,236460,236460,0,418615,418615,0,"30","25",59895,60886
"7080",165334,"CLARK UNIVERSITY                                            ","2003-2004",15,"Soccer",79374,79374,0,47545,47545,0,31829,31829,0,"23","25",11094,10953
"7087",207722,"UNIVERSITY OF SCIENCE AND ARTS OF OKLAHOMA                  ","2003-2004",15,"Soccer",79923,79923,0,41030,41030,0,38893,38893,0,"21","17",22680,20543
"7093",143288,"BLACKBURN COLLEGE                                           ","2003-2004",15,"Soccer",61623,61623,0,33466,33466,0,28157,28157,0,"25","17",11849,6540
"7095",155210,"JOHNSON COUNTY COMMUNITY COLLEGE                            ","2003-2004",15,"Soccer",148655,148655,0,72700,72700,0,75955,75955,0,"21","16",21847,20477
"7098",176008,"MISSISSIPPI DELTA COMMUNITY COLLEGE                         ","2003-2004",15,"Soccer",53617,53617,0,27953,27953,0,25664,25664,0,"13","13",10343,8054
"7105",206817,"BACONE COLLEGE                                              ","2003-2004",15,"Soccer",260000,260000,0,130000,130000,0,130000,130000,0,"18","22",15213,15231
"7107",144157,"CITY COLLEGES OF CHICAGO-KENNEDY-KING COLLEGE               ","2003-2004",15,"Soccer",26510,26510,0,13255,13255,0,13255,13255,0,"18","8",9755,9755
"7111",163046,"LOYOLA COLLEGE IN MARYLAND                                  ","2003-2004",15,"Soccer",1311865,1311865,0,668596,668596,0,643269,643269,0,"22","20",129168,64718
"7119",219790,"BRYAN COLLEGE                                               ","2003-2004",15,"Soccer",33105,33105,0,15502,15502,0,17603,17603,0,"25","16",15485,17572
"7122",117733,"LOS ANGELES VALLEY COLLEGE                                  ","2003-2004",15,"Soccer",25017,25017,0,0,0,0,25017,25017,0,".","22",0,6452
"7129",232706,"MARYMOUNT UNIVERSITY                                        ","2003-2004",15,"Soccer",53674,53674,0,23871,23871,0,29803,29803,0,"28","23",22453,27016
"7137",123217,"COLLEGE OF THE SEQUOIAS                                     ","2003-2004",15,"Soccer",14190,14190,0,0,0,0,14190,14190,0,".","16",0,4750
"7144",149842,"WILLIAM RAINEY HARPER COLLEGE                               ","2003-2004",15,"Soccer",43532,43532,0,20839,20839,0,22693,22693,0,"23","21",7429,8967
"7145",183099,"NEW HAMPSHIRE TECHNICAL INSTITUTE                           ","2003-2004",15,"Soccer",16000,16000,0,8000,8000,0,8000,8000,0,"19","17",4500,5000
"7146",239017,"LAWRENCE UNIVERSITY                                         ","2003-2004",15,"Soccer",106011,106011,0,58570,58570,0,47441,47441,0,"25","19",18530,14771
"7156",207281,"NORTHERN OKLAHOMA COLLEGE                                   ","2003-2004",15,"Soccer",64810,64810,0,36535,36535,0,28275,28275,0,"23","11",16915,10436
"7158",175883,"JONES COUNTY JUNIOR COLLEGE                                 ","2003-2004",15,"Soccer",62552,62552,0,33315,33315,0,29237,29237,0,"25","25",6962,6962
"7159",215114,"PHILADELPHIA BIBLICAL UNIVERSITY-LANGHORNE                  ","2003-2004",15,"Soccer",42562,42562,0,25897,25897,0,16665,16665,0,"26","17",22047,12670
"7162",213525,"LEHIGH CARBON COMMUNITY COLLEGE                             ","2003-2004",15,"Soccer",2450,2450,0,2450,2450,0,0,0,0,"12","0",280,0
"7163",193308,"MONROE COLLEGE-MAIN CAMPUS                                  ","2003-2004",15,"Soccer",44989,44989,0,44989,44989,0,0,0,0,"21",".",27977,0
"7164",176628,"AVILA UNIVERSITY                                            ","2003-2004",15,"Soccer",183898,183898,0,81247,81247,0,102651,102651,0,"27","24",11978,12358
"7165",193399,"COLLEGE OF MOUNT SAINT VINCENT                              ","2003-2004",15,"Soccer",0,0,0,0,0,0,0,0,0,"18","18",12000,12000
"7180",167987,"UNIVERSITY OF MASSACHUSETTS-DARTMOUTH                       ","2003-2004",15,"Soccer",69708,69708,0,36856,36856,0,32852,32852,0,"23","21",15050,14145
"7181",399212,"SANTIAGO CANYON COLLEGE                                     ","2003-2004",15,"Soccer",53358,53358,0,25408,25408,0,27950,27950,0,"25","21",10408,7950
"7182",129774,"MITCHELL COLLEGE                                            ","2003-2004",15,"Soccer",188523,188523,0,99166,99166,0,89357,89357,0,"21","19",23195,24812
"7184",229887,"WILEY COLLEGE                                               ","2003-2004",15,"Soccer",28853,28853,0,28853,28853,0,0,0,0,"21",".",7798,0
"7186",138691,"DARTON COLLEGE                                              ","2003-2004",15,"Soccer",97043,97043,0,47973,47973,0,49070,49070,0,"23","16",13665,10826
"7190",214704,"PENNSYLVANIA STATE UNIVERSITY-PENN STATE BERKS              ","2003-2004",15,"Soccer",18789,18789,0,18789,18789,0,0,0,0,"19",".",9589,0
"7202",149365,"SOUTH SUBURBAN COLLEGE                                      ","2003-2004",15,"Soccer",23800,23800,0,15000,15000,0,8800,8800,0,"22","14",12733,6700
"7205",190664,"CUNY QUEENS COLLEGE                                         ","2003-2004",15,"Soccer",79640,79640,0,0,0,0,79640,79640,0,".","18",0,9791
"7214",112686,"COMPTON COMMUNITY COLLEGE                                   ","2003-2004",15,"Soccer",19000,19000,0,19000,19000,0,0,0,0,"25",".",10000,0
"7216",122977,"SANTA MONICA COLLEGE                                        ","2003-2004",15,"Soccer",25164,25164,0,0,0,0,25164,25164,0,".","18",0,5164
"7218",237950,"WEST VIRGINIA UNIVERSITY INSTITUTE OF TECHNOLOGY            ","2003-2004",15,"Soccer",11315,11315,0,0,0,0,11315,11315,0,".","18",0,5718
"7221",183026,"SOUTHERN NEW HAMPSHIRE UNIVERSITY                           ","2003-2004",15,"Soccer",743046,743046,0,369784,369784,0,373262,373262,0,"27","26",60619,52705
"7224",117706,"LOS ANGELES PIERCE COLLEGE                                  ","2003-2004",15,"Soccer",37328,37328,0,0,0,0,37328,37328,0,".","19",0,13483
"7227",196121,"SUNY COLLEGE AT BROCKPORT                                   ","2003-2004",15,"Soccer",45760,45760,0,22465,22465,0,23295,23295,0,"20","26",20520,15399
"7241",213358,"LA ROCHE COLLEGE                                            ","2003-2004",15,"Soccer",46497,46497,0,24891,24891,0,21606,21606,0,"18","22",16241,13398
"7247",125091,"VICTOR VALLEY COLLEGE                                       ","2003-2004",15,"Soccer",52571,52571,0,26480,26480,0,26091,26091,0,"18","15",7277,9437
"7249",239512,"NORTHLAND COLLEGE                                           ","2003-2004",15,"Soccer",73515,73515,0,36966,36966,0,36549,36549,0,"18","19",18488,18072
"7252",211291,"BUCKNELL UNIVERSITY                                         ","2003-2004",15,"Soccer",548754,548754,0,181962,181962,0,366792,366792,0,"24","30",46055,59253
"7258",165112,"BUNKER HILL COMMUNITY COLLEGE                               ","2003-2004",15,"Soccer",19100,19100,0,9800,9800,0,9300,9300,0,"18","12",5460,4392
"7278",217156,"BROWN UNIVERSITY                                            ","2003-2004",15,"Soccer",527285,527285,0,277888,277888,0,249397,249397,0,"23","28",31588,74166
"7280",105154,"MESA COMMUNITY COLLEGE                                      ","2003-2004",15,"Soccer",44000,44000,0,22000,22000,0,22000,22000,0,"23","23",13000,13000
"7283",141574,"UNIVERSITY OF HAWAII AT MANOA                               ","2003-2004",15,"Soccer",391016,391016,0,0,0,0,391016,391016,0,".","26",0,201657
"7288",101709,"UNIVERSITY OF MONTEVALLO                                    ","2003-2004",15,"Soccer",214598,214598,0,106296,106296,0,108302,108302,0,"21","21",20860,20762
"7290",187198,"UNION COUNTY COLLEGE                                        ","2003-2004",15,"Soccer",38000,38000,0,38000,38000,0,0,0,0,"20",".",24000,0
"7297",209612,"PACIFIC UNIVERSITY                                          ","2003-2004",15,"Soccer",75358,75358,0,38582,38582,0,36776,36776,0,"22","20",16943,19120
"7298",229355,"TYLER JUNIOR COLLEGE                                        ","2003-2004",15,"Soccer",138595,138595,0,138595,138595,0,0,0,0,"27",".",36712,0
"7301",220473,"JOHNSON BIBLE COLLEGE                                       ","2003-2004",15,"Soccer",14961,14961,0,14961,14961,0,0,0,0,"23",".",7432,0
"7303",154642,"ALLEN COUNTY COMMUNITY COLLEGE                              ","2003-2004",15,"Soccer",36078,36078,0,18447,18447,0,17631,17631,0,"25","18",12640,12280
"7304",210669,"ALLEGHENY COLLEGE                                           ","2003-2004",15,"Soccer",106591,106591,0,58139,58139,0,48452,48452,0,"29","28",15094,23074
"7306",202134,"CLEVELAND STATE UNIVERSITY                                  ","2003-2004",15,"Soccer",322330,322330,0,253561,253561,0,68769,68769,0,"22","14",26385,7632
"7307",226152,"TEXAS A &amp; M INTERNATIONAL UNIVERSITY                        ","2003-2004",15,"Soccer",134000,134000,0,67000,67000,0,67000,67000,0,"34","27",21724,22039
"7309",178624,"NORTHWEST MISSOURI STATE UNIVERSITY                         ","2003-2004",15,"Soccer",140128,140128,0,0,0,0,140128,140128,0,".","22",0,7127
"7313",204857,"OHIO UNIVERSITY-MAIN CAMPUS                                 ","2003-2004",15,"Soccer",378549,378549,0,0,0,0,378549,378549,0,".","25",0,42889
"7317",189705,"CANISIUS COLLEGE                                            ","2003-2004",15,"Soccer",445391,445391,0,225044,225044,0,220347,220347,0,"28","25",42118,33660
"7326",153375,"GRAND VIEW COLLEGE                                          ","2003-2004",15,"Soccer",344270,344270,0,184164,184164,0,160106,160106,0,"28","28",26855,28470
"7327",190725,"DAEMEN COLLEGE                                              ","2003-2004",15,"Soccer",154593,154593,0,83253,83253,0,71340,71340,0,"25","19",25051,25051
"7329",234173,"VIRGINIA WESLEYAN COLLEGE                                   ","2003-2004",15,"Soccer",109496,109496,0,75407,75407,0,34089,34089,0,"28","29",16067,12178
"7333",150172,"CALUMET COLLEGE OF SAINT JOSEPH                             ","2003-2004",15,"Soccer",33891,33891,0,0,0,0,33891,33891,0,".","20",0,25034
"7334",181127,"HASTINGS COLLEGE                                            ","2003-2004",15,"Soccer",486133,486133,0,315080,315080,0,171053,171053,0,"37","19",20155,17228
"7338",113096,"COSUMNES RIVER COLLEGE                                      ","2003-2004",15,"Soccer",26875,26875,0,10475,10475,0,16400,16400,0,"22","22",9700,15825
"7342",158477,"CENTENARY COLLEGE OF LOUISIANA                              ","2003-2004",15,"Soccer",673091,673091,0,362883,362883,0,310208,310208,0,"30","23",75630,49877
"7350",214801,"PENNSYLVANIA STATE UNIVERSITY-PENN STATE ABINGTON           ","2003-2004",15,"Soccer",19641,19641,0,10606,10606,0,9035,9035,0,"19","12",4329,4238
"7353",150677,"GRACE COLLEGE AND THEOLOGICAL SEMINARY                      ","2003-2004",15,"Soccer",193100,193100,0,113226,113226,0,79874,79874,0,"24","23",17491,17324
"7356",214810,"PENNSYLVANIA STATE UNIVERSITY-PENN STATE SCHUYLKIL          ","2003-2004",15,"Soccer",3000,3000,0,3000,3000,0,0,0,0,"20",".",3000,0
"7358",218724,"COASTAL CAROLINA UNIVERSITY                                 ","2003-2004",15,"Soccer",645908,645908,0,347603,347603,0,298305,298305,0,"28","31",65670,41160
"7362",193900,"NEW YORK UNIVERSITY                                         ","2003-2004",15,"Soccer",332031,332031,0,161897,161897,0,170134,170134,0,"27","26",99816,109645
"7365",203368,"JOHN CARROLL UNIVERSITY                                     ","2003-2004",15,"Soccer",137786,137786,0,76596,76596,0,61190,61190,0,"28","25",37442,18973
"7370",146603,"LEWIS AND CLARK COMMUNITY COLLEGE                           ","2003-2004",15,"Soccer",100946,100946,0,50309,50309,0,50637,50637,0,"15","18",9694,10022
"7387",174914,"UNIVERSITY OF ST THOMAS                                     ","2003-2004",15,"Soccer",83441,83441,0,45251,45251,0,38190,38190,0,"27","20",26975,20537
"7392",190840,"DUTCHESS COMMUNITY COLLEGE                                  ","2003-2004",15,"Soccer",9050,9050,0,9050,9050,0,0,0,0,"20",".",3250,0
"7395",366252,"PENNSYLVANIA COLLEGE OF TECHNOLOGY                          ","2003-2004",15,"Soccer",34224,34224,0,17112,17112,0,17112,17112,0,"24","15",10656,10665
"7397",196565,"TOMPKINS-CORTLAND COMMUNITY COLLEGE                         ","2003-2004",15,"Soccer",30906,30906,0,16921,16921,0,13985,13985,0,"20","14",11697,10075
"7399",168281,"WHEATON COLLEGE                                             ","2003-2004",15,"Soccer",177309,177309,0,95606,95606,0,81703,81703,0,"26","23",38068,30624
"7407",129525,"UNIVERSITY OF HARTFORD                                      ","2003-2004",15,"Soccer",989160,989160,0,454133,454133,0,535027,535027,0,"23","21",48398,43584
"7412",131450,"GALLAUDET UNIVERSITY                                        ","2003-2004",15,"Soccer",37402,37402,0,20157,20157,0,17245,17245,0,"23","18",12957,10245
"7427",173124,"BEMIDJI STATE UNIVERSITY                                    ","2003-2004",15,"Soccer",104819,104819,0,0,0,0,104819,104819,0,".","18",0,34253
"7433",104717,"GRAND CANYON UNIVERSITY                                     ","2003-2004",15,"Soccer",381748,381748,0,177302,177302,0,204446,204446,0,"18","16",45321,50673
"7440",176789,"CALVARY BIBLE COLLEGE AND THEOLOGICAL SEMINARY              ","2003-2004",15,"Soccer",10914,10914,0,10914,10914,0,0,0,0,"14",".",3580,0
"7456",174491,"NORTHWESTERN COLLEGE                                        ","2003-2004",15,"Soccer",56316,56316,0,29927,29927,0,26389,26389,0,"24","17",19256,15321
"7471",101879,"UNIVERSITY OF NORTH ALABAMA                                 ","2003-2004",15,"Soccer",106183,106183,0,0,0,0,106183,106183,0,".","21",0,17426
"7479",181853,"YORK COLLEGE                                                ","2003-2004",15,"Soccer",34840,34840,0,16183,16183,0,18657,18657,0,"23","16",11542,10935
"7482",145682,"ILLINOIS CENTRAL COLLEGE                                    ","2003-2004",15,"Soccer",95570,95570,0,45829,45829,0,49741,49741,0,"19","16",11266,13069
"7491",154855,"CENTRAL CHRISTIAN COLLEGE OF KANSAS                         ","2003-2004",15,"Soccer",19369,19369,0,10427,10427,0,8942,8942,0,"18","17",6664,5689
"7497",104586,"EMBRY RIDDLE AERONAUTICAL UNIVERSITY-PRESCOTT               ","2003-2004",15,"Soccer",29771,29771,0,29771,29771,0,0,0,0,"18",".",21643,0
"7498",212878,"HARRISBURG AREA COMMUNITY COLLEGE-HARRISBURG                ","2003-2004",15,"Soccer",6980,6980,0,6980,6980,0,0,0,0,"21","0",4380,0
"7499",227146,"NAVARRO COLLEGE                                             ","2003-2004",15,"Soccer",81672,81672,0,0,0,0,81672,81672,0,".","20",0,11900
"7503",148584,"UNIVERSITY OF ST FRANCIS                                    ","2003-2004",15,"Soccer",274820,274820,0,140578,140578,0,134242,134242,0,"27","22",9631,11854
"7505",212911,"HAVERFORD COLLEGE                                           ","2003-2004",15,"Soccer",65969,65969,0,33284,33284,0,32685,32685,0,"28","31",32991,29071
"7514",242671,"INTER AMERICAN UNIV OF PUERTO RICO-CENTRAL OFFICE           ","2003-2004",15,"Soccer",30290,30290,0,30290,30290,0,0,0,0,"20",".",5539,0
"7516",220978,"MIDDLE TENNESSEE STATE UNIVERSITY                           ","2003-2004",15,"Soccer",370334,370334,0,0,0,0,370334,370334,0,".","25",0,77581
"7519",214689,"PENNSYLVANIA STATE UNIVERSITY-PENN STATE ALTOONA            ","2003-2004",15,"Soccer",33646,33646,0,17820,17820,0,15826,15826,0,"26","20",10549,8356
"7521",190655,"CUNY NEW YORK CITY COLLEGE OF TECHNOLOGY                    ","2003-2004",15,"Soccer",10612,10612,0,10612,10612,0,0,0,0,"24",".",10611,0
"7535",139311,"CLAYTON COLLEGE AND STATE UNIVERSITY                        ","2003-2004",15,"Soccer",278386,278386,0,147851,147851,0,130535,130535,0,"31","17",105322,96545
"7543",169521,"DELTA COLLEGE                                               ","2003-2004",15,"Soccer",14728,14728,0,14728,14728,0,0,0,0,"17",".",9228,0
"7551",228431,"STEPHEN F AUSTIN STATE UNIVERSITY                           ","2003-2004",15,"Soccer",224647,224647,0,0,0,0,224647,224647,0,".","29",0,47306
"7552",162706,"HARFORD COMMUNITY COLLEGE                                   ","2003-2004",15,"Soccer",36326,36326,0,16961,16961,0,19365,19365,0,"15","15",3274,3936
"7555",238333,"BELOIT COLLEGE                                              ","2003-2004",15,"Soccer",20610,20610,0,11040,11040,0,9570,9570,0,"23","30",11040,9570
"7559",133553,"EMBRY RIDDLE AERONAUTICAL UNIVERSITY-DAYTONA BEACH          ","2003-2004",15,"Soccer",472592,472592,0,281607,281607,0,190985,190985,0,"19","16",265434,184335
"7562",155070,"BARCLAY COLLEGE                                             ","2003-2004",15,"Soccer",6000,6000,0,6000,6000,0,0,0,0,"12","0",4475,0
"7570",110051,"BETHANY COLLEGE OF THE ASSEMBLIES OF GOD                    ","2003-2004",15,"Soccer",118511,118511,0,55060,55060,0,63451,63451,0,"14","21",10538,13676
"7573",157100,"KENTUCKY CHRISTIAN COLLEGE                                  ","2003-2004",15,"Soccer",46081,46081,0,24343,24343,0,21738,21738,0,"18","16",19988,17418
"7577",190549,"CUNY BROOKLYN COLLEGE                                       ","2003-2004",15,"Soccer",20431,20431,0,20431,20431,0,0,0,0,"22",".",11365,0
"7578",105792,"SOUTH MOUNTAIN COMMUNITY COLLEGE                            ","2003-2004",15,"Soccer",26421,26421,0,13252,13252,0,13169,13169,0,"18","15",4974,4891
"7581",165662,"EMERSON COLLEGE                                             ","2003-2004",15,"Soccer",39214,39214,0,18360,18360,0,20854,20854,0,"24","19",7256,5594
"7583",140997,"SOUTH GEORGIA COLLEGE                                       ","2003-2004",15,"Soccer",105690,105690,0,60002,60002,0,45688,45688,0,"25","18",28575,31320
"7585",173258,"CARLETON COLLEGE                                            ","2003-2004",15,"Soccer",87126,87126,0,46121,46121,0,41005,41005,0,"26","21",15361,14360
"7591",154235,"SAINT AMBROSE UNIVERSITY                                    ","2003-2004",15,"Soccer",219229,219229,0,127748,127748,0,91481,91481,0,"40","25",16694,15531
"7592",149532,"TRITON COLLEGE                                              ","2003-2004",15,"Soccer",17578,17578,0,17578,17578,0,0,0,0,"16",".",6594,0
"7593",146472,"COLLEGE OF LAKE COUNTY                                      ","2003-2004",15,"Soccer",38584,38584,0,19671,19671,0,18913,18913,0,"20","14",15596,13691
"7601",197133,"VASSAR COLLEGE                                              ","2003-2004",15,"Soccer",77372,77372,0,47115,47115,0,30257,30257,0,"25","20",17865,13133
"7602",125499,"WEST VALLEY COLLEGE                                         ","2003-2004",15,"Soccer",47762,47762,0,25607,25607,0,22155,22155,0,"29","21",4640,3360
"7605",175652,"EAST MISSISSIPPI COMMUNITY COLLEGE                          ","2003-2004",15,"Soccer",37898,37898,0,17668,17668,0,20230,20230,0,"25","25",6696,7587
"7608",182865,"HESSER COLLEGE                                              ","2003-2004",15,"Soccer",23702,23702,0,11127,11127,0,12575,12575,0,"13","13",3627,3575
"7614",231086,"SOUTHERN VERMONT COLLEGE                                    ","2003-2004",15,"Soccer",29972,29972,0,10848,10848,0,19124,19124,0,"17","17",5325,6838
"7620",176239,"PEARL RIVER COMMUNITY COLLEGE                               ","2003-2004",15,"Soccer",76284,76284,0,35882,35882,0,40402,40402,0,"22","20",13058,13131
"7623",175810,"HOLMES COMMUNITY COLLEGE                                    ","2003-2004",15,"Soccer",34215,34215,0,34215,34215,0,0,0,0,"19",".",23239,0
"7625",183080,"PLYMOUTH STATE UNIVERSITY                                   ","2003-2004",15,"Soccer",90417,90417,0,48067,48067,0,42350,42350,0,"27","25",29648,21140
"7629",141361,"YOUNG HARRIS COLLEGE                                        ","2003-2004",15,"Soccer",417173,417173,0,226298,226298,0,190875,190875,0,"21","18",68280,66390
"7632",188465,"GLOBE INSTITUTE OF TECHNOLOGY                               ","2003-2004",15,"Soccer",82909,82909,0,82909,82909,0,0,0,0,"15",".",29680,0
"7634",197294,"SUNY WESTCHESTER COMMMUNITY COLLEGE                         ","2003-2004",15,"Soccer",13875,13875,0,13875,13875,0,0,0,0,"15","0",7100,0
"7638",175856,"JACKSON STATE UNIVERSITY                                    ","2003-2004",15,"Soccer",134212,134212,0,0,0,0,134212,134212,0,".","17",0,33892
"7639",129242,"FAIRFIELD UNIVERSITY                                        ","2003-2004",15,"Soccer",1133947,1133947,0,586805,586805,0,547142,547142,0,"28","21",60113,58066
"7653",366395,"SUFFOLK COUNTY COMMUNITY COLLEGE                            ","2003-2004",15,"Soccer",18054,18054,0,18054,18054,0,0,0,0,"18",".",11243,0
"7658",166027,"HARVARD UNIVERSITY                                          ","2003-2004",15,"Soccer",611277,611277,0,279877,279877,0,331400,331400,0,"66","49",118810,144426
"7659",186283,"RIDER UNIVERSITY                                            ","2003-2004",15,"Soccer",767882,767882,0,419127,419127,0,348755,348755,0,"29","24",54782,36679
"7661",196185,"SUNY COLLEGE AT ONEONTA                                     ","2003-2004",15,"Soccer",313657,313657,0,202104,202104,0,111553,111553,0,"22","22",119677,19326
"7663",122436,"UNIVERSITY OF SAN DIEGO                                     ","2003-2004",15,"Soccer",1223104,1223104,0,621839,621839,0,601265,601265,0,"26","24",66096,64084
"7665",183743,"BERGEN COMMUNITY COLLEGE                                    ","2003-2004",15,"Soccer",30135,30135,0,15075,15075,0,15060,15060,0,"24","14",10000,10000
"7670",217235,"JOHNSON &amp; WALES UNIVERSITY                                  ","2003-2004",15,"Soccer",86400,86400,0,44870,44870,0,41530,41530,0,"24","22",30786,28294
"7671",126669,"COLORADO CHRISTIAN UNIVERSITY                               ","2003-2004",15,"Soccer",190519,190519,0,87532,87532,0,102987,102987,0,"21","15",8169,10650
"7672",189547,"BROOME COMMUNITY COLLEGE                                    ","2003-2004",15,"Soccer",37844,37844,0,19611,19611,0,18233,18233,0,"21","17",14098,12720
"7677",221519,"SEWANEE-THE UNIVERSITY OF THE SOUTH                         ","2003-2004",15,"Soccer",147576,147576,0,72930,72930,0,74646,74646,0,"27","18",39402,35184
"7683",162760,"HOOD COLLEGE                                                ","2003-2004",15,"Soccer",14708,14708,0,0,0,0,14708,14708,0,".","11",0,8208
"7690",130916,"DELAWARE TECHNICAL &amp; COMM COLL-STANTON-WILMINGTON           ","2003-2004",15,"Soccer",9817,9817,0,9817,9817,0,0,0,0,"16",".",5817,0
"7691",185509,"MERCER COUNTY COMMUNITY COLLEGE                             ","2003-2004",15,"Soccer",28000,28000,0,14000,14000,0,14000,14000,0,"24","16",13992,14000
"7693",191533,"HARTWICK COLLEGE                                            ","2003-2004",15,"Soccer",726750,726750,0,627488,627488,0,99262,99262,0,"28","22",37951,13912
"7698",213659,"LUZERNE COUNTY COMMUNITY COLLEGE                            ","2003-2004",15,"Soccer",9000,9000,0,0,0,0,9000,9000,0,".","13",0,3500
"7703",219198,"MOUNT MARTY COLLEGE                                         ","2003-2004",15,"Soccer",161116,161116,0,101433,101433,0,59683,59683,0,"22","17",10040,10040
"7708",213668,"LYCOMING COLLEGE                                            ","2003-2004",15,"Soccer",77254,77254,0,56890,56890,0,20364,20364,0,"29","22",13745,13312
"7710",144564,"DANVILLE AREA COMMUNITY COLLEGE                             ","2003-2004",15,"Soccer",13180,13180,0,13180,13180,0,0,0,0,"14",".",13179,0
"7712",168148,"TUFTS UNIVERSITY                                            ","2003-2004",15,"Soccer",89609,89609,0,44986,44986,0,44623,44623,0,"20","21",12700,12100
"7716",115296,"GROSSMONT COLLEGE                                           ","2003-2004",15,"Soccer",10923,10923,0,0,0,0,10923,10923,0,".","23",0,6923
"7718",160621,"SOUTHERN UNIVERSITY AND A &amp; M COLLEGE                       ","2003-2004",15,"Soccer",31701,31701,0,0,0,0,31701,31701,0,".","24",0,3963
"7720",216852,"WIDENER UNIVERSITY-MAIN CAMPUS                              ","2003-2004",15,"Soccer",74381,74381,0,36443,36443,0,37938,37938,0,"32","25",9819,8824
"7725",123527,"SAN BERNARDINO VALLEY COLLEGE                               ","2003-2004",15,"Soccer",23451,23451,0,11900,11900,0,11551,11551,0,"19","19",7049,6700
"7726",202523,"DENISON UNIVERSITY                                          ","2003-2004",15,"Soccer",146847,146847,0,77933,77933,0,68914,68914,0,"24","23",29904,26703
"7728",195173,"ST FRANCIS COLLEGE                                          ","2003-2004",15,"Soccer",147307,147307,0,147307,147307,0,0,0,0,"25",".",42482,0
"7740",166647,"MASSACHUSETTS BAY COMMUNITY COLLEGE                         ","2003-2004",15,"Soccer",7255,7255,0,7255,7255,0,0,0,0,"20",".",4005,0
"7741",186867,"STEVENS INSTITUTE OF TECHNOLOGY                             ","2003-2004",15,"Soccer",275676,275676,0,170076,170076,0,105600,105600,0,"26","20",43763,34830
"7743",215798,"SAINT VINCENT COLLEGE                                       ","2003-2004",15,"Soccer",275008,275008,0,146651,146651,0,128357,128357,0,"24","20",31201,31235
"7755",153311,"EASTERN IOWA COMMUNITY COLLEGE DISTRICT                     ","2003-2004",15,"Soccer",60560,60560,0,30280,30280,0,30280,30280,0,"22","13",20140,20140
"7762",110714,"UNIVERSITY OF CALIFORNIA-SANTA CRUZ                         ","2003-2004",15,"Soccer",61772,61772,0,38262,38262,0,23510,23510,0,"24","24",35798,23263
"7763",116439,"IRVINE VALLEY COLLEGE                                       ","2003-2004",15,"Soccer",37711,37711,0,37711,37711,0,0,0,0,"31","0",12466,0
"7767",154800,"BUTLER COUNTY COMMUNITY COLLEGE                             ","2003-2004",15,"Soccer",75500,75500,0,0,0,0,75500,75500,0,".","17",0,14262
"7768",213826,"MARYWOOD UNIVERSITY                                         ","2003-2004",15,"Soccer",27553,27553,0,12184,12184,0,15369,15369,0,"14","15",8800,10968
"7770",101480,"JACKSONVILLE STATE UNIVERSITY                               ","2003-2004",15,"Soccer",275701,275701,0,0,0,0,275701,275701,0,".","21",0,275700
"7774",166692,"MASSACHUSETTS MARITIME ACADEMY                              ","2003-2004",15,"Soccer",5000,5000,0,5000,5000,0,0,0,0,"22",".",4500,0
"7781",136950,"ROLLINS COLLEGE                                             ","2003-2004",15,"Soccer",755147,755147,0,414621,414621,0,340526,340526,0,"28","23",34641,29775
"7794",194028,"NORTH COUNTRY COMMUNITY COLLEGE                             ","2003-2004",15,"Soccer",32194,32194,0,13413,13413,0,18781,18781,0,"16","15",6655,11911
"7797",156082,"WASHBURN UNIVERSITY OF TOPEKA                               ","2003-2004",15,"Soccer",34711,34711,0,0,0,0,34711,34711,0,".","22",0,30297
"7799",213598,"LINCOLN UNIVERSITY                                          ","2003-2004",15,"Soccer",11400,11400,0,7200,7200,0,4200,4200,0,"20","20",5000,3900
"7824",226471,"UNIVERSITY OF MARY HARDIN-BAYLOR                            ","2003-2004",15,"Soccer",97978,97978,0,40636,40636,0,57342,57342,0,"23","17",14423,16863
"7830",186432,"SAINT PETERS COLLEGE                                        ","2003-2004",15,"Soccer",402823,402823,0,273600,273600,0,129223,129223,0,"27","17",52170,16934
"7832",200217,"UNIVERSITY OF MARY                                          ","2003-2004",15,"Soccer",270461,270461,0,127940,127940,0,142521,142521,0,"24","23",41314,44538
"7833",145646,"ILLINOIS WESLEYAN UNIVERSITY                                ","2003-2004",15,"Soccer",102710,102710,0,64855,64855,0,37855,37855,0,"28","22",11475,11475
"7838",123509,"SKYLINE COLLEGE                                             ","2003-2004",15,"Soccer",21490,21490,0,10314,10314,0,11176,11176,0,"22","21",8734,11172
"7841",165671,"EMMANUEL COLLEGE                                            ","2003-2004",15,"Soccer",69150,69150,0,33861,33861,0,35289,35289,0,"20","26",13452,11035
"7843",157359,"MID-CONTINENT COLLEGE                                       ","2003-2004",15,"Soccer",186576,186576,0,186576,186576,0,0,0,0,"22",".",27314,0
"7845",128902,"CONNECTICUT COLLEGE                                         ","2003-2004",15,"Soccer",211661,211661,0,110531,110531,0,101130,101130,0,"22","23",17352,15010
"7848",235103,"EDMONDS COMMUNITY COLLEGE                                   ","2003-2004",15,"Soccer",36777,36777,0,18544,18544,0,18233,18233,0,"20","22",11711,11711
"7857",212832,"GWYNEDD MERCY COLLEGE                                       ","2003-2004",15,"Soccer",36178,36178,0,18139,18139,0,18039,18039,0,"24","24",11139,10039
"7859",215770,"SAINT JOSEPHS UNIVERSITY                                    ","2003-2004",15,"Soccer",591276,591276,0,223822,223822,0,367454,367454,0,"26","23",59607,112428
"7862",218061,"FRANCIS MARION UNIVERSITY                                   ","2003-2004",15,"Soccer",350739,350739,0,197024,197024,0,153715,153715,0,"25","24",24353,20020
"7866",113856,"EAST LOS ANGELES COLLEGE                                    ","2003-2004",15,"Soccer",59843,59843,0,23824,23824,0,36019,36019,0,"22","22",2500,4000
"7874",130590,"TRINITY COLLEGE                                             ","2003-2004",15,"Soccer",123383,123383,0,72076,72076,0,51307,51307,0,"26","23",16432,14973
"7876",148627,"SAINT XAVIER UNIVERSITY                                     ","2003-2004",15,"Soccer",127729,127729,0,62096,62096,0,65633,65633,0,"21","21",18096,17198
"7878",195474,"SIENA COLLEGE                                               ","2003-2004",15,"Soccer",667542,667542,0,357335,357335,0,310207,310207,0,"25","26",137480,54058
"7880",159568,"LOUISIANA COLLEGE                                           ","2003-2004",15,"Soccer",56237,56237,0,27324,27325,-1,28913,28912,1,"16","17",17107,17113
"7881",225575,"HUSTON-TILLOTSON COLLEGE                                    ","2003-2004",15,"Soccer",27659,27659,0,27659,27659,0,0,0,0,"17",".",15659,0
"7882",190646,"CUNY MEDGAR EVERS COLLEGE                                   ","2003-2004",15,"Soccer",15000,15000,0,8500,8500,0,6500,6500,0,"26","18",8300,6300
"7885",161484,"NORTHERN MAINE TECHNICAL COLLEGE                            ","2003-2004",15,"Soccer",4321,4321,0,3704,3704,0,617,617,0,"14","0",1532,255
"7891",177551,"HARRIS-STOWE STATE COLLEGE                                  ","2003-2004",15,"Soccer",117997,117997,0,50590,50590,0,67407,67407,0,"15","18",13757,14749
"7905",193973,"NIAGARA UNIVERSITY                                          ","2003-2004",15,"Soccer",500830,500830,0,227290,227290,0,273540,273540,0,"22","26",43460,43206
"7906",243601,"UNIVERSIDAD DEL TURABO                                      ","2003-2004",15,"Soccer",69884,69884,0,69884,69884,0,0,0,0,"21",".",3779,0
"7907",205966,"SOUTHERN STATE COMMUNITY COLLEGE                            ","2003-2004",15,"Soccer",12100,12100,0,12100,12100,0,0,0,0,"15",".",7400,0
"7908",193016,"MERCY COLLEGE-MAIN CAMPUS                                   ","2003-2004",15,"Soccer",44000,44000,0,22000,22000,0,22000,22000,0,"18","14",10000,10000
"7918",124113,"TAFT COLLEGE                                                ","2003-2004",15,"Soccer",16016,16016,0,16016,16016,0,0,0,0,"21",".",8985,0
"7920",166124,"COLLEGE OF THE HOLY CROSS                                   ","2003-2004",15,"Soccer",755053,755053,0,303207,303207,0,451846,451846,0,"28","28",51006,33420
"7922",214768,"PENNSYLVANIA STATE UNIVERSITY-PENN STATE HAZLETON           ","2003-2004",15,"Soccer",6700,6700,0,6700,6700,0,0,0,0,"21",".",4300,0
"7930",218539,"PRESBYTERIAN COLLEGE                                        ","2003-2004",15,"Soccer",330680,330680,0,165658,165658,0,165022,165022,0,"27","20",20372,21752
"7931",210775,"ALVERNIA COLLEGE                                            ","2003-2004",15,"Soccer",36184,36184,0,16427,16427,0,19757,19757,0,"24","21",6972,9393
"7937",183877,"BURLINGTON COUNTY COLLEGE                                   ","2003-2004",15,"Soccer",7815,7815,0,7815,7815,0,0,0,0,"21","0",3360,0
"7940",183910,"CALDWELL COLLEGE                                            ","2003-2004",15,"Soccer",154729,154729,0,91727,91727,0,63002,63002,0,"22","19",12438,8410
"7950",104160,"ARIZONA WESTERN COLLEGE                                     ","2003-2004",15,"Soccer",61718,61718,0,61718,61718,0,0,0,0,"22",".",19335,0
"7953",190770,"DOWLING COLLEGE                                             ","2003-2004",15,"Soccer",276254,276254,0,276254,276254,0,0,0,0,"22",".",58166,0
"7955",181020,"DOANE COLLEGE                                               ","2003-2004",15,"Soccer",229728,229728,0,132425,132425,0,97303,97303,0,"36","17",31796,27198
"7957",130253,"SACRED HEART UNIVERSITY                                     ","2003-2004",15,"Soccer",611369,611369,0,239621,239621,0,371748,371748,0,"36","32",22855,46516
"7968",107512,"OUACHITA BAPTIST UNIVERSITY                                 ","2003-2004",15,"Soccer",259562,259562,0,101011,101011,0,158551,158551,0,"19","14",26921,25216
"7974",145691,"ILLINOIS COLLEGE                                            ","2003-2004",15,"Soccer",38289,38289,0,16755,16755,0,21534,21534,0,"25","16",12605,14184
"7975",186645,"RARITAN VALLEY COMMUNITY COLLEGE                            ","2003-2004",15,"Soccer",10911,10911,0,10911,10911,0,0,0,0,"14",".",3570,0
"7980",190600,"CUNY JOHN JAY COLLEGE CRIMINAL JUSTICE                      ","2003-2004",15,"Soccer",20090,20090,0,20090,20090,0,0,0,0,"13",".",8588,0
"7982",228006,"SAN JACINTO COLLEGE-SOUTH CAMPUS                            ","2003-2004",15,"Soccer",88050,88050,0,88050,88050,0,0,0,0,"24",".",88000,0
"7991",196042,"FARMINGDALE STATE UNIVERSITY OF NEW YORK                    ","2003-2004",15,"Soccer",47600,47600,0,23800,23800,0,23800,23800,0,"20","19",11300,11300
"7994",150668,"GOSHEN COLLEGE                                              ","2003-2004",15,"Soccer",110848,110848,0,61424,61424,0,49424,49424,0,"18","16",17697,13393
"7996",193584,"NAZARETH COLLEGE OF ROCHESTER                               ","2003-2004",15,"Soccer",102769,102769,0,46840,46840,0,55929,55929,0,"24","46",22198,29365
"7997",162557,"FREDERICK COMMUNITY COLLEGE                                 ","2003-2004",15,"Soccer",15420,15420,0,7970,7970,0,7450,7450,0,"12","12",2320,3210
"8007",205203,"UNIVERSITY OF RIO GRANDE                                    ","2003-2004",15,"Soccer",79165,79165,0,79165,79165,0,0,0,0,"34",".",14200,0
"8015",205443,"SHAWNEE STATE UNIVERSITY                                    ","2003-2004",15,"Soccer",103537,103537,0,51991,51991,0,51546,51546,0,"21","18",28711,28266
"8016",155900,"SOUTHWESTERN COLLEGE                                        ","2003-2004",15,"Soccer",55746,55746,0,28319,28319,0,27427,27427,0,"17","15",16356,12348
"8022",167905,"SPRINGFIELD TECHNICAL COMMUNITY COLLEGE                     ","2003-2004",15,"Soccer",26500,26500,0,13250,13250,0,13250,13250,0,"20","21",7750,7750
"8056",208646,"EASTERN OREGON UNIVERSITY                                   ","2003-2004",15,"Soccer",52739,52739,0,0,0,0,52739,52739,0,".","19",0,28438
"8060",147244,"MILLIKIN UNIVERSITY                                         ","2003-2004",15,"Soccer",54704,54704,0,28427,28427,0,26277,26277,0,"36","28",10419,7673
"8061",130934,"DELAWARE STATE UNIVERSITY                                   ","2003-2004",15,"Soccer",53164,53164,0,0,0,0,53164,53164,0,".","14",0,20055
"8068",215442,"POINT PARK UNIVERSITY                                       ","2003-2004",15,"Soccer",167485,167485,0,97274,97274,0,70211,70211,0,"18","16",13474,11511
"8069",229063,"TEXAS SOUTHERN UNIVERSITY                                   ","2003-2004",15,"Soccer",160859,160859,0,0,0,0,160859,160859,0,".","14",0,21900
"8070",206437,"WALSH UNIVERSITY                                            ","2003-2004",15,"Soccer",91169,91169,0,51060,51060,0,40109,40109,0,"28","19",19363,18292
"8088",177144,"CULVER-STOCKTON COLLEGE                                     ","2003-2004",15,"Soccer",52650,52650,0,24185,24185,0,28465,28465,0,"19","15",12224,13518
"8100",121044,"PASADENA CITY COLLEGE                                       ","2003-2004",15,"Soccer",63432,63432,0,31716,31716,0,31716,31716,0,"32","15",2000,2000
"8101",184481,"ESSEX COUNTY COLLEGE                                        ","2003-2004",15,"Soccer",164263,164263,0,86439,86439,0,77824,77824,0,"17","14",15259,12056
"8103",204909,"OHIO WESLEYAN UNIVERSITY                                    ","2003-2004",15,"Soccer",196991,196991,0,142361,142361,0,54630,54630,0,"46","23",44846,18921
"8107",194578,"PRATT INSTITUTE-MAIN                                        ","2003-2004",15,"Soccer",4752,4752,0,2640,2640,0,2112,2112,0,"13","13",468,312
"8109",154493,"UPPER IOWA UNIVERSITY                                       ","2003-2004",15,"Soccer",123972,123972,0,66232,66232,0,57740,57740,0,"22","15",23194,26619
"8115",198835,"LENOIR-RHYNE COLLEGE                                        ","2003-2004",15,"Soccer",325112,325112,0,154527,154527,0,170585,170585,0,"24","24",68516,82876
"8116",133492,"ECKERD COLLEGE                                              ","2003-2004",15,"Soccer",276504,276504,0,173033,173033,0,103471,103471,0,"32","20",22975,26668
"8123",170301,"HOPE COLLEGE                                                ","2003-2004",15,"Soccer",96909,96909,0,69583,69583,0,27326,27326,0,"28","25",16744,12406
"8125",164447,"AMERICAN INTERNATIONAL COLLEGE                              ","2003-2004",15,"Soccer",61187,61187,0,31136,31136,0,30051,30051,0,"24","28",29850,29651
"8133",169248,"CENTRAL MICHIGAN UNIVERSITY                                 ","2003-2004",15,"Soccer",343057,343057,0,0,0,0,343057,343057,0,".","24",0,46104
"8137",215947,"SETON HILL UNIVERSITY                                       ","2003-2004",15,"Soccer",147761,147761,0,72659,72659,0,75102,75102,0,"25","39",25300,20000
"8144",236133,"NORTHWEST COLLEGE OF THE ASSEMBLIES OF GOD                  ","2003-2004",15,"Soccer",136886,136886,0,136886,136886,0,0,0,0,"19",".",19562,0
"8148",156745,"GEORGETOWN COLLEGE                                          ","2003-2004",15,"Soccer",53473,53473,0,16500,16500,0,36973,36973,0,"29","26",12113,11153
"8152",184791,"GLOUCESTER COUNTY COLLEGE                                   ","2003-2004",15,"Soccer",11948,11948,0,5396,5396,0,6552,6552,0,"19","14",5396,6552
"8156",214272,"NEUMANN COLLEGE                                             ","2003-2004",15,"Soccer",45098,45098,0,21299,21299,0,23799,23799,0,"25","16",13500,16000
"8158",105428,"PHOENIX COLLEGE                                             ","2003-2004",15,"Soccer",93300,93300,0,26600,26600,0,66700,66700,0,"22","18",11500,11900
"8168",144050,"UNIVERSITY OF CHICAGO                                       ","2003-2004",15,"Soccer",255325,255325,0,118055,118055,0,137270,137270,0,"23","25",52376,71660
"8170",165015,"BRANDEIS UNIVERSITY                                         ","2003-2004",15,"Soccer",186889,186889,0,99819,99819,0,87070,87070,0,"23","21",42418,43002
"8171",204264,"MUSKINGUM COLLEGE                                           ","2003-2004",15,"Soccer",25512,25512,0,13456,13456,0,12056,12056,0,"28","22",13052,11934
"8175",161138,"EASTERN MAINE COMMUNITY COLLEGE                             ","2003-2004",15,"Soccer",6300,6300,0,6300,6300,0,0,0,0,"12",".",6000,0
"8181",152567,"TRI-STATE UNIVERSITY                                        ","2003-2004",15,"Soccer",98711,98711,0,54352,54352,0,44359,44359,0,"41","20",10929,10332
"8183",165574,"DEAN COLLEGE                                                ","2003-2004",15,"Soccer",93127,93127,0,51921,51921,0,41206,41206,0,"20","11",12201,4566
"8184",185536,"MIDDLESEX COUNTY COLLEGE                                    ","2003-2004",15,"Soccer",38364,38364,0,19182,19182,0,19182,19182,0,"26","14",5884,5414
"8188",238458,"CARROLL COLLEGE                                             ","2003-2004",15,"Soccer",43410,43410,0,24451,24451,0,18959,18959,0,"28","18",7790,6805
"8189",210155,"SOUTHWESTERN OREGON COMMUNITY COLLEGE                       ","2003-2004",15,"Soccer",111454,111454,0,60574,60574,0,50880,50880,0,"17","13",41142,35088
"8191",203775,"MALONE COLLEGE                                              ","2003-2004",15,"Soccer",281278,281278,0,130003,130003,0,151275,151275,0,"27","25",25153,23965
"8194",176965,"CENTRAL MISSOURI STATE UNIVERSITY                           ","2003-2004",15,"Soccer",167916,167916,0,0,0,0,167916,167916,0,".","24",0,16373
"8215",212674,"GETTYSBURG COLLEGE                                          ","2003-2004",15,"Soccer",118279,118279,0,68514,68514,0,49765,49765,0,"28","23",15183,15289
"8219",178721,"PARK UNIVERSITY                                             ","2003-2004",15,"Soccer",376067,376067,0,212966,212966,0,163101,163101,0,"20","15",24056,34057
"8226",204185,"MOUNT UNION COLLEGE                                         ","2003-2004",15,"Soccer",85409,85409,0,43784,43784,0,41625,41625,0,"35","24",16983,14354
"8227",192466,"SOUTHAMPTON COLLEGE OF LONG ISLAND UNIVERSITY               ","2003-2004",15,"Soccer",373459,373459,0,167183,167183,0,206276,206276,0,"24","30",31123,36041
"8235",177418,"FONTBONNE UNIVERSITY                                        ","2003-2004",15,"Soccer",45911,45911,0,24933,24933,0,20978,20978,0,"23","21",10403,14802
"8239",227191,"NORTH LAKE COLLEGE                                          ","2003-2004",15,"Soccer",30340,30340,0,0,0,0,30340,30340,0,".","17",0,11200
"8242",127565,"METROPOLITAN STATE COLLEGE OF DENVER                        ","2003-2004",15,"Soccer",298294,298294,0,141124,141124,0,157170,157170,0,"25","22",37126,38940
"8243",122375,"SAN DIEGO MESA COLLEGE                                      ","2003-2004",15,"Soccer",41253,41253,0,20634,20634,0,20619,20619,0,"25","26",6951,6860
"8245",213400,"LANCASTER BIBLE COLLEGE                                     ","2003-2004",15,"Soccer",15261,15261,0,8121,8121,0,7140,7140,0,"14","17",6621,5460
"8248",201858,"CINCINNATI BIBLE COLLEGE AND SEMINARY                       ","2003-2004",15,"Soccer",14465,14465,0,8620,8620,0,5845,5845,0,"15","15",6691,3916
"8253",161572,"UNITY COLLEGE                                               ","2003-2004",15,"Soccer",18000,18000,0,10500,10500,0,7500,7500,0,"21","19",5500,4500
"8254",221953,"TUSCULUM COLLEGE                                            ","2003-2004",15,"Soccer",419544,419544,0,200324,200324,0,219220,219220,0,"30","37",29240,36928
"8263",237640,"OHIO VALLEY COLLEGE                                         ","2003-2004",15,"Soccer",111281,111281,0,71859,71859,0,39422,39422,0,"15","18",10667,4815
"8266",147800,"OAKTON COMMUNITY COLLEGE                                    ","2003-2004",15,"Soccer",11750,11750,0,7931,7931,0,3819,3819,0,"23","19",7930,3818
"8267",120254,"OCCIDENTAL COLLEGE                                          ","2003-2004",15,"Soccer",73907,73907,0,37588,37588,0,36319,36319,0,"20","23",8564,7294
"8269",166823,"MASSASOIT COMMUNITY COLLEGE                                 ","2003-2004",15,"Soccer",18031,18031,0,8267,8267,0,9764,9764,0,"22","16",5169,2591
"8272",189459,"BRIARCLIFFE COLLEGE                                         ","2003-2004",15,"Soccer",202800,202800,0,0,0,0,202800,202800,0,"0","17",0,29450
"8279",232025,"EMORY AND HENRY COLLEGE                                     ","2003-2004",15,"Soccer",87863,87863,0,49094,49094,0,38769,38769,0,"21","17",16747,17410
"8283",166948,"MOUNT IDA COLLEGE                                           ","2003-2004",15,"Soccer",54523,54523,0,33282,33282,0,21241,21241,0,"18","18",23219,13541
"8285",161563,"THOMAS COLLEGE                                              ","2003-2004",15,"Soccer",36601,36601,0,22067,22067,0,14534,14534,0,"19","17",7567,7984
"8294",111920,"CHABOT COLLEGE                                              ","2003-2004",15,"Soccer",4600,4600,0,2300,2300,0,2300,2300,0,"20","18",3100,3150
"8296",139205,"BREWTON-PARKER COLLEGE                                      ","2003-2004",15,"Soccer",282844,282844,0,145951,145951,0,136893,136893,0,"22","12",27197,25443
"8299",166133,"HOLYOKE COMMUNITY COLLEGE                                   ","2003-2004",15,"Soccer",28000,28000,0,14000,14000,0,14000,14000,0,"20","18",5400,5400
"8303",196291,"SUNY MARITIME COLLEGE                                       ","2003-2004",15,"Soccer",24159,24159,0,24159,24159,0,0,0,0,"29",".",17159,0
"8305",105747,"SCOTTSDALE COMMUNITY COLLEGE                                ","2003-2004",15,"Soccer",29718,29718,0,14859,14859,0,14859,14859,0,"25","15",5000,5000
"8306",138868,"ATLANTA CHRISTIAN COLLEGE                                   ","2003-2004",15,"Soccer",26166,26166,0,13500,13500,0,12666,12666,0,"14","16",13400,12566
"8309",154101,"NORTHWESTERN COLLEGE                                        ","2003-2004",15,"Soccer",147499,147499,0,80707,80707,0,66792,66792,0,"22","20",28364,18006
"8315",107080,"HENDRIX COLLEGE                                             ","2003-2004",15,"Soccer",99500,99500,0,49750,49750,0,49750,49750,0,"22","17",21750,21750
"8316",146612,"LEWIS UNIVERSITY                                            ","2003-2004",15,"Soccer",301352,301352,0,198853,198853,0,102499,102499,0,"35","22",40305,17115
"8322",196237,"SUNY COLLEGE AT OLD WESTBURY                                ","2003-2004",15,"Soccer",7000,7000,0,7000,7000,0,0,0,0,"20",".",6000,0
"8325",137476,"SAINT THOMAS UNIVERSITY                                     ","2003-2004",15,"Soccer",315580,315580,0,150420,150420,0,165160,165160,0,"39","29",24800,25765
"8327",170037,"CORNERSTONE UNIVERSITY                                      ","2003-2004",15,"Soccer",122119,122119,0,48809,48809,0,73310,73310,0,"24","21",19707,15951
"8329",112260,"CLAREMONT MCKENNA COLLEGE                                   ","2003-2004",15,"Soccer",121994,121994,0,70234,70234,0,51760,51760,0,"23","21",28884,13568
"8333",126182,"ADAMS STATE COLLEGE                                         ","2003-2004",15,"Soccer",103674,103674,0,0,0,0,103674,103674,0,".","29",0,17238
"8337",131098,"WESLEY COLLEGE                                              ","2003-2004",15,"Soccer",65208,65208,0,34140,34140,0,31068,31068,0,"29","26",16550,14400
"8341",166638,"UNIVERSITY OF MASSACHUSETTS-BOSTON                          ","2003-2004",15,"Soccer",75210,75210,0,24129,24129,0,51081,51081,0,"19","13",14145,17308
"8342",173160,"BETHEL COLLEGE                                              ","2003-2004",15,"Soccer",85158,85158,0,53110,53110,0,32048,32048,0,"28","22",36064,14894
"8357",222983,"AUSTIN COLLEGE                                              ","2003-2004",15,"Soccer",104648,104648,0,53067,53067,0,51581,51581,0,"22","25",19815,18615
"8359",196051,"MORRISVILLE STATE COLLEGE                                   ","2003-2004",15,"Soccer",60692,60692,0,33550,33550,0,27142,27142,0,"26","21",23098,17126
"8360",107141,"JOHN BROWN UNIVERSITY                                       ","2003-2004",15,"Soccer",365637,365637,0,237046,237046,0,128591,128591,0,"24","21",26322,24512
"8361",217776,"SOUTHERN WESLEYAN UNIVERSITY                                ","2003-2004",15,"Soccer",252390,252390,0,135237,135237,0,117153,117153,0,"18","14",34487,17203
"8364",156541,"CUMBERLAND COLLEGE                                          ","2003-2004",15,"Soccer",424066,424066,0,205824,205824,0,218242,218242,0,"20","26",9520,13780
"8370",147378,"MORAINE VALLEY COMMUNITY COLLEGE                            ","2003-2004",15,"Soccer",31846,31846,0,16769,16769,0,15077,15077,0,"23","16",10371,8358
"8373",130493,"SOUTHERN CONNECTICUT STATE UNIVERSITY                       ","2003-2004",15,"Soccer",396896,396896,0,255688,255688,0,141208,141208,0,"26","25",67151,57887
"8376",224572,"EASTFIELD COLLEGE                                           ","2003-2004",15,"Soccer",21047,21047,0,0,0,0,21047,21047,0,".","18",0,7961
"8381",201195,"BALDWIN-WALLACE COLLEGE                                     ","2003-2004",15,"Soccer",114444,114444,0,58239,58239,0,56205,56205,0,"36","24",28070,25037
"8388",126775,"COLORADO SCHOOL OF MINES                                    ","2003-2004",15,"Soccer",166560,166560,0,166560,166560,0,0,0,0,"19",".",28214,0
"8396",183938,"CAMDEN COUNTY COLLEGE                                       ","2003-2004",15,"Soccer",90618,90618,0,45260,45260,0,45358,45358,0,"23","19",5168,5269
"8399",190619,"CUNY KINGSBOROUGH COMMUNITY COLLEGE                         ","2003-2004",15,"Soccer",15398,15398,0,15398,15398,0,0,0,0,"15",".",10494,0
"8417",150534,"UNIVERSITY OF EVANSVILLE                                    ","2003-2004",15,"Soccer",832974,832974,0,421460,421460,0,411514,411514,0,"27","21",67115,43409
"8427",193478,"NASSAU COMMUNITY COLLEGE                                    ","2003-2004",15,"Soccer",40661,40661,0,15691,15691,0,24970,24970,0,"23","22",5288,12798
"8429",161004,"BOWDOIN COLLEGE                                             ","2003-2004",15,"Soccer",180307,180307,0,73534,73534,0,106773,106773,0,"25","21",21061,12438
"8433",110538,"CALIFORNIA STATE UNIVERSITY-CHICO                           ","2003-2004",15,"Soccer",313932,313932,0,175330,175330,0,138602,138602,0,"24","24",45466,22194
"8437",163851,"SALISBURY UNIVERSITY                                        ","2003-2004",15,"Soccer",55998,55998,0,27999,27999,0,27999,27999,0,"28","25",14853,11905
"8440",141237,"1TT-MCCONNELL COLLEGE                                       ","2003-2004",15,"Soccer",93201,93201,0,49386,49386,0,43815,43815,0,"14","12",13158,14716
"8442",230931,"LYNDON STATE COLLEGE                                        ","2003-2004",15,"Soccer",25275,25275,0,13253,13253,0,12022,12022,0,"21","16",8743,6057
"8447",192439,"LONG ISLAND UNIVERSITY-BROOKLYN CAMPUS                      ","2003-2004",15,"Soccer",976990,976990,0,463811,463811,0,513179,513179,0,"26","22",102359,106495
"8450",413723,"CASCADE COLLEGE                                             ","2003-2004",15,"Soccer",30882,30882,0,15016,15016,0,15866,15866,0,"15","14",5079,4344
"8455",100937,"BIRMINGHAM SOUTHERN COLLEGE                                 ","2003-2004",15,"Soccer",961782,961782,0,534924,534924,0,426858,426858,0,"23","25",71153,50856
"8464",168227,"WENTWORTH INSTITUTE OF TECHNOLOGY                           ","2003-2004",15,"Soccer",111573,111573,0,27646,27646,0,83927,83927,0,"27","19",15326,20949
"8465",154712,"BENEDICTINE COLLEGE                                         ","2003-2004",15,"Soccer",300173,300173,0,202317,202317,0,97856,97856,0,"40","28",8772,9555
"8468",104425,"COCHISE COLLEGE                                             ","2003-2004",15,"Soccer",49800,49800,0,0,0,0,49800,49800,0,".","20",0,16946
"8472",175573,"COPIAH-LINCOLN COMMUNITY COLLEGE                            ","2003-2004",15,"Soccer",43841,43841,0,25691,25691,0,18150,18150,0,"16","11",6480,6480
"8482",214829,"PENNSYLVANIA STATE UNIVERSITY-PENN STATE YORK               ","2003-2004",15,"Soccer",14218,14218,0,14218,14218,0,0,0,0,"19",".",10356,0
"8494",155292,"KANSAS CITY KANSAS COMMUNITY COLLEGE                        ","2003-2004",15,"Soccer",23950,23950,0,23950,23950,0,0,0,0,"23",".",19450,0
"8496",111887,"CERRITOS COLLEGE                                            ","2003-2004",15,"Soccer",64060,64060,0,33261,33261,0,30799,30799,0,"27","20",1416,1920
"8497",217420,"RHODE ISLAND COLLEGE                                        ","2003-2004",15,"Soccer",119077,119077,0,59602,59602,0,59475,59475,0,"24","21",14393,14566
"8509",213996,"MESSIAH COLLEGE                                             ","2003-2004",15,"Soccer",124137,124137,0,68194,68194,0,55943,55943,0,"25","23",28090,23342
"8511",193283,"MOHAWK VALLEY COMMUNITY COLLEGE-UTICA BRANCH                ","2003-2004",15,"Soccer",43856,43856,0,22938,22938,0,20918,20918,0,"28","17",13944,11832
"8515",122658,"SAN JOAQUIN DELTA COLLEGE                                   ","2003-2004",15,"Soccer",37624,37624,0,18519,18519,0,19105,19105,0,"22","23",8615,8505
"8518",176318,"RUST COLLEGE                                                ","2003-2004",15,"Soccer",6431,6431,0,6431,6431,0,0,0,0,"13","0",5930,0
"8519",156213,"ASBURY COLLEGE                                              ","2003-2004",15,"Soccer",30397,30397,0,16516,16516,0,13881,13881,0,"22","14",16020,13751
"8523",155414,"KANSAS WESLEYAN UNIVERSITY                                  ","2003-2004",15,"Soccer",74596,74596,0,37230,37230,0,37366,37366,0,"16","15",12091,11727
"8530",239017,"LAWRENCE UNIVERSITY                                         ","2003-2004",16,"Softball",47384,47384,0,0,0,0,47384,47384,0,".","15",0,31384
"8532",183099,"NEW HAMPSHIRE TECHNICAL INSTITUTE                           ","2003-2004",16,"Softball",8000,8000,0,0,0,0,8000,8000,0,".","16",0,4500
"8534",234155,"VIRGINIA STATE UNIVERSITY                                   ","2003-2004",16,"Softball",67505,67505,0,0,0,0,67505,67505,0,".","15",0,25289
"8542",194028,"NORTH COUNTRY COMMUNITY COLLEGE                             ","2003-2004",16,"Softball",9573,9573,0,0,0,0,9573,9573,0,".","11",0,1843
"8544",105154,"MESA COMMUNITY COLLEGE                                      ","2003-2004",16,"Softball",59000,59000,0,0,0,0,59000,59000,0,".","25",0,15300
"8548",193399,"COLLEGE OF MOUNT SAINT VINCENT                              ","2003-2004",16,"Softball",0,0,0,0,0,0,0,0,0,".","22",0,11000
"8549",219091,"DAKOTA WESLEYAN UNIVERSITY                                  ","2003-2004",16,"Softball",75981,75981,0,0,0,0,75981,75981,0,".","15",0,8670
"8552",227146,"NAVARRO COLLEGE                                             ","2003-2004",16,"Softball",168797,168797,0,0,0,0,168797,168797,0,".","20",0,29029
"8554",144971,"EUREKA COLLEGE                                              ","2003-2004",16,"Softball",28473,28473,0,0,0,0,28473,28473,0,".","14",0,6639
"8556",167987,"UNIVERSITY OF MASSACHUSETTS-DARTMOUTH                       ","2003-2004",16,"Softball",24178,24178,0,0,0,0,24178,24178,0,".","17",0,8234
"8557",132851,"CENTRAL FLORIDA COMMUNITY COLLEGE                           ","2003-2004",16,"Softball",159825,159825,0,0,0,0,159825,159825,0,".","22",0,27250
"8558",100663,"UNIVERSITY OF ALABAMA AT BIRMINGHAM                         ","2003-2004",16,"Softball",433603,433603,0,0,0,0,433603,433603,0,".","20",0,101086
"8559",200253,"MINOT STATE UNIVERSITY                                      ","2003-2004",16,"Softball",14265,14265,0,0,0,0,14265,14265,0,".","14",0,12632
"8564",213525,"LEHIGH CARBON COMMUNITY COLLEGE                             ","2003-2004",16,"Softball",2750,2750,0,0,0,0,2750,2750,0,".","12",0,420
"8565",206817,"BACONE COLLEGE                                              ","2003-2004",16,"Softball",2e+05,2e+05,0,0,0,0,2e+05,2e+05,0,".","14",0,28531
"8572",174738,"ROCHESTER COMMUNITY AND TECHNICAL COLLEGE                   ","2003-2004",16,"Softball",25628,25628,0,0,0,0,25628,25628,0,".","12",0,18928
"8574",101602,"LURLEEN B WALLACE COMMUNITY COLLEGE-ANDALUSIA CAMPUS        ","2003-2004",16,"Softball",126367,126367,0,0,0,0,126367,126367,0,".","16",0,29625
"8577",178624,"NORTHWEST MISSOURI STATE UNIVERSITY                         ","2003-2004",16,"Softball",151428,151428,0,0,0,0,151428,151428,0,".","19",0,9039
"8578",102030,"BISHOP STATE COMMUNITY COLLEGE                              ","2003-2004",16,"Softball",49818,49818,0,0,0,0,49818,49818,0,".","23",0,49818
"8579",226806,"MIDLAND COLLEGE                                             ","2003-2004",16,"Softball",136125,136125,0,0,0,0,136125,136125,0,".","17",0,26927
"8580",205443,"SHAWNEE STATE UNIVERSITY                                    ","2003-2004",16,"Softball",54429,54429,0,0,0,0,54429,54429,0,".","13",0,31149
"8583",175652,"EAST MISSISSIPPI COMMUNITY COLLEGE                          ","2003-2004",16,"Softball",32574,32574,0,0,0,0,32574,32574,0,".","20",0,10662
"8595",148405,"ROCKFORD COLLEGE                                            ","2003-2004",16,"Softball",52489,52489,0,0,0,0,52489,52489,0,".","10",0,20757
"8607",112190,"CITY COLLEGE OF SAN FRANCISCO                               ","2003-2004",16,"Softball",15203,15203,0,0,0,0,15203,15203,0,".","15",0,6515
"8610",123527,"SAN BERNARDINO VALLEY COLLEGE                               ","2003-2004",16,"Softball",14867,14867,0,0,0,0,14867,14867,0,".","12",0,10016
"8616",175883,"JONES COUNTY JUNIOR COLLEGE                                 ","2003-2004",16,"Softball",48098,48098,0,0,0,0,48098,48098,0,".","20",0,17842
"8617",204024,"MIAMI UNIVERSITY-OXFORD                                     ","2003-2004",16,"Softball",498526,498526,0,0,0,0,498526,498526,0,".","17",0,95833
"8620",101499,"JEFFERSON DAVIS COMMUNITY COLLEGE                           ","2003-2004",16,"Softball",68665,68665,0,0,0,0,68665,68665,0,".","17",0,10500
"8624",133386,"DAYTONA BEACH COMMUNITY COLLEGE                             ","2003-2004",16,"Softball",126556,126556,0,0,0,0,126556,126556,0,".","24",0,36835
"8628",231086,"SOUTHERN VERMONT COLLEGE                                    ","2003-2004",16,"Softball",19322,19322,0,0,0,0,19322,19322,0,".","20",0,5976
"8629",211291,"BUCKNELL UNIVERSITY                                         ","2003-2004",16,"Softball",419662,419662,0,0,0,0,419662,419662,0,".","20",0,41428
"8630",168786,"AQUINAS COLLEGE                                             ","2003-2004",16,"Softball",36000,36000,0,0,0,0,36000,36000,0,".","17",0,34000
"8633",165112,"BUNKER HILL COMMUNITY COLLEGE                               ","2003-2004",16,"Softball",15900,15900,0,0,0,0,15900,15900,0,".","12",0,1464
"8636",222053,"VOLUNTEER STATE COMMUNITY COLLEGE                           ","2003-2004",16,"Softball",116339,116339,0,0,0,0,116339,116339,0,".","16",0,29329
"8638",123217,"COLLEGE OF THE SEQUOIAS                                     ","2003-2004",16,"Softball",17300,17300,0,0,0,0,17300,17300,0,".","13",0,5750
"8639",212911,"HAVERFORD COLLEGE                                           ","2003-2004",16,"Softball",15488,15488,0,0,0,0,15488,15488,0,".","16",0,15280
"8640",221397,"ROANE STATE COMMUNITY COLLEGE                               ","2003-2004",16,"Softball",48405,48405,0,0,0,0,48405,48405,0,".","15",0,10299
"8647",209612,"PACIFIC UNIVERSITY                                          ","2003-2004",16,"Softball",58412,58412,0,0,0,0,58412,58412,0,".","18",0,27696
"8649",216339,"TEMPLE UNIVERSITY                                           ","2003-2004",16,"Softball",451990,451990,0,0,0,0,451990,451990,0,".","20",0,61533
"8651",164739,"BENTLEY COLLEGE                                             ","2003-2004",16,"Softball",99677,99677,0,0,0,0,99677,99677,0,".","16",0,26423
"8656",150163,"BUTLER UNIVERSITY                                           ","2003-2004",16,"Softball",326815,326815,0,0,0,0,326815,326815,0,".","21",0,38966
"8663",126289,"ARAPAHOE COMMUNITY COLLEGE                                  ","2003-2004",16,"Softball",84343,84343,0,0,0,0,84343,84343,0,".","21",0,38562
"8664",214704,"PENNSYLVANIA STATE UNIVERSITY-PENN STATE BERKS              ","2003-2004",16,"Softball",13102,13102,0,0,0,0,13102,13102,0,".","17",0,6902
"8665",193308,"MONROE COLLEGE-MAIN CAMPUS                                  ","2003-2004",16,"Softball",31967,31967,0,0,0,0,31967,31967,0,".","14",0,18469
"8666",131450,"GALLAUDET UNIVERSITY                                        ","2003-2004",16,"Softball",20522,20522,0,0,0,0,20522,20522,0,".","18",0,13422
"8676",117706,"LOS ANGELES PIERCE COLLEGE                                  ","2003-2004",16,"Softball",27911,27911,0,0,0,0,27911,27911,0,".","11",0,8640
"8677",165662,"EMERSON COLLEGE                                             ","2003-2004",16,"Softball",18389,18389,0,0,0,0,18389,18389,0,".","18",0,5266
"8678",140997,"SOUTH GEORGIA COLLEGE                                       ","2003-2004",16,"Softball",56349,56349,0,0,0,0,56349,56349,0,".","15",0,24135
"8679",210669,"ALLEGHENY COLLEGE                                           ","2003-2004",16,"Softball",70119,70119,0,0,0,0,70119,70119,0,".","13",0,31287
"8681",158477,"CENTENARY COLLEGE OF LOUISIANA                              ","2003-2004",16,"Softball",447487,447487,0,0,0,0,447487,447487,0,".","19",0,85554
"8684",168148,"TUFTS UNIVERSITY                                            ","2003-2004",16,"Softball",33000,33000,0,0,0,0,33000,33000,0,".","13",0,9500
"8686",213358,"LA ROCHE COLLEGE                                            ","2003-2004",16,"Softball",20735,20735,0,0,0,0,20735,20735,0,".","15",0,11906
"8690",117733,"LOS ANGELES VALLEY COLLEGE                                  ","2003-2004",16,"Softball",27352,27352,0,0,0,0,27352,27352,0,".","15",0,11949
"8694",214810,"PENNSYLVANIA STATE UNIVERSITY-PENN STATE SCHUYLKIL          ","2003-2004",16,"Softball",3000,3000,0,0,0,0,3000,3000,0,".","15",0,3000
"8704",190664,"CUNY QUEENS COLLEGE                                         ","2003-2004",16,"Softball",84705,84705,0,0,0,0,84705,84705,0,".","19",0,16818
"8710",207722,"UNIVERSITY OF SCIENCE AND ARTS OF OKLAHOMA                  ","2003-2004",16,"Softball",64532,64532,0,0,0,0,64532,64532,0,".","15",0,41932
"8715",113096,"COSUMNES RIVER COLLEGE                                      ","2003-2004",16,"Softball",19001,19001,0,0,0,0,19001,19001,0,".","10",0,18516
"8716",193016,"MERCY COLLEGE-MAIN CAMPUS                                   ","2003-2004",16,"Softball",18000,18000,0,0,0,0,18000,18000,0,".","10",0,7000
"8717",237950,"WEST VIRGINIA UNIVERSITY INSTITUTE OF TECHNOLOGY            ","2003-2004",16,"Softball",8022,8022,0,0,0,0,8022,8022,0,".","13",0,5493
"8718",176628,"AVILA UNIVERSITY                                            ","2003-2004",16,"Softball",116775,116775,0,0,0,0,116775,116775,0,".","23",0,37024
"8721",243346,"UNIVERSIDAD DEL ESTE                                        ","2003-2004",16,"Softball",9331,9331,0,0,0,0,9331,9331,0,".","11",0,7731
"8722",167729,"SALEM STATE COLLEGE                                         ","2003-2004",16,"Softball",28846,28846,0,0,0,0,28846,28846,0,".","15",0,9346
"8732",129242,"FAIRFIELD UNIVERSITY                                        ","2003-2004",16,"Softball",265534,265534,0,0,0,0,265534,265534,0,".","16",0,53305
"8735",136400,"PASCO-HERNANDO COMMUNITY COLLEGE                            ","2003-2004",16,"Softball",124766,124766,0,0,0,0,124766,124766,0,".","20",0,8745
"8741",140720,"PAINE COLLEGE                                               ","2003-2004",16,"Softball",54464,54464,0,0,0,0,54464,54464,0,".","16",0,13417
"8745",110051,"BETHANY COLLEGE OF THE ASSEMBLIES OF GOD                    ","2003-2004",16,"Softball",154127,154127,0,0,0,0,154127,154127,0,".","16",0,33164
"8747",196291,"SUNY MARITIME COLLEGE                                       ","2003-2004",16,"Softball",18425,18425,0,0,0,0,18425,18425,0,".","14",0,13425
"8752",177339,"EVANGEL UNIVERSITY                                          ","2003-2004",16,"Softball",159579,159579,0,0,0,0,159579,159579,0,".","22",0,30170
"8753",186283,"RIDER UNIVERSITY                                            ","2003-2004",16,"Softball",398271,398271,0,0,0,0,398271,398271,0,".","24",0,46977
"8756",122436,"UNIVERSITY OF SAN DIEGO                                     ","2003-2004",16,"Softball",203335,203335,0,0,0,0,203335,203335,0,".","19",0,63664
"8763",154642,"ALLEN COUNTY COMMUNITY COLLEGE                              ","2003-2004",16,"Softball",28922,28922,0,0,0,0,28922,28922,0,".","13",0,19063
"8765",189547,"BROOME COMMUNITY COLLEGE                                    ","2003-2004",16,"Softball",16108,16108,0,0,0,0,16108,16108,0,".","16",0,11147
"8768",156082,"WASHBURN UNIVERSITY OF TOPEKA                               ","2003-2004",16,"Softball",40104,40104,0,0,0,0,40104,40104,0,".","15",0,35734
"8774",230931,"LYNDON STATE COLLEGE                                        ","2003-2004",16,"Softball",9135,9135,0,0,0,0,9135,9135,0,".","17",0,8674
"8781",215114,"PHILADELPHIA BIBLICAL UNIVERSITY-LANGHORNE                  ","2003-2004",16,"Softball",11388,11388,0,0,0,0,11388,11388,0,".","14",0,7453
"8786",215947,"SETON HILL UNIVERSITY                                       ","2003-2004",16,"Softball",79501,79501,0,0,0,0,79501,79501,0,".","17",0,20000
"8789",183910,"CALDWELL COLLEGE                                            ","2003-2004",16,"Softball",112337,112337,0,0,0,0,112337,112337,0,".","16",0,39962
"8790",125091,"VICTOR VALLEY COLLEGE                                       ","2003-2004",16,"Softball",34586,34586,0,0,0,0,34586,34586,0,".","13",0,17796
"8792",157058,"KENTUCKY STATE UNIVERSITY                                   ","2003-2004",16,"Softball",48600,48600,0,0,0,0,48600,48600,0,".","22",0,30000
"8796",162283,"COPPIN STATE COLLEGE                                        ","2003-2004",16,"Softball",155724,155724,0,0,0,0,155724,155724,0,".","14",0,30385
"8799",169521,"DELTA COLLEGE                                               ","2003-2004",16,"Softball",10071,10071,0,0,0,0,10071,10071,0,".","13",0,5071
"8800",213668,"LYCOMING COLLEGE                                            ","2003-2004",16,"Softball",41638,41638,0,0,0,0,41638,41638,0,".","17",0,15335
"8804",190770,"DOWLING COLLEGE                                             ","2003-2004",16,"Softball",185008,185008,0,0,0,0,185008,185008,0,".","16",0,31759
"8810",150677,"GRACE COLLEGE AND THEOLOGICAL SEMINARY                      ","2003-2004",16,"Softball",59624,59624,0,0,0,0,59624,59624,0,".","18",0,17650
"8818",101189,"FAULKNER UNIVERSITY                                         ","2003-2004",16,"Softball",251544,251544,0,0,0,0,251544,251544,0,".","19",0,65390
"8819",202523,"DENISON UNIVERSITY                                          ","2003-2004",16,"Softball",74666,74666,0,0,0,0,74666,74666,0,".","15",0,30495
"8820",154800,"BUTLER COUNTY COMMUNITY COLLEGE                             ","2003-2004",16,"Softball",124063,124063,0,0,0,0,124063,124063,0,".","13",0,25580
"8821",170055,"GRAND RAPIDS COMMUNITY COLLEGE                              ","2003-2004",16,"Softball",33127,33127,0,0,0,0,33127,33127,0,".","16",0,12133
"8824",191533,"HARTWICK COLLEGE                                            ","2003-2004",16,"Softball",32568,32568,0,0,0,0,32568,32568,0,".","15",0,8189
"8830",127389,"LAMAR COMMUNITY COLLEGE                                     ","2003-2004",16,"Softball",93000,93000,0,0,0,0,93000,93000,0,".","23",0,23184
"8831",215770,"SAINT JOSEPHS UNIVERSITY                                    ","2003-2004",16,"Softball",332336,332336,0,0,0,0,332336,332336,0,".","16",0,91582
"8832",204909,"OHIO WESLEYAN UNIVERSITY                                    ","2003-2004",16,"Softball",61097,61097,0,0,0,0,61097,61097,0,".","20",0,21098
"8853",366252,"PENNSYLVANIA COLLEGE OF TECHNOLOGY                          ","2003-2004",16,"Softball",15134,15134,0,0,0,0,15134,15134,0,".","15",0,9420
"8855",157535,"PIKEVILLE COLLEGE                                           ","2003-2004",16,"Softball",33123,33123,0,0,0,0,33123,33123,0,".","14",0,15309
"8857",160977,"BATES COLLEGE                                               ","2003-2004",16,"Softball",59818,59818,0,0,0,0,59818,59818,0,".","15",0,16434
"8858",217156,"BROWN UNIVERSITY                                            ","2003-2004",16,"Softball",178983,178983,0,0,0,0,178983,178983,0,".","20",0,54030
"8859",190248,"CONCORDIA COLLEGE                                           ","2003-2004",16,"Softball",19086,19086,0,0,0,0,19086,19086,0,".","18",0,10749
"8866",106467,"ARKANSAS TECH UNIVERSITY                                    ","2003-2004",16,"Softball",127564,127564,0,0,0,0,127564,127564,0,".","13",0,10722
"8875",174491,"NORTHWESTERN COLLEGE                                        ","2003-2004",16,"Softball",27229,27229,0,0,0,0,27229,27229,0,".","15",0,16901
"8878",173452,"MARTIN LUTHER COLLEGE                                       ","2003-2004",16,"Softball",8000,8000,0,0,0,0,8000,8000,0,".","21",0,7000
"8887",198552,"FORSYTH TECHNICAL COMMUNITY COLLEGE                         ","2003-2004",16,"Softball",2784,2784,0,0,0,0,2784,2784,0,".","10",0,659
"8890",162706,"HARFORD COMMUNITY COLLEGE                                   ","2003-2004",16,"Softball",15777,15777,0,0,0,0,15777,15777,0,".","12",0,2704
"8896",189705,"CANISIUS COLLEGE                                            ","2003-2004",16,"Softball",396270,396270,0,0,0,0,396270,396270,0,".","18",0,52823
"8898",130891,"DELAWARE TECHNICAL AND COMMUNITY COLLEGE-OWENS              ","2003-2004",16,"Softball",105222,105222,0,0,0,0,105222,105222,0,".","18",0,27000
"8903",130916,"DELAWARE TECHNICAL &amp; COMM COLL-STANTON-WILMINGTON           ","2003-2004",16,"Softball",12130,12130,0,0,0,0,12130,12130,0,".","10",0,7078
"8906",149365,"SOUTH SUBURBAN COLLEGE                                      ","2003-2004",16,"Softball",28000,28000,0,0,0,0,28000,28000,0,".","15",0,15230
"8908",204468,"NOTRE DAME COLLEGE                                          ","2003-2004",16,"Softball",45652,45652,0,0,0,0,45652,45652,0,".","12",0,18862
"8910",137281,"SAINT JOHNS RIVER COMMUNITY COLLEGE                         ","2003-2004",16,"Softball",65655,65655,0,0,0,0,65655,65655,0,".","26",0,33155
"8928",211981,"DELAWARE VALLEY COLLEGE                                     ","2003-2004",16,"Softball",23495,23495,0,0,0,0,23495,23495,0,".","14",0,11545
"8929",145646,"ILLINOIS WESLEYAN UNIVERSITY                                ","2003-2004",16,"Softball",48119,48119,0,0,0,0,48119,48119,0,".","21",0,13769
"8931",115296,"GROSSMONT COLLEGE                                           ","2003-2004",16,"Softball",40680,40680,0,0,0,0,40680,40680,0,".","20",0,13326
"8933",170037,"CORNERSTONE UNIVERSITY                                      ","2003-2004",16,"Softball",50760,50760,0,0,0,0,50760,50760,0,".","17",0,27502
"8937",238616,"CONCORDIA UNIVERSITY-WISCONSIN                              ","2003-2004",16,"Softball",18145,18145,0,0,0,0,18145,18145,0,".","15",0,11795
"8940",107512,"OUACHITA BAPTIST UNIVERSITY                                 ","2003-2004",16,"Softball",114513,114513,0,0,0,0,114513,114513,0,".","19",0,26693
"8947",182865,"HESSER COLLEGE                                              ","2003-2004",16,"Softball",8967,8967,0,0,0,0,8967,8967,0,".","12",0,2617
"8948",166133,"HOLYOKE COMMUNITY COLLEGE                                   ","2003-2004",16,"Softball",9000,9000,0,0,0,0,9000,9000,0,".","16",0,2400
"8952",177250,"EAST CENTRAL COLLEGE                                        ","2003-2004",16,"Softball",52750,52750,0,0,0,0,52750,52750,0,".","14",0,13790
"8955",204185,"MOUNT UNION COLLEGE                                         ","2003-2004",16,"Softball",42975,42975,0,0,0,0,42975,42975,0,".","17",0,10759
"8958",195322,"SCHENECTADY COUNTY COMMUNITY COLLEGE                        ","2003-2004",16,"Softball",8901,8901,0,0,0,0,8901,8901,0,".","3",0,8900
"8959",113856,"EAST LOS ANGELES COLLEGE                                    ","2003-2004",16,"Softball",6000,6000,0,0,0,0,6000,6000,0,".","17",0,5599
"8963",140447,"MERCER UNIVERSITY                                           ","2003-2004",16,"Softball",79070,79070,0,0,0,0,79070,79070,0,".","17",0,45494
"8965",177418,"FONTBONNE UNIVERSITY                                        ","2003-2004",16,"Softball",22116,22116,0,0,0,0,22116,22116,0,".","21",0,10500
"8968",174914,"UNIVERSITY OF ST THOMAS                                     ","2003-2004",16,"Softball",99257,99257,0,0,0,0,99257,99257,0,".","20",0,61377
"8969",148627,"SAINT XAVIER UNIVERSITY                                     ","2003-2004",16,"Softball",116523,116523,0,0,0,0,116523,116523,0,".","25",0,39123
"8971",195474,"SIENA COLLEGE                                               ","2003-2004",16,"Softball",412265,412265,0,0,0,0,412265,412265,0,".","23",0,120276
"8979",207281,"NORTHERN OKLAHOMA COLLEGE                                   ","2003-2004",16,"Softball",33895,33895,0,0,0,0,33895,33895,0,".","14",0,15731
"8983",169248,"CENTRAL MICHIGAN UNIVERSITY                                 ","2003-2004",16,"Softball",434350,434350,0,0,0,0,434350,434350,0,".","20",0,75620
"8984",155292,"KANSAS CITY KANSAS COMMUNITY COLLEGE                        ","2003-2004",16,"Softball",57500,57500,0,0,0,0,57500,57500,0,".","21",0,25500
"8987",175157,"VERMILION COMMUNITY COLLEGE                                 ","2003-2004",16,"Softball",10393,10393,0,0,0,0,10393,10393,0,".","13",0,1
"8992",195544,"SAINT JOSEPHS COLLEGE-MAIN CAMPUS                           ","2003-2004",16,"Softball",41515,41515,0,0,0,0,41515,41515,0,".","18",0,35000
"8996",147800,"OAKTON COMMUNITY COLLEGE                                    ","2003-2004",16,"Softball",6,6,0,0,0,0,6,6,0,".","7",0,5
"8998",136950,"ROLLINS COLLEGE                                             ","2003-2004",16,"Softball",310465,310465,0,0,0,0,310465,310465,0,".","15",0,36227
"9000",196185,"SUNY COLLEGE AT ONEONTA                                     ","2003-2004",16,"Softball",80656,80656,0,0,0,0,80656,80656,0,".","20",0,15029
"9001",214069,"COLLEGE MISERICORDIA                                        ","2003-2004",16,"Softball",14474,14474,0,0,0,0,14474,14474,0,".","19",0,3129
"9008",138691,"DARTON COLLEGE                                              ","2003-2004",16,"Softball",69727,69727,0,0,0,0,69727,69727,0,".","16",0,23493
"9010",165334,"CLARK UNIVERSITY                                            ","2003-2004",16,"Softball",41573,41573,0,0,0,0,41573,41573,0,".","13",0,7568
"9011",124113,"TAFT COLLEGE                                                ","2003-2004",16,"Softball",18331,18331,0,0,0,0,18331,18331,0,".","13",0,11096
"9019",238333,"BELOIT COLLEGE                                              ","2003-2004",16,"Softball",17316,17316,0,0,0,0,17316,17316,0,".","18",0,17316
"9032",233912,"VIRGINIA INTERMONT COLLEGE                                  ","2003-2004",16,"Softball",14400,14400,0,0,0,0,14400,14400,0,".","24",0,11528
"9034",185536,"MIDDLESEX COUNTY COLLEGE                                    ","2003-2004",16,"Softball",17052,17052,0,0,0,0,17052,17052,0,".","13",0,9308
"9036",126775,"COLORADO SCHOOL OF MINES                                    ","2003-2004",16,"Softball",96686,96686,0,0,0,0,96686,96686,0,".","16",0,38866
"9042",173258,"CARLETON COLLEGE                                            ","2003-2004",16,"Softball",69657,69657,0,0,0,0,69657,69657,0,".","16",0,20531
"9046",104160,"ARIZONA WESTERN COLLEGE                                     ","2003-2004",16,"Softball",118703,118703,0,0,0,0,118703,118703,0,".","15",0,43583
"9047",138947,"CLARK ATLANTA UNIVERSITY                                    ","2003-2004",16,"Softball",103000,103000,0,0,0,0,103000,103000,0,".","18",0,40000
"9052",107460,"NORTH ARKANSAS COLLEGE                                      ","2003-2004",16,"Softball",16760,16760,0,0,0,0,16760,16760,0,".","11",0,2062
"9055",130253,"SACRED HEART UNIVERSITY                                     ","2003-2004",16,"Softball",337902,337902,0,0,0,0,337902,337902,0,".","25",0,47986
"9061",125499,"WEST VALLEY COLLEGE                                         ","2003-2004",16,"Softball",15092,15092,0,0,0,0,15092,15092,0,".","14",0,2240
"9066",127185,"FORT LEWIS COLLEGE                                          ","2003-2004",16,"Softball",123055,123055,0,0,0,0,123055,123055,0,".","18",0,29356
"9067",131098,"WESLEY COLLEGE                                              ","2003-2004",16,"Softball",28776,28776,0,0,0,0,28776,28776,0,".","14",0,18775
"9069",132693,"BREVARD COMMUNITY COLLEGE-COCOA CAMPUS                      ","2003-2004",16,"Softball",66500,66500,0,0,0,0,66500,66500,0,".","16",0,13000
"9080",175810,"HOLMES COMMUNITY COLLEGE                                    ","2003-2004",16,"Softball",35561,35561,0,0,0,0,35561,35561,0,".","12",0,30561
"9081",154493,"UPPER IOWA UNIVERSITY                                       ","2003-2004",16,"Softball",113662,113662,0,0,0,0,113662,113662,0,".","19",0,54017
"9088",130590,"TRINITY COLLEGE                                             ","2003-2004",16,"Softball",51494,51494,0,0,0,0,51494,51494,0,".","13",0,11284
"9089",207847,"SOUTHEASTERN OKLAHOMA STATE UNIVERSITY                      ","2003-2004",16,"Softball",115844,115844,0,0,0,0,115844,115844,0,".","24",0,18722
"9092",197294,"SUNY WESTCHESTER COMMMUNITY COLLEGE                         ","2003-2004",16,"Softball",13804,13804,0,0,0,0,13804,13804,0,".","14",0,3400
"9093",104717,"GRAND CANYON UNIVERSITY                                     ","2003-2004",16,"Softball",274461,274461,0,0,0,0,274461,274461,0,".","15",0,95907
"9096",175856,"JACKSON STATE UNIVERSITY                                    ","2003-2004",16,"Softball",147477,147477,0,0,0,0,147477,147477,0,".","16",0,48124
"9100",211352,"CABRINI COLLEGE                                             ","2003-2004",16,"Softball",30514,30514,0,0,0,0,30514,30514,0,".","11",0,28848
"9115",210605,"COMMUNITY COLLEGE OF ALLEGHENY COUNTY                       ","2003-2004",16,"Softball",9126,9126,0,0,0,0,9126,9126,0,".","31",0,9100
"9120",193973,"NIAGARA UNIVERSITY                                          ","2003-2004",16,"Softball",205775,205775,0,0,0,0,205775,205775,0,".","20",0,57556
"9121",201973,"CLARK STATE COMMUNITY COLLEGE                               ","2003-2004",16,"Softball",31757,31757,0,0,0,0,31757,31757,0,".","15",0,14107
"9122",243601,"UNIVERSIDAD DEL TURABO                                      ","2003-2004",16,"Softball",36115,36115,0,0,0,0,36115,36115,0,".","20",0,5485
"9124",141644,"HAWAII PACIFIC UNIVERSITY                                   ","2003-2004",16,"Softball",238127,238127,0,0,0,0,238127,238127,0,".","14",0,60949
"9130",176008,"MISSISSIPPI DELTA COMMUNITY COLLEGE                         ","2003-2004",16,"Softball",36528,36528,0,0,0,0,36528,36528,0,".","13",0,12358
"9132",202134,"CLEVELAND STATE UNIVERSITY                                  ","2003-2004",16,"Softball",295963,295963,0,0,0,0,295963,295963,0,".","19",0,61523
"9134",166124,"COLLEGE OF THE HOLY CROSS                                   ","2003-2004",16,"Softball",221752,221752,0,0,0,0,221752,221752,0,".","17",0,36277
"9137",210739,"DESALES UNIVERSITY                                          ","2003-2004",16,"Softball",27228,27228,0,0,0,0,27228,27228,0,".","17",0,18537
"9139",221519,"SEWANEE-THE UNIVERSITY OF THE SOUTH                         ","2003-2004",16,"Softball",37961,37961,0,0,0,0,37961,37961,0,".","13",0,19139
"9146",135160,"LAKE CITY COMMUNITY COLLEGE                                 ","2003-2004",16,"Softball",171060,171060,0,0,0,0,171060,171060,0,".","19",0,120600
"9150",126748,"COLORADO NORTHWESTERN COMMUNITY COLLEGE                     ","2003-2004",16,"Softball",96449,96449,0,0,0,0,96449,96449,0,".","12",0,38423
"9152",215309,"UNIVERSITY OF PITTSBURGH-TITUSVILLE                         ","2003-2004",16,"Softball",14556,14556,0,0,0,0,14556,14556,0,".","10",0,2556
"9158",135717,"MIAMI DADE COLLEGE                                          ","2003-2004",16,"Softball",206610,206610,0,0,0,0,206610,206610,0,".","19",0,19455
"9160",226471,"UNIVERSITY OF MARY HARDIN-BAYLOR                            ","2003-2004",16,"Softball",63338,63338,0,0,0,0,63338,63338,0,".","14",0,22244
"9166",232025,"EMORY AND HENRY COLLEGE                                     ","2003-2004",16,"Softball",47041,47041,0,0,0,0,47041,47041,0,".","12",0,14291
"9170",154235,"SAINT AMBROSE UNIVERSITY                                    ","2003-2004",16,"Softball",67289,67289,0,0,0,0,67289,67289,0,".","24",0,12439
"9173",214801,"PENNSYLVANIA STATE UNIVERSITY-PENN STATE ABINGTON           ","2003-2004",16,"Softball",9787,9787,0,0,0,0,9787,9787,0,".","11",0,3194
"9174",184205,"CUMBERLAND COUNTY COLLEGE                                   ","2003-2004",16,"Softball",29920,29920,0,0,0,0,29920,29920,0,".","13",0,12270
"9175",137476,"SAINT THOMAS UNIVERSITY                                     ","2003-2004",16,"Softball",137900,137900,0,0,0,0,137900,137900,0,".","13",0,15500
"9176",160621,"SOUTHERN UNIVERSITY AND A &amp; M COLLEGE                       ","2003-2004",16,"Softball",35349,35349,0,0,0,0,35349,35349,0,".","16",0,2357
"9181",198756,"JOHNSON C SMITH UNIVERSITY                                  ","2003-2004",16,"Softball",33125,33125,0,0,0,0,33125,33125,0,".","10",0,7042
"9183",145682,"ILLINOIS CENTRAL COLLEGE                                    ","2003-2004",16,"Softball",94789,94789,0,0,0,0,94789,94789,0,".","16",0,36498
"9186",213826,"MARYWOOD UNIVERSITY                                         ","2003-2004",16,"Softball",11320,11320,0,0,0,0,11320,11320,0,".","16",0,6466
"9187",237899,"WEST VIRGINIA STATE COLLEGE                                 ","2003-2004",16,"Softball",113824,113824,0,0,0,0,113824,113824,0,".","18",0,29618
"9198",167534,"QUINSIGAMOND COMMUNITY COLLEGE                              ","2003-2004",16,"Softball",6044,6044,0,0,0,0,6044,6044,0,".","15",0,5544
"9201",199722,"SOUTHEASTERN COMMUNITY COLLEGE                              ","2003-2004",16,"Softball",7700,7700,0,0,0,0,7700,7700,0,".","15",0,6500
"9212",162557,"FREDERICK COMMUNITY COLLEGE                                 ","2003-2004",16,"Softball",8425,8425,0,0,0,0,8425,8425,0,".","12",0,2745
"9216",213996,"MESSIAH COLLEGE                                             ","2003-2004",16,"Softball",51718,51718,0,0,0,0,51718,51718,0,".","16",0,23888
"9221",176354,"SOUTHWEST MISSISSIPPI COMMUNITY COLLEGE                     ","2003-2004",16,"Softball",65462,65462,0,0,0,0,65462,65462,0,".","15",0,12712
"9226",154952,"COWLEY COUNTY COMMUNITY COLLEGE                             ","2003-2004",16,"Softball",107341,107341,0,0,0,0,107341,107341,0,".","24",0,35077
"9231",155900,"SOUTHWESTERN COLLEGE                                        ","2003-2004",16,"Softball",33560,33560,0,0,0,0,33560,33560,0,".","11",0,23086
"9233",203368,"JOHN CARROLL UNIVERSITY                                     ","2003-2004",16,"Softball",46670,46670,0,0,0,0,46670,46670,0,".","17",0,18566
"9235",153375,"GRAND VIEW COLLEGE                                          ","2003-2004",16,"Softball",155286,155286,0,0,0,0,155286,155286,0,".","26",0,43251
"9238",175236,"RIDGEWATER COLLEGE                                          ","2003-2004",16,"Softball",24865,24865,0,0,0,0,24865,24865,0,".","14",0,9900
"9239",120254,"OCCIDENTAL COLLEGE                                          ","2003-2004",16,"Softball",20831,20831,0,0,0,0,20831,20831,0,".","12",0,8331
"9241",166027,"HARVARD UNIVERSITY                                          ","2003-2004",16,"Softball",249313,249313,0,0,0,0,249313,249313,0,".","47",0,100565
"9250",117247,"LANEY COLLEGE                                               ","2003-2004",16,"Softball",20041,20041,0,0,0,0,20041,20041,0,".","14",0,20034
"9266",218539,"PRESBYTERIAN COLLEGE                                        ","2003-2004",16,"Softball",181630,181630,0,0,0,0,181630,181630,0,".","22",0,26407
"9280",105792,"SOUTH MOUNTAIN COMMUNITY COLLEGE                            ","2003-2004",16,"Softball",18323,18323,0,0,0,0,18323,18323,0,".","17",0,8625
"9284",183938,"CAMDEN COUNTY COLLEGE                                       ","2003-2004",16,"Softball",47583,47583,0,0,0,0,47583,47583,0,".","14",0,7494
"9287",186432,"SAINT PETERS COLLEGE                                        ","2003-2004",16,"Softball",222001,222001,0,0,0,0,222001,222001,0,".","19",0,29939
"9289",183026,"SOUTHERN NEW HAMPSHIRE UNIVERSITY                           ","2003-2004",16,"Softball",210893,210893,0,0,0,0,210893,210893,0,".","18",0,58630
"9290",144564,"DANVILLE AREA COMMUNITY COLLEGE                             ","2003-2004",16,"Softball",19219,19219,0,0,0,0,19219,19219,0,".","15",0,19218
"9292",101879,"UNIVERSITY OF NORTH ALABAMA                                 ","2003-2004",16,"Softball",140261,140261,0,0,0,0,140261,140261,0,".","14",0,27059
"9301",157359,"MID-CONTINENT COLLEGE                                       ","2003-2004",16,"Softball",123510,123510,0,0,0,0,123510,123510,0,".","19",0,30735
"9303",218724,"COASTAL CAROLINA UNIVERSITY                                 ","2003-2004",16,"Softball",345354,345354,0,0,0,0,345354,345354,0,".","17",0,77011
"9307",212674,"GETTYSBURG COLLEGE                                          ","2003-2004",16,"Softball",81579,81579,0,0,0,0,81579,81579,0,".","18",0,8954
"9314",251260,"SOUTHERN UNION STATE COMMUNITY COLLEGE                      ","2003-2004",16,"Softball",94824,94824,0,0,0,0,94824,94824,0,".","25",0,30962
"9318",123554,"SAINT MARYS COLLEGE OF CALIFORNIA                           ","2003-2004",16,"Softball",202259,202259,0,0,0,0,202259,202259,0,".","17",0,47497
"9319",214625,"PENNSYLVANIA STATE UNIV-PENN STATE NEW KENSINGTON           ","2003-2004",16,"Softball",12894,12894,0,0,0,0,12894,12894,0,".","11",0,8800
"9320",218061,"FRANCIS MARION UNIVERSITY                                   ","2003-2004",16,"Softball",140129,140129,0,0,0,0,140129,140129,0,".","16",0,36530
"9330",141361,"YOUNG HARRIS COLLEGE                                        ","2003-2004",16,"Softball",198722,198722,0,0,0,0,198722,198722,0,".","19",0,63659
"9341",164447,"AMERICAN INTERNATIONAL COLLEGE                              ","2003-2004",16,"Softball",26329,26329,0,0,0,0,26329,26329,0,".","20",0,25679
"9342",190646,"CUNY MEDGAR EVERS COLLEGE                                   ","2003-2004",16,"Softball",10350,10350,0,0,0,0,10350,10350,0,".","18",0,10250
"9347",204264,"MUSKINGUM COLLEGE                                           ","2003-2004",16,"Softball",30326,30326,0,0,0,0,30326,30326,0,".","36",0,29883
"9350",192819,"MARIST COLLEGE                                              ","2003-2004",16,"Softball",170429,170429,0,0,0,0,170429,170429,0,".","17",0,50877
"9351",143288,"BLACKBURN COLLEGE                                           ","2003-2004",16,"Softball",27854,27854,0,0,0,0,27854,27854,0,".","11",0,9340
"9352",195003,"ROCHESTER INSTITUTE OF TECHNOLOGY                           ","2003-2004",16,"Softball",39498,39498,0,0,0,0,39498,39498,0,".","18",0,29254
"9355",200572,"VALLEY CITY STATE UNIVERSITY                                ","2003-2004",16,"Softball",38071,38071,0,0,0,0,38071,38071,0,".","13",0,11766
"9366",205966,"SOUTHERN STATE COMMUNITY COLLEGE                            ","2003-2004",16,"Softball",11924,11924,0,0,0,0,11924,11924,0,".","10",0,7224
"9373",173124,"BEMIDJI STATE UNIVERSITY                                    ","2003-2004",16,"Softball",72032,72032,0,0,0,0,72032,72032,0,".","15",0,22624
"9375",157818,"TRANSYLVANIA UNIVERSITY                                     ","2003-2004",16,"Softball",79792,79792,0,0,0,0,79792,79792,0,".","15",0,30659
"9384",118718,"MERCED COLLEGE                                              ","2003-2004",16,"Softball",11958,11958,0,0,0,0,11958,11958,0,".","13",0,6258
"9387",155414,"KANSAS WESLEYAN UNIVERSITY                                  ","2003-2004",16,"Softball",43838,43838,0,0,0,0,43838,43838,0,".","22",0,28648
"9390",195173,"ST FRANCIS COLLEGE                                          ","2003-2004",16,"Softball",130994,130994,0,0,0,0,130994,130994,0,".","19",0,43250
"9392",243179,"UNIVERSITY OF PUERTO RICO-HUMACAO                           ","2003-2004",16,"Softball",7640,7640,0,0,0,0,7640,7640,0,".","20",0,2288
"9394",201195,"BALDWIN-WALLACE COLLEGE                                     ","2003-2004",16,"Softball",56763,56763,0,0,0,0,56763,56763,0,".","29",0,24551
"9398",150172,"CALUMET COLLEGE OF SAINT JOSEPH                             ","2003-2004",16,"Softball",25331,25331,0,0,0,0,25331,25331,0,".","14",0,14866
"9400",122658,"SAN JOAQUIN DELTA COLLEGE                                   ","2003-2004",16,"Softball",43028,43028,0,0,0,0,43028,43028,0,".","16",0,11901
"9403",133702,"FLORIDA COMMUNITY COLLEGE AT JACKSONVILLE                   ","2003-2004",16,"Softball",188463,188463,0,0,0,0,188463,188463,0,".","25",0,88232
"9406",154101,"NORTHWESTERN COLLEGE                                        ","2003-2004",16,"Softball",83919,83919,0,0,0,0,83919,83919,0,".","16",0,28216
"9413",181020,"DOANE COLLEGE                                               ","2003-2004",16,"Softball",88388,88388,0,0,0,0,88388,88388,0,".","23",0,20464
"9419",146472,"COLLEGE OF LAKE COUNTY                                      ","2003-2004",16,"Softball",17094,17094,0,0,0,0,17094,17094,0,".","11",0,12934
"9422",190840,"DUTCHESS COMMUNITY COLLEGE                                  ","2003-2004",16,"Softball",10000,10000,0,0,0,0,10000,10000,0,".","15",0,4500
"9423",119067,"MONTEREY PENINSULA COLLEGE                                  ","2003-2004",16,"Softball",21015,21015,0,0,0,0,21015,21015,0,".","10",0,8660
"9424",200226,"MAYVILLE STATE UNIVERSITY                                   ","2003-2004",16,"Softball",23136,23136,0,0,0,0,23136,23136,0,".","13",0,22974
"9433",154378,"SOUTHEASTERN COMMUNITY COLLEGE                              ","2003-2004",16,"Softball",40819,40819,0,0,0,0,40819,40819,0,".","15",0,16518
"9434",196033,"SUNY COLLEGE OF AGRIC AND TECHN AT COBLESKILL               ","2003-2004",16,"Softball",4831,4831,0,0,0,0,4831,4831,0,".","16",0,3248
"9435",168607,"ALPENA COMMUNITY COLLEGE                                    ","2003-2004",16,"Softball",18479,18479,0,0,0,0,18479,18479,0,".","14",0,8886
"9437",146603,"LEWIS AND CLARK COMMUNITY COLLEGE                           ","2003-2004",16,"Softball",45911,45911,0,0,0,0,45911,45911,0,".","15",0,13476
"9442",223922,"CLARENDON COLLEGE                                           ","2003-2004",16,"Softball",55131,55131,0,0,0,0,55131,55131,0,".","19",0,28178
"9452",196042,"FARMINGDALE STATE UNIVERSITY OF NEW YORK                    ","2003-2004",16,"Softball",25500,25500,0,0,0,0,25500,25500,0,".","16",0,13000
"9453",150668,"GOSHEN COLLEGE                                              ","2003-2004",16,"Softball",62168,62168,0,0,0,0,62168,62168,0,".","16",0,22862
"9457",122375,"SAN DIEGO MESA COLLEGE                                      ","2003-2004",16,"Softball",23620,23620,0,0,0,0,23620,23620,0,".","15",0,7498
"9464",205203,"UNIVERSITY OF RIO GRANDE                                    ","2003-2004",16,"Softball",51501,51501,0,0,0,0,51501,51501,0,".","25",0,12031
"9468",112260,"CLAREMONT MCKENNA COLLEGE                                   ","2003-2004",16,"Softball",68045,68045,0,0,0,0,68045,68045,0,".","13",0,19772
"9469",221953,"TUSCULUM COLLEGE                                            ","2003-2004",16,"Softball",167685,167685,0,0,0,0,167685,167685,0,".","18",0,31998
"9475",366395,"SUFFOLK COUNTY COMMUNITY COLLEGE                            ","2003-2004",16,"Softball",16608,16608,0,0,0,0,16608,16608,0,".","12",0,9018
"9476",234173,"VIRGINIA WESLEYAN COLLEGE                                   ","2003-2004",16,"Softball",19409,19409,0,0,0,0,19409,19409,0,".","24",0,10209
"9484",179715,"NORTH CENTRAL MISSOURI COLLEGE                              ","2003-2004",16,"Softball",61536,61536,0,0,0,0,61536,61536,0,".","12",0,13704
"9493",133492,"ECKERD COLLEGE                                              ","2003-2004",16,"Softball",88527,88527,0,0,0,0,88527,88527,0,".","16",0,24285
"9495",217235,"JOHNSON &amp; WALES UNIVERSITY                                  ","2003-2004",16,"Softball",40696,40696,0,0,0,0,40696,40696,0,".","18",0,29205
"9496",173735,"HIBBING COMMUNITY COLLEGE-A TECH AND COMM COLL              ","2003-2004",16,"Softball",19545,19545,0,0,0,0,19545,19545,0,".","13",0,11524
"9503",144050,"UNIVERSITY OF CHICAGO                                       ","2003-2004",16,"Softball",93698,93698,0,0,0,0,93698,93698,0,".","17",0,40792
"9507",206862,"SOUTHERN NAZARENE UNIVERSITY                                ","2003-2004",16,"Softball",110789,110789,0,0,0,0,110789,110789,0,".","14",0,14329
"9514",178721,"PARK UNIVERSITY                                             ","2003-2004",16,"Softball",121068,121068,0,0,0,0,121068,121068,0,".","13",0,20381
"9516",156189,"ALICE LLOYD COLLEGE                                         ","2003-2004",16,"Softball",6500,6500,0,0,0,0,6500,6500,0,".","11",0,5500
"9519",227687,"RANGER COLLEGE                                              ","2003-2004",16,"Softball",98959,98959,0,0,0,0,98959,98959,0,".","15",0,9012
"9520",130934,"DELAWARE STATE UNIVERSITY                                   ","2003-2004",16,"Softball",211349,211349,0,0,0,0,211349,211349,0,".","13",0,53845
"9521",190549,"CUNY BROOKLYN COLLEGE                                       ","2003-2004",16,"Softball",15708,15708,0,0,0,0,15708,15708,0,".","13",0,9049
"9535",214272,"NEUMANN COLLEGE                                             ","2003-2004",16,"Softball",27799,27799,0,0,0,0,27799,27799,0,".","16",0,20000
"9537",196121,"SUNY COLLEGE AT BROCKPORT                                   ","2003-2004",16,"Softball",15580,15580,0,0,0,0,15580,15580,0,".","24",0,10826
"9545",216852,"WIDENER UNIVERSITY-MAIN CAMPUS                              ","2003-2004",16,"Softball",33091,33091,0,0,0,0,33091,33091,0,".","16",0,11476
"9547",177144,"CULVER-STOCKTON COLLEGE                                     ","2003-2004",16,"Softball",64287,64287,0,0,0,0,64287,64287,0,".","24",0,23491
"9552",166638,"UNIVERSITY OF MASSACHUSETTS-BOSTON                          ","2003-2004",16,"Softball",39914,39914,0,0,0,0,39914,39914,0,".","18",0,13456
"9560",130493,"SOUTHERN CONNECTICUT STATE UNIVERSITY                       ","2003-2004",16,"Softball",83665,83665,0,0,0,0,83665,83665,0,".","22",0,28804
"9564",137759,"TALLAHASSEE COMMUNITY COLLEGE                               ","2003-2004",16,"Softball",157439,157439,0,0,0,0,157439,157439,0,".","15",0,32305
"9571",148584,"UNIVERSITY OF ST FRANCIS                                    ","2003-2004",16,"Softball",203381,203381,0,0,0,0,203381,203381,0,".","21",0,23412
"9573",136233,"OKALOOSA-WALTON COMMUNITY COLLEGE                           ","2003-2004",16,"Softball",31325,31325,0,0,0,0,31325,31325,0,".","22",0,10000
"9574",198835,"LENOIR-RHYNE COLLEGE                                        ","2003-2004",16,"Softball",156436,156436,0,0,0,0,156436,156436,0,".","13",0,78936
"9579",156541,"CUMBERLAND COLLEGE                                          ","2003-2004",16,"Softball",180635,180635,0,0,0,0,180635,180635,0,".","17",0,11832
"9585",136358,"PALM BEACH COMMUNITY COLLEGE                                ","2003-2004",16,"Softball",89651,89651,0,0,0,0,89651,89651,0,".","19",0,26887
"9587",122977,"SANTA MONICA COLLEGE                                        ","2003-2004",16,"Softball",21073,21073,0,0,0,0,21073,21073,0,".","10",0,5073
"9591",187134,"THE COLLEGE OF NEW JERSEY                                   ","2003-2004",16,"Softball",88303,88303,0,0,0,0,88303,88303,0,".","19",0,20937
"9593",148672,"SAUK VALLEY COMMUNITY COLLEGE                               ","2003-2004",16,"Softball",16582,16582,0,0,0,0,16582,16582,0,".","11",0,5475
"9595",198507,"ELIZABETH CITY STATE UNIVERSITY                             ","2003-2004",16,"Softball",31228,31228,0,0,0,0,31228,31228,0,".","13",0,22035
"9599",129525,"UNIVERSITY OF HARTFORD                                      ","2003-2004",16,"Softball",359569,359569,0,0,0,0,359569,359569,0,".","17",0,56999
"9601",156745,"GEORGETOWN COLLEGE                                          ","2003-2004",16,"Softball",32675,32675,0,0,0,0,32675,32675,0,".","18",0,14662
"9606",106485,"UNIVERSITY OF ARKANSAS AT MONTICELLO                        ","2003-2004",16,"Softball",97686,97686,0,0,0,0,97686,97686,0,".","20",0,31778
"9623",161563,"THOMAS COLLEGE                                              ","2003-2004",16,"Softball",30956,30956,0,0,0,0,30956,30956,0,".","18",0,23456
"9627",214768,"PENNSYLVANIA STATE UNIVERSITY-PENN STATE HAZLETON           ","2003-2004",16,"Softball",5000,5000,0,0,0,0,5000,5000,0,".","15",0,2800
"9628",191515,"HAMILTON COLLEGE                                            ","2003-2004",16,"Softball",34739,34739,0,0,0,0,34739,34739,0,".","16",0,11271
"9629",117274,"LASSEN COMMUNITY COLLEGE                                    ","2003-2004",16,"Softball",50244,50244,0,0,0,0,50244,50244,0,".","14",0,12200
"9640",165574,"DEAN COLLEGE                                                ","2003-2004",16,"Softball",37569,37569,0,0,0,0,37569,37569,0,".","11",0,9969
"9644",170967,"ROCHESTER COLLEGE                                           ","2003-2004",16,"Softball",35318,35318,0,0,0,0,35318,35318,0,".","14",0,4082
"9645",101736,"NORTHWEST SHOALS COMMUNITY COLLEGE-MUSCLE SHOALS            ","2003-2004",16,"Softball",27655,27655,0,0,0,0,27655,27655,0,".","19",0,14450
"9652",210155,"SOUTHWESTERN OREGON COMMUNITY COLLEGE                       ","2003-2004",16,"Softball",56489,56489,0,0,0,0,56489,56489,0,".","15",0,34593
"9658",196237,"SUNY COLLEGE AT OLD WESTBURY                                ","2003-2004",16,"Softball",10000,10000,0,0,0,0,10000,10000,0,".","25",0,7500
"9663",101949,"ALABAMA SOUTHERN COMMUNITY COLLEGE                          ","2003-2004",16,"Softball",108432,108432,0,0,0,0,108432,108432,0,".","26",0,81614
"9666",214689,"PENNSYLVANIA STATE UNIVERSITY-PENN STATE ALTOONA            ","2003-2004",16,"Softball",24070,24070,0,0,0,0,24070,24070,0,".","12",0,13843
"9669",181853,"YORK COLLEGE                                                ","2003-2004",16,"Softball",24140,24140,0,0,0,0,24140,24140,0,".","15",0,9720
"9673",219295,"PRESENTATION COLLEGE                                        ","2003-2004",16,"Softball",19287,19287,0,0,0,0,19287,19287,0,".","12",0,8348
"9679",145691,"ILLINOIS COLLEGE                                            ","2003-2004",16,"Softball",25947,25947,0,0,0,0,25947,25947,0,".","17",0,13883
"9680",212832,"GWYNEDD MERCY COLLEGE                                       ","2003-2004",16,"Softball",17930,17930,0,0,0,0,17930,17930,0,".","18",0,10930
"9681",154855,"CENTRAL CHRISTIAN COLLEGE OF KANSAS                         ","2003-2004",16,"Softball",9259,9259,0,0,0,0,9259,9259,0,".","12",0,5137
"9683",155195,"HUTCHINSON COMMUNITY COLLEGE                                ","2003-2004",16,"Softball",48418,48418,0,0,0,0,48418,48418,0,".","13",0,21793
"9692",183080,"PLYMOUTH STATE UNIVERSITY                                   ","2003-2004",16,"Softball",48449,48449,0,0,0,0,48449,48449,0,".","19",0,20993
"9695",146612,"LEWIS UNIVERSITY                                            ","2003-2004",16,"Softball",191428,191428,0,0,0,0,191428,191428,0,".","28",0,46423
"9704",220978,"MIDDLE TENNESSEE STATE UNIVERSITY                           ","2003-2004",16,"Softball",349411,349411,0,0,0,0,349411,349411,0,".","23",0,94504
"9706",166948,"MOUNT IDA COLLEGE                                           ","2003-2004",16,"Softball",34842,34842,0,0,0,0,34842,34842,0,".","11",0,29342
"9709",133021,"CHIPOLA COLLEGE                                             ","2003-2004",16,"Softball",159422,159422,0,0,0,0,159422,159422,0,".","20",0,20390
"9711",190655,"CUNY NEW YORK CITY COLLEGE OF TECHNOLOGY                    ","2003-2004",16,"Softball",10062,10062,0,0,0,0,10062,10062,0,".","25",0,10061
"9716",173160,"BETHEL COLLEGE                                              ","2003-2004",16,"Softball",42813,42813,0,0,0,0,42813,42813,0,".","17",0,20434
"9726",161004,"BOWDOIN COLLEGE                                             ","2003-2004",16,"Softball",52323,52323,0,0,0,0,52323,52323,0,".","15",0,7492
"9730",183743,"BERGEN COMMUNITY COLLEGE                                    ","2003-2004",16,"Softball",21695,21695,0,0,0,0,21695,21695,0,".","13",0,15000
"9733",166823,"MASSASOIT COMMUNITY COLLEGE                                 ","2003-2004",16,"Softball",18761,18761,0,0,0,0,18761,18761,0,".","13",0,12228
"9737",217776,"SOUTHERN WESLEYAN UNIVERSITY                                ","2003-2004",16,"Softball",115223,115223,0,0,0,0,115223,115223,0,".","14",0,27758
"9741",193283,"MOHAWK VALLEY COMMUNITY COLLEGE-UTICA BRANCH                ","2003-2004",16,"Softball",15254,15254,0,0,0,0,15254,15254,0,".","14",0,7112
"9748",196051,"MORRISVILLE STATE COLLEGE                                   ","2003-2004",16,"Softball",25599,25599,0,0,0,0,25599,25599,0,".","12",0,15183
"9756",146506,"LAKE LAND COLLEGE                                           ","2003-2004",16,"Softball",46809,46809,0,0,0,0,46809,46809,0,".","16",0,21465
"9761",206914,"CAMERON UNIVERSITY                                          ","2003-2004",16,"Softball",13172,13172,0,0,0,0,13172,13172,0,".","15",0,12779
"9772",219198,"MOUNT MARTY COLLEGE                                         ","2003-2004",16,"Softball",68006,68006,0,0,0,0,68006,68006,0,".","19",0,10150
"9774",190619,"CUNY KINGSBOROUGH COMMUNITY COLLEGE                         ","2003-2004",16,"Softball",11117,11117,0,0,0,0,11117,11117,0,".","10",0,6706
"9777",200217,"UNIVERSITY OF MARY                                          ","2003-2004",16,"Softball",147876,147876,0,0,0,0,147876,147876,0,".","24",0,37707
"9782",149532,"TRITON COLLEGE                                              ","2003-2004",16,"Softball",21448,21448,0,0,0,0,21448,21448,0,".","13",0,7117
"9783",193353,"MOUNT SAINT MARY COLLEGE                                    ","2003-2004",16,"Softball",15356,15356,0,0,0,0,15356,15356,0,".","15",0,12855
"9786",173638,"MINNESOTA WEST COMMUNITY AND TECHNICAL COLLEGE              ","2003-2004",16,"Softball",12603,12603,0,0,0,0,12603,12603,0,".","15",0,5196
"9790",165015,"BRANDEIS UNIVERSITY                                         ","2003-2004",16,"Softball",88770,88770,0,0,0,0,88770,88770,0,".","15",0,31829
"9792",235103,"EDMONDS COMMUNITY COLLEGE                                   ","2003-2004",16,"Softball",21328,21328,0,0,0,0,21328,21328,0,".","14",0,12134
"9802",193478,"NASSAU COMMUNITY COLLEGE                                    ","2003-2004",16,"Softball",17090,17090,0,0,0,0,17090,17090,0,".","17",0,6477
"9808",192466,"SOUTHAMPTON COLLEGE OF LONG ISLAND UNIVERSITY               ","2003-2004",16,"Softball",128545,128545,0,0,0,0,128545,128545,0,".","14",0,27132
"9810",237932,"WEST LIBERTY STATE COLLEGE                                  ","2003-2004",16,"Softball",50200,50200,0,0,0,0,50200,50200,0,".","21",0,7773
"9823",170301,"HOPE COLLEGE                                                ","2003-2004",16,"Softball",47922,47922,0,0,0,0,47922,47922,0,".","19",0,25008
"9827",170657,"LANSING COMMUNITY COLLEGE                                   ","2003-2004",16,"Softball",89405,89405,0,0,0,0,89405,89405,0,".","15",0,31421
"9829",196565,"TOMPKINS-CORTLAND COMMUNITY COLLEGE                         ","2003-2004",16,"Softball",15926,15926,0,0,0,0,15926,15926,0,".","20",0,11940
"9830",168281,"WHEATON COLLEGE                                             ","2003-2004",16,"Softball",93978,93978,0,0,0,0,93978,93978,0,".","17",0,39972
"9835",101480,"JACKSONVILLE STATE UNIVERSITY                               ","2003-2004",16,"Softball",293704,293704,0,0,0,0,293704,293704,0,".","17",0,293703
"9836",150534,"UNIVERSITY OF EVANSVILLE                                    ","2003-2004",16,"Softball",469481,469481,0,0,0,0,469481,469481,0,".","18",0,78380
"9838",185509,"MERCER COUNTY COMMUNITY COLLEGE                             ","2003-2004",16,"Softball",14000,14000,0,0,0,0,14000,14000,0,".","18",0,13986
"9839",136473,"PENSACOLA JUNIOR COLLEGE                                    ","2003-2004",16,"Softball",153834,153834,0,0,0,0,153834,153834,0,".","20",0,41092
"9841",122791,"COLLEGE OF SAN MATEO                                        ","2003-2004",16,"Softball",43883,43883,0,0,0,0,43883,43883,0,".","12",0,9477
"9842",237640,"OHIO VALLEY COLLEGE                                         ","2003-2004",16,"Softball",59410,59410,0,0,0,0,59410,59410,0,".","14",0,13382
"9845",100937,"BIRMINGHAM SOUTHERN COLLEGE                                 ","2003-2004",16,"Softball",482086,482086,0,0,0,0,482086,482086,0,".","19",0,50334
"9847",218399,"MORRIS COLLEGE                                              ","2003-2004",16,"Softball",24240,24240,0,0,0,0,24240,24240,0,".","15",0,18572
"9848",101505,"JEFFERSON STATE COMMUNITY COLLEGE                           ","2003-2004",16,"Softball",216792,216792,0,0,0,0,216792,216792,0,".","19",0,82794
"9851",134343,"GULF COAST COMMUNITY COLLEGE                                ","2003-2004",16,"Softball",257293,257293,0,0,0,0,257293,257293,0,".","19",0,35552
"9856",203775,"MALONE COLLEGE                                              ","2003-2004",16,"Softball",131513,131513,0,0,0,0,131513,131513,0,".","17",0,39429
"9860",100760,"CENTRAL ALABAMA COMMUNITY COLLEGE                           ","2003-2004",16,"Softball",62814,62814,0,0,0,0,62814,62814,0,".","16",0,23408
"9861",105428,"PHOENIX COLLEGE                                             ","2003-2004",16,"Softball",84200,84200,0,0,0,0,84200,84200,0,".","15",0,18300
"9862",111887,"CERRITOS COLLEGE                                            ","2003-2004",16,"Softball",49300,49300,0,0,0,0,49300,49300,0,".","16",0,5709
"9863",163851,"SALISBURY UNIVERSITY                                        ","2003-2004",16,"Softball",22542,22542,0,0,0,0,22542,22542,0,".","17",0,11896
"9872",162760,"HOOD COLLEGE                                                ","2003-2004",16,"Softball",14824,14824,0,0,0,0,14824,14824,0,".","13",0,8324
"9874",213659,"LUZERNE COUNTY COMMUNITY COLLEGE                            ","2003-2004",16,"Softball",9000,9000,0,0,0,0,9000,9000,0,".","13",0,4100
"9879",105747,"SCOTTSDALE COMMUNITY COLLEGE                                ","2003-2004",16,"Softball",26578,26578,0,0,0,0,26578,26578,0,".","18",0,14600
"9899",175573,"COPIAH-LINCOLN COMMUNITY COLLEGE                            ","2003-2004",16,"Softball",40401,40401,0,0,0,0,40401,40401,0,".","12",0,9473
"9900",152567,"TRI-STATE UNIVERSITY                                        ","2003-2004",16,"Softball",32531,32531,0,0,0,0,32531,32531,0,".","21",0,10531
"9903",232043,"EASTERN MENNONITE UNIVERSITY                                ","2003-2004",16,"Softball",21980,21980,0,0,0,0,21980,21980,0,".","10",0,910
"9904",136145,"NORTH FLORIDA COMMUNITY COLLEGE                             ","2003-2004",16,"Softball",112781,112781,0,0,0,0,112781,112781,0,".","16",0,17663
"9907",101435,"HUNTINGDON COLLEGE                                          ","2003-2004",16,"Softball",85326,85326,0,0,0,0,85326,85326,0,".","20",0,29163
"9917",181127,"HASTINGS COLLEGE                                            ","2003-2004",16,"Softball",275319,275319,0,0,0,0,275319,275319,0,".","35",0,15719
"9920",111920,"CHABOT COLLEGE                                              ","2003-2004",16,"Softball",3300,3300,0,0,0,0,3300,3300,0,".","12",0,5700
"9926",104577,"EASTERN ARIZONA COLLEGE                                     ","2003-2004",16,"Softball",118897,118897,0,0,0,0,118897,118897,0,".","20",0,43077
"9928",215798,"SAINT VINCENT COLLEGE                                       ","2003-2004",16,"Softball",79462,79462,0,0,0,0,79462,79462,0,".","16",0,27173
"9932",189459,"BRIARCLIFFE COLLEGE                                         ","2003-2004",16,"Softball",189280,189280,0,0,0,0,189280,189280,0,".","14",0,67600
"9934",107080,"HENDRIX COLLEGE                                             ","2003-2004",16,"Softball",64600,64600,0,0,0,0,64600,64600,0,".","13",0,22600
"9949",128258,"TRINIDAD STATE JUNIOR COLLEGE                               ","2003-2004",16,"Softball",56977,56977,0,0,0,0,56977,56977,0,".","14",0,18369
"9952",208646,"EASTERN OREGON UNIVERSITY                                   ","2003-2004",16,"Softball",70561,70561,0,0,0,0,70561,70561,0,".","19",0,25990
"9953",126182,"ADAMS STATE COLLEGE                                         ","2003-2004",16,"Softball",120657,120657,0,0,0,0,120657,120657,0,".","21",0,19713
"9963",183877,"BURLINGTON COUNTY COLLEGE                                   ","2003-2004",16,"Softball",9225,9225,0,0,0,0,9225,9225,0,".","13",0,15743
"9965",173203,"CENTRAL LAKES COLLEGE-BRAINERD                              ","2003-2004",16,"Softball",10590,10590,0,0,0,0,10590,10590,0,".","12",0,6032
"9969",149505,"TRINITY CHRISTIAN COLLEGE                                   ","2003-2004",16,"Softball",38958,38958,0,0,0,0,38958,38958,0,".","15",0,26558
"9971",184791,"GLOUCESTER COUNTY COLLEGE                                   ","2003-2004",16,"Softball",25732,25732,0,0,0,0,25732,25732,0,".","14",0,25732
"9974",176965,"CENTRAL MISSOURI STATE UNIVERSITY                           ","2003-2004",16,"Softball",235995,235995,0,0,0,0,235995,235995,0,".","27",0,30628
"9979",154712,"BENEDICTINE COLLEGE                                         ","2003-2004",16,"Softball",124417,124417,0,0,0,0,124417,124417,0,".","26",0,26524
"9983",148335,"ROBERT MORRIS COLLEGE                                       ","2003-2004",16,"Softball",448951,448951,0,0,0,0,448951,448951,0,".","30",0,109679
"9993",175786,"HINDS COMMUNITY COLLEGE                                     ","2003-2004",16,"Softball",45207,45207,0,0,0,0,45207,45207,0,".","20",0,10001
"9996",110538,"CALIFORNIA STATE UNIVERSITY-CHICO                           ","2003-2004",16,"Softball",149901,149901,0,0,0,0,149901,149901,0,".","17",0,31639
"9998",180984,"CONCORDIA UNIVERSITY                                        ","2003-2004",16,"Softball",69394,69394,0,0,0,0,69394,69394,0,".","21",0,13209
"9999",186645,"RARITAN VALLEY COMMUNITY COLLEGE                            ","2003-2004",16,"Softball",13156,13156,0,0,0,0,13156,13156,0,".","13",0,4316
"10003",190600,"CUNY JOHN JAY COLLEGE CRIMINAL JUSTICE                      ","2003-2004",16,"Softball",26463,26463,0,0,0,0,26463,26463,0,".","19",0,14057
"10006",168227,"WENTWORTH INSTITUTE OF TECHNOLOGY                           ","2003-2004",16,"Softball",18645,18645,0,0,0,0,18645,18645,0,".","16",0,7535
"10009",228006,"SAN JACINTO COLLEGE-SOUTH CAMPUS                            ","2003-2004",16,"Softball",100467,100467,0,0,0,0,100467,100467,0,".","17",0,100400
"10010",166647,"MASSACHUSETTS BAY COMMUNITY COLLEGE                         ","2003-2004",16,"Softball",6220,6220,0,0,0,0,6220,6220,0,".","15",0,1220
"10013",238458,"CARROLL COLLEGE                                             ","2003-2004",16,"Softball",25000,25000,0,0,0,0,25000,25000,0,".","18",0,6600
"10015",229504,"VERNON COLLEGE                                              ","2003-2004",16,"Softball",79996,79996,0,0,0,0,79996,79996,0,".","19",0,31384
"10018",210775,"ALVERNIA COLLEGE                                            ","2003-2004",16,"Softball",14431,14431,0,0,0,0,14431,14431,0,".","15",0,4476
"10024",139250,"COASTAL GEORGIA COMMUNITY COLLEGE                           ","2003-2004",16,"Softball",72427,72427,0,0,0,0,72427,72427,0,".","12",0,67778
"10025",153533,"IOWA LAKES COMMUNITY COLLEGE                                ","2003-2004",16,"Softball",48276,48276,0,0,0,0,48276,48276,0,".","14",0,22315
"10034",182005,"COMMUNITY COLLEGE OF SOUTHERN NEVADA                        ","2003-2004",16,"Softball",125000,125000,0,0,0,0,125000,125000,0,".","16",0,120000
"10038",217420,"RHODE ISLAND COLLEGE                                        ","2003-2004",16,"Softball",60423,60423,0,0,0,0,60423,60423,0,".","18",0,41096
"10040",139205,"BREWTON-PARKER COLLEGE                                      ","2003-2004",16,"Softball",124188,124188,0,0,0,0,124188,124188,0,".","22",0,24800
"10044",155070,"BARCLAY COLLEGE                                             ","2003-2004",16,"Softball",1850,1850,0,0,0,0,1850,1850,0,".","12",0,1350
"10045",147244,"MILLIKIN UNIVERSITY                                         ","2003-2004",16,"Softball",19050,19050,0,0,0,0,19050,19050,0,".","25",0,12946
"10054",176239,"PEARL RIVER COMMUNITY COLLEGE                               ","2003-2004",16,"Softball",60546,60546,0,0,0,0,60546,60546,0,".","16",0,11149
"10056",228431,"STEPHEN F AUSTIN STATE UNIVERSITY                           ","2003-2004",16,"Softball",239412,239412,0,0,0,0,239412,239412,0,".","23",0,51623
"10058",135391,"MANATEE COMMUNITY COLLEGE                                   ","2003-2004",16,"Softball",103019,103019,0,0,0,0,103019,103019,0,".","23",0,50920
"10060",168148,"TUFTS UNIVERSITY                                            ","2003-2004",17,"Squash",48328,48328,0,24164,24164,0,24164,24164,0,"13","16",7200,7200
"10067",217156,"BROWN UNIVERSITY                                            ","2003-2004",17,"Squash",111535,111535,0,55537,55537,0,55998,55998,0,"10","16",12620,9295
"10072",166027,"HARVARD UNIVERSITY                                          ","2003-2004",17,"Squash",276649,276649,0,145548,145548,0,131101,131101,0,"24","14",44038,36852
"10075",130590,"TRINITY COLLEGE                                             ","2003-2004",17,"Squash",94421,94421,0,48690,48690,0,45731,45731,0,"18","13",8352,11063
"10077",128902,"CONNECTICUT COLLEGE                                         ","2003-2004",17,"Squash",32562,32562,0,17147,17147,0,15415,15415,0,"11","10",10652,8920
"10078",212911,"HAVERFORD COLLEGE                                           ","2003-2004",17,"Squash",9514,9514,0,4757,4757,0,4757,4757,0,"20","18",4618,4618
"10083",161004,"BOWDOIN COLLEGE                                             ","2003-2004",17,"Squash",54087,54087,0,26135,26135,0,27952,27952,0,"11","13",8283,9762
"10115",189705,"CANISIUS COLLEGE                                            ","2003-2004",18,"Swimming and Diving",82641,82641,0,35716,35716,0,46925,46925,0,"18","17",14229,14438
"10116",110714,"UNIVERSITY OF CALIFORNIA-SANTA CRUZ                         ","2003-2004",18,"Swimming and Diving",39164,39164,0,13055,13055,0,26109,26109,0,"27","31",10203,20405
"10118",165015,"BRANDEIS UNIVERSITY                                         ","2003-2004",18,"Swimming and Diving",112890,112890,0,56445,56445,0,56445,56445,0,"20","23",27142,27142
"10124",122436,"UNIVERSITY OF SAN DIEGO                                     ","2003-2004",18,"Swimming and Diving",320584,320584,0,0,0,0,320584,320584,0,".","27",0,42010
"10125",130590,"TRINITY COLLEGE                                             ","2003-2004",18,"Swimming and Diving",79300,79300,0,37596,37596,0,41704,41704,0,"16","30",12640,16740
"10130",129242,"FAIRFIELD UNIVERSITY                                        ","2003-2004",18,"Swimming and Diving",141450,141450,0,66886,66886,0,74564,74564,0,"15","16",20472,21035
"10146",196185,"SUNY COLLEGE AT ONEONTA                                     ","2003-2004",18,"Swimming and Diving",109868,109868,0,54739,54739,0,55129,55129,0,"20","20",12871,13260
"10152",210669,"ALLEGHENY COLLEGE                                           ","2003-2004",18,"Swimming and Diving",96946,96946,0,48473,48473,0,48473,48473,0,"14","18",12367,12367
"10154",166124,"COLLEGE OF THE HOLY CROSS                                   ","2003-2004",18,"Swimming and Diving",218658,218658,0,52015,52015,0,166643,166643,0,"15","23",14157,15230
"10166",168148,"TUFTS UNIVERSITY                                            ","2003-2004",18,"Swimming and Diving",121052,121052,0,59922,59922,0,61130,61130,0,"51","44",13700,14600
"10173",217156,"BROWN UNIVERSITY                                            ","2003-2004",18,"Swimming and Diving",341549,341549,0,166168,166168,0,175381,175381,0,"18","33",25198,40821
"10175",193900,"NEW YORK UNIVERSITY                                         ","2003-2004",18,"Swimming and Diving",161185,161185,0,87489,87489,0,73696,73696,0,"24","28",61420,44710
"10179",196121,"SUNY COLLEGE AT BROCKPORT                                   ","2003-2004",18,"Swimming and Diving",47348,47348,0,23674,23674,0,23674,23674,0,"12","23",8332,8332
"10182",168281,"WHEATON COLLEGE                                             ","2003-2004",18,"Swimming and Diving",93213,93213,0,39892,39892,0,53321,53321,0,"13","21",13767,26052
"10183",123013,"SANTA ROSA JUNIOR COLLEGE                                   ","2003-2004",18,"Swimming and Diving",47330,47330,0,22607,22607,0,24723,24723,0,"16","21",6617,8772
"10185",204024,"MIAMI UNIVERSITY-OXFORD                                     ","2003-2004",18,"Swimming and Diving",830678,830678,0,257305,257305,0,573373,573373,0,"30","52",53596,71048
"10191",193584,"NAZARETH COLLEGE OF ROCHESTER                               ","2003-2004",18,"Swimming and Diving",92617,92617,0,42961,42961,0,49656,49656,0,"15","21",14990,27951
"10194",173258,"CARLETON COLLEGE                                            ","2003-2004",18,"Swimming and Diving",104750,104750,0,52445,52445,0,52305,52305,0,"18","25",15361,14360
"10195",183080,"PLYMOUTH STATE UNIVERSITY                                   ","2003-2004",18,"Swimming and Diving",40798,40798,0,0,0,0,40798,40798,0,".","19",0,15180
"10197",190664,"CUNY QUEENS COLLEGE                                         ","2003-2004",18,"Swimming and Diving",122983,122983,0,49152,49152,0,73831,73831,0,"14","12",1598,13643
"10198",144971,"EUREKA COLLEGE                                              ","2003-2004",18,"Swimming and Diving",8597,8597,0,3047,3047,0,5550,5550,0,"2","9",1769,1769
"10201",128902,"CONNECTICUT COLLEGE                                         ","2003-2004",18,"Swimming and Diving",92002,92002,0,43440,43440,0,48562,48562,0,"10","18",6899,12021
"10208",214689,"PENNSYLVANIA STATE UNIVERSITY-PENN STATE ALTOONA            ","2003-2004",18,"Swimming and Diving",17342,17342,0,8671,8671,0,8671,8671,0,".","17",4306,4307
"10209",186283,"RIDER UNIVERSITY                                            ","2003-2004",18,"Swimming and Diving",490321,490321,0,242539,242539,0,247782,247782,0,"22","22",68038,68038
"10211",187134,"THE COLLEGE OF NEW JERSEY                                   ","2003-2004",18,"Swimming and Diving",155387,155387,0,89924,89924,0,65463,65463,0,"20","28",12172,12395
"10213",122977,"SANTA MONICA COLLEGE                                        ","2003-2004",18,"Swimming and Diving",55097,55097,0,28338,28338,0,26759,26759,0,"15","9",8337,6759
"10218",195003,"ROCHESTER INSTITUTE OF TECHNOLOGY                           ","2003-2004",18,"Swimming and Diving",53312,53312,0,26656,26656,0,26656,26656,0,"25","21",8924,8924
"10221",191533,"HARTWICK COLLEGE                                            ","2003-2004",18,"Swimming and Diving",169082,169082,0,85523,85523,0,83559,83559,0,"20","18",16761,15105
"10226",204185,"MOUNT UNION COLLEGE                                         ","2003-2004",18,"Swimming and Diving",50900,50900,0,25450,25450,0,25450,25450,0,"10","22",9684,9684
"10227",161004,"BOWDOIN COLLEGE                                             ","2003-2004",18,"Swimming and Diving",97911,97911,0,45412,45412,0,52499,52499,0,"14","26",3193,9536
"10229",193973,"NIAGARA UNIVERSITY                                          ","2003-2004",18,"Swimming and Diving",205692,205692,0,101331,101331,0,104361,104361,0,"13","18",16693,17443
"10233",194310,"PACE UNIVERSITY-NEW YORK                                    ","2003-2004",18,"Swimming and Diving",14800,14800,0,6300,6300,0,8500,8500,0,"1","14",250,2500
"10238",167987,"UNIVERSITY OF MASSACHUSETTS-DARTMOUTH                       ","2003-2004",18,"Swimming and Diving",82763,82763,0,36660,36660,0,46103,46103,0,"12","23",12586,21751
"10239",123217,"COLLEGE OF THE SEQUOIAS                                     ","2003-2004",18,"Swimming and Diving",17994,17994,0,7497,7497,0,10497,10497,0,"8","8",1722,4722
"10241",246354,"PALO ALTO COLLEGE                                           ","2003-2004",18,"Swimming and Diving",7021,7021,0,3304,3304,0,3717,3717,0,"8","9",3304,3717
"10245",144050,"UNIVERSITY OF CHICAGO                                       ","2003-2004",18,"Swimming and Diving",158208,158208,0,72511,72511,0,85697,85697,0,"9","13",15465,22566
"10259",203368,"JOHN CARROLL UNIVERSITY                                     ","2003-2004",18,"Swimming and Diving",95414,95414,0,38469,38469,0,56945,56945,0,"14","32",14290,33345
"10262",130493,"SOUTHERN CONNECTICUT STATE UNIVERSITY                       ","2003-2004",18,"Swimming and Diving",139766,139766,0,68011,68011,0,71755,71755,0,"25","16",24363,27325
"10266",110404,"CALIFORNIA INSTITUTE OF TECHNOLOGY                          ","2003-2004",18,"Swimming and Diving",42940,42940,0,21470,21470,0,21470,21470,0,"18","18",7061,7061
"10273",186432,"SAINT PETERS COLLEGE                                        ","2003-2004",18,"Swimming and Diving",151184,151184,0,110762,110762,0,40422,40422,0,"8","9",5247,4795
"10279",174914,"UNIVERSITY OF ST THOMAS                                     ","2003-2004",18,"Swimming and Diving",66206,66206,0,31970,31970,0,34236,34236,0,"11","18",5478,7744
"10283",167358,"NORTHEASTERN UNIVERSITY                                     ","2003-2004",18,"Swimming and Diving",633691,633691,0,0,0,0,633691,633691,0,"0","25",0,32409
"10288",111887,"CERRITOS COLLEGE                                            ","2003-2004",18,"Swimming and Diving",47065,47065,0,21065,21065,0,26000,26000,0,"16","15",3759,4034
"10290",118718,"MERCED COLLEGE                                              ","2003-2004",18,"Swimming and Diving",10202,10202,0,7792,7792,0,2410,2410,0,"20",".",3292,1910
"10308",166027,"HARVARD UNIVERSITY                                          ","2003-2004",18,"Swimming and Diving",569368,569368,0,304617,304617,0,264751,264751,0,"35","32",113022,90048
"10314",117706,"LOS ANGELES PIERCE COLLEGE                                  ","2003-2004",18,"Swimming and Diving",32558,32558,0,12781,12781,0,19777,19777,0,"18","9",4163,4169
"10327",195474,"SIENA COLLEGE                                               ","2003-2004",18,"Swimming and Diving",112534,112534,0,0,0,0,112534,112534,0,".","15",0,25375
"10328",130253,"SACRED HEART UNIVERSITY                                     ","2003-2004",18,"Swimming and Diving",101194,101194,0,0,0,0,101194,101194,0,".","15",0,26663
"10332",121691,"UNIVERSITY OF REDLANDS                                      ","2003-2004",18,"Swimming and Diving",90860,90860,0,45849,45849,0,45011,45011,0,"25","24",9762,8924
"10333",196033,"SUNY COLLEGE OF AGRIC AND TECHN AT COBLESKILL               ","2003-2004",18,"Swimming and Diving",10634,10634,0,5317,5317,0,5317,5317,0,"11","9",3729,3735
"10334",122658,"SAN JOAQUIN DELTA COLLEGE                                   ","2003-2004",18,"Swimming and Diving",31354,31354,0,15775,15775,0,15579,15579,0,"12","11",4685,4489
"10337",150534,"UNIVERSITY OF EVANSVILLE                                    ","2003-2004",18,"Swimming and Diving",434966,434966,0,160092,160092,0,274874,274874,0,"16","21",20404,21414
"10345",120254,"OCCIDENTAL COLLEGE                                          ","2003-2004",18,"Swimming and Diving",112684,112684,0,52682,52682,0,60002,60002,0,"10","18",9411,16731
"10349",156213,"ASBURY COLLEGE                                              ","2003-2004",18,"Swimming and Diving",11001,11001,0,5502,5502,0,5499,5499,0,"4","11",5402,5399
"10356",196291,"SUNY MARITIME COLLEGE                                       ","2003-2004",18,"Swimming and Diving",24875,24875,0,18200,18200,0,6675,6675,0,"25","7",14200,1675
"10361",204909,"OHIO WESLEYAN UNIVERSITY                                    ","2003-2004",18,"Swimming and Diving",89485,89485,0,44742,44742,0,44743,44743,0,"12","21",11521,11522
"10363",115296,"GROSSMONT COLLEGE                                           ","2003-2004",18,"Swimming and Diving",80677,80677,0,46006,46006,0,34671,34671,0,"25","17",12356,12679
"10366",165334,"CLARK UNIVERSITY                                            ","2003-2004",18,"Swimming and Diving",58288,58288,0,15738,15738,0,42550,42550,0,"9","24",4212,11387
"10369",107080,"HENDRIX COLLEGE                                             ","2003-2004",18,"Swimming and Diving",68500,68500,0,34250,34250,0,34250,34250,0,"9","13",8750,8750
"10381",141574,"UNIVERSITY OF HAWAII AT MANOA                               ","2003-2004",18,"Swimming and Diving",878943,878943,0,414361,414361,0,464582,464582,0,"27","28",190200,180726
"10382",157818,"TRANSYLVANIA UNIVERSITY                                     ","2003-2004",18,"Swimming and Diving",131935,131935,0,66659,66659,0,65276,65276,0,"15","25",22317,22303
"10388",107141,"JOHN BROWN UNIVERSITY                                       ","2003-2004",18,"Swimming and Diving",87826,87826,0,45838,45838,0,41988,41988,0,"9","8",12091,12091
"10390",239017,"LAWRENCE UNIVERSITY                                         ","2003-2004",18,"Swimming and Diving",87387,87387,0,42429,42429,0,44958,44958,0,"16","25",14949,17478
"10394",222983,"AUSTIN COLLEGE                                              ","2003-2004",18,"Swimming and Diving",49181,49181,0,22656,22656,0,26525,26525,0,"10","13",10895,14442
"10396",201195,"BALDWIN-WALLACE COLLEGE                                     ","2003-2004",18,"Swimming and Diving",87517,87517,0,43251,43251,0,44266,44266,0,"18","25",20446,21456
"10405",122375,"SAN DIEGO MESA COLLEGE                                      ","2003-2004",18,"Swimming and Diving",24366,24366,0,12184,12184,0,12182,12182,0,"10","20",4772,4770
"10408",170301,"HOPE COLLEGE                                                ","2003-2004",18,"Swimming and Diving",171526,171526,0,103568,103568,0,67958,67958,0,"29","29",12859,12859
"10412",143084,"AUGUSTANA COLLEGE                                           ","2003-2004",18,"Swimming and Diving",27620,27620,0,12421,12421,0,15199,15199,0,"15","20",5257,6735
"10415",127565,"METROPOLITAN STATE COLLEGE OF DENVER                        ","2003-2004",18,"Swimming and Diving",96052,96052,0,49372,49372,0,46680,46680,0,"14","11",17727,18043
"10418",195173,"ST FRANCIS COLLEGE                                          ","2003-2004",18,"Swimming and Diving",140698,140698,0,70077,70077,0,70621,70621,0,"18","16",14425,14424
"10419",126775,"COLORADO SCHOOL OF MINES                                    ","2003-2004",18,"Swimming and Diving",71720,71720,0,39035,39035,0,32685,32685,0,"23","17",11018,11018
"10424",117733,"LOS ANGELES VALLEY COLLEGE                                  ","2003-2004",18,"Swimming and Diving",32924,32924,0,14461,14461,0,18463,18463,0,"20","15",3659,3518
"10426",111920,"CHABOT COLLEGE                                              ","2003-2004",18,"Swimming and Diving",2700,2700,0,1350,1350,0,1350,1350,0,"16","18",2208,2214
"10446",202523,"DENISON UNIVERSITY                                          ","2003-2004",18,"Swimming and Diving",282532,282532,0,141905,141905,0,140627,140627,0,"28","38",65520,64258
"10456",163046,"LOYOLA COLLEGE IN MARYLAND                                  ","2003-2004",18,"Swimming and Diving",197932,197932,0,95236,95236,0,102696,102696,0,"21","30",14203,14203
"10459",145646,"ILLINOIS WESLEYAN UNIVERSITY                                ","2003-2004",18,"Swimming and Diving",67660,67660,0,33077,33077,0,34583,34583,0,"16","19",8094,9600
"10463",202134,"CLEVELAND STATE UNIVERSITY                                  ","2003-2004",18,"Swimming and Diving",483568,483568,0,247781,247781,0,235787,235787,0,"26","17",34468,22835
"10471",216852,"WIDENER UNIVERSITY-MAIN CAMPUS                              ","2003-2004",19,"Swimming",66276,66276,0,33138,33138,0,33138,33138,0,"18","19",11318,11318
"10478",212674,"GETTYSBURG COLLEGE                                          ","2003-2004",19,"Swimming",122094,122094,0,61047,61047,0,61047,61047,0,"21","21",13108,13108
"10480",238333,"BELOIT COLLEGE                                              ","2003-2004",19,"Swimming",16800,16800,0,4090,4090,0,12710,12710,0,"10","31",4090,12710
"10484",193399,"COLLEGE OF MOUNT SAINT VINCENT                              ","2003-2004",19,"Swimming",0,0,0,0,0,0,0,0,0,".","14",0,4000
"10487",213668,"LYCOMING COLLEGE                                            ","2003-2004",19,"Swimming",66547,66547,0,24955,24955,0,41592,41592,0,"18","30",9856,16427
"10490",121044,"PASADENA CITY COLLEGE                                       ","2003-2004",19,"Swimming",52860,52860,0,26430,26430,0,26430,26430,0,"13","11",2500,2500
"10492",150163,"BUTLER UNIVERSITY                                           ","2003-2004",19,"Swimming",126618,126618,0,66664,66664,0,59954,59954,0,"11","12",19760,19760
"10494",186867,"STEVENS INSTITUTE OF TECHNOLOGY                             ","2003-2004",19,"Swimming",103511,103511,0,50865,50865,0,52646,52646,0,"7","11",21256,21561
"10514",163851,"SALISBURY UNIVERSITY                                        ","2003-2004",19,"Swimming",37612,37612,0,18806,18806,0,18806,18806,0,"15","20",7302,7302
"10520",131450,"GALLAUDET UNIVERSITY                                        ","2003-2004",19,"Swimming",15746,15746,0,6221,6221,0,9525,9525,0,"3","8",1951,5275
"10522",122791,"COLLEGE OF SAN MATEO                                        ","2003-2004",19,"Swimming",18530,18530,0,9265,9265,0,9265,9265,0,"6","19",2443,2443
"10528",209612,"PACIFIC UNIVERSITY                                          ","2003-2004",19,"Swimming",14390,14390,0,0,0,0,14390,14390,0,".","12",0,14190
"10529",162760,"HOOD COLLEGE                                                ","2003-2004",19,"Swimming",9801,9801,0,0,0,0,9801,9801,0,".","9",0,3301
"10534",193353,"MOUNT SAINT MARY COLLEGE                                    ","2003-2004",19,"Swimming",19772,19772,0,6688,6688,0,13084,13084,0,"5","11",3840,10054
"10544",115126,"GOLDEN WEST COLLEGE                                         ","2003-2004",19,"Swimming",45115,45115,0,18053,18053,0,27062,27062,0,"19","13",5505,4082
"10549",158477,"CENTENARY COLLEGE OF LOUISIANA                              ","2003-2004",19,"Swimming",169654,169654,0,111428,111428,0,58226,58226,0,"5","7",7913,8547
"10560",196237,"SUNY COLLEGE AT OLD WESTBURY                                ","2003-2004",19,"Swimming",12000,12000,0,6000,6000,0,6000,6000,0,"10","10",3000,3000
"10568",243601,"UNIVERSIDAD DEL TURABO                                      ","2003-2004",19,"Swimming",85247,85247,0,78812,78812,0,6435,6435,0,"12","3",5019,1255
"10573",147244,"MILLIKIN UNIVERSITY                                         ","2003-2004",19,"Swimming",35038,35038,0,18081,18081,0,16957,16957,0,"13","16",11832,9639
"10575",243179,"UNIVERSITY OF PUERTO RICO-HUMACAO                           ","2003-2004",19,"Swimming",13776,13776,0,9230,9230,0,4546,4546,0,"6","6",2672,2672
"10576",156541,"CUMBERLAND COLLEGE                                          ","2003-2004",19,"Swimming",190618,190618,0,141779,141779,0,48839,48839,0,"17","10",29903,4440
"10582",125499,"WEST VALLEY COLLEGE                                         ","2003-2004",19,"Swimming",34393,34393,0,19978,19978,0,14415,14415,0,"14","15",2240,2400
"10586",117247,"LANEY COLLEGE                                               ","2003-2004",19,"Swimming",11483,11483,0,0,0,0,11483,11483,0,".","10",0,11480
"10588",190549,"CUNY BROOKLYN COLLEGE                                       ","2003-2004",19,"Swimming",18664,18664,0,8852,8852,0,9812,9812,0,"11","18",3696,4559
"10594",190600,"CUNY JOHN JAY COLLEGE CRIMINAL JUSTICE                      ","2003-2004",19,"Swimming",41146,41146,0,0,0,0,41146,41146,0,".","20",0,7053
"10598",136950,"ROLLINS COLLEGE                                             ","2003-2004",19,"Swimming",62224,62224,0,31112,31112,0,31112,31112,0,"11","19",16586,16586
"10608",242671,"INTER AMERICAN UNIV OF PUERTO RICO-CENTRAL OFFICE           ","2003-2004",19,"Swimming",2798,2798,0,0,0,0,2798,2798,0,".","2",0,600
"10614",238458,"CARROLL COLLEGE                                             ","2003-2004",19,"Swimming",22176,22176,0,11088,11088,0,11088,11088,0,"6","12",3802,3802
"10615",138691,"DARTON COLLEGE                                              ","2003-2004",19,"Swimming",20338,20338,0,13588,13588,0,6750,6750,0,"6","3",3690,2094
"10624",232706,"MARYMOUNT UNIVERSITY                                        ","2003-2004",19,"Swimming",20777,20777,0,7743,7743,0,13034,13034,0,"10","16",7521,12034
"10625",241100,"AMERICAN UNIVERSITY OF PUERTO RICO                          ","2003-2004",19,"Swimming",77826,77826,0,44804,44804,0,33022,33022,0,"5","4",5347,6567
"10631",146612,"LEWIS UNIVERSITY                                            ","2003-2004",19,"Swimming",209700,209700,0,92609,92609,0,117091,117091,0,"12","15",30259,29476
"10633",173258,"CARLETON COLLEGE                                            ","2003-2004",20,"Synchronized swimming",18499,18499,0,0,0,0,18499,18499,0,".","8",0,10010
"10635",100663,"UNIVERSITY OF ALABAMA AT BIRMINGHAM                         ","2003-2004",20,"Synchronized swimming",211179,211179,0,0,0,0,211179,211179,0,".","11",0,52904
"10636",168281,"WHEATON COLLEGE                                             ","2003-2004",20,"Synchronized swimming",57823,57823,0,0,0,0,57823,57823,0,".","9",0,19131
"10638",189705,"CANISIUS COLLEGE                                            ","2003-2004",20,"Synchronized swimming",84206,84206,0,0,0,0,84206,84206,0,".","18",0,24318
"10641",206437,"WALSH UNIVERSITY                                            ","2003-2004",20,"Synchronized swimming",28036,28036,0,0,0,0,28036,28036,0,".","11",0,13450
"10644",105154,"MESA COMMUNITY COLLEGE                                      ","2003-2004",22,"Tennis",17200,17200,0,8600,8600,0,8600,8600,0,"10","10",4300,4300
"10648",155177,"HESSTON COLLEGE                                             ","2003-2004",22,"Tennis",11712,11712,0,5856,5856,0,5856,5856,0,"8","4",856,856
"10651",163046,"LOYOLA COLLEGE IN MARYLAND                                  ","2003-2004",22,"Tennis",102728,102728,0,18357,18357,0,84371,84371,0,"9","12",8005,15764
"10655",204024,"MIAMI UNIVERSITY-OXFORD                                     ","2003-2004",22,"Tennis",319810,319810,0,0,0,0,319810,319810,0,".","13",0,54374
"10677",191126,"FASHION INSTITUTE OF TECHNOLOGY                             ","2003-2004",22,"Tennis",32745,32745,0,14545,14545,0,18200,18200,0,"6","12",11720,15375
"10679",139144,"BERRY COLLEGE                                               ","2003-2004",22,"Tennis",267766,267766,0,133883,133883,0,133883,133883,0,"8","12",24485,24485
"10681",104717,"GRAND CANYON UNIVERSITY                                     ","2003-2004",22,"Tennis",124245,124245,0,0,0,0,124245,124245,0,".","6",0,24825
"10682",107512,"OUACHITA BAPTIST UNIVERSITY                                 ","2003-2004",22,"Tennis",286249,286249,0,174518,174518,0,111731,111731,0,"8","8",39473,18337
"10683",146603,"LEWIS AND CLARK COMMUNITY COLLEGE                           ","2003-2004",22,"Tennis",18633,18633,0,10685,10685,0,7948,7948,0,"9","8",5685,4948
"10684",239017,"LAWRENCE UNIVERSITY                                         ","2003-2004",22,"Tennis",14390,14390,0,7975,7975,0,6415,6415,0,"14","14",4975,3415
"10687",192819,"MARIST COLLEGE                                              ","2003-2004",22,"Tennis",192411,192411,0,102532,102532,0,89879,89879,0,"10","10",38035,24331
"10691",212911,"HAVERFORD COLLEGE                                           ","2003-2004",22,"Tennis",23559,23559,0,7778,7778,0,15781,15781,0,"16","11",7252,14877
"10698",190664,"CUNY QUEENS COLLEGE                                         ","2003-2004",22,"Tennis",83641,83641,0,47248,47248,0,36393,36393,0,"9","9",7894,2648
"10701",193016,"MERCY COLLEGE-MAIN CAMPUS                                   ","2003-2004",22,"Tennis",7500,7500,0,7500,7500,0,0,0,0,"6","0",3000,0
"10703",210669,"ALLEGHENY COLLEGE                                           ","2003-2004",22,"Tennis",54966,54966,0,27587,27587,0,27379,27379,0,"9","10",7094,6886
"10704",128902,"CONNECTICUT COLLEGE                                         ","2003-2004",22,"Tennis",68343,68343,0,31683,31683,0,36660,36660,0,"9","8",7580,12557
"10706",140872,"REINHARDT COLLEGE                                           ","2003-2004",22,"Tennis",46199,46199,0,31610,31610,0,14589,14589,0,"6","6",668,681
"10707",129774,"MITCHELL COLLEGE                                            ","2003-2004",22,"Tennis",6812,6812,0,3406,3406,0,3406,3406,0,"4","3",1276,956
"10709",238333,"BELOIT COLLEGE                                              ","2003-2004",22,"Tennis",11358,11358,0,5778,5778,0,5580,5580,0,"9","10",5778,5580
"10719",193399,"COLLEGE OF MOUNT SAINT VINCENT                              ","2003-2004",22,"Tennis",0,0,0,0,0,0,0,0,0,"9","8",3500,3500
"10726",190770,"DOWLING COLLEGE                                             ","2003-2004",22,"Tennis",164274,164274,0,74256,74256,0,90018,90018,0,"7","6",13777,5308
"10731",150163,"BUTLER UNIVERSITY                                           ","2003-2004",22,"Tennis",240978,240978,0,117537,117537,0,123441,123441,0,"9","9",19381,17652
"10737",218724,"COASTAL CAROLINA UNIVERSITY                                 ","2003-2004",22,"Tennis",253563,253563,0,111808,111808,0,141755,141755,0,"8","8",18255,24982
"10744",126669,"COLORADO CHRISTIAN UNIVERSITY                               ","2003-2004",22,"Tennis",57646,57646,0,37198,37198,0,20448,20448,0,"7","7",4886,4886
"10746",190840,"DUTCHESS COMMUNITY COLLEGE                                  ","2003-2004",22,"Tennis",6000,6000,0,3000,3000,0,3000,3000,0,"8","8",1000,1000
"10749",216852,"WIDENER UNIVERSITY-MAIN CAMPUS                              ","2003-2004",22,"Tennis",15520,15520,0,6695,6695,0,8825,8825,0,"7","8",3365,3922
"10750",233912,"VIRGINIA INTERMONT COLLEGE                                  ","2003-2004",22,"Tennis",14200,14200,0,7100,7100,0,7100,7100,0,"10","7",6000,6000
"10752",204909,"OHIO WESLEYAN UNIVERSITY                                    ","2003-2004",22,"Tennis",35120,35120,0,17199,17199,0,17921,17921,0,"10","12",9483,10541
"10764",141361,"YOUNG HARRIS COLLEGE                                        ","2003-2004",22,"Tennis",64682,64682,0,0,0,0,64682,64682,0,".","10",0,15433
"10765",130590,"TRINITY COLLEGE                                             ","2003-2004",22,"Tennis",100010,100010,0,52469,52469,0,47541,47541,0,"14","10",2800,11370
"10771",229355,"TYLER JUNIOR COLLEGE                                        ","2003-2004",22,"Tennis",183952,183952,0,91976,91976,0,91976,91976,0,"10","9",36830,36831
"10774",167729,"SALEM STATE COLLEGE                                         ","2003-2004",22,"Tennis",21403,21403,0,10122,10122,0,11281,11281,0,"7","9",5922,6081
"10777",136400,"PASCO-HERNANDO COMMUNITY COLLEGE                            ","2003-2004",22,"Tennis",39762,39762,0,0,0,0,39762,39762,0,".","9",0,4580
"10778",243577,"UNIVERSIDAD POLITECNICA DE PUERTO RICO                      ","2003-2004",22,"Tennis",4000,4000,0,2000,2000,0,2000,2000,0,"5","5",400,400
"10779",129242,"FAIRFIELD UNIVERSITY                                        ","2003-2004",22,"Tennis",153852,153852,0,80138,80138,0,73714,73714,0,"10","12",19920,19022
"10787",240338,"WISCONSIN LUTHERAN COLLEGE                                  ","2003-2004",22,"Tennis",10660,10660,0,0,0,0,10660,10660,0,".","12",0,4120
"10792",214704,"PENNSYLVANIA STATE UNIVERSITY-PENN STATE BERKS              ","2003-2004",22,"Tennis",15643,15643,0,9000,9000,0,6643,6643,0,"9","6",5800,3263
"10799",177418,"FONTBONNE UNIVERSITY                                        ","2003-2004",22,"Tennis",5781,5781,0,3353,3353,0,2428,2428,0,"9","9",947,947
"10811",123527,"SAN BERNARDINO VALLEY COLLEGE                               ","2003-2004",22,"Tennis",7746,7746,0,7746,7746,0,0,0,0,"9",".",5396,0
"10815",232609,"LYNCHBURG COLLEGE                                           ","2003-2004",22,"Tennis",29371,29371,0,14472,14472,0,14899,14899,0,"8","9",4372,5403
"10825",183910,"CALDWELL COLLEGE                                            ","2003-2004",22,"Tennis",34218,34218,0,20982,20982,0,13236,13236,0,"6","7",505,625
"10842",237950,"WEST VIRGINIA UNIVERSITY INSTITUTE OF TECHNOLOGY            ","2003-2004",22,"Tennis",4811,4811,0,2794,2794,0,2017,2017,0,"6","7",901,1342
"10846",181020,"DOANE COLLEGE                                               ","2003-2004",22,"Tennis",7454,7454,0,3727,3727,0,3727,3727,0,"6","4",1816,1816
"10848",185572,"MONMOUTH UNIVERSITY                                         ","2003-2004",22,"Tennis",95059,95059,0,40963,40963,0,54096,54096,0,"8","9",11439,7463
"10851",119067,"MONTEREY PENINSULA COLLEGE                                  ","2003-2004",22,"Tennis",13103,13103,0,0,0,0,13103,13103,0,".","7",0,4655
"10853",366252,"PENNSYLVANIA COLLEGE OF TECHNOLOGY                          ","2003-2004",22,"Tennis",4916,4916,0,3440,3440,0,1476,1476,0,"10",".",2210,0
"10861",199643,"SHAW UNIVERSITY                                             ","2003-2004",22,"Tennis",188339,188339,0,97908,97908,0,90431,90431,0,"5","6",17241,16823
"10863",213826,"MARYWOOD UNIVERSITY                                         ","2003-2004",22,"Tennis",38415,38415,0,14304,14304,0,24111,24111,0,"9","12",5788,11664
"10866",203368,"JOHN CARROLL UNIVERSITY                                     ","2003-2004",22,"Tennis",17668,17668,0,8848,8848,0,8820,8820,0,"10","11",3383,3665
"10867",366395,"SUFFOLK COUNTY COMMUNITY COLLEGE                            ","2003-2004",22,"Tennis",13646,13646,0,6823,6823,0,6823,6823,0,"6","7",4248,4248
"10871",121044,"PASADENA CITY COLLEGE                                       ","2003-2004",22,"Tennis",31716,31716,0,0,0,0,31716,31716,0,".","8",0,2000
"10873",123554,"SAINT MARYS COLLEGE OF CALIFORNIA                           ","2003-2004",22,"Tennis",307016,307016,0,143017,143017,0,163999,163999,0,"10","9",19376,15290
"10883",183080,"PLYMOUTH STATE UNIVERSITY                                   ","2003-2004",22,"Tennis",12929,12929,0,0,0,0,12929,12929,0,".","14",0,5316
"10891",150677,"GRACE COLLEGE AND THEOLOGICAL SEMINARY                      ","2003-2004",22,"Tennis",87312,87312,0,46288,46288,0,41024,41024,0,"12","16",12923,4280
"10892",156541,"CUMBERLAND COLLEGE                                          ","2003-2004",22,"Tennis",96920,96920,0,67957,67957,0,28963,28963,0,"8","6",13296,3624
"10900",165015,"BRANDEIS UNIVERSITY                                         ","2003-2004",22,"Tennis",81102,81102,0,40551,40551,0,40551,40551,0,"12","13",15926,15926
"10901",122977,"SANTA MONICA COLLEGE                                        ","2003-2004",22,"Tennis",20439,20439,0,0,0,0,20439,20439,0,".","8",0,4438
"10904",217156,"BROWN UNIVERSITY                                            ","2003-2004",22,"Tennis",258714,258714,0,139623,139623,0,119091,119091,0,"10","9",42382,31291
"10912",240471,"UNIVERSITY OF WISCONSIN-RIVER FALLS                         ","2003-2004",22,"Tennis",13400,13400,0,0,0,0,13400,13400,0,".","12",0,5739
"10916",218061,"FRANCIS MARION UNIVERSITY                                   ","2003-2004",22,"Tennis",133167,133167,0,80278,80278,0,52889,52889,0,"13","8",9411,8468
"10918",157058,"KENTUCKY STATE UNIVERSITY                                   ","2003-2004",22,"Tennis",20700,20700,0,10350,10350,0,10350,10350,0,"5","5",5000,5000
"10921",122436,"UNIVERSITY OF SAN DIEGO                                     ","2003-2004",22,"Tennis",686026,686026,0,291465,291465,0,394561,394561,0,"10","8",50738,61821
"10923",183743,"BERGEN COMMUNITY COLLEGE                                    ","2003-2004",22,"Tennis",6775,6775,0,6775,6775,0,0,0,0,"10",".",5000,0
"10924",196185,"SUNY COLLEGE AT ONEONTA                                     ","2003-2004",22,"Tennis",61356,61356,0,32239,32239,0,29117,29117,0,"12","12",10012,6891
"10928",189547,"BROOME COMMUNITY COLLEGE                                    ","2003-2004",22,"Tennis",22423,22423,0,6388,6388,0,16035,16035,0,"10","10",3080,13058
"10930",213598,"LINCOLN UNIVERSITY                                          ","2003-2004",22,"Tennis",7400,7400,0,3700,3700,0,3700,3700,0,"12","12",2000,3400
"10934",175856,"JACKSON STATE UNIVERSITY                                    ","2003-2004",22,"Tennis",171392,171392,0,91350,91350,0,80042,80042,0,"7","6",18946,17370
"10950",243179,"UNIVERSITY OF PUERTO RICO-HUMACAO                           ","2003-2004",22,"Tennis",3000,3000,0,0,0,0,3000,3000,0,".","4",0,705
"10951",125091,"VICTOR VALLEY COLLEGE                                       ","2003-2004",22,"Tennis",36749,36749,0,19169,19169,0,17580,17580,0,"9","8",6013,4978
"10953",191533,"HARTWICK COLLEGE                                            ","2003-2004",22,"Tennis",38977,38977,0,15530,15530,0,23447,23447,0,"12","17",5999,5185
"10959",212878,"HARRISBURG AREA COMMUNITY COLLEGE-HARRISBURG                ","2003-2004",22,"Tennis",4878,4878,0,2710,2710,0,2168,2168,0,"5","4",1265,1012
"10967",168148,"TUFTS UNIVERSITY                                            ","2003-2004",22,"Tennis",65188,65188,0,31294,31294,0,33894,33894,0,"15","33",6900,9500
"10973",196121,"SUNY COLLEGE AT BROCKPORT                                   ","2003-2004",22,"Tennis",6478,6478,0,0,0,0,6478,6478,0,".","12",0,4947
"10975",141167,"THOMAS UNIVERSITY                                           ","2003-2004",22,"Tennis",15776,15776,0,0,0,0,15776,15776,0,".","7",0,9725
"10983",212674,"GETTYSBURG COLLEGE                                          ","2003-2004",22,"Tennis",21679,21679,0,10560,10560,0,11119,11119,0,"11","13",2301,2532
"10989",111920,"CHABOT COLLEGE                                              ","2003-2004",22,"Tennis",2200,2200,0,1100,1100,0,1100,1100,0,"8","11",3200,3201
"10990",190600,"CUNY JOHN JAY COLLEGE CRIMINAL JUSTICE                      ","2003-2004",22,"Tennis",28234,28234,0,17122,17122,0,11112,11112,0,"8","6",10422,5092
"11008",207847,"SOUTHEASTERN OKLAHOMA STATE UNIVERSITY                      ","2003-2004",22,"Tennis",101628,101628,0,54331,54331,0,47297,47297,0,"9","9",5886,6107
"11010",174914,"UNIVERSITY OF ST THOMAS                                     ","2003-2004",22,"Tennis",46321,46321,0,23862,23862,0,22459,22459,0,"13","12",8804,8215
"11015",213996,"MESSIAH COLLEGE                                             ","2003-2004",22,"Tennis",25022,25022,0,12571,12571,0,12451,12451,0,"9","10",7686,7566
"11017",164447,"AMERICAN INTERNATIONAL COLLEGE                              ","2003-2004",22,"Tennis",17400,17400,0,8650,8650,0,8750,8750,0,"8","16",4900,4900
"11018",110714,"UNIVERSITY OF CALIFORNIA-SANTA CRUZ                         ","2003-2004",22,"Tennis",49094,49094,0,29310,29310,0,19784,19784,0,"16","9",26848,18593
"11019",157535,"PIKEVILLE COLLEGE                                           ","2003-2004",22,"Tennis",23309,23309,0,12949,12949,0,10360,10360,0,"10","8",7957,6366
"11020",214689,"PENNSYLVANIA STATE UNIVERSITY-PENN STATE ALTOONA            ","2003-2004",22,"Tennis",16660,16660,0,9730,9730,0,6930,6930,0,"14","7",3966,2074
"11025",204264,"MUSKINGUM COLLEGE                                           ","2003-2004",22,"Tennis",7009,7009,0,3806,3806,0,3203,3203,0,"14","12",3801,3127
"11040",136950,"ROLLINS COLLEGE                                             ","2003-2004",22,"Tennis",468856,468856,0,224151,224151,0,244705,244705,0,"18","9",27537,22681
"11042",117706,"LOS ANGELES PIERCE COLLEGE                                  ","2003-2004",22,"Tennis",32063,32063,0,32063,32063,0,0,0,0,"12",".",6139,0
"11049",209612,"PACIFIC UNIVERSITY                                          ","2003-2004",22,"Tennis",25333,25333,0,12422,12422,0,12911,12911,0,"8","9",5395,5876
"11051",178624,"NORTHWEST MISSOURI STATE UNIVERSITY                         ","2003-2004",22,"Tennis",156155,156155,0,81662,81662,0,74493,74493,0,"9","7",9954,9954
"11052",165334,"CLARK UNIVERSITY                                            ","2003-2004",22,"Tennis",19284,19284,0,8971,8971,0,10313,10313,0,"13","14",1801,2909
"11060",166124,"COLLEGE OF THE HOLY CROSS                                   ","2003-2004",22,"Tennis",60009,60009,0,12733,12733,0,47276,47276,0,"10","10",4804,6485
"11062",139904,"GEORGIA MILITARY COLLEGE-MAIN CAMPUS                        ","2003-2004",22,"Tennis",2384,2384,0,0,0,0,2384,2384,0,".","6",0,563
"11064",206862,"SOUTHERN NAZARENE UNIVERSITY                                ","2003-2004",22,"Tennis",73982,73982,0,0,0,0,73982,73982,0,".","7",0,15207
"11074",105747,"SCOTTSDALE COMMUNITY COLLEGE                                ","2003-2004",22,"Tennis",16454,16454,0,8227,8227,0,8227,8227,0,"7","10",3200,3200
"11077",156213,"ASBURY COLLEGE                                              ","2003-2004",22,"Tennis",8336,8336,0,4632,4632,0,3704,3704,0,"12","10",4533,3702
"11079",193973,"NIAGARA UNIVERSITY                                          ","2003-2004",22,"Tennis",151713,151713,0,68526,68526,0,83187,83187,0,"8","12",16828,19264
"11080",175810,"HOLMES COMMUNITY COLLEGE                                    ","2003-2004",22,"Tennis",15378,15378,0,7689,7689,0,7689,7689,0,"3","6",3277,3277
"11082",162283,"COPPIN STATE COLLEGE                                        ","2003-2004",22,"Tennis",149066,149066,0,64374,64374,0,84692,84692,0,"9","7",13569,14271
"11085",158477,"CENTENARY COLLEGE OF LOUISIANA                              ","2003-2004",22,"Tennis",197334,197334,0,65925,65925,0,131409,131409,0,"11","8",11456,27421
"11093",192439,"LONG ISLAND UNIVERSITY-BROOKLYN CAMPUS                      ","2003-2004",22,"Tennis",223263,223263,0,0,0,0,223263,223263,0,".","8",0,33222
"11095",130253,"SACRED HEART UNIVERSITY                                     ","2003-2004",22,"Tennis",109677,109677,0,38533,38533,0,71144,71144,0,"12","8",11968,14540
"11096",214801,"PENNSYLVANIA STATE UNIVERSITY-PENN STATE ABINGTON           ","2003-2004",22,"Tennis",6554,6554,0,4096,4096,0,2458,2458,0,"8",".",1345,806
"11108",101709,"UNIVERSITY OF MONTEVALLO                                    ","2003-2004",22,"Tennis",32729,32729,0,0,0,0,32729,32729,0,".","9",0,14234
"11115",211291,"BUCKNELL UNIVERSITY                                         ","2003-2004",22,"Tennis",244480,244480,0,86894,86894,0,157586,157586,0,"10","12",25360,28519
"11116",139311,"CLAYTON COLLEGE AND STATE UNIVERSITY                        ","2003-2004",22,"Tennis",109803,109803,0,0,0,0,109803,109803,0,".","7",0,84481
"11126",146612,"LEWIS UNIVERSITY                                            ","2003-2004",22,"Tennis",91159,91159,0,38510,38510,0,52649,52649,0,"8","11",6185,8024
"11136",159568,"LOUISIANA COLLEGE                                           ","2003-2004",22,"Tennis",8862,8862,0,0,0,0,8862,8862,0,".","8",0,4909
"11138",220978,"MIDDLE TENNESSEE STATE UNIVERSITY                           ","2003-2004",22,"Tennis",474445,474445,0,223446,223446,0,250999,250999,0,"8","6",48734,41364
"11146",215114,"PHILADELPHIA BIBLICAL UNIVERSITY-LANGHORNE                  ","2003-2004",22,"Tennis",7135,7135,0,3465,3465,0,3670,3670,0,"8","8",1265,1470
"11148",143288,"BLACKBURN COLLEGE                                           ","2003-2004",22,"Tennis",9715,9715,0,0,0,0,9715,9715,0,".","9",0,2326
"11149",237899,"WEST VIRGINIA STATE COLLEGE                                 ","2003-2004",22,"Tennis",32771,32771,0,9137,9137,0,23634,23634,0,"9","11",2453,12146
"11152",234173,"VIRGINIA WESLEYAN COLLEGE                                   ","2003-2004",22,"Tennis",16832,16832,0,8416,8416,0,8416,8416,0,"9","9",5666,5629
"11156",129525,"UNIVERSITY OF HARTFORD                                      ","2003-2004",22,"Tennis",201307,201307,0,99917,99917,0,101390,101390,0,"8","9",8584,10816
"11159",147800,"OAKTON COMMUNITY COLLEGE                                    ","2003-2004",22,"Tennis",3640,3640,0,1858,1858,0,1782,1782,0,"7","3",1857,1781
"11160",215798,"SAINT VINCENT COLLEGE                                       ","2003-2004",22,"Tennis",47775,47775,0,21412,21412,0,26363,26363,0,"11","12",14669,15063
"11161",113096,"COSUMNES RIVER COLLEGE                                      ","2003-2004",22,"Tennis",5799,5799,0,3188,3188,0,2611,2611,0,"1","4",3113,2536
"11167",141644,"HAWAII PACIFIC UNIVERSITY                                   ","2003-2004",22,"Tennis",273426,273426,0,125718,125718,0,147708,147708,0,"7","7",21724,25693
"11172",243665,"UNIVERSITY OF THE VIRGIN ISLANDS                            ","2003-2004",22,"Tennis",13000,13000,0,5000,5000,0,8000,8000,0,"4","4",3000,3000
"11175",193283,"MOHAWK VALLEY COMMUNITY COLLEGE-UTICA BRANCH                ","2003-2004",22,"Tennis",12851,12851,0,7554,7554,0,5297,5297,0,"9","7",1251,1169
"11176",156082,"WASHBURN UNIVERSITY OF TOPEKA                               ","2003-2004",22,"Tennis",23299,23299,0,11062,11062,0,12237,12237,0,"7","8",10369,11024
"11182",162760,"HOOD COLLEGE                                                ","2003-2004",22,"Tennis",17255,17255,0,8131,8131,0,9124,9124,0,"7","12",3131,4124
"11186",218539,"PRESBYTERIAN COLLEGE                                        ","2003-2004",22,"Tennis",242208,242208,0,121174,121174,0,121034,121034,0,"7","12",15669,13199
"11189",205443,"SHAWNEE STATE UNIVERSITY                                    ","2003-2004",22,"Tennis",24381,24381,0,0,0,0,24381,24381,0,".","14",0,12101
"11190",196200,"SUNY-POTSDAM                                                ","2003-2004",22,"Tennis",15150,15150,0,0,0,0,15150,15150,0,".","9",0,4029
"11195",156189,"ALICE LLOYD COLLEGE                                         ","2003-2004",22,"Tennis",4500,4500,0,2250,2250,0,2250,2250,0,"6","7",1500,1500
"11200",166027,"HARVARD UNIVERSITY                                          ","2003-2004",22,"Tennis",525433,525433,0,300167,300167,0,225266,225266,0,"16","11",120853,84827
"11202",186283,"RIDER UNIVERSITY                                            ","2003-2004",22,"Tennis",110037,110037,0,51387,51387,0,58650,58650,0,"12","10",6385,5320
"11203",213668,"LYCOMING COLLEGE                                            ","2003-2004",22,"Tennis",11516,11516,0,7223,7223,0,4293,4293,0,"9","11",3777,3219
"11208",232025,"EMORY AND HENRY COLLEGE                                     ","2003-2004",22,"Tennis",56157,56157,0,15819,15819,0,40338,40338,0,"10","9",7759,7309
"11209",183026,"SOUTHERN NEW HAMPSHIRE UNIVERSITY                           ","2003-2004",22,"Tennis",59535,59535,0,34847,34847,0,24688,24688,0,"11","9",9419,10714
"11212",148335,"ROBERT MORRIS COLLEGE                                       ","2003-2004",22,"Tennis",67528,67528,0,0,0,0,67528,67528,0,".","7",0,5148
"11213",200217,"UNIVERSITY OF MARY                                          ","2003-2004",22,"Tennis",53782,53782,0,26891,26891,0,26891,26891,0,"8","11",7208,7208
"11216",232043,"EASTERN MENNONITE UNIVERSITY                                ","2003-2004",22,"Tennis",24997,24997,0,12779,12779,0,12218,12218,0,"6","8",1,1
"11217",165671,"EMMANUEL COLLEGE                                            ","2003-2004",22,"Tennis",13630,13630,0,0,0,0,13630,13630,0,".","8",0,4727
"11223",198756,"JOHNSON C SMITH UNIVERSITY                                  ","2003-2004",22,"Tennis",86593,86593,0,34843,34843,0,51750,51750,0,"8","6",11011,8550
"11227",202523,"DENISON UNIVERSITY                                          ","2003-2004",22,"Tennis",113693,113693,0,47361,47361,0,66332,66332,0,"13","12",17329,38184
"11233",212832,"GWYNEDD MERCY COLLEGE                                       ","2003-2004",22,"Tennis",18484,18484,0,9242,9242,0,9242,9242,0,"8","12",4242,4242
"11240",177339,"EVANGEL UNIVERSITY                                          ","2003-2004",22,"Tennis",54320,54320,0,0,0,0,54320,54320,0,".","9",0,13220
"11253",150668,"GOSHEN COLLEGE                                              ","2003-2004",22,"Tennis",40361,40361,0,17679,17679,0,22682,22682,0,"8","7",4554,3732
"11263",176354,"SOUTHWEST MISSISSIPPI COMMUNITY COLLEGE                     ","2003-2004",22,"Tennis",26797,26797,0,17865,17865,0,8932,8932,0,"4","2",1028,514
"11266",221953,"TUSCULUM COLLEGE                                            ","2003-2004",22,"Tennis",131988,131988,0,67435,67435,0,64553,64553,0,"11","9",9937,9525
"11267",168281,"WHEATON COLLEGE                                             ","2003-2004",22,"Tennis",100982,100982,0,53208,53208,0,47774,47774,0,"14","13",16415,11264
"11269",154952,"COWLEY COUNTY COMMUNITY COLLEGE                             ","2003-2004",22,"Tennis",81487,81487,0,54305,54305,0,27182,27182,0,"8","8",11165,5186
"11270",215947,"SETON HILL UNIVERSITY                                       ","2003-2004",22,"Tennis",70000,70000,0,35000,35000,0,35000,35000,0,"10","10",7000,7000
"11271",190655,"CUNY NEW YORK CITY COLLEGE OF TECHNOLOGY                    ","2003-2004",22,"Tennis",8201,8201,0,3655,3655,0,4546,4546,0,"6","9",3654,4545
"11272",106467,"ARKANSAS TECH UNIVERSITY                                    ","2003-2004",22,"Tennis",75821,75821,0,0,0,0,75821,75821,0,".","6",0,8984
"11281",155195,"HUTCHINSON COMMUNITY COLLEGE                                ","2003-2004",22,"Tennis",24802,24802,0,12405,12405,0,12397,12397,0,"6","6",1733,1208
"11282",174491,"NORTHWESTERN COLLEGE                                        ","2003-2004",22,"Tennis",8271,8271,0,4283,4283,0,3988,3988,0,"7","7",1753,1461
"11283",243601,"UNIVERSIDAD DEL TURABO                                      ","2003-2004",22,"Tennis",14574,14574,0,14574,14574,0,0,0,0,"5",".",688,0
"11291",133492,"ECKERD COLLEGE                                              ","2003-2004",22,"Tennis",65435,65435,0,37592,37592,0,27843,27843,0,"10","8",16564,10419
"11292",101879,"UNIVERSITY OF NORTH ALABAMA                                 ","2003-2004",22,"Tennis",143126,143126,0,70735,70735,0,72391,72391,0,"7","7",9149,9149
"11296",162706,"HARFORD COMMUNITY COLLEGE                                   ","2003-2004",22,"Tennis",10038,10038,0,4493,4493,0,5545,5545,0,"8","7",1259,860
"11302",214768,"PENNSYLVANIA STATE UNIVERSITY-PENN STATE HAZLETON           ","2003-2004",22,"Tennis",4000,4000,0,2000,2000,0,2000,2000,0,"8","4",850,850
"11305",144050,"UNIVERSITY OF CHICAGO                                       ","2003-2004",22,"Tennis",79398,79398,0,39899,39899,0,39499,39499,0,"12","13",12583,12183
"11306",155414,"KANSAS WESLEYAN UNIVERSITY                                  ","2003-2004",22,"Tennis",18962,18962,0,9481,9481,0,9481,9481,0,"7","7",3093,3093
"11310",166133,"HOLYOKE COMMUNITY COLLEGE                                   ","2003-2004",22,"Tennis",4000,4000,0,2000,2000,0,2000,2000,0,".","7",400,400
"11312",185509,"MERCER COUNTY COMMUNITY COLLEGE                             ","2003-2004",22,"Tennis",14000,14000,0,7000,7000,0,7000,7000,0,"8","8",7000,7000
"11321",106485,"UNIVERSITY OF ARKANSAS AT MONTICELLO                        ","2003-2004",22,"Tennis",7026,7026,0,0,0,0,7026,7026,0,".","7",0,4296
"11322",197045,"UTICA COLLEGE                                               ","2003-2004",22,"Tennis",15550,15550,0,6300,6300,0,9250,9250,0,"10","12",2150,4900
"11323",165662,"EMERSON COLLEGE                                             ","2003-2004",22,"Tennis",20521,20521,0,10722,10722,0,9799,9799,0,"9","7",1835,1499
"11329",167288,"MASSACHUSETTS COLLEGE OF LIBERAL ARTS                       ","2003-2004",22,"Tennis",5518,5518,0,0,0,0,5518,5518,0,".","7",0,1518
"11332",154493,"UPPER IOWA UNIVERSITY                                       ","2003-2004",22,"Tennis",76187,76187,0,58876,58876,0,17311,17311,0,"7","6",12464,6675
"11334",154235,"SAINT AMBROSE UNIVERSITY                                    ","2003-2004",22,"Tennis",62054,62054,0,30570,30570,0,31484,31484,0,"7","10",6816,6030
"11335",214272,"NEUMANN COLLEGE                                             ","2003-2004",22,"Tennis",22098,22098,0,11049,11049,0,11049,11049,0,"7","10",3250,3250
"11338",137476,"SAINT THOMAS UNIVERSITY                                     ","2003-2004",22,"Tennis",106620,106620,0,53310,53310,0,53310,53310,0,"10","6",8000,8000
"11344",151786,"MARIAN COLLEGE                                              ","2003-2004",22,"Tennis",90453,90453,0,40026,40026,0,50427,50427,0,"9","12",1473,1474
"11345",115296,"GROSSMONT COLLEGE                                           ","2003-2004",22,"Tennis",21870,21870,0,11283,11283,0,10587,10587,0,"8","11",7283,6587
"11357",145691,"ILLINOIS COLLEGE                                            ","2003-2004",22,"Tennis",19307,19307,0,9304,9304,0,10003,10003,0,"10","13",6304,7003
"11360",186867,"STEVENS INSTITUTE OF TECHNOLOGY                             ","2003-2004",22,"Tennis",95140,95140,0,47492,47492,0,47648,47648,0,"12","10",20044,20207
"11368",148584,"UNIVERSITY OF ST FRANCIS                                    ","2003-2004",22,"Tennis",66631,66631,0,35680,35680,0,30951,30951,0,"6","5",7580,4951
"11376",195474,"SIENA COLLEGE                                               ","2003-2004",22,"Tennis",117333,117333,0,45657,45657,0,71676,71676,0,"12","12",26557,19897
"11383",116439,"IRVINE VALLEY COLLEGE                                       ","2003-2004",22,"Tennis",29890,29890,0,14935,14935,0,14955,14955,0,"9","9",4805,4825
"11389",187134,"THE COLLEGE OF NEW JERSEY                                   ","2003-2004",22,"Tennis",85546,85546,0,42773,42773,0,42773,42773,0,"10","10",12092,12092
"11391",148672,"SAUK VALLEY COMMUNITY COLLEGE                               ","2003-2004",22,"Tennis",34463,34463,0,14294,14294,0,20169,20169,0,"7","6",3084,6673
"11392",175883,"JONES COUNTY JUNIOR COLLEGE                                 ","2003-2004",22,"Tennis",42130,42130,0,20309,20309,0,21821,21821,0,"9","9",3660,3660
"11393",155900,"SOUTHWESTERN COLLEGE                                        ","2003-2004",22,"Tennis",16232,16232,0,8110,8110,0,8122,8122,0,"8","8",4239,4188
"11395",195003,"ROCHESTER INSTITUTE OF TECHNOLOGY                           ","2003-2004",22,"Tennis",49630,49630,0,24815,24815,0,24815,24815,0,"12","17",12090,12090
"11406",161004,"BOWDOIN COLLEGE                                             ","2003-2004",22,"Tennis",117439,117439,0,61429,61429,0,56010,56010,0,"10","10",10833,15254
"11414",167987,"UNIVERSITY OF MASSACHUSETTS-DARTMOUTH                       ","2003-2004",22,"Tennis",18835,18835,0,8563,8563,0,10272,10272,0,"11","12",2810,4969
"11415",100760,"CENTRAL ALABAMA COMMUNITY COLLEGE                           ","2003-2004",22,"Tennis",38349,38349,0,19542,19542,0,18807,18807,0,"8","8",8016,7864
"11417",157818,"TRANSYLVANIA UNIVERSITY                                     ","2003-2004",22,"Tennis",46149,46149,0,20360,20360,0,25789,25789,0,"13","14",6484,13235
"11436",210775,"ALVERNIA COLLEGE                                            ","2003-2004",22,"Tennis",12950,12950,0,6190,6190,0,6760,6760,0,"8","7",1872,2442
"11449",173258,"CARLETON COLLEGE                                            ","2003-2004",22,"Tennis",67638,67638,0,21683,21683,0,45955,45955,0,"9","11",7052,14918
"11451",190619,"CUNY KINGSBOROUGH COMMUNITY COLLEGE                         ","2003-2004",22,"Tennis",14486,14486,0,7243,7243,0,7243,7243,0,"10","10",4522,4522
"11453",160904,"XAVIER UNIVERSITY OF LOUISIANA                              ","2003-2004",22,"Tennis",266059,266059,0,133377,133377,0,132682,132682,0,"7","6",17420,17420
"11455",186432,"SAINT PETERS COLLEGE                                        ","2003-2004",22,"Tennis",122137,122137,0,69608,69608,0,52529,52529,0,"8","10",8418,5162
"11459",193353,"MOUNT SAINT MARY COLLEGE                                    ","2003-2004",22,"Tennis",10830,10830,0,3589,3589,0,7241,7241,0,"8","12",2488,5352
"11464",133553,"EMBRY RIDDLE AERONAUTICAL UNIVERSITY-DAYTONA BEACH          ","2003-2004",22,"Tennis",216018,216018,0,108009,108009,0,108009,108009,0,"7","7",105284,105284
"11471",140164,"KENNESAW STATE UNIVERSITY                                   ","2003-2004",22,"Tennis",142117,142117,0,0,0,0,142117,142117,0,".","7",0,18570
"11476",247834,"COLLIN COUNTY COMMUNITY COLLEGE DISTRICT                    ","2003-2004",22,"Tennis",67552,67552,0,33776,33776,0,33776,33776,0,"10","7",16926,16926
"11480",143084,"AUGUSTANA COLLEGE                                           ","2003-2004",22,"Tennis",25752,25752,0,13627,13627,0,12125,12125,0,"10","13",7666,4390
"11484",192466,"SOUTHAMPTON COLLEGE OF LONG ISLAND UNIVERSITY               ","2003-2004",22,"Tennis",30788,30788,0,30788,30788,0,0,0,0,"6","0",1744,0
"11494",193584,"NAZARETH COLLEGE OF ROCHESTER                               ","2003-2004",22,"Tennis",79453,79453,0,38678,38678,0,40775,40775,0,"8","12",15794,18734
"11497",234155,"VIRGINIA STATE UNIVERSITY                                   ","2003-2004",22,"Tennis",76243,76243,0,20648,20648,0,55595,55595,0,"6","7",7196,16391
"11503",122375,"SAN DIEGO MESA COLLEGE                                      ","2003-2004",22,"Tennis",33126,33126,0,15904,15904,0,17222,17222,0,"8","7",3823,4759
"11504",160621,"SOUTHERN UNIVERSITY AND A &amp; M COLLEGE                       ","2003-2004",22,"Tennis",32916,32916,0,16458,16458,0,16458,16458,0,"8","7",1176,1176
"11508",228787,"THE UNIVERSITY OF TEXAS AT DALLAS                           ","2003-2004",22,"Tennis",10600,10600,0,5300,5300,0,5300,5300,0,"12","11",5281,5166
"11512",193900,"NEW YORK UNIVERSITY                                         ","2003-2004",22,"Tennis",161443,161443,0,78550,78550,0,82893,82893,0,"12","14",44719,55381
"11513",198507,"ELIZABETH CITY STATE UNIVERSITY                             ","2003-2004",22,"Tennis",6217,6217,0,0,0,0,6217,6217,0,".","8",0,6216
"11526",120254,"OCCIDENTAL COLLEGE                                          ","2003-2004",22,"Tennis",26377,26377,0,12674,12674,0,13703,13703,0,"13","9",2674,3703
"11532",132851,"CENTRAL FLORIDA COMMUNITY COLLEGE                           ","2003-2004",22,"Tennis",46650,46650,0,0,0,0,46650,46650,0,".","6",0,14650
"11535",107141,"JOHN BROWN UNIVERSITY                                       ","2003-2004",22,"Tennis",53359,53359,0,22718,22718,0,30641,30641,0,"14","16",4158,4394
"11536",217235,"JOHNSON &amp; WALES UNIVERSITY                                  ","2003-2004",22,"Tennis",30804,30804,0,18300,18300,0,12504,12504,0,"11","10",9002,5736
"11539",111887,"CERRITOS COLLEGE                                            ","2003-2004",22,"Tennis",50410,50410,0,23802,23802,0,26608,26608,0,"8","10",1536,2164
"11552",180984,"CONCORDIA UNIVERSITY                                        ","2003-2004",22,"Tennis",69673,69673,0,38099,38099,0,31574,31574,0,"6","6",3498,3498
"11553",195173,"ST FRANCIS COLLEGE                                          ","2003-2004",22,"Tennis",51002,51002,0,27241,27241,0,23761,23761,0,"10","9",8172,8172
"11554",201195,"BALDWIN-WALLACE COLLEGE                                     ","2003-2004",22,"Tennis",31401,31401,0,19351,19351,0,12050,12050,0,"12","8",13745,6672
"11560",154855,"CENTRAL CHRISTIAN COLLEGE OF KANSAS                         ","2003-2004",22,"Tennis",4944,4944,0,2472,2472,0,2472,2472,0,"6","7",885,885
"11563",100937,"BIRMINGHAM SOUTHERN COLLEGE                                 ","2003-2004",22,"Tennis",437372,437372,0,167076,167076,0,270296,270296,0,"7","8",20578,20578
"11564",126775,"COLORADO SCHOOL OF MINES                                    ","2003-2004",22,"Tennis",36509,36509,0,36509,36509,0,0,0,0,"9",".",19718,0
"11565",133702,"FLORIDA COMMUNITY COLLEGE AT JACKSONVILLE                   ","2003-2004",22,"Tennis",56638,56638,0,0,0,0,56638,56638,0,".","9",0,33367
"11571",203775,"MALONE COLLEGE                                              ","2003-2004",22,"Tennis",68297,68297,0,33767,33767,0,34530,34530,0,"7","8",12932,11695
"11572",138947,"CLARK ATLANTA UNIVERSITY                                    ","2003-2004",22,"Tennis",78000,78000,0,0,0,0,78000,78000,0,".","7",0,10000
"11573",228769,"THE UNIVERSITY OF TEXAS AT ARLINGTON                        ","2003-2004",22,"Tennis",259511,259511,0,132039,132039,0,127472,127472,0,"8","8",32256,27982
"11584",161563,"THOMAS COLLEGE                                              ","2003-2004",22,"Tennis",3937,3937,0,3937,3937,0,0,0,0,"8",".",1537,0
"11590",196051,"MORRISVILLE STATE COLLEGE                                   ","2003-2004",22,"Tennis",13195,13195,0,0,0,0,13195,13195,0,".","5",0,6003
"11596",168227,"WENTWORTH INSTITUTE OF TECHNOLOGY                           ","2003-2004",22,"Tennis",11980,11980,0,6215,6215,0,5765,5765,0,"9","9",2310,1860
"11598",146506,"LAKE LAND COLLEGE                                           ","2003-2004",22,"Tennis",47324,47324,0,24162,24162,0,23162,23162,0,"8","8",11490,9490
"11604",204185,"MOUNT UNION COLLEGE                                         ","2003-2004",22,"Tennis",23218,23218,0,11911,11911,0,11307,11307,0,"12","12",4572,4301
"11605",176239,"PEARL RIVER COMMUNITY COLLEGE                               ","2003-2004",22,"Tennis",15856,15856,0,7928,7928,0,7928,7928,0,"7","3",1263,1263
"11607",194578,"PRATT INSTITUTE-MAIN                                        ","2003-2004",22,"Tennis",4528,4528,0,4528,4528,0,0,0,0,"8","0",480,0
"11613",229063,"TEXAS SOUTHERN UNIVERSITY                                   ","2003-2004",22,"Tennis",164094,164094,0,68938,68938,0,95156,95156,0,"8","9",23819,32289
"11620",170301,"HOPE COLLEGE                                                ","2003-2004",22,"Tennis",29075,29075,0,13899,13899,0,15176,15176,0,"10","10",9354,10316
"11623",101435,"HUNTINGDON COLLEGE                                          ","2003-2004",22,"Tennis",44807,44807,0,0,0,0,44807,44807,0,".","9",0,10173
"11629",127565,"METROPOLITAN STATE COLLEGE OF DENVER                        ","2003-2004",22,"Tennis",98887,98887,0,46125,46125,0,52762,52762,0,"9","10",15186,15803
"11631",190248,"CONCORDIA COLLEGE                                           ","2003-2004",22,"Tennis",19424,19424,0,15299,15299,0,4125,4125,0,"7","8",3979,3900
"11641",175786,"HINDS COMMUNITY COLLEGE                                     ","2003-2004",22,"Tennis",31538,31538,0,15769,15769,0,15769,15769,0,"9","9",3114,3114
"11642",193478,"NASSAU COMMUNITY COLLEGE                                    ","2003-2004",22,"Tennis",17314,17314,0,9357,9357,0,7957,7957,0,"7","7",3327,2555
"11644",156745,"GEORGETOWN COLLEGE                                          ","2003-2004",22,"Tennis",49520,49520,0,17895,17895,0,31625,31625,0,"7","11",2954,5684
"11652",175573,"COPIAH-LINCOLN COMMUNITY COLLEGE                            ","2003-2004",22,"Tennis",22367,22367,0,11511,11511,0,10856,10856,0,"8","6",2495,2559
"11653",196219,"SUNY COLLEGE AT PURCHASE                                    ","2003-2004",22,"Tennis",20501,20501,0,10080,10080,0,10421,10421,0,"6","9",8900,8900
"11655",107080,"HENDRIX COLLEGE                                             ","2003-2004",22,"Tennis",44600,44600,0,22300,22300,0,22300,22300,0,"13","13",11800,11800
"11660",228431,"STEPHEN F AUSTIN STATE UNIVERSITY                           ","2003-2004",22,"Tennis",115540,115540,0,0,0,0,115540,115540,0,".","10",0,11963
"11664",210739,"DESALES UNIVERSITY                                          ","2003-2004",22,"Tennis",22173,22173,0,12512,12512,0,9661,9661,0,"6","8",7267,4091
"11669",238458,"CARROLL COLLEGE                                             ","2003-2004",22,"Tennis",18036,18036,0,9200,9200,0,8836,8836,0,"7","10",3400,3627
"11670",130934,"DELAWARE STATE UNIVERSITY                                   ","2003-2004",22,"Tennis",109738,109738,0,50195,50195,0,59543,59543,0,"5","6",16989,16099
"11672",147244,"MILLIKIN UNIVERSITY                                         ","2003-2004",22,"Tennis",7950,7950,0,0,0,0,7950,7950,0,".","8",0,2070
"11678",181127,"HASTINGS COLLEGE                                            ","2003-2004",22,"Tennis",98335,98335,0,62530,62530,0,35805,35805,0,"11","9",2980,2980
"11681",110404,"CALIFORNIA INSTITUTE OF TECHNOLOGY                          ","2003-2004",22,"Tennis",35707,35707,0,17194,17194,0,18513,18513,0,"16","11",1892,3175
"11682",137032,"SAINT LEO UNIVERSITY                                        ","2003-2004",22,"Tennis",36979,36979,0,18176,18176,0,18803,18803,0,"8","7",7816,6873
"11684",117751,"THE MASTER'S COLLEGE AND SEMINARY                           ","2003-2004",22,"Tennis",36726,36726,0,0,0,0,36726,36726,0,".","10",0,10889
"11687",226471,"UNIVERSITY OF MARY HARDIN-BAYLOR                            ","2003-2004",22,"Tennis",55094,55094,0,27547,27547,0,27547,27547,0,"6","6",10721,10721
"11690",184791,"GLOUCESTER COUNTY COLLEGE                                   ","2003-2004",22,"Tennis",7750,7750,0,5334,5334,0,2416,2416,0,"6","8",5334,2416
"11697",170055,"GRAND RAPIDS COMMUNITY COLLEGE                              ","2003-2004",22,"Tennis",31478,31478,0,14077,14077,0,17401,17401,0,"8","9",2969,6495
"11698",196291,"SUNY MARITIME COLLEGE                                       ","2003-2004",22,"Tennis",5570,5570,0,5570,5570,0,0,0,0,"8",".",2570,0
"11702",146472,"COLLEGE OF LAKE COUNTY                                      ","2003-2004",22,"Tennis",16840,16840,0,8427,8427,0,8413,8413,0,"8","9",4817,4803
"11703",145646,"ILLINOIS WESLEYAN UNIVERSITY                                ","2003-2004",22,"Tennis",23001,23001,0,14250,14250,0,8751,8751,0,"12","14",9100,5781
"11706",173160,"BETHEL COLLEGE                                              ","2003-2004",22,"Tennis",26765,26765,0,13380,13380,0,13385,13385,0,"15","26",6375,6396
"11712",237932,"WEST LIBERTY STATE COLLEGE                                  ","2003-2004",22,"Tennis",69976,69976,0,40566,40566,0,29410,29410,0,"9","12",6579,5463
"11716",166638,"UNIVERSITY OF MASSACHUSETTS-BOSTON                          ","2003-2004",22,"Tennis",19496,19496,0,9311,9311,0,10185,10185,0,"7","6",2203,3317
"11720",216339,"TEMPLE UNIVERSITY                                           ","2003-2004",22,"Tennis",353899,353899,0,74019,74019,0,279880,279880,0,"8","9",21019,34145
"11726",174899,"THE COLLEGE OF SAINT SCHOLASTICA                            ","2003-2004",22,"Tennis",85268,85268,0,42505,42505,0,42763,42763,0,"8","12",15506,17019
"11728",215770,"SAINT JOSEPHS UNIVERSITY                                    ","2003-2004",22,"Tennis",209356,209356,0,143545,143545,0,65811,65811,0,"11","15",33022,16709
"11730",222983,"AUSTIN COLLEGE                                              ","2003-2004",22,"Tennis",34839,34839,0,16594,16594,0,18245,18245,0,"7","9",5263,6699
"11734",163851,"SALISBURY UNIVERSITY                                        ","2003-2004",22,"Tennis",21432,21432,0,10716,10716,0,10716,10716,0,"10","9",3895,3895
"11737",123217,"COLLEGE OF THE SEQUOIAS                                     ","2003-2004",22,"Tennis",19940,19940,0,9600,9600,0,10340,10340,0,"8","8",1660,2400
"11745",175236,"RIDGEWATER COLLEGE                                          ","2003-2004",22,"Tennis",8586,8586,0,0,0,0,8586,8586,0,".","8",0,2500
"11746",131098,"WESLEY COLLEGE                                              ","2003-2004",22,"Tennis",46298,46298,0,21338,21338,0,24960,24960,0,"8","7",4670,6005
"11747",243212,"UNIVERSITY OF PUERTO RICO-PONCE                             ","2003-2004",22,"Tennis",10339,10339,0,6166,6166,0,4173,4173,0,"4","3",2386,1803
"11751",214829,"PENNSYLVANIA STATE UNIVERSITY-PENN STATE YORK               ","2003-2004",22,"Tennis",5739,5739,0,5739,5739,0,0,0,0,"12",".",4477,0
"11752",101480,"JACKSONVILLE STATE UNIVERSITY                               ","2003-2004",22,"Tennis",251606,251606,0,112587,112587,0,139019,139019,0,"9","10",112586,139018
"11753",104577,"EASTERN ARIZONA COLLEGE                                     ","2003-2004",22,"Tennis",11273,11273,0,0,0,0,11273,11273,0,".","7",0,6493
"11756",202134,"CLEVELAND STATE UNIVERSITY                                  ","2003-2004",22,"Tennis",181284,181284,0,78487,78487,0,102797,102797,0,"8","7",19267,19549
"11761",190549,"CUNY BROOKLYN COLLEGE                                       ","2003-2004",22,"Tennis",16503,16503,0,7887,7887,0,8616,8616,0,"12","11",4411,4840
"11773",154712,"BENEDICTINE COLLEGE                                         ","2003-2004",22,"Tennis",75360,75360,0,56341,56341,0,19019,19019,0,"12","11",4193,4193
"11774",144971,"EUREKA COLLEGE                                              ","2003-2004",22,"Tennis",8341,8341,0,4396,4396,0,3945,3945,0,"7","8",1628,1445
"11777",101736,"NORTHWEST SHOALS COMMUNITY COLLEGE-MUSCLE SHOALS            ","2003-2004",22,"Tennis",20284,20284,0,0,0,0,20284,20284,0,".","7",0,9350
"11778",230913,"JOHNSON STATE COLLEGE                                       ","2003-2004",22,"Tennis",7974,7974,0,3689,3689,0,4285,4285,0,"6","9",1875,2565
"11779",131450,"GALLAUDET UNIVERSITY                                        ","2003-2004",22,"Tennis",8383,8383,0,8383,8383,0,0,0,0,"7",".",6883,0
"11787",150534,"UNIVERSITY OF EVANSVILLE                                    ","2003-2004",22,"Tennis",226020,226020,0,104123,104123,0,121897,121897,0,"6","7",11521,14829
"11788",152567,"TRI-STATE UNIVERSITY                                        ","2003-2004",22,"Tennis",25230,25230,0,15283,15283,0,9947,9947,0,"8","7",3439,2603
"11792",217420,"RHODE ISLAND COLLEGE                                        ","2003-2004",22,"Tennis",17782,17782,0,7677,7677,0,10105,10105,0,"10","12",3517,4905
"11797",173124,"BEMIDJI STATE UNIVERSITY                                    ","2003-2004",22,"Tennis",18561,18561,0,0,0,0,18561,18561,0,".","7",0,7619
"11798",220604,"LE MOYNE-OWEN COLLEGE                                       ","2003-2004",22,"Tennis",44000,44000,0,12000,12000,0,32000,32000,0,"6","7",7000,7000
"11806",209065,"LINFIELD COLLEGE                                            ","2003-2004",23,"Track and Field, Indoor",7078,7078,0,3539,3539,0,3539,3539,0,"39","22",1209,1210
"11813",150163,"BUTLER UNIVERSITY                                           ","2003-2004",23,"Track and Field, Indoor",160800,160800,0,91400,91400,0,69400,69400,0,"30","30",9300,9300
"11819",164270,"MCDANIEL COLLEGE                                            ","2003-2004",23,"Track and Field, Indoor",30724,30724,0,15362,15362,0,15362,15362,0,"17","15",5761,5761
"11829",174899,"THE COLLEGE OF SAINT SCHOLASTICA                            ","2003-2004",23,"Track and Field, Indoor",22221,22221,0,0,0,0,22221,22221,0,".","20",0,12433
"11838",190655,"CUNY NEW YORK CITY COLLEGE OF TECHNOLOGY                    ","2003-2004",23,"Track and Field, Indoor",5656,5656,0,2828,2828,0,2828,2828,0,"14","3",2827,2827
"11839",128902,"CONNECTICUT COLLEGE                                         ","2003-2004",23,"Track and Field, Indoor",68948,68948,0,34820,34820,0,34128,34128,0,"23","31",8058,7366
"11845",122597,"SAN FRANCISCO STATE UNIVERSITY                              ","2003-2004",23,"Track and Field, Indoor",39310,39310,0,0,0,0,39310,39310,0,".","34",0,11081
"11847",239017,"LAWRENCE UNIVERSITY                                         ","2003-2004",23,"Track and Field, Indoor",46206,46206,0,23103,23103,0,23103,23103,0,"15","21",16206,16206
"11848",168148,"TUFTS UNIVERSITY                                            ","2003-2004",23,"Track and Field, Indoor",74577,74577,0,39459,39459,0,35118,35118,0,"49","49",12600,14600
"11850",170037,"CORNERSTONE UNIVERSITY                                      ","2003-2004",23,"Track and Field, Indoor",34774,34774,0,17387,17387,0,17387,17387,0,"18","20",9147,9147
"11851",196042,"FARMINGDALE STATE UNIVERSITY OF NEW YORK                    ","2003-2004",23,"Track and Field, Indoor",17416,17416,0,8708,8708,0,8708,8708,0,"18","6",3933,3933
"11859",167729,"SALEM STATE COLLEGE                                         ","2003-2004",23,"Track and Field, Indoor",6122,6122,0,3061,3061,0,3061,3061,0,"8","3",1768,1768
"11864",232043,"EASTERN MENNONITE UNIVERSITY                                ","2003-2004",23,"Track and Field, Indoor",26946,26946,0,13473,13473,0,13473,13473,0,"22","12",1,1
"11870",185536,"MIDDLESEX COUNTY COLLEGE                                    ","2003-2004",23,"Track and Field, Indoor",9374,9374,0,4687,4687,0,4687,4687,0,"4","3",1221,1221
"11881",187134,"THE COLLEGE OF NEW JERSEY                                   ","2003-2004",23,"Track and Field, Indoor",46320,46320,0,23160,23160,0,23160,23160,0,"38","38",8692,8692
"11890",190840,"DUTCHESS COMMUNITY COLLEGE                                  ","2003-2004",23,"Track and Field, Indoor",4200,4200,0,2100,2100,0,2100,2100,0,"12",".",1000,1000
"11895",129525,"UNIVERSITY OF HARTFORD                                      ","2003-2004",23,"Track and Field, Indoor",61280,61280,0,30640,30640,0,30640,30640,0,"18","18",7614,7614
"11898",193283,"MOHAWK VALLEY COMMUNITY COLLEGE-UTICA BRANCH                ","2003-2004",23,"Track and Field, Indoor",14682,14682,0,7301,7301,0,7381,7381,0,"10","7",2960,2072
"11899",196185,"SUNY COLLEGE AT ONEONTA                                     ","2003-2004",23,"Track and Field, Indoor",68418,68418,0,34076,34076,0,34342,34342,0,"20","20",11849,12115
"11900",155520,"MIDAMERICA NAZARENE UNIVERSITY                              ","2003-2004",23,"Track and Field, Indoor",74000,74000,0,37000,37000,0,37000,37000,0,"35","29",9500,9500
"11909",165024,"BRIDGEWATER STATE COLLEGE                                   ","2003-2004",23,"Track and Field, Indoor",6000,6000,0,3000,3000,0,3000,3000,0,"8","11",2975,2975
"11911",131450,"GALLAUDET UNIVERSITY                                        ","2003-2004",23,"Track and Field, Indoor",22794,22794,0,14256,14256,0,8538,8538,0,"14","6",10006,4288
"11914",195173,"ST FRANCIS COLLEGE                                          ","2003-2004",23,"Track and Field, Indoor",73478,73478,0,34263,34263,0,39215,39215,0,"20","20",12004,12004
"11915",174491,"NORTHWESTERN COLLEGE                                        ","2003-2004",23,"Track and Field, Indoor",15771,15771,0,8007,8007,0,7764,7764,0,"8","8",3044,2800
"11922",217420,"RHODE ISLAND COLLEGE                                        ","2003-2004",23,"Track and Field, Indoor",16959,16959,0,9882,9882,0,7077,7077,0,"17","12",4915,2110
"11923",193478,"NASSAU COMMUNITY COLLEGE                                    ","2003-2004",23,"Track and Field, Indoor",12233,12233,0,8353,8353,0,3880,3880,0,"13","5",1846,710
"11927",141574,"UNIVERSITY OF HAWAII AT MANOA                               ","2003-2004",23,"Track and Field, Indoor",175678,175678,0,0,0,0,175678,175678,0,".","46",0,96532
"11929",110404,"CALIFORNIA INSTITUTE OF TECHNOLOGY                          ","2003-2004",24,"Track and Field, Outdoor",47007,47007,0,23515,23515,0,23492,23492,0,"21","16",7087,7052
"11934",190840,"DUTCHESS COMMUNITY COLLEGE                                  ","2003-2004",24,"Track and Field, Outdoor",4200,4200,0,2100,2100,0,2100,2100,0,"12",".",1000,1000
"11935",115393,"HARTNELL COLLEGE                                            ","2003-2004",24,"Track and Field, Outdoor",43196,43196,0,22852,22852,0,20344,20344,0,"31","16",12330,9822
"11942",150163,"BUTLER UNIVERSITY                                           ","2003-2004",24,"Track and Field, Outdoor",160800,160800,0,91400,91400,0,69400,69400,0,"30","30",9300,9300
"11945",123527,"SAN BERNARDINO VALLEY COLLEGE                               ","2003-2004",24,"Track and Field, Outdoor",17837,17837,0,10122,10122,0,7715,7715,0,"21","3",5373,2966
"11947",187134,"THE COLLEGE OF NEW JERSEY                                   ","2003-2004",24,"Track and Field, Outdoor",46320,46320,0,23160,23160,0,23160,23160,0,"38","38",8692,8692
"11951",128902,"CONNECTICUT COLLEGE                                         ","2003-2004",24,"Track and Field, Outdoor",68948,68948,0,34820,34820,0,34128,34128,0,"23","31",8058,7366
"11957",190655,"CUNY NEW YORK CITY COLLEGE OF TECHNOLOGY                    ","2003-2004",24,"Track and Field, Outdoor",5656,5656,0,2828,2828,0,2828,2828,0,"14","4",2827,2827
"11966",164270,"MCDANIEL COLLEGE                                            ","2003-2004",24,"Track and Field, Outdoor",30724,30724,0,15362,15362,0,15362,15362,0,"16","19",5761,5761
"11967",243665,"UNIVERSITY OF THE VIRGIN ISLANDS                            ","2003-2004",24,"Track and Field, Outdoor",15000,15000,0,5000,5000,0,10000,10000,0,"3","5",2500,5000
"11968",155520,"MIDAMERICA NAZARENE UNIVERSITY                              ","2003-2004",24,"Track and Field, Outdoor",74000,74000,0,37000,37000,0,37000,37000,0,"35","29",9500,9500
"11969",162210,"COLUMBIA UNION COLLEGE                                      ","2003-2004",24,"Track and Field, Outdoor",29340,29340,0,12670,16670,-4000,16670,12670,4000,"15",".",1191,1191
"11971",170037,"CORNERSTONE UNIVERSITY                                      ","2003-2004",24,"Track and Field, Outdoor",34774,34774,0,17387,17387,0,17387,17387,0,"21","20",9147,9147
"11974",399212,"SANTIAGO CANYON COLLEGE                                     ","2003-2004",24,"Track and Field, Outdoor",26064,26064,0,12858,12858,0,13206,13206,0,"13","14",2858,3206
"11981",161572,"UNITY COLLEGE                                               ","2003-2004",24,"Track and Field, Outdoor",6600,6600,0,3300,3300,0,3300,3300,0,"6","1",1500,1500
"11982",216852,"WIDENER UNIVERSITY-MAIN CAMPUS                              ","2003-2004",24,"Track and Field, Outdoor",28500,28500,0,14250,14250,0,14250,14250,0,"52","11",4631,4631
"11985",119067,"MONTEREY PENINSULA COLLEGE                                  ","2003-2004",24,"Track and Field, Outdoor",33072,33072,0,17968,17968,0,15104,15104,0,"15","7",5370,2506
"11986",122375,"SAN DIEGO MESA COLLEGE                                      ","2003-2004",24,"Track and Field, Outdoor",45567,45567,0,22783,22783,0,22784,22784,0,"22","11",6725,6726
"11990",225627,"UNIVERSITY OF THE INCARNATE WORD                            ","2003-2004",24,"Track and Field, Outdoor",46368,46368,0,23184,23184,0,23184,23184,0,"8","8",6275,6275
"11993",174899,"THE COLLEGE OF SAINT SCHOLASTICA                            ","2003-2004",24,"Track and Field, Outdoor",22221,22221,0,0,0,0,22221,22221,0,".","20",0,12433
"11997",125499,"WEST VALLEY COLLEGE                                         ","2003-2004",24,"Track and Field, Outdoor",24265,24265,0,16960,16960,0,7305,7305,0,"20","5",3200,800
"12000",196042,"FARMINGDALE STATE UNIVERSITY OF NEW YORK                    ","2003-2004",24,"Track and Field, Outdoor",17416,17416,0,8708,8708,0,8708,8708,0,"12","7",3933,3933
"12001",239017,"LAWRENCE UNIVERSITY                                         ","2003-2004",24,"Track and Field, Outdoor",46206,46206,0,23103,23103,0,23103,23103,0,"18","21",16206,16206
"12005",129525,"UNIVERSITY OF HARTFORD                                      ","2003-2004",24,"Track and Field, Outdoor",61280,61280,0,30640,30640,0,30640,30640,0,"15","17",6345,7191
"12010",118772,"MERRITT COLLEGE                                             ","2003-2004",24,"Track and Field, Outdoor",36688,36688,0,18344,18344,0,18344,18344,0,"8","8",5272,5272
"12011",196185,"SUNY COLLEGE AT ONEONTA                                     ","2003-2004",24,"Track and Field, Outdoor",57950,57950,0,29060,29060,0,28890,28890,0,"20","20",6833,6663
"12023",175786,"HINDS COMMUNITY COLLEGE                                     ","2003-2004",24,"Track and Field, Outdoor",30207,30207,0,30207,30207,0,0,0,0,"25",".",14052,0
"12027",117715,"LOS ANGELES SOUTHWEST COLLEGE                               ","2003-2004",24,"Track and Field, Outdoor",45648,45648,0,22824,22824,0,22824,22824,0,"10","20",6200,6200
"12028",163046,"LOYOLA COLLEGE IN MARYLAND                                  ","2003-2004",24,"Track and Field, Outdoor",21260,21260,0,0,0,0,21260,21260,0,".","25",0,9410
"12029",232043,"EASTERN MENNONITE UNIVERSITY                                ","2003-2004",24,"Track and Field, Outdoor",26946,26946,0,13473,13473,0,13473,13473,0,"22","12",1,1
"12033",185536,"MIDDLESEX COUNTY COLLEGE                                    ","2003-2004",24,"Track and Field, Outdoor",13504,13504,0,6752,6752,0,6752,6752,0,"7","2",1673,1673
"12034",217420,"RHODE ISLAND COLLEGE                                        ","2003-2004",24,"Track and Field, Outdoor",59610,59610,0,29937,29937,0,29673,29673,0,"19","10",1935,1948
"12038",174491,"NORTHWESTERN COLLEGE                                        ","2003-2004",24,"Track and Field, Outdoor",17164,17164,0,9135,9135,0,8029,8029,0,"8","7",4172,3065
"12047",150668,"GOSHEN COLLEGE                                              ","2003-2004",24,"Track and Field, Outdoor",63460,63460,0,31839,31839,0,31621,31621,0,"19","12",4900,8932
"12052",140164,"KENNESAW STATE UNIVERSITY                                   ","2003-2004",24,"Track and Field, Outdoor",179599,179599,0,90757,90757,0,88842,88842,0,"20","19",11414,13584
"12055",168148,"TUFTS UNIVERSITY                                            ","2003-2004",24,"Track and Field, Outdoor",81677,81677,0,41759,41759,0,39918,39918,0,"49","43",14900,14400
"12057",193478,"NASSAU COMMUNITY COLLEGE                                    ","2003-2004",24,"Track and Field, Outdoor",11707,11707,0,5902,5902,0,5805,5805,0,"19","15",1564,1466
"12059",131450,"GALLAUDET UNIVERSITY                                        ","2003-2004",24,"Track and Field, Outdoor",26526,26526,0,15478,15478,0,11048,11048,0,"20","12",10728,6298
"12060",122977,"SANTA MONICA COLLEGE                                        ","2003-2004",24,"Track and Field, Outdoor",48164,48164,0,25493,25493,0,22671,22671,0,"15","16",7493,4671
"12062",231086,"SOUTHERN VERMONT COLLEGE                                    ","2003-2004",24,"Track and Field, Outdoor",7284,7284,0,3642,3642,0,3642,3642,0,"14","7",1142,1142
"12065",157058,"KENTUCKY STATE UNIVERSITY                                   ","2003-2004",24,"Track and Field, Outdoor",61100,61100,0,32900,32900,0,28200,28200,0,"15","10",20900,15200
"12071",121044,"PASADENA CITY COLLEGE                                       ","2003-2004",24,"Track and Field, Outdoor",99376,99376,0,49688,49688,0,49688,49688,0,"13","10",2500,2500
"12073",141574,"UNIVERSITY OF HAWAII AT MANOA                               ","2003-2004",24,"Track and Field, Outdoor",294887,294887,0,0,0,0,294887,294887,0,".","46",0,209998
"12074",123217,"COLLEGE OF THE SEQUOIAS                                     ","2003-2004",24,"Track and Field, Outdoor",16950,16950,0,8775,8775,0,8175,8175,0,"27","14",3000,2400
"12082",111887,"CERRITOS COLLEGE                                            ","2003-2004",24,"Track and Field, Outdoor",73896,73896,0,36508,36508,0,37388,37388,0,"34","29",5913,4414
"12088",110538,"CALIFORNIA STATE UNIVERSITY-CHICO                           ","2003-2004",24,"Track and Field, Outdoor",312252,312252,0,172070,172070,0,140182,140182,0,"65","60",34894,33478
"12089",237932,"WEST LIBERTY STATE COLLEGE                                  ","2003-2004",24,"Track and Field, Outdoor",22610,22610,0,12361,12361,0,10249,10249,0,"43","27",2981,2981
"12101",125471,"WEST LOS ANGELES COLLEGE                                    ","2003-2004",24,"Track and Field, Outdoor",52758,52758,0,20553,20553,0,32205,32205,0,"17","15",8374,14836
"12107",210155,"SOUTHWESTERN OREGON COMMUNITY COLLEGE                       ","2003-2004",24,"Track and Field, Outdoor",71668,71668,0,35834,35834,0,35834,35834,0,"14","12",19538,19538
"12108",149842,"WILLIAM RAINEY HARPER COLLEGE                               ","2003-2004",24,"Track and Field, Outdoor",55792,55792,0,33311,33311,0,22481,22481,0,"30","15",21660,10830
"12114",193283,"MOHAWK VALLEY COMMUNITY COLLEGE-UTICA BRANCH                ","2003-2004",24,"Track and Field, Outdoor",18204,18204,0,9062,9062,0,9142,9142,0,"12","9",4356,3267
"12126",195173,"ST FRANCIS COLLEGE                                          ","2003-2004",24,"Track and Field, Outdoor",67189,67189,0,31080,31080,0,36109,36109,0,"20","17",10952,11031
"12127",122791,"COLLEGE OF SAN MATEO                                        ","2003-2004",24,"Track and Field, Outdoor",44822,44822,0,22411,22411,0,22411,22411,0,"12","7",3613,3613
"12130",117247,"LANEY COLLEGE                                               ","2003-2004",24,"Track and Field, Outdoor",10133,10133,0,0,0,0,10133,10133,0,".","4",0,10132
"12136",167729,"SALEM STATE COLLEGE                                         ","2003-2004",24,"Track and Field, Outdoor",6122,6122,0,3061,3061,0,3061,3061,0,"7","5",1768,1768
"12138",243179,"UNIVERSITY OF PUERTO RICO-HUMACAO                           ","2003-2004",24,"Track and Field, Outdoor",23200,23200,0,11600,11600,0,11600,11600,0,"11","8",3615,3615
"12152",225575,"HUSTON-TILLOTSON COLLEGE                                    ","2003-2004",24,"Track and Field, Outdoor",78965,78965,0,32902,32902,0,46063,46063,0,".","24",17256,24158
"12154",125091,"VICTOR VALLEY COLLEGE                                       ","2003-2004",24,"Track and Field, Outdoor",32500,32500,0,16250,16250,0,16250,16250,0,"15","4",4942,4942
"12159",234173,"VIRGINIA WESLEYAN COLLEGE                                   ","2003-2004",25,"Track and Field, X-Country",9614,9614,0,4807,4807,0,4807,4807,0,"6","6",2307,2307
"12165",157058,"KENTUCKY STATE UNIVERSITY                                   ","2003-2004",25,"Track and Field, X-Country",18300,18300,0,9150,9150,0,9150,9150,0,"8","6",2900,2900
"12166",148672,"SAUK VALLEY COMMUNITY COLLEGE                               ","2003-2004",25,"Track and Field, X-Country",16185,16185,0,8691,8691,0,7494,7494,0,"7","5",1670,1193
"12168",219091,"DAKOTA WESLEYAN UNIVERSITY                                  ","2003-2004",25,"Track and Field, X-Country",166971,166971,0,100445,100445,0,66526,66526,0,"33","21",20431,13620
"12170",129242,"FAIRFIELD UNIVERSITY                                        ","2003-2004",25,"Track and Field, X-Country",33536,33536,0,17781,17781,0,15755,15755,0,"15","18",10289,8615
"12171",197911,"BARTON COLLEGE                                              ","2003-2004",25,"Track and Field, X-Country",90151,90151,0,43401,43401,0,46750,46750,0,"10","8",6395,6395
"12172",214810,"PENNSYLVANIA STATE UNIVERSITY-PENN STATE SCHUYLKIL          ","2003-2004",25,"Track and Field, X-Country",1000,1000,0,500,500,0,500,500,0,"6","6",498,498
"12176",204264,"MUSKINGUM COLLEGE                                           ","2003-2004",25,"Track and Field, X-Country",27829,27829,0,13914,13914,0,13915,13915,0,"43","26",13667,13667
"12179",197133,"VASSAR COLLEGE                                              ","2003-2004",25,"Track and Field, X-Country",51189,51189,0,25348,25348,0,25841,25841,0,"10","14",6997,7490
"12180",145682,"ILLINOIS CENTRAL COLLEGE                                    ","2003-2004",25,"Track and Field, X-Country",30919,30919,0,14203,14203,0,16716,16716,0,"7","6",2936,2936
"12183",165662,"EMERSON COLLEGE                                             ","2003-2004",25,"Track and Field, X-Country",7772,7772,0,3686,3686,0,4086,4086,0,"6","10",450,650
"12184",187134,"THE COLLEGE OF NEW JERSEY                                   ","2003-2004",25,"Track and Field, X-Country",44390,44390,0,22195,22195,0,22195,22195,0,"16","15",6727,6727
"12191",112260,"CLAREMONT MCKENNA COLLEGE                                   ","2003-2004",25,"Track and Field, X-Country",144516,144516,0,72147,72147,0,72369,72369,0,"37","34",29718,29839
"12196",125499,"WEST VALLEY COLLEGE                                         ","2003-2004",25,"Track and Field, X-Country",27585,27585,0,14670,14670,0,12915,12915,0,"15","7",2400,1120
"12198",214704,"PENNSYLVANIA STATE UNIVERSITY-PENN STATE BERKS              ","2003-2004",25,"Track and Field, X-Country",14384,14384,0,7192,7192,0,7192,7192,0,"7","9",2042,2042
"12199",190770,"DOWLING COLLEGE                                             ","2003-2004",25,"Track and Field, X-Country",31952,31952,0,0,0,0,31952,31952,0,".","6",0,3227
"12210",157359,"MID-CONTINENT COLLEGE                                       ","2003-2004",25,"Track and Field, X-Country",23482,23482,0,11741,11741,0,11741,11741,0,"1","1",3827,3827
"12211",174914,"UNIVERSITY OF ST THOMAS                                     ","2003-2004",25,"Track and Field, X-Country",281522,281522,0,148740,148740,0,132782,132782,0,"140","97",66800,44715
"12215",136950,"ROLLINS COLLEGE                                             ","2003-2004",25,"Track and Field, X-Country",25280,25280,0,12640,12640,0,12640,12640,0,"6","8",3762,3762
"12216",148584,"UNIVERSITY OF ST FRANCIS                                    ","2003-2004",25,"Track and Field, X-Country",154898,154898,0,0,0,0,154898,154898,0,".","21",0,9698
"12221",170037,"CORNERSTONE UNIVERSITY                                      ","2003-2004",25,"Track and Field, X-Country",31228,31228,0,15614,15614,0,15614,15614,0,"9","7",3668,3668
"12223",229887,"WILEY COLLEGE                                               ","2003-2004",25,"Track and Field, X-Country",26885,26885,0,7268,7268,0,19617,19617,0,"2","6",1799,3597
"12227",215798,"SAINT VINCENT COLLEGE                                       ","2003-2004",25,"Track and Field, X-Country",140721,140721,0,69605,69605,0,71116,71116,0,"15","17",14505,14505
"12229",155900,"SOUTHWESTERN COLLEGE                                        ","2003-2004",25,"Track and Field, X-Country",113428,113428,0,64513,64513,0,48915,48915,0,"36","20",28101,28101
"12236",110714,"UNIVERSITY OF CALIFORNIA-SANTA CRUZ                         ","2003-2004",25,"Track and Field, X-Country",10175,10175,0,0,0,0,10175,10175,0,".","10",0,9000
"12240",123217,"COLLEGE OF THE SEQUOIAS                                     ","2003-2004",25,"Track and Field, X-Country",12185,12185,0,6220,6220,0,5965,5965,0,"14","6",1500,1245
"12243",399212,"SANTIAGO CANYON COLLEGE                                     ","2003-2004",25,"Track and Field, X-Country",27904,27904,0,14199,14199,0,13705,13705,0,"17","12",4199,3705
"12249",177418,"FONTBONNE UNIVERSITY                                        ","2003-2004",25,"Track and Field, X-Country",4754,4754,0,0,0,0,4754,4754,0,".","6",0,4753
"12250",196042,"FARMINGDALE STATE UNIVERSITY OF NEW YORK                    ","2003-2004",25,"Track and Field, X-Country",17418,17418,0,8709,8709,0,8709,8709,0,"8","7",3934,3934
"12253",225627,"UNIVERSITY OF THE INCARNATE WORD                            ","2003-2004",25,"Track and Field, X-Country",137744,137744,0,68129,68129,0,69615,69615,0,"6","8",1700,1700
"12258",193973,"NIAGARA UNIVERSITY                                          ","2003-2004",25,"Track and Field, X-Country",51755,51755,0,26558,26558,0,25197,25197,0,"9","7",6115,5365
"12264",106485,"UNIVERSITY OF ARKANSAS AT MONTICELLO                        ","2003-2004",25,"Track and Field, X-Country",7587,7587,0,0,0,0,7587,7587,0,".","6",0,3163
"12265",150941,"HUNTINGTON COLLEGE                                          ","2003-2004",25,"Track and Field, X-Country",53224,53224,0,26612,26612,0,26612,26612,0,"7","8",3960,3960
"12268",156745,"GEORGETOWN COLLEGE                                          ","2003-2004",25,"Track and Field, X-Country",26386,26386,0,5743,5743,0,20643,20643,0,"8","12",2594,2594
"12269",190655,"CUNY NEW YORK CITY COLLEGE OF TECHNOLOGY                    ","2003-2004",25,"Track and Field, X-Country",4226,4226,0,2113,2113,0,2113,2113,0,"18","12",2112,2112
"12279",125471,"WEST LOS ANGELES COLLEGE                                    ","2003-2004",25,"Track and Field, X-Country",46708,46708,0,23354,23354,0,23354,23354,0,"10","10",14420,14420
"12287",122375,"SAN DIEGO MESA COLLEGE                                      ","2003-2004",25,"Track and Field, X-Country",29792,29792,0,15261,15261,0,14531,14531,0,"6","11",3500,3708
"12295",200253,"MINOT STATE UNIVERSITY                                      ","2003-2004",25,"Track and Field, X-Country",45000,45000,0,22500,22500,0,22500,22500,0,"25","17",21894,21894
"12297",198507,"ELIZABETH CITY STATE UNIVERSITY                             ","2003-2004",25,"Track and Field, X-Country",4832,4832,0,2416,2416,0,2416,2416,0,"7","7",2415,2415
"12301",239512,"NORTHLAND COLLEGE                                           ","2003-2004",25,"Track and Field, X-Country",25458,25458,0,12767,12767,0,12691,12691,0,"13","12",9061,8910
"12302",198303,"CHOWAN COLLEGE                                              ","2003-2004",25,"Track and Field, X-Country",6104,6104,0,0,0,0,6104,6104,0,".","7",0,604
"12304",233912,"VIRGINIA INTERMONT COLLEGE                                  ","2003-2004",25,"Track and Field, X-Country",52200,52200,0,26700,26700,0,25500,25500,0,"11","16",18157,16985
"12323",190840,"DUTCHESS COMMUNITY COLLEGE                                  ","2003-2004",25,"Track and Field, X-Country",3200,3200,0,3200,3200,0,0,0,0,"8",".",1000,0
"12328",119067,"MONTEREY PENINSULA COLLEGE                                  ","2003-2004",25,"Track and Field, X-Country",17145,17145,0,8472,8472,0,8673,8673,0,"10","7",1350,1554
"12329",206604,"WRIGHT STATE UNIVERSITY-MAIN CAMPUS                         ","2003-2004",25,"Track and Field, X-Country",179357,179357,0,35507,35507,0,143850,143850,0,"14","73",7265,39749
"12333",190248,"CONCORDIA COLLEGE                                           ","2003-2004",25,"Track and Field, X-Country",1136,1136,0,1136,1136,0,0,0,0,"9",".",508,0
"12334",157535,"PIKEVILLE COLLEGE                                           ","2003-2004",25,"Track and Field, X-Country",11828,11828,0,4549,4549,0,7279,7279,0,"5","8",2501,4001
"12335",243577,"UNIVERSIDAD POLITECNICA DE PUERTO RICO                      ","2003-2004",25,"Track and Field, X-Country",6000,6000,0,4000,4000,0,2000,2000,0,"8","4",600,300
"12340",143288,"BLACKBURN COLLEGE                                           ","2003-2004",25,"Track and Field, X-Country",11525,11525,0,5762,5762,0,5763,5763,0,"7","6",1190,1191
"12343",183910,"CALDWELL COLLEGE                                            ","2003-2004",25,"Track and Field, X-Country",7414,7414,0,0,0,0,7414,7414,0,".","6",0,588
"12345",141574,"UNIVERSITY OF HAWAII AT MANOA                               ","2003-2004",25,"Track and Field, X-Country",156855,156855,0,0,0,0,156855,156855,0,".","19",0,125466
"12347",139311,"CLAYTON COLLEGE AND STATE UNIVERSITY                        ","2003-2004",25,"Track and Field, X-Country",137751,137751,0,71633,71633,0,66118,66118,0,"15","12",62507,58359
"12350",174899,"THE COLLEGE OF SAINT SCHOLASTICA                            ","2003-2004",25,"Track and Field, X-Country",47860,47860,0,23930,23930,0,23930,23930,0,"17","35",13374,13374
"12359",174491,"NORTHWESTERN COLLEGE                                        ","2003-2004",25,"Track and Field, X-Country",24923,24923,0,12829,12829,0,12094,12094,0,"6","11",6122,5387
"12361",140872,"REINHARDT COLLEGE                                           ","2003-2004",25,"Track and Field, X-Country",28390,28390,0,13835,13835,0,14555,14555,0,"7","6",712,509
"12367",137476,"SAINT THOMAS UNIVERSITY                                     ","2003-2004",25,"Track and Field, X-Country",71000,71000,0,35000,35000,0,36000,36000,0,"11","5",5000,5000
"12368",213996,"MESSIAH COLLEGE                                             ","2003-2004",25,"Track and Field, X-Country",92240,92240,0,46120,46120,0,46120,46120,0,"89","98",18272,18272
"12374",162760,"HOOD COLLEGE                                                ","2003-2004",25,"Track and Field, X-Country",11579,11579,0,0,0,0,11579,11579,0,".","12",0,5079
"12377",189705,"CANISIUS COLLEGE                                            ","2003-2004",25,"Track and Field, X-Country",81057,81057,0,44468,44468,0,36589,36589,0,"9","8",11906,10559
"12381",205443,"SHAWNEE STATE UNIVERSITY                                    ","2003-2004",25,"Track and Field, X-Country",69160,69160,0,35280,35280,0,33880,33880,0,"18","11",18500,17100
"12382",129525,"UNIVERSITY OF HARTFORD                                      ","2003-2004",25,"Track and Field, X-Country",61280,61280,0,30640,30640,0,30640,30640,0,"8","10",3384,4230
"12383",161299,"MAINE MARITIME ACADEMY                                      ","2003-2004",25,"Track and Field, X-Country",4086,4086,0,2172,2172,0,1914,1914,0,"10","7",1364,1308
"12388",115001,"GLENDALE COMMUNITY COLLEGE                                  ","2003-2004",25,"Track and Field, X-Country",15779,15779,0,7355,7355,0,8424,8424,0,"10","10",3415,2365
"12402",148335,"ROBERT MORRIS COLLEGE                                       ","2003-2004",25,"Track and Field, X-Country",188024,188024,0,92686,92686,0,95338,95338,0,"9","9",10627,10627
"12405",139144,"BERRY COLLEGE                                               ","2003-2004",25,"Track and Field, X-Country",248864,248864,0,124432,124432,0,124432,124432,0,"15","15",25545,25545
"12406",191719,"HUDSON VALLEY COMMUNITY COLLEGE                             ","2003-2004",25,"Track and Field, X-Country",3337,3337,0,0,0,0,3337,3337,0,".","1",0,1466
"12411",115296,"GROSSMONT COLLEGE                                           ","2003-2004",25,"Track and Field, X-Country",8359,8359,0,0,0,0,8359,8359,0,".","14",0,4359
"12413",198756,"JOHNSON C SMITH UNIVERSITY                                  ","2003-2004",25,"Track and Field, X-Country",119306,119306,0,46818,46818,0,72488,72488,0,"19","23",11280,12296
"12414",246354,"PALO ALTO COLLEGE                                           ","2003-2004",25,"Track and Field, X-Country",2875,2875,0,1150,1150,0,1725,1725,0,"2","3",1150,1725
"12416",107512,"OUACHITA BAPTIST UNIVERSITY                                 ","2003-2004",25,"Track and Field, X-Country",40447,40447,0,0,0,0,40447,40447,0,".","9",0,4036
"12420",131098,"WESLEY COLLEGE                                              ","2003-2004",25,"Track and Field, X-Country",12335,12335,0,6167,6167,0,6168,6168,0,"3","7",2145,5005
"12421",213826,"MARYWOOD UNIVERSITY                                         ","2003-2004",25,"Track and Field, X-Country",19356,19356,0,9780,9780,0,9576,9576,0,"6","13",4991,4788
"12430",218061,"FRANCIS MARION UNIVERSITY                                   ","2003-2004",25,"Track and Field, X-Country",75009,75009,0,45070,45070,0,29939,29939,0,"12","14",8794,8762
"12431",184791,"GLOUCESTER COUNTY COLLEGE                                   ","2003-2004",25,"Track and Field, X-Country",5052,5052,0,2524,2524,0,2528,2528,0,"4","8",2524,2528
"12432",237932,"WEST LIBERTY STATE COLLEGE                                  ","2003-2004",25,"Track and Field, X-Country",19373,19373,0,10743,10743,0,8630,8630,0,"10","10",2043,2043
"12436",106148,"YAVAPAI COLLEGE                                             ","2003-2004",25,"Track and Field, X-Country",66163,66163,0,0,0,0,66163,66163,0,".","10",0,17623
"12444",148627,"SAINT XAVIER UNIVERSITY                                     ","2003-2004",25,"Track and Field, X-Country",35320,35320,0,17410,17410,0,17910,17910,0,"4","10",9410,9410
"12446",170301,"HOPE COLLEGE                                                ","2003-2004",25,"Track and Field, X-Country",132334,132334,0,65390,65390,0,66944,66944,0,"58","78",30328,30328
"12448",184205,"CUMBERLAND COUNTY COLLEGE                                   ","2003-2004",25,"Track and Field, X-Country",25958,25958,0,12979,12979,0,12979,12979,0,"9","4",4685,4685
"12449",239017,"LAWRENCE UNIVERSITY                                         ","2003-2004",25,"Track and Field, X-Country",17954,17954,0,8447,8447,0,9507,9507,0,"11","19",6747,7807
"12458",122977,"SANTA MONICA COLLEGE                                        ","2003-2004",25,"Track and Field, X-Country",37130,37130,0,18326,18326,0,18804,18804,0,"11","9",2326,2804
"12459",211352,"CABRINI COLLEGE                                             ","2003-2004",25,"Track and Field, X-Country",6768,6768,0,3384,3384,0,3384,3384,0,"9","4",3100,3100
"12463",195173,"ST FRANCIS COLLEGE                                          ","2003-2004",25,"Track and Field, X-Country",54502,54502,0,24730,24730,0,29772,29772,0,"7","8",4604,4694
"12464",153375,"GRAND VIEW COLLEGE                                          ","2003-2004",25,"Track and Field, X-Country",32086,32086,0,13276,13276,0,18810,18810,0,"7","5",3802,2395
"12465",366395,"SUFFOLK COUNTY COMMUNITY COLLEGE                            ","2003-2004",25,"Track and Field, X-Country",16239,16239,0,6060,6060,0,10179,10179,0,"2","6",2000,6119
"12471",186867,"STEVENS INSTITUTE OF TECHNOLOGY                             ","2003-2004",25,"Track and Field, X-Country",75472,75472,0,39264,39264,0,36208,36208,0,"30","14",15112,12056
"12486",165334,"CLARK UNIVERSITY                                            ","2003-2004",25,"Track and Field, X-Country",14707,14707,0,9265,9265,0,5442,5442,0,"15","9",2435,1430
"12489",170657,"LANSING COMMUNITY COLLEGE                                   ","2003-2004",25,"Track and Field, X-Country",78421,78421,0,49328,49328,0,29093,29093,0,"51","26",21008,10345
"12490",133553,"EMBRY RIDDLE AERONAUTICAL UNIVERSITY-DAYTONA BEACH          ","2003-2004",25,"Track and Field, X-Country",134356,134356,0,67178,67178,0,67178,67178,0,"16","9",66578,66578
"12492",122597,"SAN FRANCISCO STATE UNIVERSITY                              ","2003-2004",25,"Track and Field, X-Country",16201,16201,0,7909,7909,0,8292,8292,0,"9","11",4730,5192
"12507",201195,"BALDWIN-WALLACE COLLEGE                                     ","2003-2004",25,"Track and Field, X-Country",250850,250850,0,125425,125425,0,125425,125425,0,"102","110",69107,69107
"12510",100937,"BIRMINGHAM SOUTHERN COLLEGE                                 ","2003-2004",25,"Track and Field, X-Country",231650,231650,0,100599,100599,0,131051,131051,0,"12","11",14450,14450
"12513",215442,"POINT PARK UNIVERSITY                                       ","2003-2004",25,"Track and Field, X-Country",56798,56798,0,29399,29399,0,27399,27399,0,"7","9",3499,3499
"12519",183974,"CENTENARY COLLEGE                                           ","2003-2004",25,"Track and Field, X-Country",2716,2716,0,1358,1358,0,1358,1358,0,"5","8",208,208
"12521",115126,"GOLDEN WEST COLLEGE                                         ","2003-2004",25,"Track and Field, X-Country",75641,75641,0,41181,41181,0,34460,34460,0,"18","7",10383,3662
"12524",173258,"CARLETON COLLEGE                                            ","2003-2004",25,"Track and Field, X-Country",205830,205830,0,102033,102033,0,103797,103797,0,"96","76",27125,28711
"12527",111887,"CERRITOS COLLEGE                                            ","2003-2004",25,"Track and Field, X-Country",37542,37542,0,16806,16806,0,20736,20736,0,"18","11",1168,1368
"12529",130253,"SACRED HEART UNIVERSITY                                     ","2003-2004",25,"Track and Field, X-Country",495017,495017,0,196695,196695,0,298322,298322,0,"69","91",39091,48490
"12530",220631,"LINCOLN MEMORIAL UNIVERSITY                                 ","2003-2004",25,"Track and Field, X-Country",99933,99933,0,45467,45467,0,54466,54466,0,"9","6",4376,4376
"12532",232043,"EASTERN MENNONITE UNIVERSITY                                ","2003-2004",25,"Track and Field, X-Country",28671,28671,0,14335,14335,0,14336,14336,0,"7","8",1,1
"12533",192439,"LONG ISLAND UNIVERSITY-BROOKLYN CAMPUS                      ","2003-2004",25,"Track and Field, X-Country",1e+05,1e+05,0,50000,50000,0,50000,50000,0,"7","9",6635,6635
"12536",214689,"PENNSYLVANIA STATE UNIVERSITY-PENN STATE ALTOONA            ","2003-2004",25,"Track and Field, X-Country",15978,15978,0,7989,7989,0,7989,7989,0,"23",".",3730,3729
"12539",123527,"SAN BERNARDINO VALLEY COLLEGE                               ","2003-2004",25,"Track and Field, X-Country",5834,5834,0,5834,5834,0,0,0,0,"9",".",4162,0
"12541",165699,"ENDICOTT COLLEGE                                            ","2003-2004",25,"Track and Field, X-Country",13860,13860,0,6930,6930,0,6930,6930,0,"7","11",3000,3000
"12549",121044,"PASADENA CITY COLLEGE                                       ","2003-2004",25,"Track and Field, X-Country",57088,57088,0,28544,28544,0,28544,28544,0,"11","10",2000,2000
"12550",196033,"SUNY COLLEGE OF AGRIC AND TECHN AT COBLESKILL               ","2003-2004",25,"Track and Field, X-Country",7818,7818,0,3909,3909,0,3909,3909,0,"15","8",1920,1920
"12552",110404,"CALIFORNIA INSTITUTE OF TECHNOLOGY                          ","2003-2004",25,"Track and Field, X-Country",15264,15264,0,7632,7632,0,7632,7632,0,"16","6",3220,3220
"12559",154493,"UPPER IOWA UNIVERSITY                                       ","2003-2004",25,"Track and Field, X-Country",334924,334924,0,167462,167462,0,167462,167462,0,"20","15",8876,8876
"12560",198835,"LENOIR-RHYNE COLLEGE                                        ","2003-2004",25,"Track and Field, X-Country",43019,43019,0,23481,23481,0,19538,19538,0,"8","4",5091,4573
"12562",207847,"SOUTHEASTERN OKLAHOMA STATE UNIVERSITY                      ","2003-2004",25,"Track and Field, X-Country",24024,24024,0,0,0,0,24024,24024,0,".","7",0,3406
"12564",150668,"GOSHEN COLLEGE                                              ","2003-2004",25,"Track and Field, X-Country",48436,48436,0,26178,26178,0,22258,22258,0,"9","11",5085,6215
"12567",159568,"LOUISIANA COLLEGE                                           ","2003-2004",25,"Track and Field, X-Country",6173,6173,0,0,0,0,6173,6173,0,".","5",0,1847
"12569",149842,"WILLIAM RAINEY HARPER COLLEGE                               ","2003-2004",25,"Track and Field, X-Country",26409,26409,0,14005,14005,0,12404,12404,0,"11","8",5863,4264
"12575",150677,"GRACE COLLEGE AND THEOLOGICAL SEMINARY                      ","2003-2004",25,"Track and Field, X-Country",94788,94788,0,50991,50991,0,43797,43797,0,"13","14",11303,11303
"12584",215947,"SETON HILL UNIVERSITY                                       ","2003-2004",25,"Track and Field, X-Country",83078,83078,0,47778,47778,0,35300,35300,0,"12","15",7300,7300
"12590",123013,"SANTA ROSA JUNIOR COLLEGE                                   ","2003-2004",25,"Track and Field, X-Country",41337,41337,0,20957,20957,0,20380,20380,0,"10","9",5192,4605
"12591",191533,"HARTWICK COLLEGE                                            ","2003-2004",25,"Track and Field, X-Country",111373,111373,0,49746,49746,0,61627,61627,0,"32","44",16655,23000
"12594",170587,"KIRTLAND COMMUNITY COLLEGE                                  ","2003-2004",25,"Track and Field, X-Country",9074,9074,0,0,0,0,9074,9074,0,".","5",0,3348
"12596",126775,"COLORADO SCHOOL OF MINES                                    ","2003-2004",25,"Track and Field, X-Country",147994,147994,0,78787,78787,0,69207,69207,0,"56","20",28591,28591
"12598",243601,"UNIVERSIDAD DEL TURABO                                      ","2003-2004",25,"Track and Field, X-Country",557071,557071,0,341441,341441,0,215630,215630,0,"44","18",48811,19937
"12600",141644,"HAWAII PACIFIC UNIVERSITY                                   ","2003-2004",25,"Track and Field, X-Country",218829,218829,0,119748,119748,0,99081,99081,0,"8","8",13666,11127
"12603",126669,"COLORADO CHRISTIAN UNIVERSITY                               ","2003-2004",25,"Track and Field, X-Country",23640,23640,0,6820,6820,0,16820,16820,0,"18","9",2934,2943
"12604",217235,"JOHNSON &amp; WALES UNIVERSITY                                  ","2003-2004",25,"Track and Field, X-Country",19966,19966,0,9893,9893,0,10073,10073,0,"9","12",3918,4012
"12605",226152,"TEXAS A &amp; M INTERNATIONAL UNIVERSITY                        ","2003-2004",25,"Track and Field, X-Country",38950,38950,0,19475,19475,0,19475,19475,0,"8","8",15475,15475
"12606",243665,"UNIVERSITY OF THE VIRGIN ISLANDS                            ","2003-2004",25,"Track and Field, X-Country",15000,15000,0,5000,5000,0,10000,10000,0,"5","3",4000,3000
"12609",157818,"TRANSYLVANIA UNIVERSITY                                     ","2003-2004",25,"Track and Field, X-Country",21908,21908,0,11005,11005,0,10903,10903,0,"7","9",5141,5141
"12614",163046,"LOYOLA COLLEGE IN MARYLAND                                  ","2003-2004",25,"Track and Field, X-Country",99539,99539,0,40259,40259,0,59280,59280,0,"16","19",9410,9410
"12618",139904,"GEORGIA MILITARY COLLEGE-MAIN CAMPUS                        ","2003-2004",25,"Track and Field, X-Country",4959,4959,0,4959,4959,0,0,0,0,"8",".",1713,0
"12619",199069,"MOUNT OLIVE COLLEGE                                         ","2003-2004",25,"Track and Field, X-Country",42611,42611,0,25789,25790,-1,16822,16821,1,"8","5",1694,2464
"12620",153533,"IOWA LAKES COMMUNITY COLLEGE                                ","2003-2004",25,"Track and Field, X-Country",14965,14965,0,11988,11988,0,2977,2977,0,"4","1",1884,1884
"12625",126748,"COLORADO NORTHWESTERN COMMUNITY COLLEGE                     ","2003-2004",25,"Track and Field, X-Country",35670,35670,0,9401,9401,0,26269,26269,0,"3","7",3055,7129
"12627",196200,"SUNY-POTSDAM                                                ","2003-2004",25,"Track and Field, X-Country",30074,30074,0,15037,15037,0,15037,15037,0,"8","13",11657,11656
"12632",220604,"LE MOYNE-OWEN COLLEGE                                       ","2003-2004",25,"Track and Field, X-Country",32000,32000,0,16000,16000,0,16000,16000,0,"9","8",6000,6000
"12638",158477,"CENTENARY COLLEGE OF LOUISIANA                              ","2003-2004",25,"Track and Field, X-Country",82955,82955,0,55303,55303,0,27652,27652,0,"9","11",6692,6692
"12644",183026,"SOUTHERN NEW HAMPSHIRE UNIVERSITY                           ","2003-2004",25,"Track and Field, X-Country",102759,102759,0,50774,50774,0,51985,51985,0,"9","9",7226,5820
"12646",154235,"SAINT AMBROSE UNIVERSITY                                    ","2003-2004",25,"Track and Field, X-Country",119888,119888,0,68269,68269,0,51619,51619,0,"23","19",6969,6969
"12658",101189,"FAULKNER UNIVERSITY                                         ","2003-2004",25,"Track and Field, X-Country",7840,7840,0,4875,4875,0,2965,2965,0,"6","6",4869,2964
"12659",221953,"TUSCULUM COLLEGE                                            ","2003-2004",25,"Track and Field, X-Country",49812,49812,0,24431,24431,0,25381,25381,0,"7","6",4034,4034
"12660",128902,"CONNECTICUT COLLEGE                                         ","2003-2004",25,"Track and Field, X-Country",50961,50961,0,13703,13703,0,37258,37258,0,"14","24",6571,8054
"12661",214829,"PENNSYLVANIA STATE UNIVERSITY-PENN STATE YORK               ","2003-2004",25,"Track and Field, X-Country",3813,3813,0,3813,3813,0,0,0,0,"8",".",3300,0
"12665",154855,"CENTRAL CHRISTIAN COLLEGE OF KANSAS                         ","2003-2004",25,"Track and Field, X-Country",3940,3940,0,3038,3038,0,902,902,0,"6","5",2978,852
"12666",172635,"WAYNE COUNTY COMMUNITY COLLEGE DISTRICT                     ","2003-2004",25,"Track and Field, X-Country",10000,10000,0,10000,10000,0,0,0,0,"8","0",9000,0
"12672",196291,"SUNY MARITIME COLLEGE                                       ","2003-2004",25,"Track and Field, X-Country",13925,13925,0,13925,13925,0,0,0,0,"12",".",7925,0
"12673",113856,"EAST LOS ANGELES COLLEGE                                    ","2003-2004",25,"Track and Field, X-Country",17966,17966,0,8983,8983,0,8983,8983,0,"17","22",4000,4000
"12674",123554,"SAINT MARYS COLLEGE OF CALIFORNIA                           ","2003-2004",25,"Track and Field, X-Country",109231,109231,0,48858,48858,0,60373,60373,0,"11","15",6330,8904
"12676",217420,"RHODE ISLAND COLLEGE                                        ","2003-2004",25,"Track and Field, X-Country",13039,13039,0,7161,7161,0,5878,5878,0,"12","8",1615,1775
"12677",128744,"UNIVERSITY OF BRIDGEPORT                                    ","2003-2004",25,"Track and Field, X-Country",49858,49858,0,20404,20404,0,29454,29454,0,"7","7",404,378
"12699",121691,"UNIVERSITY OF REDLANDS                                      ","2003-2004",25,"Track and Field, X-Country",66474,66474,0,33284,33284,0,33190,33190,0,"35","31",10437,10343
"12709",203368,"JOHN CARROLL UNIVERSITY                                     ","2003-2004",25,"Track and Field, X-Country",147586,147586,0,83213,83213,0,64373,64373,0,"64","41",37886,20400
"12713",110538,"CALIFORNIA STATE UNIVERSITY-CHICO                           ","2003-2004",25,"Track and Field, X-Country",105553,105553,0,54562,54562,0,50991,50991,0,"19","24",6425,6425
"12714",185536,"MIDDLESEX COUNTY COLLEGE                                    ","2003-2004",25,"Track and Field, X-Country",9114,9114,0,4557,4557,0,4557,4557,0,"3","5",678,678
"12715",153162,"CORNELL COLLEGE                                             ","2003-2004",25,"Track and Field, X-Country",134348,134348,0,67597,67597,0,66751,66751,0,"64","75",32015,30972
"12724",196185,"SUNY COLLEGE AT ONEONTA                                     ","2003-2004",25,"Track and Field, X-Country",62670,62670,0,31335,31335,0,31335,31335,0,"13","13",9107,9107
"12726",217776,"SOUTHERN WESLEYAN UNIVERSITY                                ","2003-2004",25,"Track and Field, X-Country",87608,87608,0,41858,41858,0,45750,45750,0,"10","9",9283,9250
"12732",146472,"COLLEGE OF LAKE COUNTY                                      ","2003-2004",25,"Track and Field, X-Country",8086,8086,0,4043,4043,0,4043,4043,0,"4","2",2839,2839
"12734",145646,"ILLINOIS WESLEYAN UNIVERSITY                                ","2003-2004",25,"Track and Field, X-Country",127004,127004,0,62303,62303,0,64701,64701,0,"37","49",15708,18106
"12743",150534,"UNIVERSITY OF EVANSVILLE                                    ","2003-2004",25,"Track and Field, X-Country",202250,202250,0,125437,125437,0,76813,76813,0,"13","12",6983,7072
"12744",218539,"PRESBYTERIAN COLLEGE                                        ","2003-2004",25,"Track and Field, X-Country",50669,50669,0,25468,25468,0,25201,25201,0,"11","10",4711,4246
"12748",111920,"CHABOT COLLEGE                                              ","2003-2004",25,"Track and Field, X-Country",5826,5826,0,2913,2913,0,2913,2913,0,"30","16",5520,5504
"12751",193478,"NASSAU COMMUNITY COLLEGE                                    ","2003-2004",25,"Track and Field, X-Country",7602,7602,0,3947,3947,0,3655,3655,0,"7","5",917,655
"12752",190600,"CUNY JOHN JAY COLLEGE CRIMINAL JUSTICE                      ","2003-2004",25,"Track and Field, X-Country",39866,39866,0,19297,19297,0,20569,20569,0,"8","7",1531,1532
"12757",166647,"MASSACHUSETTS BAY COMMUNITY COLLEGE                         ","2003-2004",25,"Track and Field, X-Country",500,500,0,0,0,0,500,500,0,".","2",0,2
"12759",232025,"EMORY AND HENRY COLLEGE                                     ","2003-2004",25,"Track and Field, X-Country",4502,4502,0,2251,2251,0,2251,2251,0,"2","1",909,902
"12766",186432,"SAINT PETERS COLLEGE                                        ","2003-2004",25,"Track and Field, X-Country",272743,272743,0,211329,211329,0,61414,61414,0,"77","63",10366,5965
"12769",168148,"TUFTS UNIVERSITY                                            ","2003-2004",25,"Track and Field, X-Country",53737,53737,0,29586,29586,0,24151,24151,0,"28","27",6350,6350
"12770",158802,"DILLARD UNIVERSITY                                          ","2003-2004",25,"Track and Field, X-Country",55050,55050,0,27525,27525,0,27525,27525,0,"6","7",4587,3932
"12779",144050,"UNIVERSITY OF CHICAGO                                       ","2003-2004",25,"Track and Field, X-Country",203362,203362,0,102032,102032,0,101330,101330,0,"41","41",49884,49182
"12781",366252,"PENNSYLVANIA COLLEGE OF TECHNOLOGY                          ","2003-2004",25,"Track and Field, X-Country",5280,5280,0,4320,4320,0,960,960,0,"11",".",2266,0
"12782",219295,"PRESENTATION COLLEGE                                        ","2003-2004",25,"Track and Field, X-Country",16736,16736,0,0,0,0,16736,16736,0,".","2",0,822
"12789",166638,"UNIVERSITY OF MASSACHUSETTS-BOSTON                          ","2003-2004",25,"Track and Field, X-Country",10481,10481,0,5487,5487,0,4994,4994,0,"8","6",1808,1392
"12792",140720,"PAINE COLLEGE                                               ","2003-2004",25,"Track and Field, X-Country",145943,145943,0,76242,76242,0,69701,69701,0,"13","14",14638,9321
"12793",105747,"SCOTTSDALE COMMUNITY COLLEGE                                ","2003-2004",25,"Track and Field, X-Country",47480,47480,0,23740,23740,0,23740,23740,0,"21","26",9253,9253
"12799",189459,"BRIARCLIFFE COLLEGE                                         ","2003-2004",25,"Track and Field, X-Country",38969,38969,0,13520,13520,0,25449,25449,0,"6","6",4767,4767
"12801",107080,"HENDRIX COLLEGE                                             ","2003-2004",25,"Track and Field, X-Country",45000,45000,0,22500,22500,0,22500,22500,0,"10","11",13750,13750
"12804",160904,"XAVIER UNIVERSITY OF LOUISIANA                              ","2003-2004",25,"Track and Field, X-Country",379795,379795,0,195786,195786,0,184009,184009,0,"26","29",49065,49065
"12811",195474,"SIENA COLLEGE                                               ","2003-2004",25,"Track and Field, X-Country",90125,90125,0,38112,38112,0,52013,52013,0,"11","24",5073,11505
"12813",230913,"JOHNSON STATE COLLEGE                                       ","2003-2004",25,"Track and Field, X-Country",4050,4050,0,2025,2025,0,2025,2025,0,"6","5",455,455
"12818",166948,"MOUNT IDA COLLEGE                                           ","2003-2004",25,"Track and Field, X-Country",15760,15760,0,0,0,0,15760,15760,0,".","13",0,12760
"12828",106467,"ARKANSAS TECH UNIVERSITY                                    ","2003-2004",25,"Track and Field, X-Country",50877,50877,0,0,0,0,50877,50877,0,".","7",0,12310
"12832",129774,"MITCHELL COLLEGE                                            ","2003-2004",25,"Track and Field, X-Country",6687,6687,0,6687,6687,0,0,0,0,"3",".",237,0
"12833",162210,"COLUMBIA UNION COLLEGE                                      ","2003-2004",25,"Track and Field, X-Country",36830,36830,0,23515,23515,0,13315,13315,0,"16",".",1743,1743
"12837",209065,"LINFIELD COLLEGE                                            ","2003-2004",25,"Track and Field, X-Country",27028,27028,0,13514,13514,0,13514,13514,0,"16","12",3648,3660
"12838",213659,"LUZERNE COUNTY COMMUNITY COLLEGE                            ","2003-2004",25,"Track and Field, X-Country",7500,7500,0,3750,3750,0,3750,3750,0,"5","3",1750,1750
"12844",122436,"UNIVERSITY OF SAN DIEGO                                     ","2003-2004",25,"Track and Field, X-Country",92642,92642,0,46321,46321,0,46321,46321,0,"9","15",16008,16008
"12847",167987,"UNIVERSITY OF MASSACHUSETTS-DARTMOUTH                       ","2003-2004",25,"Track and Field, X-Country",120140,120140,0,59405,59405,0,60735,60735,0,"65","48",24599,26557
"12851",202134,"CLEVELAND STATE UNIVERSITY                                  ","2003-2004",25,"Track and Field, X-Country",39045,39045,0,0,0,0,39045,39045,0,".","8",0,5632
"12854",155520,"MIDAMERICA NAZARENE UNIVERSITY                              ","2003-2004",25,"Track and Field, X-Country",77150,77150,0,38575,38575,0,38575,38575,0,"11","12",7500,7500
"12859",122791,"COLLEGE OF SAN MATEO                                        ","2003-2004",25,"Track and Field, X-Country",21852,21852,0,10926,10926,0,10926,10926,0,"6","4",1138,1138
"12861",193283,"MOHAWK VALLEY COMMUNITY COLLEGE-UTICA BRANCH                ","2003-2004",25,"Track and Field, X-Country",12782,12782,0,6351,6351,0,6431,6431,0,"10","7",1870,1309
"12865",117733,"LOS ANGELES VALLEY COLLEGE                                  ","2003-2004",25,"Track and Field, X-Country",46321,46321,0,24151,24151,0,22170,22170,0,"42","18",7519,6140
"12867",210775,"ALVERNIA COLLEGE                                            ","2003-2004",25,"Track and Field, X-Country",4900,4900,0,2450,2450,0,2450,2450,0,"5","6",632,632
"12868",155335,"NEWMAN UNIVERSITY                                           ","2003-2004",25,"Track and Field, X-Country",24000,24000,0,12000,12000,0,12000,12000,0,"10","10",6550,6550
"12875",213668,"LYCOMING COLLEGE                                            ","2003-2004",25,"Track and Field, X-Country",3622,3622,0,0,0,0,3622,3622,0,".","8",0,1479
"12880",167288,"MASSACHUSETTS COLLEGE OF LIBERAL ARTS                       ","2003-2004",25,"Track and Field, X-Country",5425,5425,0,2713,2713,0,2712,2712,0,"7","3",713,712
"12884",176965,"CENTRAL MISSOURI STATE UNIVERSITY                           ","2003-2004",25,"Track and Field, X-Country",417912,417912,0,234595,234595,0,183317,183317,0,"59","39",47941,47666
"12888",166124,"COLLEGE OF THE HOLY CROSS                                   ","2003-2004",25,"Track and Field, X-Country",851253,851253,0,172274,172274,0,678979,678979,0,"129","157",66575,66668
"12890",130493,"SOUTHERN CONNECTICUT STATE UNIVERSITY                       ","2003-2004",25,"Track and Field, X-Country",204402,204402,0,126564,126564,0,77838,77838,0,"47","41",44961,49040
"12894",140164,"KENNESAW STATE UNIVERSITY                                   ","2003-2004",25,"Track and Field, X-Country",167523,167523,0,91687,91687,0,75836,75836,0,"16","10",15008,14608
"12903",146612,"LEWIS UNIVERSITY                                            ","2003-2004",25,"Track and Field, X-Country",386844,386844,0,223862,223862,0,162982,162982,0,"62","35",33817,33816
"12904",191126,"FASHION INSTITUTE OF TECHNOLOGY                             ","2003-2004",25,"Track and Field, X-Country",16000,16000,0,6000,6000,0,10000,10000,0,".","19",1684,6315
"12905",154800,"BUTLER COUNTY COMMUNITY COLLEGE                             ","2003-2004",25,"Track and Field, X-Country",238775,238775,0,128662,128662,0,110113,110113,0,"74",".",21345,20508
"12910",190549,"CUNY BROOKLYN COLLEGE                                       ","2003-2004",25,"Track and Field, X-Country",8549,8549,0,4242,4242,0,4307,4307,0,"9","18",2712,2778
"12912",101736,"NORTHWEST SHOALS COMMUNITY COLLEGE-MUSCLE SHOALS            ","2003-2004",25,"Track and Field, X-Country",12905,12905,0,12905,12905,0,0,0,0,"7",".",4900,0
"12916",237640,"OHIO VALLEY COLLEGE                                         ","2003-2004",25,"Track and Field, X-Country",24654,24654,0,8652,8652,0,16002,16002,0,"8","11",1415,1415
"12918",167729,"SALEM STATE COLLEGE                                         ","2003-2004",25,"Track and Field, X-Country",9746,9746,0,4873,4873,0,4873,4873,0,"9","5",2145,2145
"12920",236230,"PACIFIC LUTHERAN UNIVERSITY                                 ","2003-2004",25,"Track and Field, X-Country",29200,29200,0,14600,14600,0,14600,14600,0,"24","26",14000,14000
"12922",149505,"TRINITY CHRISTIAN COLLEGE                                   ","2003-2004",25,"Track and Field, X-Country",27099,27099,0,12048,12048,0,15051,15051,0,"11","18",5848,8851
"12923",150163,"BUTLER UNIVERSITY                                           ","2003-2004",25,"Track and Field, X-Country",161035,161035,0,91483,91483,0,69552,69552,0,"18","12",9260,9260
"12925",210331,"WESTERN BAPTIST COLLEGE                                     ","2003-2004",25,"Track and Field, X-Country",30240,30240,0,15120,15120,0,15120,15120,0,"10","8",2913,2913
"12930",251260,"SOUTHERN UNION STATE COMMUNITY COLLEGE                      ","2003-2004",25,"Track and Field, X-Country",5926,5926,0,2963,2963,0,2963,2963,0,"4","6",1063,1063
"12932",189547,"BROOME COMMUNITY COLLEGE                                    ","2003-2004",25,"Track and Field, X-Country",6198,6198,0,3099,3099,0,3099,3099,0,"7","8",894,894
"12934",232706,"MARYMOUNT UNIVERSITY                                        ","2003-2004",25,"Track and Field, X-Country",10761,10761,0,2153,2153,0,8608,8608,0,"2","8",1789,7152
"12935",213358,"LA ROCHE COLLEGE                                            ","2003-2004",25,"Track and Field, X-Country",10698,10698,0,5349,5349,0,5349,5349,0,"5","5",2515,2515
"12938",190725,"DAEMEN COLLEGE                                              ","2003-2004",25,"Track and Field, X-Country",68816,68816,0,35315,35315,0,33501,33501,0,"7","7",8551,8551
"12946",433660,"FLORIDA GULF COAST UNIVERSITY                               ","2003-2004",25,"Track and Field, X-Country",18000,18000,0,9000,9000,0,9000,9000,0,"8","9",4000,4000
"12957",209612,"PACIFIC UNIVERSITY                                          ","2003-2004",25,"Track and Field, X-Country",59602,59602,0,29835,29835,0,29767,29767,0,"28","27",11576,11423
"12963",206491,"WILBERFORCE UNIVERSITY                                      ","2003-2004",25,"Track and Field, X-Country",3000,3000,0,1500,1500,0,1500,1500,0,"6","6",1000,1000
"12964",243179,"UNIVERSITY OF PUERTO RICO-HUMACAO                           ","2003-2004",25,"Track and Field, X-Country",3000,3000,0,1500,1500,0,1500,1500,0,"6","4",318,318
"12974",125727,"WESTMONT COLLEGE                                            ","2003-2004",25,"Track and Field, X-Country",178656,178656,0,90698,90698,0,87958,87958,0,"25","32",18142,23221
"12976",101879,"UNIVERSITY OF NORTH ALABAMA                                 ","2003-2004",25,"Track and Field, X-Country",56375,56375,0,30485,30485,0,25890,25890,0,"7","8",4822,4822
"12977",118772,"MERRITT COLLEGE                                             ","2003-2004",25,"Track and Field, X-Country",31517,31517,0,16654,16654,0,14863,14863,0,"2","1",3582,1791
"12987",200484,"TRINITY BIBLE COLLEGE                                       ","2003-2004",26,"Volleyball",27159,27159,0,0,0,0,27159,27159,0,".","9",0,8415
"12988",174914,"UNIVERSITY OF ST THOMAS                                     ","2003-2004",26,"Volleyball",83333,83333,0,0,0,0,83333,83333,0,".","23",0,31455
"12990",217235,"JOHNSON &amp; WALES UNIVERSITY                                  ","2003-2004",26,"Volleyball",67597,67597,0,34008,34008,0,33589,33589,0,"12","13",21181,20612
"12991",227979,"SAN JACINTO COLLEGE-CENTRAL CAMPUS                          ","2003-2004",26,"Volleyball",115919,115919,0,0,0,0,115919,115919,0,".","14",0,20611
"12992",107512,"OUACHITA BAPTIST UNIVERSITY                                 ","2003-2004",26,"Volleyball",166903,166903,0,0,0,0,166903,166903,0,".","15",0,22836
"12993",219091,"DAKOTA WESLEYAN UNIVERSITY                                  ","2003-2004",26,"Volleyball",70130,70130,0,0,0,0,70130,70130,0,".","17",0,13605
"12996",190248,"CONCORDIA COLLEGE                                           ","2003-2004",26,"Volleyball",7027,7027,0,0,0,0,7027,7027,0,"0","11",0,6452
"12997",117247,"LANEY COLLEGE                                               ","2003-2004",26,"Volleyball",12133,12133,0,0,0,0,12133,12133,0,".","12",0,12132
"13007",237109,"YAKIMA VALLEY COMMUNITY COLLEGE                             ","2003-2004",26,"Volleyball",43558,43558,0,0,0,0,43558,43558,0,".","12",0,23195
"13016",123527,"SAN BERNARDINO VALLEY COLLEGE                               ","2003-2004",26,"Volleyball",10792,10792,0,0,0,0,10792,10792,0,".","12",0,8442
"13023",117104,"LIFE PACIFIC COLLEGE                                        ","2003-2004",26,"Volleyball",13000,13000,0,0,0,0,13000,13000,0,".","12",0,12048
"13024",204264,"MUSKINGUM COLLEGE                                           ","2003-2004",26,"Volleyball",15049,15049,0,0,0,0,15049,15049,0,".","27",0,14863
"13030",193399,"COLLEGE OF MOUNT SAINT VINCENT                              ","2003-2004",26,"Volleyball",0,0,0,0,0,0,0,0,0,"10","14",10000,10000
"13031",145682,"ILLINOIS CENTRAL COLLEGE                                    ","2003-2004",26,"Volleyball",95481,95481,0,0,0,0,95481,95481,0,".","12",0,29222
"13034",218724,"COASTAL CAROLINA UNIVERSITY                                 ","2003-2004",26,"Volleyball",273461,273461,0,0,0,0,273461,273461,0,"0","10",0,42341
"13035",206817,"BACONE COLLEGE                                              ","2003-2004",26,"Volleyball",82000,82000,0,0,0,0,82000,82000,0,".","12",0,20023
"13041",213525,"LEHIGH CARBON COMMUNITY COLLEGE                             ","2003-2004",26,"Volleyball",4750,4750,0,0,0,0,4750,4750,0,"0","8",0,700
"13044",243346,"UNIVERSIDAD DEL ESTE                                        ","2003-2004",26,"Volleyball",67583,67583,0,25459,25459,0,42124,42124,0,"12","12",22459,39124
"13045",212911,"HAVERFORD COLLEGE                                           ","2003-2004",26,"Volleyball",24060,24060,0,0,0,0,24060,24060,0,".","10",0,21581
"13048",162760,"HOOD COLLEGE                                                ","2003-2004",26,"Volleyball",14170,14170,0,0,0,0,14170,14170,0,".","8",0,7670
"13051",238616,"CONCORDIA UNIVERSITY-WISCONSIN                              ","2003-2004",26,"Volleyball",13755,13755,0,0,0,0,13755,13755,0,".","16",0,10035
"13058",153922,"MARSHALLTOWN COMMUNITY COLLEGE                              ","2003-2004",26,"Volleyball",14761,14761,0,0,0,0,14761,14761,0,".","10",0,13133
"13059",219204,"NATIONAL AMERICAN UNIVERSITY                                ","2003-2004",26,"Volleyball",130944,130944,0,0,0,0,130944,130944,0,".","11",0,17043
"13064",149365,"SOUTH SUBURBAN COLLEGE                                      ","2003-2004",26,"Volleyball",15000,15000,0,0,0,0,15000,15000,0,".","10",0,11000
"13067",129525,"UNIVERSITY OF HARTFORD                                      ","2003-2004",26,"Volleyball",265994,265994,0,0,0,0,265994,265994,0,".","12",0,30925
"13073",177418,"FONTBONNE UNIVERSITY                                        ","2003-2004",26,"Volleyball",17713,17713,0,0,0,0,17713,17713,0,".","15",0,10008
"13075",229355,"TYLER JUNIOR COLLEGE                                        ","2003-2004",26,"Volleyball",95612,95612,0,0,0,0,95612,95612,0,".","16",0,33652
"13077",158477,"CENTENARY COLLEGE OF LOUISIANA                              ","2003-2004",26,"Volleyball",337139,337139,0,0,0,0,337139,337139,0,"0","11",0,59624
"13080",113096,"COSUMNES RIVER COLLEGE                                      ","2003-2004",26,"Volleyball",6801,6801,0,0,0,0,6801,6801,0,".","10",0,6426
"13084",140872,"REINHARDT COLLEGE                                           ","2003-2004",26,"Volleyball",48358,48358,0,0,0,0,48358,48358,0,".","7",0,2636
"13095",129774,"MITCHELL COLLEGE                                            ","2003-2004",26,"Volleyball",51863,51863,0,0,0,0,51863,51863,0,".","12",0,12368
"13096",153533,"IOWA LAKES COMMUNITY COLLEGE                                ","2003-2004",26,"Volleyball",39910,39910,0,0,0,0,39910,39910,0,".","9",0,11807
"13106",204468,"NOTRE DAME COLLEGE                                          ","2003-2004",26,"Volleyball",40778,40778,0,0,0,0,40778,40778,0,"0","9",0,12778
"13114",229887,"WILEY COLLEGE                                               ","2003-2004",26,"Volleyball",38136,38136,0,0,0,0,38136,38136,0,".","21",0,11857
"13116",193973,"NIAGARA UNIVERSITY                                          ","2003-2004",26,"Volleyball",118231,118231,0,0,0,0,118231,118231,0,".","11",0,24712
"13122",165662,"EMERSON COLLEGE                                             ","2003-2004",26,"Volleyball",13187,13187,0,0,0,0,13187,13187,0,".","11",0,3459
"13123",190770,"DOWLING COLLEGE                                             ","2003-2004",26,"Volleyball",179721,179721,0,0,0,0,179721,179721,0,".","10",0,24766
"13124",198251,"CENTRAL CAROLINA COMMUNITY COLLEGE                          ","2003-2004",26,"Volleyball",7500,7500,0,0,0,0,7500,7500,0,".","8",0,6250
"13133",232043,"EASTERN MENNONITE UNIVERSITY                                ","2003-2004",26,"Volleyball",61449,61449,0,28042,28042,0,33407,33407,0,"16","10",2130,1080
"13140",205443,"SHAWNEE STATE UNIVERSITY                                    ","2003-2004",26,"Volleyball",47293,47293,0,0,0,0,47293,47293,0,".","12",0,24013
"13145",150172,"CALUMET COLLEGE OF SAINT JOSEPH                             ","2003-2004",26,"Volleyball",51520,51520,0,28830,28830,0,22690,22690,0,"10","12",15214,14185
"13148",104586,"EMBRY RIDDLE AERONAUTICAL UNIVERSITY-PRESCOTT               ","2003-2004",26,"Volleyball",188790,188790,0,0,0,0,188790,188790,0,".","10",0,31174
"13149",155098,"FORT SCOTT COMMUNITY COLLEGE                                ","2003-2004",26,"Volleyball",45426,45426,0,0,0,0,45426,45426,0,".","10",0,13601
"13150",227146,"NAVARRO COLLEGE                                             ","2003-2004",26,"Volleyball",109410,109410,0,0,0,0,109410,109410,0,".","12",0,13473
"13152",157058,"KENTUCKY STATE UNIVERSITY                                   ","2003-2004",26,"Volleyball",51500,51500,0,0,0,0,51500,51500,0,".","12",0,16100
"13154",214069,"COLLEGE MISERICORDIA                                        ","2003-2004",26,"Volleyball",8805,8805,0,0,0,0,8805,8805,0,".","14",0,1596
"13155",134495,"HILLSBOROUGH COMMUNITY COLLEGE                              ","2003-2004",26,"Volleyball",9350,9350,0,0,0,0,9350,9350,0,".","12",0,9100
"13156",198835,"LENOIR-RHYNE COLLEGE                                        ","2003-2004",26,"Volleyball",135019,135019,0,0,0,0,135019,135019,0,".","10",0,75049
"13158",210669,"ALLEGHENY COLLEGE                                           ","2003-2004",26,"Volleyball",52090,52090,0,0,0,0,52090,52090,0,"0","11",0,20701
"13159",146612,"LEWIS UNIVERSITY                                            ","2003-2004",26,"Volleyball",448141,448141,0,229613,229613,0,218528,218528,0,"16","14",78770,27021
"13162",207847,"SOUTHEASTERN OKLAHOMA STATE UNIVERSITY                      ","2003-2004",26,"Volleyball",81273,81273,0,0,0,0,81273,81273,0,".","12",0,11285
"13166",156541,"CUMBERLAND COLLEGE                                          ","2003-2004",26,"Volleyball",136700,136700,0,0,0,0,136700,136700,0,"0","15",0,11610
"13167",157359,"MID-CONTINENT COLLEGE                                       ","2003-2004",26,"Volleyball",58107,58107,0,0,0,0,58107,58107,0,".","10",0,8553
"13169",204857,"OHIO UNIVERSITY-MAIN CAMPUS                                 ","2003-2004",26,"Volleyball",427285,427285,0,0,0,0,427285,427285,0,".","13",0,42854
"13170",198756,"JOHNSON C SMITH UNIVERSITY                                  ","2003-2004",26,"Volleyball",55278,55278,0,0,0,0,55278,55278,0,".","10",0,7632
"13175",165015,"BRANDEIS UNIVERSITY                                         ","2003-2004",26,"Volleyball",101214,101214,0,0,0,0,101214,101214,0,".","11",0,40150
"13177",168281,"WHEATON COLLEGE                                             ","2003-2004",26,"Volleyball",72027,72027,0,0,0,0,72027,72027,0,".","12",0,22376
"13178",199926,"WILKES COMMUNITY COLLEGE                                    ","2003-2004",26,"Volleyball",10476,10476,0,0,0,0,10476,10476,0,".","6",0,1746
"13182",106467,"ARKANSAS TECH UNIVERSITY                                    ","2003-2004",26,"Volleyball",138228,138228,0,0,0,0,138228,138228,0,".","13",0,29856
"13190",186867,"STEVENS INSTITUTE OF TECHNOLOGY                             ","2003-2004",26,"Volleyball",169843,169843,0,103648,103648,0,66195,66195,0,"16","12",28464,20034
"13197",213668,"LYCOMING COLLEGE                                            ","2003-2004",26,"Volleyball",24837,24837,0,0,0,0,24837,24837,0,".","16",0,15933
"13199",154642,"ALLEN COUNTY COMMUNITY COLLEGE                              ","2003-2004",26,"Volleyball",27317,27317,0,0,0,0,27317,27317,0,".","13",0,18023
"13200",136950,"ROLLINS COLLEGE                                             ","2003-2004",26,"Volleyball",260386,260386,0,0,0,0,260386,260386,0,"0","12",0,33570
"13204",167987,"UNIVERSITY OF MASSACHUSETTS-DARTMOUTH                       ","2003-2004",26,"Volleyball",20982,20982,0,0,0,0,20982,20982,0,".","11",0,12543
"13206",148627,"SAINT XAVIER UNIVERSITY                                     ","2003-2004",26,"Volleyball",72432,72432,0,0,0,0,72432,72432,0,".","19",0,18432
"13207",108667,"COLLEGE OF ALAMEDA                                          ","2003-2004",26,"Volleyball",24897,24897,0,0,0,0,24897,24897,0,".","8",0,8471
"13212",232609,"LYNCHBURG COLLEGE                                           ","2003-2004",26,"Volleyball",47881,47881,0,0,0,0,47881,47881,0,".","14",0,15963
"13226",206914,"CAMERON UNIVERSITY                                          ","2003-2004",26,"Volleyball",33022,33022,0,0,0,0,33022,33022,0,".","11",0,15827
"13238",215798,"SAINT VINCENT COLLEGE                                       ","2003-2004",26,"Volleyball",119757,119757,0,0,0,0,119757,119757,0,".","17",0,34635
"13240",198233,"CATAWBA VALLEY COMMUNITY COLLEGE                            ","2003-2004",26,"Volleyball",5659,5659,0,0,0,0,5659,5659,0,".","8",0,5656
"13250",119067,"MONTEREY PENINSULA COLLEGE                                  ","2003-2004",26,"Volleyball",14325,14325,0,0,0,0,14325,14325,0,".","10",0,6800
"13255",192439,"LONG ISLAND UNIVERSITY-BROOKLYN CAMPUS                      ","2003-2004",26,"Volleyball",357708,357708,0,0,0,0,357708,357708,0,".","9",0,68952
"13258",199643,"SHAW UNIVERSITY                                             ","2003-2004",26,"Volleyball",157817,157817,0,0,0,0,157817,157817,0,".","12",0,13197
"13261",237899,"WEST VIRGINIA STATE COLLEGE                                 ","2003-2004",26,"Volleyball",80275,80275,0,0,0,0,80275,80275,0,".","12",0,26227
"13264",101709,"UNIVERSITY OF MONTEVALLO                                    ","2003-2004",26,"Volleyball",122587,122587,0,0,0,0,122587,122587,0,".","13",0,25223
"13269",251260,"SOUTHERN UNION STATE COMMUNITY COLLEGE                      ","2003-2004",26,"Volleyball",41485,41485,0,0,0,0,41485,41485,0,".","12",0,12770
"13271",231086,"SOUTHERN VERMONT COLLEGE                                    ","2003-2004",26,"Volleyball",16207,16207,0,0,0,0,16207,16207,0,".","10",0,3013
"13275",194578,"PRATT INSTITUTE-MAIN                                        ","2003-2004",26,"Volleyball",6262,6262,0,0,0,0,6262,6262,0,"0","13",0,1092
"13279",241836,"ELECTRONIC DATA PROCESSING COL OF PR INC-SAN SBSTN          ","2003-2004",26,"Volleyball",2650,2650,0,1700,1700,0,950,950,0,"12","12",200,200
"13295",196051,"MORRISVILLE STATE COLLEGE                                   ","2003-2004",26,"Volleyball",25137,25137,0,0,0,0,25137,25137,0,".","12",0,14685
"13297",214689,"PENNSYLVANIA STATE UNIVERSITY-PENN STATE ALTOONA            ","2003-2004",26,"Volleyball",16335,16335,0,0,0,0,16335,16335,0,".","15",0,9219
"13298",129242,"FAIRFIELD UNIVERSITY                                        ","2003-2004",26,"Volleyball",430960,430960,0,0,0,0,430960,430960,0,".","9",0,39443
"13299",169248,"CENTRAL MICHIGAN UNIVERSITY                                 ","2003-2004",26,"Volleyball",344690,344690,0,0,0,0,344690,344690,0,".","19",0,50936
"13302",101499,"JEFFERSON DAVIS COMMUNITY COLLEGE                           ","2003-2004",26,"Volleyball",45798,45798,0,0,0,0,45798,45798,0,".","11",0,7500
"13303",111920,"CHABOT COLLEGE                                              ","2003-2004",26,"Volleyball",2600,2600,0,0,0,0,2600,2600,0,".","11",0,5753
"13309",141574,"UNIVERSITY OF HAWAII AT MANOA                               ","2003-2004",26,"Volleyball",1356919,1356919,0,576625,576625,0,780294,780294,0,"20","22",172002,343931
"13320",227386,"PANOLA COLLEGE                                              ","2003-2004",26,"Volleyball",106670,106670,0,0,0,0,106670,106670,0,".","12",0,11000
"13326",194028,"NORTH COUNTRY COMMUNITY COLLEGE                             ","2003-2004",26,"Volleyball",8604,8604,0,0,0,0,8604,8604,0,".","7",0,1210
"13328",161457,"UNIVERSITY OF NEW ENGLAND                                   ","2003-2004",26,"Volleyball",25101,25101,0,0,0,0,25101,25101,0,".","12",0,13601
"13338",181534,"PERU STATE COLLEGE                                          ","2003-2004",26,"Volleyball",169489,169489,0,56184,56184,0,113305,113305,0,"10","13",7981,10599
"13340",144050,"UNIVERSITY OF CHICAGO                                       ","2003-2004",26,"Volleyball",91995,91995,0,0,0,0,91995,91995,0,".","10",0,40263
"13341",189705,"CANISIUS COLLEGE                                            ","2003-2004",26,"Volleyball",305112,305112,0,0,0,0,305112,305112,0,".","11",0,33444
"13342",190655,"CUNY NEW YORK CITY COLLEGE OF TECHNOLOGY                    ","2003-2004",26,"Volleyball",17323,17323,0,8387,8387,0,8936,8936,0,"9","14",8386,8935
"13348",193308,"MONROE COLLEGE-MAIN CAMPUS                                  ","2003-2004",26,"Volleyball",20054,20054,0,0,0,0,20054,20054,0,".","9",0,9699
"13349",195173,"ST FRANCIS COLLEGE                                          ","2003-2004",26,"Volleyball",93733,93733,0,0,0,0,93733,93733,0,".","10",0,18838
"13366",117706,"LOS ANGELES PIERCE COLLEGE                                  ","2003-2004",26,"Volleyball",58110,58110,0,23809,23809,0,34301,34301,0,"16","13",8616,11990
"13371",130253,"SACRED HEART UNIVERSITY                                     ","2003-2004",26,"Volleyball",236296,236296,0,30985,30985,0,205311,205311,0,"13","14",13467,20215
"13373",125499,"WEST VALLEY COLLEGE                                         ","2003-2004",26,"Volleyball",13167,13167,0,0,0,0,13167,13167,0,".","11",0,1760
"13388",107600,"PHILANDER SMITH COLLEGE                                     ","2003-2004",26,"Volleyball",12154,12154,0,0,0,0,12154,12154,0,".","11",0,6174
"13397",218061,"FRANCIS MARION UNIVERSITY                                   ","2003-2004",26,"Volleyball",98016,98016,0,0,0,0,98016,98016,0,".","11",0,19308
"13404",193584,"NAZARETH COLLEGE OF ROCHESTER                               ","2003-2004",26,"Volleyball",47782,47782,0,0,0,0,47782,47782,0,".","15",0,24997
"13409",101879,"UNIVERSITY OF NORTH ALABAMA                                 ","2003-2004",26,"Volleyball",239800,239800,0,0,0,0,239800,239800,0,".","14",0,69020
"13410",193353,"MOUNT SAINT MARY COLLEGE                                    ","2003-2004",26,"Volleyball",14249,14249,0,0,0,0,14249,14249,0,"0","13",0,11973
"13413",104717,"GRAND CANYON UNIVERSITY                                     ","2003-2004",26,"Volleyball",192489,192489,0,0,0,0,192489,192489,0,".","13",0,44857
"13414",220978,"MIDDLE TENNESSEE STATE UNIVERSITY                           ","2003-2004",26,"Volleyball",442621,442621,0,0,0,0,442621,442621,0,".","15",0,110059
"13419",136400,"PASCO-HERNANDO COMMUNITY COLLEGE                            ","2003-2004",26,"Volleyball",149807,149807,0,0,0,0,149807,149807,0,".","15",0,26909
"13425",155900,"SOUTHWESTERN COLLEGE                                        ","2003-2004",26,"Volleyball",46325,46325,0,0,0,0,46325,46325,0,".","12",0,22317
"13431",210605,"COMMUNITY COLLEGE OF ALLEGHENY COUNTY                       ","2003-2004",26,"Volleyball",4455,4455,0,0,0,0,4455,4455,0,".","10",0,4400
"13434",110404,"CALIFORNIA INSTITUTE OF TECHNOLOGY                          ","2003-2004",26,"Volleyball",21466,21466,0,0,0,0,21466,21466,0,"0","13",0,11730
"13440",161004,"BOWDOIN COLLEGE                                             ","2003-2004",26,"Volleyball",42059,42059,0,0,0,0,42059,42059,0,"0","10",0,13794
"13446",105428,"PHOENIX COLLEGE                                             ","2003-2004",26,"Volleyball",81200,81200,0,0,0,0,81200,81200,0,".","12",0,16900
"13448",226152,"TEXAS A &amp; M INTERNATIONAL UNIVERSITY                        ","2003-2004",26,"Volleyball",59675,59675,0,0,0,0,59675,59675,0,"0","18",0,14399
"13458",213598,"LINCOLN UNIVERSITY                                          ","2003-2004",26,"Volleyball",6300,6300,0,0,0,0,6300,6300,0,".","12",0,4700
"13459",166124,"COLLEGE OF THE HOLY CROSS                                   ","2003-2004",26,"Volleyball",154320,154320,0,0,0,0,154320,154320,0,".","11",0,29288
"13486",211981,"DELAWARE VALLEY COLLEGE                                     ","2003-2004",26,"Volleyball",100,100,0,0,0,0,100,100,0,".","9",0,1
"13487",196237,"SUNY COLLEGE AT OLD WESTBURY                                ","2003-2004",26,"Volleyball",7000,7000,0,0,0,0,7000,7000,0,".","15",0,6000
"13489",149532,"TRITON COLLEGE                                              ","2003-2004",26,"Volleyball",12967,12967,0,0,0,0,12967,12967,0,".","9",0,3586
"13491",168148,"TUFTS UNIVERSITY                                            ","2003-2004",26,"Volleyball",36119,36119,0,0,0,0,36119,36119,0,".","12",0,12600
"13498",167358,"NORTHEASTERN UNIVERSITY                                     ","2003-2004",26,"Volleyball",664755,664755,0,0,0,0,664755,664755,0,"0","14",0,58187
"13501",226806,"MIDLAND COLLEGE                                             ","2003-2004",26,"Volleyball",69110,69110,0,0,0,0,69110,69110,0,".","12",0,23094
"13503",165699,"ENDICOTT COLLEGE                                            ","2003-2004",26,"Volleyball",75762,75762,0,46106,46106,0,29656,29656,0,"9","12",23700,15100
"13510",230737,"UTAH VALLEY STATE COLLEGE                                   ","2003-2004",26,"Volleyball",225377,225377,0,0,0,0,225377,225377,0,".","14",0,40892
"13514",177339,"EVANGEL UNIVERSITY                                          ","2003-2004",26,"Volleyball",132360,132360,0,0,0,0,132360,132360,0,".","21",0,35460
"13519",199722,"SOUTHEASTERN COMMUNITY COLLEGE                              ","2003-2004",26,"Volleyball",9100,9100,0,0,0,0,9100,9100,0,".","8",0,7400
"13521",113856,"EAST LOS ANGELES COLLEGE                                    ","2003-2004",26,"Volleyball",18098,18098,0,0,0,0,18098,18098,0,".","14",0,5000
"13527",160904,"XAVIER UNIVERSITY OF LOUISIANA                              ","2003-2004",26,"Volleyball",147499,147499,0,0,0,0,147499,147499,0,".","15",0,55331
"13531",229504,"VERNON COLLEGE                                              ","2003-2004",26,"Volleyball",72831,72831,0,0,0,0,72831,72831,0,".","10",0,18129
"13535",136358,"PALM BEACH COMMUNITY COLLEGE                                ","2003-2004",26,"Volleyball",55292,55292,0,0,0,0,55292,55292,0,".","14",0,17321
"13556",166027,"HARVARD UNIVERSITY                                          ","2003-2004",26,"Volleyball",236589,236589,0,57399,57399,0,179190,179190,0,"12","29",31896,42396
"13559",205966,"SOUTHERN STATE COMMUNITY COLLEGE                            ","2003-2004",26,"Volleyball",10558,10558,0,0,0,0,10558,10558,0,".","10",0,5858
"13562",243601,"UNIVERSIDAD DEL TURABO                                      ","2003-2004",26,"Volleyball",105136,105136,0,41838,41838,0,63298,63298,0,"13","17",2304,2903
"13566",240505,"CASPER COLLEGE                                              ","2003-2004",26,"Volleyball",96750,96750,0,0,0,0,96750,96750,0,".","11",0,15242
"13567",174491,"NORTHWESTERN COLLEGE                                        ","2003-2004",26,"Volleyball",29394,29394,0,0,0,0,29394,29394,0,".","14",0,16732
"13568",176628,"AVILA UNIVERSITY                                            ","2003-2004",26,"Volleyball",98516,98516,0,0,0,0,98516,98516,0,".","22",0,15242
"13569",198552,"FORSYTH TECHNICAL COMMUNITY COLLEGE                         ","2003-2004",26,"Volleyball",4820,4820,0,0,0,0,4820,4820,0,".","10",0,2210
"13570",178624,"NORTHWEST MISSOURI STATE UNIVERSITY                         ","2003-2004",26,"Volleyball",157089,157089,0,0,0,0,157089,157089,0,".","14",0,10982
"13575",157076,"KENTUCKY WESLEYAN COLLEGE                                   ","2003-2004",26,"Volleyball",43112,43112,0,0,0,0,43112,43112,0,".","9",0,11585
"13577",240596,"EASTERN WYOMING COLLEGE                                     ","2003-2004",26,"Volleyball",89581,89581,0,0,0,0,89581,89581,0,".","13",0,23776
"13581",238333,"BELOIT COLLEGE                                              ","2003-2004",26,"Volleyball",13787,13787,0,0,0,0,13787,13787,0,"0","17",0,13787
"13583",155414,"KANSAS WESLEYAN UNIVERSITY                                  ","2003-2004",26,"Volleyball",40346,40346,0,0,0,0,40346,40346,0,"0","25",0,16182
"13588",182865,"HESSER COLLEGE                                              ","2003-2004",26,"Volleyball",10757,10757,0,0,0,0,10757,10757,0,"0","10",0,3757
"13593",137281,"SAINT JOHNS RIVER COMMUNITY COLLEGE                         ","2003-2004",26,"Volleyball",43960,43960,0,0,0,0,43960,43960,0,".","14",0,25960
"13597",135717,"MIAMI DADE COLLEGE                                          ","2003-2004",26,"Volleyball",153000,153000,0,0,0,0,153000,153000,0,".","13",0,14414
"13601",210155,"SOUTHWESTERN OREGON COMMUNITY COLLEGE                       ","2003-2004",26,"Volleyball",57304,57304,0,0,0,0,57304,57304,0,".","13",0,37396
"13606",206437,"WALSH UNIVERSITY                                            ","2003-2004",26,"Volleyball",41841,41841,0,0,0,0,41841,41841,0,".","13",0,22722
"13607",183026,"SOUTHERN NEW HAMPSHIRE UNIVERSITY                           ","2003-2004",26,"Volleyball",146780,146780,0,0,0,0,146780,146780,0,".","12",0,26518
"13608",173258,"CARLETON COLLEGE                                            ","2003-2004",26,"Volleyball",51930,51930,0,0,0,0,51930,51930,0,".","14",0,11703
"13612",200217,"UNIVERSITY OF MARY                                          ","2003-2004",26,"Volleyball",118451,118451,0,0,0,0,118451,118451,0,".","26",0,29870
"13614",123509,"SKYLINE COLLEGE                                             ","2003-2004",26,"Volleyball",9337,9337,0,0,0,0,9337,9337,0,".","12",0,9336
"13620",177144,"CULVER-STOCKTON COLLEGE                                     ","2003-2004",26,"Volleyball",35411,35411,0,0,0,0,35411,35411,0,".","25",0,14352
"13625",219295,"PRESENTATION COLLEGE                                        ","2003-2004",26,"Volleyball",28310,28310,0,0,0,0,28310,28310,0,".","12",0,15669
"13628",166638,"UNIVERSITY OF MASSACHUSETTS-BOSTON                          ","2003-2004",26,"Volleyball",24716,24716,0,0,0,0,24716,24716,0,".","12",0,14733
"13630",168607,"ALPENA COMMUNITY COLLEGE                                    ","2003-2004",26,"Volleyball",17712,17712,0,0,0,0,17712,17712,0,".","10",0,8120
"13631",154855,"CENTRAL CHRISTIAN COLLEGE OF KANSAS                         ","2003-2004",26,"Volleyball",11310,11310,0,0,0,0,11310,11310,0,".","14",0,7495
"13633",127389,"LAMAR COMMUNITY COLLEGE                                     ","2003-2004",26,"Volleyball",71745,71745,0,0,0,0,71745,71745,0,".","14",0,12328
"13634",172635,"WAYNE COUNTY COMMUNITY COLLEGE DISTRICT                     ","2003-2004",26,"Volleyball",25000,25000,0,0,0,0,25000,25000,0,"0","12",0,10000
"13635",204909,"OHIO WESLEYAN UNIVERSITY                                    ","2003-2004",26,"Volleyball",56862,56862,0,0,0,0,56862,56862,0,".","16",0,14527
"13639",204185,"MOUNT UNION COLLEGE                                         ","2003-2004",26,"Volleyball",42148,42148,0,0,0,0,42148,42148,0,".","19",0,17431
"13642",164270,"MCDANIEL COLLEGE                                            ","2003-2004",26,"Volleyball",54915,54915,0,0,0,0,54915,54915,0,".","13",0,21756
"13644",155201,"INDEPENDENCE COMMUNITY COLLEGE                              ","2003-2004",26,"Volleyball",39164,39164,0,0,0,0,39164,39164,0,".","11",0,9768
"13645",183080,"PLYMOUTH STATE UNIVERSITY                                   ","2003-2004",26,"Volleyball",65642,65642,0,0,0,0,65642,65642,0,".","14",0,29687
"13653",242671,"INTER AMERICAN UNIV OF PUERTO RICO-CENTRAL OFFICE           ","2003-2004",26,"Volleyball",96720,96720,0,46411,46411,0,50309,50309,0,"11","13",8244,14153
"13656",172963,"ANOKA-RAMSEY COMMUNITY COLLEGE-COON RAPIDS CAMPUS           ","2003-2004",26,"Volleyball",14943,14943,0,0,0,0,14943,14943,0,".","9",0,6029
"13661",112260,"CLAREMONT MCKENNA COLLEGE                                   ","2003-2004",26,"Volleyball",56910,56910,0,0,0,0,56910,56910,0,".","12",0,13261
"13662",150677,"GRACE COLLEGE AND THEOLOGICAL SEMINARY                      ","2003-2004",26,"Volleyball",79241,79241,0,0,0,0,79241,79241,0,".","11",0,18937
"13663",157535,"PIKEVILLE COLLEGE                                           ","2003-2004",26,"Volleyball",35004,35004,0,0,0,0,35004,35004,0,".","12",0,18069
"13665",243577,"UNIVERSIDAD POLITECNICA DE PUERTO RICO                      ","2003-2004",26,"Volleyball",24000,24000,0,12000,12000,0,12000,12000,0,"12","12",1000,1000
"13673",200572,"VALLEY CITY STATE UNIVERSITY                                ","2003-2004",26,"Volleyball",36978,36978,0,0,0,0,36978,36978,0,".","13",0,11132
"13678",186283,"RIDER UNIVERSITY                                            ","2003-2004",26,"Volleyball",216935,216935,0,0,0,0,216935,216935,0,".","13",0,22744
"13679",212160,"EDINBORO UNIVERSITY OF PENNSYLVANIA                         ","2003-2004",26,"Volleyball",200043,200043,0,0,0,0,200043,200043,0,".","14",0,41949
"13683",229841,"WHARTON COUNTY JUNIOR COLLEGE                               ","2003-2004",26,"Volleyball",36546,36546,0,0,0,0,36546,36546,0,".","10",0,15834
"13690",214759,"PENNSYLVANIA STATE UNIVERSITY-PENN STATE FAYETTE            ","2003-2004",26,"Volleyball",17725,17725,0,0,0,0,17725,17725,0,".","8",0,4800
"13693",157818,"TRANSYLVANIA UNIVERSITY                                     ","2003-2004",26,"Volleyball",50185,50185,0,0,0,0,50185,50185,0,".","12",0,18911
"13700",210739,"DESALES UNIVERSITY                                          ","2003-2004",26,"Volleyball",35673,35673,0,0,0,0,35673,35673,0,".","12",0,13708
"13706",130916,"DELAWARE TECHNICAL &amp; COMM COLL-STANTON-WILMINGTON           ","2003-2004",26,"Volleyball",13084,13084,0,0,0,0,13084,13084,0,".","9",0,7659
"13707",166133,"HOLYOKE COMMUNITY COLLEGE                                   ","2003-2004",26,"Volleyball",6000,6000,0,0,0,0,6000,6000,0,".","12",0,2400
"13711",190725,"DAEMEN COLLEGE                                              ","2003-2004",26,"Volleyball",141663,141663,0,0,0,0,141663,141663,0,".","12",0,31051
"13712",173160,"BETHEL COLLEGE                                              ","2003-2004",26,"Volleyball",40022,40022,0,0,0,0,40022,40022,0,".","22",0,16500
"13713",165574,"DEAN COLLEGE                                                ","2003-2004",26,"Volleyball",31422,31422,0,0,0,0,31422,31422,0,".","10",0,5122
"13717",137315,"SOUTH FLORIDA COMMUNITY COLLEGE                             ","2003-2004",26,"Volleyball",101627,101627,0,0,0,0,101627,101627,0,"0","12",0,24291
"13734",213358,"LA ROCHE COLLEGE                                            ","2003-2004",26,"Volleyball",14672,14672,0,0,0,0,14672,14672,0,".","9",0,7668
"13735",214801,"PENNSYLVANIA STATE UNIVERSITY-PENN STATE ABINGTON           ","2003-2004",26,"Volleyball",7531,7531,0,0,0,0,7531,7531,0,".","11",0,2870
"13737",133809,"FLORIDA COLLEGE                                             ","2003-2004",26,"Volleyball",81781,81781,0,0,0,0,81781,81781,0,".","12",0,20399
"13743",214810,"PENNSYLVANIA STATE UNIVERSITY-PENN STATE SCHUYLKIL          ","2003-2004",26,"Volleyball",2000,2000,0,0,0,0,2000,2000,0,".","12",0,2004
"13744",190840,"DUTCHESS COMMUNITY COLLEGE                                  ","2003-2004",26,"Volleyball",9000,9000,0,0,0,0,9000,9000,0,".","10",0,2750
"13746",128902,"CONNECTICUT COLLEGE                                         ","2003-2004",26,"Volleyball",65751,65751,0,0,0,0,65751,65751,0,".","15",0,13702
"13747",168227,"WENTWORTH INSTITUTE OF TECHNOLOGY                           ","2003-2004",26,"Volleyball",25747,25747,0,13880,13880,0,11867,11867,0,"14","14",7885,5872
"13753",196033,"SUNY COLLEGE OF AGRIC AND TECHN AT COBLESKILL               ","2003-2004",26,"Volleyball",6894,6894,0,0,0,0,6894,6894,0,".","13",0,5317
"13757",223922,"CLARENDON COLLEGE                                           ","2003-2004",26,"Volleyball",30365,30365,0,0,0,0,30365,30365,0,".","15",0,11711
"13758",123554,"SAINT MARYS COLLEGE OF CALIFORNIA                           ","2003-2004",26,"Volleyball",572309,572309,0,0,0,0,572309,572309,0,"0","13",0,57966
"13759",199768,"SURRY COMMUNITY COLLEGE                                     ","2003-2004",26,"Volleyball",7552,7552,0,0,0,0,7552,7552,0,".","9",0,3522
"13768",196042,"FARMINGDALE STATE UNIVERSITY OF NEW YORK                    ","2003-2004",26,"Volleyball",25600,25600,0,0,0,0,25600,25600,0,".","10",0,12600
"13771",197294,"SUNY WESTCHESTER COMMMUNITY COLLEGE                         ","2003-2004",26,"Volleyball",8192,8192,0,0,0,0,8192,8192,0,"0","9",0,2500
"13772",191126,"FASHION INSTITUTE OF TECHNOLOGY                             ","2003-2004",26,"Volleyball",21350,21350,0,0,0,0,21350,21350,0,".","15",0,15600
"13774",167729,"SALEM STATE COLLEGE                                         ","2003-2004",26,"Volleyball",10573,10573,0,0,0,0,10573,10573,0,"0","13",0,9803
"13776",213400,"LANCASTER BIBLE COLLEGE                                     ","2003-2004",26,"Volleyball",11001,11001,0,3826,3826,0,7175,7175,0,"10","12",2476,5555
"13779",164447,"AMERICAN INTERNATIONAL COLLEGE                              ","2003-2004",26,"Volleyball",24400,24400,0,0,0,0,24400,24400,0,".","11",0,18800
"13783",155292,"KANSAS CITY KANSAS COMMUNITY COLLEGE                        ","2003-2004",26,"Volleyball",50500,50500,0,0,0,0,50500,50500,0,".","15",0,18500
"13784",366252,"PENNSYLVANIA COLLEGE OF TECHNOLOGY                          ","2003-2004",26,"Volleyball",13712,13712,0,11262,11262,0,2450,2450,0,"12","13",6204,1495
"13785",215114,"PHILADELPHIA BIBLICAL UNIVERSITY-LANGHORNE                  ","2003-2004",26,"Volleyball",34393,34393,0,18989,18989,0,15404,15404,0,"12","11",15304,11289
"13788",105154,"MESA COMMUNITY COLLEGE                                      ","2003-2004",26,"Volleyball",18000,18000,0,0,0,0,18000,18000,0,".","15",0,10500
"13789",143288,"BLACKBURN COLLEGE                                           ","2003-2004",26,"Volleyball",15730,15730,0,0,0,0,15730,15730,0,".","13",0,5908
"13792",234173,"VIRGINIA WESLEYAN COLLEGE                                   ","2003-2004",26,"Volleyball",12749,12749,0,0,0,0,12749,12749,0,".","13",0,7249
"13797",190664,"CUNY QUEENS COLLEGE                                         ","2003-2004",26,"Volleyball",98746,98746,0,31589,31589,0,67157,67157,0,"15","12",5501,9359
"13798",144971,"EUREKA COLLEGE                                              ","2003-2004",26,"Volleyball",22117,22117,0,0,0,0,22117,22117,0,".","10",0,9167
"13803",150941,"HUNTINGTON COLLEGE                                          ","2003-2004",26,"Volleyball",55820,55820,0,0,0,0,55820,55820,0,".","10",0,12220
"13806",141644,"HAWAII PACIFIC UNIVERSITY                                   ","2003-2004",26,"Volleyball",277873,277873,0,0,0,0,277873,277873,0,".","13",0,73228
"13808",169521,"DELTA COLLEGE                                               ","2003-2004",26,"Volleyball",10194,10194,0,0,0,0,10194,10194,0,".","9",0,5194
"13811",126669,"COLORADO CHRISTIAN UNIVERSITY                               ","2003-2004",26,"Volleyball",145108,145108,0,0,0,0,145108,145108,0,".","13",0,17043
"13813",100760,"CENTRAL ALABAMA COMMUNITY COLLEGE                           ","2003-2004",26,"Volleyball",20783,20783,0,0,0,0,20783,20783,0,".","9",0,8586
"13819",156082,"WASHBURN UNIVERSITY OF TOPEKA                               ","2003-2004",26,"Volleyball",31206,31206,0,0,0,0,31206,31206,0,".","15",0,26269
"13820",118718,"MERCED COLLEGE                                              ","2003-2004",26,"Volleyball",11857,11857,0,0,0,0,11857,11857,0,".","12",0,5
"13836",130934,"DELAWARE STATE UNIVERSITY                                   ","2003-2004",26,"Volleyball",139329,139329,0,0,0,0,139329,139329,0,".","8",0,23079
"13838",191533,"HARTWICK COLLEGE                                            ","2003-2004",26,"Volleyball",84240,84240,0,0,0,0,84240,84240,0,".","17",0,23546
"13840",100937,"BIRMINGHAM SOUTHERN COLLEGE                                 ","2003-2004",26,"Volleyball",479612,479612,0,0,0,0,479612,479612,0,".","12",0,57540
"13843",133702,"FLORIDA COMMUNITY COLLEGE AT JACKSONVILLE                   ","2003-2004",26,"Volleyball",186890,186890,0,0,0,0,186890,186890,0,".","15",0,80422
"13847",219198,"MOUNT MARTY COLLEGE                                         ","2003-2004",26,"Volleyball",73091,73091,0,0,0,0,73091,73091,0,".","15",0,16464
"13858",160621,"SOUTHERN UNIVERSITY AND A &amp; M COLLEGE                       ","2003-2004",26,"Volleyball",30839,30839,0,0,0,0,30839,30839,0,".","7",0,3084
"13865",101189,"FAULKNER UNIVERSITY                                         ","2003-2004",26,"Volleyball",194918,194918,0,0,0,0,194918,194918,0,".","9",0,77916
"13869",150534,"UNIVERSITY OF EVANSVILLE                                    ","2003-2004",26,"Volleyball",386191,386191,0,0,0,0,386191,386191,0,".","12",0,38757
"13879",193478,"NASSAU COMMUNITY COLLEGE                                    ","2003-2004",26,"Volleyball",19371,19371,0,0,0,0,19371,19371,0,".","13",0,8758
"13882",237932,"WEST LIBERTY STATE COLLEGE                                  ","2003-2004",26,"Volleyball",26408,26408,0,0,0,0,26408,26408,0,"0","10",0,8293
"13889",154493,"UPPER IOWA UNIVERSITY                                       ","2003-2004",26,"Volleyball",87985,87985,0,0,0,0,87985,87985,0,".","12",0,20500
"13893",237950,"WEST VIRGINIA UNIVERSITY INSTITUTE OF TECHNOLOGY            ","2003-2004",26,"Volleyball",5956,5956,0,0,0,0,5956,5956,0,".","6",0,4712
"13902",213996,"MESSIAH COLLEGE                                             ","2003-2004",26,"Volleyball",50524,50524,0,0,0,0,50524,50524,0,".","12",0,22503
"13913",136473,"PENSACOLA JUNIOR COLLEGE                                    ","2003-2004",26,"Volleyball",94488,94488,0,0,0,0,94488,94488,0,".","13",0,24138
"13916",156745,"GEORGETOWN COLLEGE                                          ","2003-2004",26,"Volleyball",219001,219001,0,0,0,0,219001,219001,0,".","14",0,28963
"13918",236133,"NORTHWEST COLLEGE OF THE ASSEMBLIES OF GOD                  ","2003-2004",26,"Volleyball",138925,138925,0,0,0,0,138925,138925,0,".","10",0,18914
"13927",201973,"CLARK STATE COMMUNITY COLLEGE                               ","2003-2004",26,"Volleyball",32526,32526,0,0,0,0,32526,32526,0,".","8",0,13876
"13931",209612,"PACIFIC UNIVERSITY                                          ","2003-2004",26,"Volleyball",36522,36522,0,0,0,0,36522,36522,0,".","14",0,16743
"13937",165334,"CLARK UNIVERSITY                                            ","2003-2004",26,"Volleyball",44770,44770,0,0,0,0,44770,44770,0,".","13",0,9516
"13943",219790,"BRYAN COLLEGE                                               ","2003-2004",26,"Volleyball",11685,11685,0,0,0,0,11685,11685,0,".","11",0,11528
"13951",206862,"SOUTHERN NAZARENE UNIVERSITY                                ","2003-2004",26,"Volleyball",102621,102621,0,0,0,0,102621,102621,0,".","14",0,12692
"13955",110051,"BETHANY COLLEGE OF THE ASSEMBLIES OF GOD                    ","2003-2004",26,"Volleyball",116148,116148,0,0,0,0,116148,116148,0,".","11",0,21052
"13957",233912,"VIRGINIA INTERMONT COLLEGE                                  ","2003-2004",26,"Volleyball",17700,17700,0,0,0,0,17700,17700,0,"0","8",0,16889
"13959",157100,"KENTUCKY CHRISTIAN COLLEGE                                  ","2003-2004",26,"Volleyball",19590,19590,0,0,0,0,19590,19590,0,".","16",0,15270
"13962",213659,"LUZERNE COUNTY COMMUNITY COLLEGE                            ","2003-2004",26,"Volleyball",9000,9000,0,0,0,0,9000,9000,0,".","12",0,4000
"13970",107141,"JOHN BROWN UNIVERSITY                                       ","2003-2004",26,"Volleyball",153670,153670,0,0,0,0,153670,153670,0,".","12",0,21487
"13972",154235,"SAINT AMBROSE UNIVERSITY                                    ","2003-2004",26,"Volleyball",175677,175677,0,52061,52061,0,123616,123616,0,"13","30",11211,15789
"13976",214272,"NEUMANN COLLEGE                                             ","2003-2004",26,"Volleyball",23349,23349,0,0,0,0,23349,23349,0,".","9",0,15550
"13980",137476,"SAINT THOMAS UNIVERSITY                                     ","2003-2004",26,"Volleyball",137240,137240,0,0,0,0,137240,137240,0,"0","12",0,19000
"13981",170037,"CORNERSTONE UNIVERSITY                                      ","2003-2004",26,"Volleyball",50975,50975,0,0,0,0,50975,50975,0,".","15",0,21176
"13982",200226,"MAYVILLE STATE UNIVERSITY                                   ","2003-2004",26,"Volleyball",12332,12332,0,0,0,0,12332,12332,0,".","13",0,11742
"13995",132693,"BREVARD COMMUNITY COLLEGE-COCOA CAMPUS                      ","2003-2004",26,"Volleyball",43425,43425,0,0,0,0,43425,43425,0,".","12",0,8925
"13998",130493,"SOUTHERN CONNECTICUT STATE UNIVERSITY                       ","2003-2004",26,"Volleyball",51909,51909,0,0,0,0,51909,51909,0,".","11",0,16439
"13999",196291,"SUNY MARITIME COLLEGE                                       ","2003-2004",26,"Volleyball",13749,13749,0,0,0,0,13749,13749,0,".","12",0,5749
"14000",166647,"MASSACHUSETTS BAY COMMUNITY COLLEGE                         ","2003-2004",26,"Volleyball",6418,6418,0,3209,3209,0,3209,3209,0,"9","8",959,959
"14002",155195,"HUTCHINSON COMMUNITY COLLEGE                                ","2003-2004",26,"Volleyball",55357,55357,0,0,0,0,55357,55357,0,".","13",0,20736
"14003",214625,"PENNSYLVANIA STATE UNIV-PENN STATE NEW KENSINGTON           ","2003-2004",26,"Volleyball",7897,7897,0,0,0,0,7897,7897,0,".","7",0,5373
"14014",137953,"TRINITY BAPTIST COLLEGE                                     ","2003-2004",26,"Volleyball",4800,4800,0,0,0,0,4800,4800,0,".","10",0,3800
"14017",195474,"SIENA COLLEGE                                               ","2003-2004",26,"Volleyball",464256,464256,0,0,0,0,464256,464256,0,".","13",0,152620
"14021",196565,"TOMPKINS-CORTLAND COMMUNITY COLLEGE                         ","2003-2004",26,"Volleyball",11892,11892,0,0,0,0,11892,11892,0,"0","9",0,8223
"14022",190646,"CUNY MEDGAR EVERS COLLEGE                                   ","2003-2004",26,"Volleyball",8850,8850,0,4750,4750,0,4100,4100,0,"16","14",4000,4000
"14023",207281,"NORTHERN OKLAHOMA COLLEGE                                   ","2003-2004",26,"Volleyball",27535,27535,0,0,0,0,27535,27535,0,".","13",0,11350
"14024",205203,"UNIVERSITY OF RIO GRANDE                                    ","2003-2004",26,"Volleyball",47036,47036,0,0,0,0,47036,47036,0,".","17",0,6864
"14038",195544,"SAINT JOSEPHS COLLEGE-MAIN CAMPUS                           ","2003-2004",26,"Volleyball",43367,43367,0,0,0,0,43367,43367,0,".","10",0,35000
"14046",147800,"OAKTON COMMUNITY COLLEGE                                    ","2003-2004",26,"Volleyball",4888,4888,0,0,0,0,4888,4888,0,".","9",0,4887
"14051",193016,"MERCY COLLEGE-MAIN CAMPUS                                   ","2003-2004",26,"Volleyball",19000,19000,0,0,0,0,19000,19000,0,"0","9",0,9000
"14052",183743,"BERGEN COMMUNITY COLLEGE                                    ","2003-2004",26,"Volleyball",7725,7725,0,0,0,0,7725,7725,0,".","10",0,7000
"14057",124113,"TAFT COLLEGE                                                ","2003-2004",26,"Volleyball",14225,14225,0,0,0,0,14225,14225,0,".","12",0,6990
"14059",111887,"CERRITOS COLLEGE                                            ","2003-2004",26,"Volleyball",37761,37761,0,0,0,0,37761,37761,0,".","12",0,2878
"14061",161563,"THOMAS COLLEGE                                              ","2003-2004",26,"Volleyball",4776,4776,0,0,0,0,4776,4776,0,".","9",0,2376
"14064",214768,"PENNSYLVANIA STATE UNIVERSITY-PENN STATE HAZLETON           ","2003-2004",26,"Volleyball",5000,5000,0,0,0,0,5000,5000,0,".","9",0,3000
"14069",161572,"UNITY COLLEGE                                               ","2003-2004",26,"Volleyball",5500,5500,0,0,0,0,5500,5500,0,".","11",0,2500
"14075",210775,"ALVERNIA COLLEGE                                            ","2003-2004",26,"Volleyball",12093,12093,0,0,0,0,12093,12093,0,".","11",0,4638
"14081",173203,"CENTRAL LAKES COLLEGE-BRAINERD                              ","2003-2004",26,"Volleyball",22575,22575,0,0,0,0,22575,22575,0,".","11",0,12162
"14084",107080,"HENDRIX COLLEGE                                             ","2003-2004",26,"Volleyball",76600,76600,0,0,0,0,76600,76600,0,".","16",0,27600
"14086",161864,"BALTIMORE CITY COMMUNITY COLLEGE                            ","2003-2004",26,"Volleyball",29850,29850,0,0,0,0,29850,29850,0,".","11",0,19850
"14089",167288,"MASSACHUSETTS COLLEGE OF LIBERAL ARTS                       ","2003-2004",26,"Volleyball",14087,14087,0,0,0,0,14087,14087,0,".","10",0,9087
"14090",232025,"EMORY AND HENRY COLLEGE                                     ","2003-2004",26,"Volleyball",20339,20339,0,0,0,0,20339,20339,0,".","10",0,12683
"14091",104160,"ARIZONA WESTERN COLLEGE                                     ","2003-2004",26,"Volleyball",92008,92008,0,0,0,0,92008,92008,0,".","11",0,42322
"14095",162007,"BOWIE STATE UNIVERSITY                                      ","2003-2004",26,"Volleyball",39441,39441,0,0,0,0,39441,39441,0,"0","9",0,12491
"14103",146472,"COLLEGE OF LAKE COUNTY                                      ","2003-2004",26,"Volleyball",15687,15687,0,0,0,0,15687,15687,0,".","10",0,11362
"14105",145646,"ILLINOIS WESLEYAN UNIVERSITY                                ","2003-2004",26,"Volleyball",50803,50803,0,0,0,0,50803,50803,0,".","16",0,13731
"14107",235103,"EDMONDS COMMUNITY COLLEGE                                   ","2003-2004",26,"Volleyball",18145,18145,0,0,0,0,18145,18145,0,".","12",0,9089
"14110",212674,"GETTYSBURG COLLEGE                                          ","2003-2004",26,"Volleyball",71386,71386,0,0,0,0,71386,71386,0,".","14",0,12505
"14122",198817,"LENOIR COMMUNITY COLLEGE                                    ","2003-2004",26,"Volleyball",17004,17004,0,0,0,0,17004,17004,0,".","9",0,11490
"14131",190619,"CUNY KINGSBOROUGH COMMUNITY COLLEGE                         ","2003-2004",26,"Volleyball",11033,11033,0,0,0,0,11033,11033,0,".","16",0,6451
"14136",130590,"TRINITY COLLEGE                                             ","2003-2004",26,"Volleyball",53885,53885,0,0,0,0,53885,53885,0,".","13",0,12636
"14137",162557,"FREDERICK COMMUNITY COLLEGE                                 ","2003-2004",26,"Volleyball",8057,8057,0,0,0,0,8057,8057,0,".","8",0,2507
"14141",149842,"WILLIAM RAINEY HARPER COLLEGE                               ","2003-2004",26,"Volleyball",19754,19754,0,0,0,0,19754,19754,0,".","12",0,7584
"14142",175856,"JACKSON STATE UNIVERSITY                                    ","2003-2004",26,"Volleyball",196910,196910,0,0,0,0,196910,196910,0,".","11",0,54257
"14143",122375,"SAN DIEGO MESA COLLEGE                                      ","2003-2004",26,"Volleyball",35092,35092,0,15977,15977,0,19115,19115,0,"13","11",5469,5165
"14144",201858,"CINCINNATI BIBLE COLLEGE AND SEMINARY                       ","2003-2004",26,"Volleyball",8508,8508,0,0,0,0,8508,8508,0,".","9",0,7008
"14149",177551,"HARRIS-STOWE STATE COLLEGE                                  ","2003-2004",26,"Volleyball",42532,42532,0,0,0,0,42532,42532,0,".","13",0,10854
"14150",180522,"MONTANA STATE UNIVERSITY-NORTHERN                           ","2003-2004",26,"Volleyball",77589,77589,0,0,0,0,77589,77589,0,".","14",0,25784
"14152",217156,"BROWN UNIVERSITY                                            ","2003-2004",26,"Volleyball",135310,135310,0,0,0,0,135310,135310,0,".","16",0,32539
"14158",153375,"GRAND VIEW COLLEGE                                          ","2003-2004",26,"Volleyball",103045,103045,0,0,0,0,103045,103045,0,".","17",0,21075
"14160",243586,"PONTIFICAL CATHOLIC UNIV OF PUERTO RICO-MAYAGUEZ            ","2003-2004",26,"Volleyball",8199,8199,0,4072,4072,0,4127,4127,0,"12","12",1566,1587
"14163",140720,"PAINE COLLEGE                                               ","2003-2004",26,"Volleyball",81786,81786,0,0,0,0,81786,81786,0,".","12",0,21956
"14165",120254,"OCCIDENTAL COLLEGE                                          ","2003-2004",26,"Volleyball",22309,22309,0,0,0,0,22309,22309,0,".","13",0,10434
"14179",202134,"CLEVELAND STATE UNIVERSITY                                  ","2003-2004",26,"Volleyball",303910,303910,0,0,0,0,303910,303910,0,".","14",0,39124
"14183",176789,"CALVARY BIBLE COLLEGE AND THEOLOGICAL SEMINARY              ","2003-2004",26,"Volleyball",9684,9684,0,0,0,0,9684,9684,0,".","8",0,3896
"14188",117274,"LASSEN COMMUNITY COLLEGE                                    ","2003-2004",26,"Volleyball",44569,44569,0,0,0,0,44569,44569,0,".","18",0,10000
"14196",150163,"BUTLER UNIVERSITY                                           ","2003-2004",26,"Volleyball",445864,445864,0,0,0,0,445864,445864,0,".","15",0,40159
"14204",154712,"BENEDICTINE COLLEGE                                         ","2003-2004",26,"Volleyball",129844,129844,0,0,0,0,129844,129844,0,".","22",0,24966
"14221",147378,"MORAINE VALLEY COMMUNITY COLLEGE                            ","2003-2004",26,"Volleyball",15579,15579,0,0,0,0,15579,15579,0,".","13",0,9285
"14222",165671,"EMMANUEL COLLEGE                                            ","2003-2004",26,"Volleyball",57587,57587,0,29860,29860,0,27727,27727,0,"12","14",14176,10049
"14226",110714,"UNIVERSITY OF CALIFORNIA-SANTA CRUZ                         ","2003-2004",26,"Volleyball",45459,45459,0,18843,18843,0,26616,26616,0,"15","13",16132,18063
"14234",202523,"DENISON UNIVERSITY                                          ","2003-2004",26,"Volleyball",61796,61796,0,0,0,0,61796,61796,0,".","18",0,20304
"14237",213826,"MARYWOOD UNIVERSITY                                         ","2003-2004",26,"Volleyball",18628,18628,0,0,0,0,18628,18628,0,".","16",0,12404
"14239",145691,"ILLINOIS COLLEGE                                            ","2003-2004",26,"Volleyball",33595,33595,0,0,0,0,33595,33595,0,".","24",0,19531
"14243",104577,"EASTERN ARIZONA COLLEGE                                     ","2003-2004",26,"Volleyball",88357,88357,0,0,0,0,88357,88357,0,".","16",0,34005
"14253",138947,"CLARK ATLANTA UNIVERSITY                                    ","2003-2004",26,"Volleyball",103000,103000,0,0,0,0,103000,103000,0,"0","10",0,25000
"14254",162283,"COPPIN STATE COLLEGE                                        ","2003-2004",26,"Volleyball",134085,134085,0,0,0,0,134085,134085,0,".","11",0,17212
"14267",170657,"LANSING COMMUNITY COLLEGE                                   ","2003-2004",26,"Volleyball",43235,43235,0,0,0,0,43235,43235,0,".","11",0,13653
"14268",116439,"IRVINE VALLEY COLLEGE                                       ","2003-2004",26,"Volleyball",69093,69093,0,34789,34789,0,34304,34304,0,"13","11",9845,4950
"14271",239017,"LAWRENCE UNIVERSITY                                         ","2003-2004",26,"Volleyball",40956,40956,0,0,0,0,40956,40956,0,".","14",0,18976
"14272",122977,"SANTA MONICA COLLEGE                                        ","2003-2004",26,"Volleyball",47229,47229,0,21751,21751,0,25478,25478,0,"11","11",5751,7428
"14273",221953,"TUSCULUM COLLEGE                                            ","2003-2004",26,"Volleyball",106495,106495,0,0,0,0,106495,106495,0,".","14",0,19706
"14274",101480,"JACKSONVILLE STATE UNIVERSITY                               ","2003-2004",26,"Volleyball",251729,251729,0,0,0,0,251729,251729,0,"0","12",0,251728
"14280",215947,"SETON HILL UNIVERSITY                                       ","2003-2004",26,"Volleyball",30571,30571,0,0,0,0,30571,30571,0,".","15",0,24000
"14282",166692,"MASSACHUSETTS MARITIME ACADEMY                              ","2003-2004",26,"Volleyball",10000,10000,0,0,0,0,10000,10000,0,".","12",0,3500
"14290",218399,"MORRIS COLLEGE                                              ","2003-2004",26,"Volleyball",7781,7781,0,0,0,0,7781,7781,0,".","10",0,2113
"14292",133492,"ECKERD COLLEGE                                              ","2003-2004",26,"Volleyball",110712,110712,0,0,0,0,110712,110712,0,".","12",0,19039
"14302",128258,"TRINIDAD STATE JUNIOR COLLEGE                               ","2003-2004",26,"Volleyball",73658,73658,0,0,0,0,73658,73658,0,".","13",0,29583
"14303",163851,"SALISBURY UNIVERSITY                                        ","2003-2004",26,"Volleyball",20502,20502,0,0,0,0,20502,20502,0,".","14",0,12175
"14305",193283,"MOHAWK VALLEY COMMUNITY COLLEGE-UTICA BRANCH                ","2003-2004",26,"Volleyball",20812,20812,0,0,0,0,20812,20812,0,".","13",0,13988
"14307",126182,"ADAMS STATE COLLEGE                                         ","2003-2004",26,"Volleyball",110114,110114,0,0,0,0,110114,110114,0,".","17",0,20763
"14313",155070,"BARCLAY COLLEGE                                             ","2003-2004",26,"Volleyball",5325,5325,0,0,0,0,5325,5325,0,"0","10",0,3875
"14319",126748,"COLORADO NORTHWESTERN COMMUNITY COLLEGE                     ","2003-2004",26,"Volleyball",98469,98469,0,0,0,0,98469,98469,0,".","12",0,32568
"14322",201195,"BALDWIN-WALLACE COLLEGE                                     ","2003-2004",26,"Volleyball",79693,79693,0,0,0,0,79693,79693,0,".","14",0,30218
"14329",101736,"NORTHWEST SHOALS COMMUNITY COLLEGE-MUSCLE SHOALS            ","2003-2004",26,"Volleyball",28074,28074,0,0,0,0,28074,28074,0,".","12",0,18700
"14337",148335,"ROBERT MORRIS COLLEGE                                       ","2003-2004",26,"Volleyball",178212,178212,0,0,0,0,178212,178212,0,".","14",0,38159
"14354",139205,"BREWTON-PARKER COLLEGE                                      ","2003-2004",26,"Volleyball",102238,102238,0,0,0,0,102238,102238,0,".","14",0,20140
"14356",216339,"TEMPLE UNIVERSITY                                           ","2003-2004",26,"Volleyball",530737,530737,0,0,0,0,530737,530737,0,".","15",0,65450
"14366",121044,"PASADENA CITY COLLEGE                                       ","2003-2004",26,"Volleyball",31716,31716,0,0,0,0,31716,31716,0,".","10",0,1500
"14380",234155,"VIRGINIA STATE UNIVERSITY                                   ","2003-2004",26,"Volleyball",62611,62611,0,0,0,0,62611,62611,0,".","14",0,15073
"14400",175157,"VERMILION COMMUNITY COLLEGE                                 ","2003-2004",26,"Volleyball",33065,33065,0,0,0,0,33065,33065,0,".","10",0,9705
"14412",117690,"LOS ANGELES HARBOR COLLEGE                                  ","2003-2004",26,"Volleyball",37970,37970,0,0,0,0,37970,37970,0,".","12",0,6981
"14413",226471,"UNIVERSITY OF MARY HARDIN-BAYLOR                            ","2003-2004",26,"Volleyball",74123,74123,0,0,0,0,74123,74123,0,".","13",0,25945
"14414",190549,"CUNY BROOKLYN COLLEGE                                       ","2003-2004",26,"Volleyball",28825,28825,0,15230,15230,0,13595,13595,0,"14","14",9062,7666
"14415",203775,"MALONE COLLEGE                                              ","2003-2004",26,"Volleyball",97063,97063,0,0,0,0,97063,97063,0,"0","15",0,24243
"14417",230898,"GREEN MOUNTAIN COLLEGE                                      ","2003-2004",26,"Volleyball",11256,11256,0,0,0,0,11256,11256,0,".","8",0,7256
"14418",122436,"UNIVERSITY OF SAN DIEGO                                     ","2003-2004",26,"Volleyball",616464,616464,0,0,0,0,616464,616464,0,".","15",0,56589
"14421",228431,"STEPHEN F AUSTIN STATE UNIVERSITY                           ","2003-2004",26,"Volleyball",231050,231050,0,0,0,0,231050,231050,0,".","12",0,38490
"14424",133553,"EMBRY RIDDLE AERONAUTICAL UNIVERSITY-DAYTONA BEACH          ","2003-2004",26,"Volleyball",223024,223024,0,0,0,0,223024,223024,0,".","10",0,192431
"14426",196121,"SUNY COLLEGE AT BROCKPORT                                   ","2003-2004",26,"Volleyball",22089,22089,0,0,0,0,22089,22089,0,".","16",0,21958
"14430",170301,"HOPE COLLEGE                                                ","2003-2004",26,"Volleyball",80327,80327,0,0,0,0,80327,80327,0,".","14",0,14716
"14448",237358,"DAVIS AND ELKINS COLLEGE                                    ","2003-2004",26,"Volleyball",24574,24574,0,0,0,0,24574,24574,0,".","8",0,11063
"14449",110538,"CALIFORNIA STATE UNIVERSITY-CHICO                           ","2003-2004",26,"Volleyball",126620,126620,0,0,0,0,126620,126620,0,".","15",0,25406
"14454",238458,"CARROLL COLLEGE                                             ","2003-2004",26,"Volleyball",19258,19258,0,0,0,0,19258,19258,0,".","15",0,7756
"14456",126775,"COLORADO SCHOOL OF MINES                                    ","2003-2004",26,"Volleyball",148336,148336,0,0,0,0,148336,148336,0,".","15",0,34366
"14462",112190,"CITY COLLEGE OF SAN FRANCISCO                               ","2003-2004",26,"Volleyball",13357,13357,0,0,0,0,13357,13357,0,".","14",0,5233
"14476",214829,"PENNSYLVANIA STATE UNIVERSITY-PENN STATE YORK               ","2003-2004",26,"Volleyball",10180,10180,0,0,0,0,10180,10180,0,".","8",0,6531
"14479",146506,"LAKE LAND COLLEGE                                           ","2003-2004",26,"Volleyball",45585,45585,0,0,0,0,45585,45585,0,".","14",0,23409
"14489",192466,"SOUTHAMPTON COLLEGE OF LONG ISLAND UNIVERSITY               ","2003-2004",26,"Volleyball",119274,119274,0,65506,65506,0,53768,53768,0,"9","9",8184,9450
"14490",134343,"GULF COAST COMMUNITY COLLEGE                                ","2003-2004",26,"Volleyball",60275,60275,0,0,0,0,60275,60275,0,".","14",0,22175
"14497",123217,"COLLEGE OF THE SEQUOIAS                                     ","2003-2004",26,"Volleyball",15295,15295,0,0,0,0,15295,15295,0,".","10",0,4500
"14502",243665,"UNIVERSITY OF THE VIRGIN ISLANDS                            ","2003-2004",26,"Volleyball",85000,85000,0,35000,35000,0,50000,50000,0,"12","16",30000,44000
"14504",127565,"METROPOLITAN STATE COLLEGE OF DENVER                        ","2003-2004",26,"Volleyball",303268,303268,0,0,0,0,303268,303268,0,".","12",0,50294
"14511",232706,"MARYMOUNT UNIVERSITY                                        ","2003-2004",26,"Volleyball",23056,23056,0,0,0,0,23056,23056,0,".","14",0,16848
"14512",176965,"CENTRAL MISSOURI STATE UNIVERSITY                           ","2003-2004",26,"Volleyball",316779,316779,0,0,0,0,316779,316779,0,".","17",0,43679
"14513",136516,"POLK COMMUNITY COLLEGE                                      ","2003-2004",26,"Volleyball",55403,55403,0,0,0,0,55403,55403,0,".","12",0,33501
"14519",178721,"PARK UNIVERSITY                                             ","2003-2004",26,"Volleyball",256715,256715,0,124019,124019,0,132696,132696,0,"12","12",22052,24159
"14527",203368,"JOHN CARROLL UNIVERSITY                                     ","2003-2004",26,"Volleyball",34458,34458,0,0,0,0,34458,34458,0,".","19",0,12069
"14528",212832,"GWYNEDD MERCY COLLEGE                                       ","2003-2004",26,"Volleyball",12710,12710,0,0,0,0,12710,12710,0,".","12",0,5710
"14535",217420,"RHODE ISLAND COLLEGE                                        ","2003-2004",26,"Volleyball",18460,18460,0,0,0,0,18460,18460,0,".","9",0,8757
"14536",225575,"HUSTON-TILLOTSON COLLEGE                                    ","2003-2004",26,"Volleyball",34998,34998,0,0,0,0,34998,34998,0,".","13",0,22998
"14537",218539,"PRESBYTERIAN COLLEGE                                        ","2003-2004",26,"Volleyball",138137,138137,0,0,0,0,138137,138137,0,".","10",0,23703
"14538",122658,"SAN JOAQUIN DELTA COLLEGE                                   ","2003-2004",26,"Volleyball",43024,43024,0,0,0,0,43024,43024,0,".","12",0,12262
"14540",186432,"SAINT PETERS COLLEGE                                        ","2003-2004",26,"Volleyball",178261,178261,0,0,0,0,178261,178261,0,".","10",0,16710
"14541",196185,"SUNY COLLEGE AT ONEONTA                                     ","2003-2004",26,"Volleyball",82691,82691,0,0,0,0,82691,82691,0,".","18",0,18465
"14543",189547,"BROOME COMMUNITY COLLEGE                                    ","2003-2004",26,"Volleyball",17604,17604,0,0,0,0,17604,17604,0,".","14",0,13194
"14559",243212,"UNIVERSITY OF PUERTO RICO-PONCE                             ","2003-2004",26,"Volleyball",21800,21800,0,11630,11630,0,10170,10170,0,"13","12",2010,2010
"14568",366395,"SUFFOLK COUNTY COMMUNITY COLLEGE                            ","2003-2004",26,"Volleyball",16486,16486,0,0,0,0,16486,16486,0,".","13",0,9018
"14569",243179,"UNIVERSITY OF PUERTO RICO-HUMACAO                           ","2003-2004",26,"Volleyball",5500,5500,0,0,0,0,5500,5500,0,".","12",0,4808
"14572",222983,"AUSTIN COLLEGE                                              ","2003-2004",26,"Volleyball",39819,39819,0,0,0,0,39819,39819,0,".","18",0,24285
"14579",152567,"TRI-STATE UNIVERSITY                                        ","2003-2004",26,"Volleyball",39198,39198,0,0,0,0,39198,39198,0,".","17",0,8724
"14585",163046,"LOYOLA COLLEGE IN MARYLAND                                  ","2003-2004",26,"Volleyball",221307,221307,0,0,0,0,221307,221307,0,".","11",0,35630
"14589",230959,"MIDDLEBURY COLLEGE                                          ","2003-2004",26,"Volleyball",32062,32062,0,0,0,0,32062,32062,0,".","14",0,13055
"14594",190600,"CUNY JOHN JAY COLLEGE CRIMINAL JUSTICE                      ","2003-2004",26,"Volleyball",16867,16867,0,0,0,0,16867,16867,0,".","11",0,9113
"14595",135391,"MANATEE COMMUNITY COLLEGE                                   ","2003-2004",26,"Volleyball",53452,53452,0,0,0,0,53452,53452,0,".","12",0,21149
"14599",125091,"VICTOR VALLEY COLLEGE                                       ","2003-2004",26,"Volleyball",37017,37017,0,0,0,0,37017,37017,0,".","9",0,20542
"14601",150668,"GOSHEN COLLEGE                                              ","2003-2004",26,"Volleyball",40287,40287,0,0,0,0,40287,40287,0,".","10",0,10752
"14621",237640,"OHIO VALLEY COLLEGE                                         ","2003-2004",26,"Volleyball",57944,57944,0,0,0,0,57944,57944,0,".","12",0,7460
"14627",173124,"BEMIDJI STATE UNIVERSITY                                    ","2003-2004",26,"Volleyball",123112,123112,0,0,0,0,123112,123112,0,".","11",0,30247
"14635",208646,"EASTERN OREGON UNIVERSITY                                   ","2003-2004",26,"Volleyball",99150,99150,0,0,0,0,99150,99150,0,".","17",0,23823
"14636",170055,"GRAND RAPIDS COMMUNITY COLLEGE                              ","2003-2004",26,"Volleyball",32817,32817,0,0,0,0,32817,32817,0,".","12",0,11351
"14637",216852,"WIDENER UNIVERSITY-MAIN CAMPUS                              ","2003-2004",26,"Volleyball",29051,29051,0,0,0,0,29051,29051,0,".","14",0,8544
"14638",181127,"HASTINGS COLLEGE                                            ","2003-2004",26,"Volleyball",280731,280731,0,0,0,0,280731,280731,0,".","28",0,21381
"14651",217156,"BROWN UNIVERSITY                                            ","2003-2004",27,"Water Polo",86042,86042,0,41926,41926,0,44116,44116,0,"16","17",14963,18276
"14656",110404,"CALIFORNIA INSTITUTE OF TECHNOLOGY                          ","2003-2004",27,"Water Polo",62020,62020,0,30058,30058,0,31962,31962,0,"21","11",8112,9607
"14661",141574,"UNIVERSITY OF HAWAII AT MANOA                               ","2003-2004",27,"Water Polo",312704,312704,0,0,0,0,312704,312704,0,".","22",0,184780
"14663",122977,"SANTA MONICA COLLEGE                                        ","2003-2004",27,"Water Polo",24778,24778,0,0,0,0,24778,24778,0,".","10",0,6411
"14664",120254,"OCCIDENTAL COLLEGE                                          ","2003-2004",27,"Water Polo",62663,62663,0,30884,30884,0,31779,31779,0,"13","13",10134,11029
"14667",112260,"CLAREMONT MCKENNA COLLEGE                                   ","2003-2004",27,"Water Polo",72197,72197,0,32596,32596,0,39601,39601,0,"12","14",10181,15692
"14668",110714,"UNIVERSITY OF CALIFORNIA-SANTA CRUZ                         ","2003-2004",27,"Water Polo",72135,72135,0,31015,31015,0,41120,41120,0,"23","21",15874,15195
"14671",121691,"UNIVERSITY OF REDLANDS                                      ","2003-2004",27,"Water Polo",84476,84476,0,39281,39281,0,45195,45195,0,"25","20",10942,16828
"14675",122658,"SAN JOAQUIN DELTA COLLEGE                                   ","2003-2004",27,"Water Polo",49276,49276,0,31743,31743,0,17533,17533,0,"16","12",9560,10263
"14680",195173,"ST FRANCIS COLLEGE                                          ","2003-2004",27,"Water Polo",147858,147858,0,94180,94180,0,53678,53678,0,"14","11",38981,14473
"14684",125499,"WEST VALLEY COLLEGE                                         ","2003-2004",27,"Water Polo",33500,33500,0,20640,20640,0,12860,12860,0,"16","10",2560,1600
"14689",121044,"PASADENA CITY COLLEGE                                       ","2003-2004",27,"Water Polo",23787,23787,0,0,0,0,23787,23787,0,".","8",0,1500
"14694",211291,"BUCKNELL UNIVERSITY                                         ","2003-2004",27,"Water Polo",233772,233772,0,75053,75053,0,158719,158719,0,"16","28",33101,48871
"14700",122375,"SAN DIEGO MESA COLLEGE                                      ","2003-2004",27,"Water Polo",34638,34638,0,17838,17838,0,16800,16800,0,"13","13",4155,4122
"14705",118718,"MERCED COLLEGE                                              ","2003-2004",27,"Water Polo",24184,24184,0,11648,11648,0,12536,12536,0,"12","17",5448,7336
"14709",195474,"SIENA COLLEGE                                               ","2003-2004",27,"Water Polo",30076,30076,0,0,0,0,30076,30076,0,".","11",0,16249
"14711",115296,"GROSSMONT COLLEGE                                           ","2003-2004",27,"Water Polo",70726,70726,0,45364,45364,0,25362,25362,0,"18","15",12714,8590
"14718",122791,"COLLEGE OF SAN MATEO                                        ","2003-2004",27,"Water Polo",18601,18601,0,0,0,0,18601,18601,0,".","19",0,4750
"14728",166027,"HARVARD UNIVERSITY                                          ","2003-2004",27,"Water Polo",159763,159763,0,73563,73563,0,86200,86200,0,"21","19",23487,43738
"14732",111920,"CHABOT COLLEGE                                              ","2003-2004",27,"Water Polo",1100,1100,0,0,0,0,1100,1100,0,".","17",0,2499
"14734",190664,"CUNY QUEENS COLLEGE                                         ","2003-2004",27,"Water Polo",103567,103567,0,64547,64547,0,39020,39020,0,"14","11",7997,1384
"14739",191533,"HARTWICK COLLEGE                                            ","2003-2004",27,"Water Polo",432578,432578,0,0,0,0,432578,432578,0,".","26",0,52985
"14743",115126,"GOLDEN WEST COLLEGE                                         ","2003-2004",27,"Water Polo",52710,52710,0,32657,32657,0,20053,20053,0,"22","11",10747,8575
"14748",117247,"LANEY COLLEGE                                               ","2003-2004",27,"Water Polo",9733,9733,0,0,0,0,9733,9733,0,".","9",0,9729
"14756",192819,"MARIST COLLEGE                                              ","2003-2004",27,"Water Polo",144549,144549,0,0,0,0,144549,144549,0,".","14",0,25105
"14758",183080,"PLYMOUTH STATE UNIVERSITY                                   ","2003-2004",28,"Wrestling",42686,42686,0,42686,42686,0,0,0,0,"18",".",24811,0
"14761",169248,"CENTRAL MICHIGAN UNIVERSITY                                 ","2003-2004",28,"Wrestling",391211,391211,0,391211,391211,0,0,0,0,"37",".",39492,0
"14769",217156,"BROWN UNIVERSITY                                            ","2003-2004",28,"Wrestling",212927,212927,0,212927,212927,0,0,0,0,"27",".",53298,0
"14772",204857,"OHIO UNIVERSITY-MAIN CAMPUS                                 ","2003-2004",28,"Wrestling",264462,264462,0,264462,264462,0,0,0,0,"26",".",36765,0
"14775",113856,"EAST LOS ANGELES COLLEGE                                    ","2003-2004",28,"Wrestling",31883,31883,0,31883,31883,0,0,0,0,"13",".",5000,0
"14776",204264,"MUSKINGUM COLLEGE                                           ","2003-2004",28,"Wrestling",17934,17934,0,17934,17934,0,0,0,0,"35",".",17436,0
"14785",184791,"GLOUCESTER COUNTY COLLEGE                                   ","2003-2004",28,"Wrestling",12606,12606,0,12606,12606,0,0,0,0,"22",".",12606,0
"14790",239017,"LAWRENCE UNIVERSITY                                         ","2003-2004",28,"Wrestling",34133,34133,0,34133,34133,0,0,0,0,"17",".",29133,0
"14793",125499,"WEST VALLEY COLLEGE                                         ","2003-2004",28,"Wrestling",16960,16960,0,16960,16960,0,0,0,0,"20",".",3200,0
"14820",154493,"UPPER IOWA UNIVERSITY                                       ","2003-2004",28,"Wrestling",110779,110779,0,110779,110779,0,0,0,0,"41",".",43817,0
"14821",238616,"CONCORDIA UNIVERSITY-WISCONSIN                              ","2003-2004",28,"Wrestling",15686,15686,0,15686,15686,0,0,0,0,"24",".",7220,0
"14830",217235,"JOHNSON &amp; WALES UNIVERSITY                                  ","2003-2004",28,"Wrestling",41684,41684,0,41684,41684,0,0,0,0,"23",".",29134,0
"14835",183743,"BERGEN COMMUNITY COLLEGE                                    ","2003-2004",28,"Wrestling",11540,11540,0,11540,11540,0,0,0,0,"14",".",6500,0
"14843",193900,"NEW YORK UNIVERSITY                                         ","2003-2004",28,"Wrestling",135991,135991,0,135991,135991,0,0,0,0,"21",".",63135,0
"14848",156541,"CUMBERLAND COLLEGE                                          ","2003-2004",28,"Wrestling",496455,496455,0,322519,322519,0,173936,173936,0,"17","30",9894,42750
"14849",204185,"MOUNT UNION COLLEGE                                         ","2003-2004",28,"Wrestling",40544,40544,0,40544,40544,0,0,0,0,"29",".",15361,0
"14851",126182,"ADAMS STATE COLLEGE                                         ","2003-2004",28,"Wrestling",117486,117486,0,117486,117486,0,0,0,0,"33",".",23788,0
"14856",104586,"EMBRY RIDDLE AERONAUTICAL UNIVERSITY-PRESCOTT               ","2003-2004",28,"Wrestling",292072,292072,0,292072,292072,0,0,0,0,"22",".",46619,0
"14860",178244,"MISSOURI BAPTIST UNIVERSITY                                 ","2003-2004",28,"Wrestling",346357,346357,0,346357,346357,0,0,0,0,"36",".",27414,0
"14864",145691,"ILLINOIS COLLEGE                                            ","2003-2004",28,"Wrestling",42861,42861,0,42861,42861,0,0,0,0,"12",".",6861,0
"14865",130934,"DELAWARE STATE UNIVERSITY                                   ","2003-2004",28,"Wrestling",94075,94075,0,94075,94075,0,0,0,0,"17",".",19867,0
"14866",196291,"SUNY MARITIME COLLEGE                                       ","2003-2004",28,"Wrestling",23600,23600,0,23600,23600,0,0,0,0,"21",".",13600,0
"14873",130253,"SACRED HEART UNIVERSITY                                     ","2003-2004",28,"Wrestling",171762,171762,0,171762,171762,0,0,0,0,"26",".",27406,0
"14876",203368,"JOHN CARROLL UNIVERSITY                                     ","2003-2004",28,"Wrestling",86164,86164,0,86164,86164,0,0,0,0,"26",".",38683,0
"14881",196051,"MORRISVILLE STATE COLLEGE                                   ","2003-2004",28,"Wrestling",31898,31898,0,31898,31898,0,0,0,0,"11",".",21482,0
"14883",193478,"NASSAU COMMUNITY COLLEGE                                    ","2003-2004",28,"Wrestling",29179,29179,0,29179,29179,0,0,0,0,"24",".",12772,0
"14890",213996,"MESSIAH COLLEGE                                             ","2003-2004",28,"Wrestling",50056,50056,0,50056,50056,0,0,0,0,"28",".",23371,0
"14893",243179,"UNIVERSITY OF PUERTO RICO-HUMACAO                           ","2003-2004",28,"Wrestling",5800,5800,0,5800,5800,0,0,0,0,"8",".",2146,0
"14897",212160,"EDINBORO UNIVERSITY OF PENNSYLVANIA                         ","2003-2004",28,"Wrestling",322022,322022,0,322022,322022,0,0,0,0,"34",".",51192,0
"14898",176965,"CENTRAL MISSOURI STATE UNIVERSITY                           ","2003-2004",28,"Wrestling",143689,143689,0,143689,143689,0,0,0,0,"30",".",31650,0
"14899",126775,"COLORADO SCHOOL OF MINES                                    ","2003-2004",28,"Wrestling",141745,141745,0,141745,141745,0,0,0,0,"33",".",26649,0
"14902",111887,"CERRITOS COLLEGE                                            ","2003-2004",28,"Wrestling",37731,37731,0,37731,37731,0,0,0,0,"19",".",6764,0
"14904",131450,"GALLAUDET UNIVERSITY                                        ","2003-2004",28,"Wrestling",9365,9365,0,9365,9365,0,0,0,0,"7",".",4865,0
"14906",206817,"BACONE COLLEGE                                              ","2003-2004",28,"Wrestling",195000,195000,0,195000,195000,0,0,0,0,"13",".",23246,0
"14908",202134,"CLEVELAND STATE UNIVERSITY                                  ","2003-2004",28,"Wrestling",268392,268392,0,268392,268392,0,0,0,0,"35",".",33824,0
"14909",212674,"GETTYSBURG COLLEGE                                          ","2003-2004",28,"Wrestling",46641,46641,0,46641,46641,0,0,0,0,"18",".",21328,0
"14910",149532,"TRITON COLLEGE                                              ","2003-2004",28,"Wrestling",20525,20525,0,20525,20525,0,0,0,0,"17",".",10590,0
"14911",149842,"WILLIAM RAINEY HARPER COLLEGE                               ","2003-2004",28,"Wrestling",33240,33240,0,33240,33240,0,0,0,0,"32",".",18016,0
"14920",144050,"UNIVERSITY OF CHICAGO                                       ","2003-2004",28,"Wrestling",83589,83589,0,83589,83589,0,0,0,0,"25",".",22248,0
"14922",211024,"BAPTIST BIBLE COLLEGE AND SEMINARY                          ","2003-2004",28,"Wrestling",6545,6545,0,6545,6545,0,0,0,0,"14",".",4545,0
"14923",167905,"SPRINGFIELD TECHNICAL COMMUNITY COLLEGE                     ","2003-2004",28,"Wrestling",11450,11450,0,5725,5725,0,5725,5725,0,"12",".",1725,1725
"14929",196121,"SUNY COLLEGE AT BROCKPORT                                   ","2003-2004",28,"Wrestling",49118,49118,0,49118,49118,0,0,0,0,"29",".",38612,0
"14941",122658,"SAN JOAQUIN DELTA COLLEGE                                   ","2003-2004",28,"Wrestling",13784,13784,0,13784,13784,0,0,0,0,"8",".",4272,0
"14947",115126,"GOLDEN WEST COLLEGE                                         ","2003-2004",28,"Wrestling",49869,49869,0,49869,49869,0,0,0,0,"24",".",3921,0
"14956",210155,"SOUTHWESTERN OREGON COMMUNITY COLLEGE                       ","2003-2004",28,"Wrestling",80788,80788,0,80788,80788,0,0,0,0,"28",".",40300,0
"14966",217420,"RHODE ISLAND COLLEGE                                        ","2003-2004",28,"Wrestling",54032,54032,0,54032,54032,0,0,0,0,"29",".",42275,0
"14968",144157,"CITY COLLEGES OF CHICAGO-KENNEDY-KING COLLEGE               ","2003-2004",28,"Wrestling",26383,26383,0,26383,26383,0,0,0,0,"9",".",21383,0
"14973",201195,"BALDWIN-WALLACE COLLEGE                                     ","2003-2004",28,"Wrestling",51035,51035,0,51035,51035,0,0,0,0,"26",".",31862,0
"14976",130590,"TRINITY COLLEGE                                             ","2003-2004",28,"Wrestling",27741,27741,0,27741,27741,0,0,0,0,"26",".",15236,0
"14979",200217,"UNIVERSITY OF MARY                                          ","2003-2004",28,"Wrestling",136210,136210,0,136210,136210,0,0,0,0,"20",".",29596,0
"14982",123509,"SKYLINE COLLEGE                                             ","2003-2004",28,"Wrestling",11577,11577,0,11577,11577,0,0,0,0,"10",".",11580,0
"14987",164447,"AMERICAN INTERNATIONAL COLLEGE                              ","2003-2004",28,"Wrestling",33250,33250,0,33250,33250,0,0,0,0,"16",".",24200,0
"15002",196185,"SUNY COLLEGE AT ONEONTA                                     ","2003-2004",28,"Wrestling",107129,107129,0,107129,107129,0,0,0,0,"22",".",18996,0
"15008",185536,"MIDDLESEX COUNTY COLLEGE                                    ","2003-2004",28,"Wrestling",26150,26150,0,26150,26150,0,0,0,0,"17","0",9585,0
"15013",209612,"PACIFIC UNIVERSITY                                          ","2003-2004",28,"Wrestling",68812,68812,0,41364,41364,0,27448,27448,0,"20","14",21425,16572
"15023",186283,"RIDER UNIVERSITY                                            ","2003-2004",28,"Wrestling",641226,641226,0,641226,641226,0,0,0,0,"30",".",72215,0
"15028",230737,"UTAH VALLEY STATE COLLEGE                                   ","2003-2004",28,"Wrestling",159629,159629,0,159629,159629,0,0,0,0,"24",".",27310,0
"15029",111920,"CHABOT COLLEGE                                              ","2003-2004",28,"Wrestling",3000,3000,0,3000,3000,0,0,0,0,"12",".",6036,0
"15034",166027,"HARVARD UNIVERSITY                                          ","2003-2004",28,"Wrestling",216682,216682,0,216682,216682,0,0,0,0,"19",".",83341,0
"15041",147244,"MILLIKIN UNIVERSITY                                         ","2003-2004",28,"Wrestling",15744,15744,0,15744,15744,0,0,0,0,"22",".",11926,0
"15043",125091,"VICTOR VALLEY COLLEGE                                       ","2003-2004",28,"Wrestling",25075,25075,0,25075,25075,0,0,0,0,"12",".",9617,0
"15044",195003,"ROCHESTER INSTITUTE OF TECHNOLOGY                           ","2003-2004",28,"Wrestling",38073,38073,0,38073,38073,0,0,0,0,"20",".",26936,0
"15054",219091,"DAKOTA WESLEYAN UNIVERSITY                                  ","2003-2004",28,"Wrestling",68072,68072,0,68072,68072,0,0,0,0,"16",".",20091,0
"15061",243577,"UNIVERSIDAD POLITECNICA DE PUERTO RICO                      ","2003-2004",29,"Other Sports",10000,10000,0,6000,6000,0,4000,4000,0,"20","10",1500,750
"15062",154855,"CENTRAL CHRISTIAN COLLEGE OF KANSAS                         ","2003-2004",29,"Other Sports",8383,8383,0,3115,3115,0,5268,5268,0,"3","7",322,753
"15063",205203,"UNIVERSITY OF RIO GRANDE                                    ","2003-2004",29,"Other Sports",7244,7244,0,0,0,0,7244,7244,0,".","13",0,2553
"15065",194392,"PAUL SMITHS COLLEGE OF ARTS AND SCIENCE                     ","2003-2004",29,"Other Sports",3250,3250,0,3250,3250,0,0,0,0,"20",".",3000,0
"15069",214625,"PENNSYLVANIA STATE UNIV-PENN STATE NEW KENSINGTON           ","2003-2004",29,"Other Sports",2340,2340,0,0,0,0,2340,2340,0,".","13",0,780
"15071",151786,"MARIAN COLLEGE                                              ","2003-2004",29,"Other Sports",66021,66021,0,66021,66021,0,0,0,0,"11",".",23560,0
"15085",366252,"PENNSYLVANIA COLLEGE OF TECHNOLOGY                          ","2003-2004",29,"Other Sports",1664,1664,0,256,256,0,1408,1408,0,"13",".",1742,0
"15086",161004,"BOWDOIN COLLEGE                                             ","2003-2004",29,"Other Sports",56680,56680,0,29075,29075,0,27605,27605,0,"0","23",17575,16105
"15089",177144,"CULVER-STOCKTON COLLEGE                                     ","2003-2004",29,"Other Sports",8436,8436,0,2109,2109,0,6327,6327,0,"0","20",1440,4321
"15090",242671,"INTER AMERICAN UNIV OF PUERTO RICO-CENTRAL OFFICE           ","2003-2004",29,"Other Sports",29119,29119,0,26969,26969,0,2150,2150,0,"23","5",5887,2000
"15091",168786,"AQUINAS COLLEGE                                             ","2003-2004",29,"Other Sports",12000,12000,0,6000,6000,0,6000,6000,0,"21","15",4494,4500
"15098",153375,"GRAND VIEW COLLEGE                                          ","2003-2004",29,"Other Sports",59765,59765,0,0,0,0,59765,59765,0,".","18",0,10214
"15101",154952,"COWLEY COUNTY COMMUNITY COLLEGE                             ","2003-2004",29,"Other Sports",38548,38548,0,2721,2721,0,35827,35827,0,"6","42",2221,12351
"15102",212911,"HAVERFORD COLLEGE                                           ","2003-2004",29,"Other Sports",4482,4482,0,4482,4482,0,0,0,0,"16",".",4306,0
"15104",154235,"SAINT AMBROSE UNIVERSITY                                    ","2003-2004",29,"Other Sports",62704,62704,0,0,0,0,62704,62704,0,"0","21",0,8554
"15105",204024,"MIAMI UNIVERSITY-OXFORD                                     ","2003-2004",29,"Other Sports",298307,298307,0,0,0,0,298307,298307,0,".","52",0,159418
"15109",196291,"SUNY MARITIME COLLEGE                                       ","2003-2004",29,"Other Sports",12175,12175,0,12175,12175,0,0,0,0,"36",".",7175,0
"15110",156541,"CUMBERLAND COLLEGE                                          ","2003-2004",29,"Other Sports",89897,89897,0,89897,89897,0,0,0,0,"10","0",12110,0
"15115",243212,"UNIVERSITY OF PUERTO RICO-PONCE                             ","2003-2004",29,"Other Sports",3264,3264,0,1582,1582,0,1682,1682,0,"2","2",132,132
"15116",243179,"UNIVERSITY OF PUERTO RICO-HUMACAO                           ","2003-2004",29,"Other Sports",17244,17244,0,8622,8622,0,8622,8622,0,"20","20",5039,5039
"15118",241100,"AMERICAN UNIVERSITY OF PUERTO RICO                          ","2003-2004",29,"Other Sports",16254,16254,0,8127,8127,0,8127,8127,0,"1","1",463,463
"15120",101736,"NORTHWEST SHOALS COMMUNITY COLLEGE-MUSCLE SHOALS            ","2003-2004",29,"Other Sports",14862,14862,0,0,0,0,14862,14862,0,".","12",0,7000
"15121",243601,"UNIVERSIDAD DEL TURABO                                      ","2003-2004",29,"Other Sports",6972,6972,0,6972,6972,0,0,0,0,"12",".",1692,0
"15126",167987,"UNIVERSITY OF MASSACHUSETTS-DARTMOUTH                       ","2003-2004",29,"Other Sports",10389,10389,0,0,0,0,10389,10389,0,".","32",0,5399
"15130",181534,"PERU STATE COLLEGE                                          ","2003-2004",29,"Other Sports",5275,5275,0,0,0,0,5275,5275,0,".","11",0,675
"15133",105525,"PIMA COMMUNITY COLLEGE                                      ","2003-2004",29,"Other Sports",17654,17654,0,980,980,0,16674,16674,0,".","18",628,10681
"15137",163976,"ST JOHN'S COLLEGE                                           ","2003-2004",29,"Other Sports",3000,3000,0,1500,1500,0,1500,1500,0,"8","2",1200,1200
"15142",366252,"PENNSYLVANIA COLLEGE OF TECHNOLOGY                          ","2003-2004",30,"Archery",11432,11432,0,8070,8070,0,3362,3362,0,"17",".",7667,0
"15146",113856,"EAST LOS ANGELES COLLEGE                                    ","2003-2004",31,"Badminton",4500,4500,0,0,0,0,4500,4500,0,".","7",0,4000
"15147",122375,"SAN DIEGO MESA COLLEGE                                      ","2003-2004",31,"Badminton",15401,15401,0,0,0,0,15401,15401,0,".","8",0,3719
"15148",115296,"GROSSMONT COLLEGE                                           ","2003-2004",31,"Badminton",8450,8450,0,0,0,0,8450,8450,0,".","6",0,4450
"15149",112686,"COMPTON COMMUNITY COLLEGE                                   ","2003-2004",31,"Badminton",9500,9500,0,0,0,0,9500,9500,0,".","10",0,3500
"15152",116439,"IRVINE VALLEY COLLEGE                                       ","2003-2004",31,"Badminton",27055,27055,0,0,0,0,27055,27055,0,".","9",0,4950
"15153",123509,"SKYLINE COLLEGE                                             ","2003-2004",31,"Badminton",5580,5580,0,0,0,0,5580,5580,0,".","7",0,5579
"15154",121044,"PASADENA CITY COLLEGE                                       ","2003-2004",31,"Badminton",28544,28544,0,0,0,0,28544,28544,0,".","7",0,1500
"15157",120342,"ORANGE COAST COLLEGE                                        ","2003-2004",31,"Badminton",9153,9153,0,0,0,0,9153,9153,0,".","7",0,9005
"15158",118930,"MISSION COLLEGE                                             ","2003-2004",31,"Badminton",17840,17840,0,0,0,0,17840,17840,0,".","5",0,1976
"15161",112190,"CITY COLLEGE OF SAN FRANCISCO                               ","2003-2004",31,"Badminton",6056,6056,0,0,0,0,6056,6056,0,".","10",0,3605
"15163",243586,"PONTIFICAL CATHOLIC UNIV OF PUERTO RICO-MAYAGUEZ            ","2003-2004",32,"Beach Volleyball",3417,3417,0,1697,1697,0,1720,1720,0,"5","5",652,661
"15166",243212,"UNIVERSITY OF PUERTO RICO-PONCE                             ","2003-2004",32,"Beach Volleyball",4989,4989,0,3140,3140,0,1849,1849,0,"5","3",830,499
"15168",243346,"UNIVERSIDAD DEL ESTE                                        ","2003-2004",32,"Beach Volleyball",360,360,0,160,160,0,200,200,0,"4","4",160,200
"15169",243665,"UNIVERSITY OF THE VIRGIN ISLANDS                            ","2003-2004",32,"Beach Volleyball",9000,9000,0,3000,3000,0,6000,6000,0,"4","4",2500,3000
"15172",243577,"UNIVERSIDAD POLITECNICA DE PUERTO RICO                      ","2003-2004",32,"Beach Volleyball",6000,6000,0,3000,3000,0,3000,3000,0,"5","5",400,400
"15176",193283,"MOHAWK VALLEY COMMUNITY COLLEGE-UTICA BRANCH                ","2003-2004",33,"Bowling",15012,15012,0,7466,7466,0,7546,7546,0,"12","6",4656,2328
"15182",157535,"PIKEVILLE COLLEGE                                           ","2003-2004",33,"Bowling",44783,44783,0,29429,29429,0,15354,15354,0,"23","12",28074,14647
"15183",176965,"CENTRAL MISSOURI STATE UNIVERSITY                           ","2003-2004",33,"Bowling",89040,89040,0,0,0,0,89040,89040,0,".","12",0,23534
"15190",175856,"JACKSON STATE UNIVERSITY                                    ","2003-2004",33,"Bowling",52565,52565,0,0,0,0,52565,52565,0,".","8",0,16480
"15191",366252,"PENNSYLVANIA COLLEGE OF TECHNOLOGY                          ","2003-2004",33,"Bowling",5954,5954,0,4122,4122,0,1832,1832,0,"13",".",5473,0
"15193",130253,"SACRED HEART UNIVERSITY                                     ","2003-2004",33,"Bowling",98427,98427,0,10487,10487,0,87940,87940,0,"10","11",4163,18927
"15198",162283,"COPPIN STATE COLLEGE                                        ","2003-2004",33,"Bowling",70250,70250,0,0,0,0,70250,70250,0,".","7",0,11064
"15199",198756,"JOHNSON C SMITH UNIVERSITY                                  ","2003-2004",33,"Bowling",12393,12393,0,0,0,0,12393,12393,0,".","10",0,7570
"15201",195322,"SCHENECTADY COUNTY COMMUNITY COLLEGE                        ","2003-2004",33,"Bowling",11339,11339,0,5669,5669,0,5670,5670,0,"6","5",5400,5400
"15208",199643,"SHAW UNIVERSITY                                             ","2003-2004",33,"Bowling",40793,40793,0,0,0,0,40793,40793,0,".","9",0,8105
"15210",210605,"COMMUNITY COLLEGE OF ALLEGHENY COUNTY                       ","2003-2004",33,"Bowling",18262,18262,0,9131,9131,0,9131,9131,0,"22","12",7250,7285
"15211",229063,"TEXAS SOUTHERN UNIVERSITY                                   ","2003-2004",33,"Bowling",107463,107463,0,0,0,0,107463,107463,0,".","8",0,52004
"15225",197294,"SUNY WESTCHESTER COMMMUNITY COLLEGE                         ","2003-2004",33,"Bowling",3938,3938,0,1969,1969,0,1969,1969,0,"5","6",825,825
"15226",130934,"DELAWARE STATE UNIVERSITY                                   ","2003-2004",33,"Bowling",42210,42210,0,0,0,0,42210,42210,0,".","8",0,6390
"15227",198507,"ELIZABETH CITY STATE UNIVERSITY                             ","2003-2004",33,"Bowling",13150,13150,0,0,0,0,13150,13150,0,".","10",0,13150
"15228",193478,"NASSAU COMMUNITY COLLEGE                                    ","2003-2004",33,"Bowling",12998,12998,0,6499,6499,0,6499,6499,0,"6","6",3484,3484
"15231",189459,"BRIARCLIFFE COLLEGE                                         ","2003-2004",33,"Bowling",285920,285920,0,189280,189280,0,96640,96640,0,"14","7",20764,9975
"15235",191126,"FASHION INSTITUTE OF TECHNOLOGY                             ","2003-2004",33,"Bowling",11750,11750,0,5375,5375,0,6375,6375,0,".","10",2800,4200
"15237",188465,"GLOBE INSTITUTE OF TECHNOLOGY                               ","2003-2004",33,"Bowling",6150,6150,0,6150,6150,0,0,0,0,"4",".",1150,0
"15239",186432,"SAINT PETERS COLLEGE                                        ","2003-2004",33,"Bowling",10964,10964,0,0,0,0,10964,10964,0,".","7",0,7997
"15244",188641,"ALFRED UNIVERSITY                                           ","2003-2004",34,"Equestrian",38544,38544,0,0,0,0,38544,38544,0,".","20",0,6500
"15246",221519,"SEWANEE-THE UNIVERSITY OF THE SOUTH                         ","2003-2004",34,"Equestrian",98138,98138,0,0,0,0,98138,98138,0,".","31",0,19209
"15248",166948,"MOUNT IDA COLLEGE                                           ","2003-2004",34,"Equestrian",69529,69529,0,0,0,0,69529,69529,0,".","20",0,64529
"15258",186867,"STEVENS INSTITUTE OF TECHNOLOGY                             ","2003-2004",34,"Equestrian",28483,28483,0,0,0,0,28483,28483,0,".","8",0,12483
"15260",165699,"ENDICOTT COLLEGE                                            ","2003-2004",34,"Equestrian",26765,26765,0,0,0,0,26765,26765,0,".","21",0,18100
"15262",193478,"NASSAU COMMUNITY COLLEGE                                    ","2003-2004",34,"Equestrian",12160,12160,0,2432,2432,0,9728,9728,0,"2","8",1424,5696
"15272",123217,"COLLEGE OF THE SEQUOIAS                                     ","2003-2004",34,"Equestrian",31490,31490,0,0,0,0,31490,31490,0,".","27",0,14000
"15274",193584,"NAZARETH COLLEGE OF ROCHESTER                               ","2003-2004",34,"Equestrian",43923,43923,0,0,0,0,43923,43923,0,".","23",0,38178
"15278",139144,"BERRY COLLEGE                                               ","2003-2004",34,"Equestrian",243554,243554,0,121777,121777,0,121777,121777,0,"2","43",1568,33723
"15284",191533,"HARTWICK COLLEGE                                            ","2003-2004",34,"Equestrian",121605,121605,0,0,0,0,121605,121605,0,".","27",0,7596
"15286",130253,"SACRED HEART UNIVERSITY                                     ","2003-2004",34,"Equestrian",32855,32855,0,0,0,0,32855,32855,0,".","13",0,7815
"15288",190770,"DOWLING COLLEGE                                             ","2003-2004",34,"Equestrian",36470,36470,0,6631,6631,0,29839,29839,0,".","11",1540,6930
"15289",215947,"SETON HILL UNIVERSITY                                       ","2003-2004",34,"Equestrian",11893,11893,0,0,0,0,11893,11893,0,".","9",0,8100
"15290",232609,"LYNCHBURG COLLEGE                                           ","2003-2004",34,"Equestrian",39977,39977,0,0,0,0,39977,39977,0,".","16",0,4812
"15291",167987,"UNIVERSITY OF MASSACHUSETTS-DARTMOUTH                       ","2003-2004",34,"Equestrian",24331,24331,0,0,0,0,24331,24331,0,".","17",0,6958
"15294",217156,"BROWN UNIVERSITY                                            ","2003-2004",34,"Equestrian",65311,65311,0,0,0,0,65311,65311,0,".","35",0,23733
"15300",223922,"CLARENDON COLLEGE                                           ","2003-2004",35,"Rodeo",48544,48544,0,33980,33980,0,14564,14564,0,"12","5",15299,6557
"15302",127389,"LAMAR COMMUNITY COLLEGE                                     ","2003-2004",35,"Rodeo",78701,78701,0,52763,52763,0,25938,25938,0,"30",".",21245,10464
"15310",240505,"CASPER COLLEGE                                              ","2003-2004",35,"Rodeo",125991,125991,0,81894,81894,0,44097,44097,0,"21","11",27488,14801
"15312",175643,"EAST CENTRAL COMMUNITY COLLEGE                              ","2003-2004",35,"Rodeo",16908,16908,0,8454,8454,0,8454,8454,0,"6","4",3454,3454
"15316",180522,"MONTANA STATE UNIVERSITY-NORTHERN                           ","2003-2004",35,"Rodeo",14282,14282,0,7141,7141,0,7141,7141,0,"14",".",4127,4127
"15317",219204,"NATIONAL AMERICAN UNIVERSITY                                ","2003-2004",35,"Rodeo",262970,262970,0,156146,156146,0,106824,106824,0,"21","12",23486,13420
"15320",208646,"EASTERN OREGON UNIVERSITY                                   ","2003-2004",35,"Rodeo",31812,31812,0,15906,15906,0,15906,15906,0,"11","11",7726,7726
"15322",210234,"TREASURE VALLEY COMMUNITY COLLEGE                           ","2003-2004",35,"Rodeo",62928,62928,0,31464,31464,0,31464,31464,0,"18","6",18000,2000
"15323",240596,"EASTERN WYOMING COLLEGE                                     ","2003-2004",35,"Rodeo",95761,95761,0,61287,61287,0,34474,34474,0,"44",".",26408,14855
"15325",240514,"CENTRAL WYOMING COLLEGE                                     ","2003-2004",35,"Rodeo",104064,104064,0,69237,69237,0,34827,34827,0,"21","10",27850,13262
"15333",240666,"SHERIDAN COLLEGE                                            ","2003-2004",35,"Rodeo",63689,63689,0,36394,36394,0,27295,27295,0,"8","6",6617,4962
"15334",155098,"FORT SCOTT COMMUNITY COLLEGE                                ","2003-2004",35,"Rodeo",155044,155044,0,101148,101148,0,53896,53896,0,"55","10",26666,8889
"15341",229841,"WHARTON COUNTY JUNIOR COLLEGE                               ","2003-2004",35,"Rodeo",60710,60710,0,47961,47961,0,12749,12749,0,"29",".",35539,9447
"15350",161299,"MAINE MARITIME ACADEMY                                      ","2003-2004",36,"Sailing",57232,57232,0,40762,40762,0,16470,16470,0,"58",".",11575,1881
"15356",165015,"BRANDEIS UNIVERSITY                                         ","2003-2004",36,"Sailing",6530,6530,0,3265,3265,0,3265,3265,0,".","7",1510,1510
"15359",168148,"TUFTS UNIVERSITY                                            ","2003-2004",36,"Sailing",96653,96653,0,42850,42850,0,53803,53803,0,"35","53",14313,21675
"15360",217235,"JOHNSON &amp; WALES UNIVERSITY                                  ","2003-2004",36,"Sailing",21913,21913,0,13148,13148,0,8765,8765,0,".","15",8495,5663
"15363",166027,"HARVARD UNIVERSITY                                          ","2003-2004",36,"Sailing",204778,204778,0,102389,102389,0,102389,102389,0,"15","32",34988,34989
"15364",196291,"SUNY MARITIME COLLEGE                                       ","2003-2004",36,"Sailing",14500,14500,0,14500,14500,0,0,0,0,"42",".",12500,0
"15368",128902,"CONNECTICUT COLLEGE                                         ","2003-2004",36,"Sailing",102630,102630,0,53559,53559,0,49071,49071,0,"35","18",23691,19203
"15369",141574,"UNIVERSITY OF HAWAII AT MANOA                               ","2003-2004",36,"Sailing",63098,63098,0,0,0,0,63098,63098,0,".","19",0,35768
"15373",163976,"ST JOHN'S COLLEGE                                           ","2003-2004",36,"Sailing",4600,4600,0,2300,2300,0,2300,2300,0,"11","1",2000,2000
"15378",136950,"ROLLINS COLLEGE                                             ","2003-2004",36,"Sailing",14344,14344,0,7172,7172,0,7172,7172,0,"15",".",4298,4298
"15382",243577,"UNIVERSIDAD POLITECNICA DE PUERTO RICO                      ","2003-2004",37,"Table Tennis",2000,2000,0,2000,2000,0,0,0,0,"5",".",400,0
"15384",241836,"ELECTRONIC DATA PROCESSING COL OF PR INC-SAN SBSTN          ","2003-2004",37,"Table Tennis",2450,2450,0,1600,1600,0,850,850,0,"4","4",100,100
"15387",191126,"FASHION INSTITUTE OF TECHNOLOGY                             ","2003-2004",37,"Table Tennis",9250,9250,0,4625,4625,0,4625,4625,0,"8",".",4278,1222
"15388",243212,"UNIVERSITY OF PUERTO RICO-PONCE                             ","2003-2004",37,"Table Tennis",3735,3735,0,1058,1058,0,2677,2677,0,"2","3",218,307
"15390",242671,"INTER AMERICAN UNIV OF PUERTO RICO-CENTRAL OFFICE           ","2003-2004",37,"Table Tennis",15434,15434,0,13134,13134,0,2300,2300,0,"5","3",2540,1850
"15392",243586,"PONTIFICAL CATHOLIC UNIV OF PUERTO RICO-MAYAGUEZ            ","2003-2004",37,"Table Tennis",2733,2733,0,1357,1357,0,1376,1376,0,"4","4",522,529
"15397",243346,"UNIVERSIDAD DEL ESTE                                        ","2003-2004",37,"Table Tennis",589,589,0,589,589,0,0,0,0,"3",".",589,0
"15401",243212,"UNIVERSITY OF PUERTO RICO-PONCE                             ","2003-2004",38,"Weight Lifting",17557,17557,0,11113,11113,0,6444,6444,0,"12","7",3073,1794
"15402",243586,"PONTIFICAL CATHOLIC UNIV OF PUERTO RICO-MAYAGUEZ            ","2003-2004",38,"Weight Lifting",344,344,0,0,0,0,344,344,0,".","1",0,132
"15409",243601,"UNIVERSIDAD DEL TURABO                                      ","2003-2004",38,"Weight Lifting",15847,15847,0,9692,9692,0,6155,6155,0,"5","6",3595,1708
"15410",243346,"UNIVERSIDAD DEL ESTE                                        ","2003-2004",38,"Weight Lifting",1780,1780,0,1780,1780,0,0,0,0,"3",".",1380,0
"15421",209612,"PACIFIC UNIVERSITY                                          ","2003-2004",39,"Total Participants",436595,436595,0,207051,207051,0,229544,229544,0,"126","135",153450,150425
"15425",123527,"SAN BERNARDINO VALLEY COLLEGE                               ","2003-2004",39,"Total Participants",100880,100880,0,55955,55955,0,44925,44925,0,"153","56",114514,43432
"15426",212674,"GETTYSBURG COLLEGE                                          ","2003-2004",39,"Total Participants",1041928,1041928,0,508270,508270,0,533658,533658,0,"347","258",198436,127996
"15433",205443,"SHAWNEE STATE UNIVERSITY                                    ","2003-2004",39,"Total Participants",382113,382113,0,170584,170584,0,211529,211529,0,"87","82",137354,152783
"15434",130396,"GATEWAY COMMUNITY COLLEGE                                   ","2003-2004",39,"Total Participants",14000,14000,0,14000,14000,0,0,0,0,"28","12",11310,6360
"15439",157058,"KENTUCKY STATE UNIVERSITY                                   ","2003-2004",39,"Total Participants",257500,257500,0,109700,109700,0,147800,147800,0,"135","67",228600,125200
"15442",102030,"BISHOP STATE COMMUNITY COLLEGE                              ","2003-2004",39,"Total Participants",108300,108300,0,58482,58482,0,49818,49818,0,"45","41",97470,88806
"15444",165662,"EMERSON COLLEGE                                             ","2003-2004",39,"Total Participants",135170,135170,0,58771,58771,0,76399,76399,0,"86","85",31451,24916
"15447",196185,"SUNY COLLEGE AT ONEONTA                                     ","2003-2004",39,"Total Participants",1276501,1276501,0,668559,668559,0,607942,607942,0,"207","211",239823,141304
"15451",193016,"MERCY COLLEGE-MAIN CAMPUS                                   ","2003-2004",39,"Total Participants",144500,144500,0,73000,73000,0,71500,71500,0,"78","60",39000,40000
"15455",214689,"PENNSYLVANIA STATE UNIVERSITY-PENN STATE ALTOONA            ","2003-2004",39,"Total Participants",178100,178100,0,98279,98279,0,79821,79821,0,"122","83",69493,54599
"15456",204264,"MUSKINGUM COLLEGE                                           ","2003-2004",39,"Total Participants",165244,165244,0,85143,85143,0,80101,80101,0,"349","154",185546,101084
"15475",177418,"FONTBONNE UNIVERSITY                                        ","2003-2004",39,"Total Participants",129294,129294,0,61305,61305,0,67989,67989,0,"75","86",49787,53950
"15477",221397,"ROANE STATE COMMUNITY COLLEGE                               ","2003-2004",39,"Total Participants",125590,125590,0,77185,77185,0,48405,48405,0,"36","29",33936,26564
"15483",113856,"EAST LOS ANGELES COLLEGE                                    ","2003-2004",39,"Total Participants",148590,148590,0,74990,74990,0,73600,73600,0,"153","94",26334,28268
"15485",243601,"UNIVERSIDAD DEL TURABO                                      ","2003-2004",39,"Total Participants",910738,910738,0,583105,583105,0,327633,327633,0,"145","73",76559,33962
"15492",144050,"UNIVERSITY OF CHICAGO                                       ","2003-2004",39,"Total Participants",1084698,1084698,0,535209,535209,0,549489,549489,0,"209","131",416842,296860
"15503",145691,"ILLINOIS COLLEGE                                            ","2003-2004",39,"Total Participants",313125,313125,0,171010,171010,0,142115,142115,0,"228","121",172414,104339
"15504",183910,"CALDWELL COLLEGE                                            ","2003-2004",39,"Total Participants",463723,463723,0,267734,267734,0,195989,195989,0,"70","59",78888,67412
"15505",228006,"SAN JACINTO COLLEGE-SOUTH CAMPUS                            ","2003-2004",39,"Total Participants",188517,188517,0,88050,88050,0,100467,100467,0,"24","17",88000,100400
"15506",137281,"SAINT JOHNS RIVER COMMUNITY COLLEGE                         ","2003-2004",39,"Total Participants",189924,189924,0,80309,80309,0,109615,109615,0,"36","40",59520,59115
"15507",204909,"OHIO WESLEYAN UNIVERSITY                                    ","2003-2004",39,"Total Participants",942755,942755,0,529166,529166,0,413589,413589,0,"269","181",294375,162739
"15511",176239,"PEARL RIVER COMMUNITY COLLEGE                               ","2003-2004",39,"Total Participants",280589,280589,0,171713,171713,0,108876,108876,0,"146","52",170168,56583
"15513",186283,"RIDER UNIVERSITY                                            ","2003-2004",39,"Total Participants",3988022,3988022,0,2191985,2191985,0,1796037,1796037,0,"203","163",493936,378599
"15516",198233,"CATAWBA VALLEY COMMUNITY COLLEGE                            ","2003-2004",39,"Total Participants",5659,5659,0,0,0,0,5659,5659,0,"10","8",9010,5656
"15518",141361,"YOUNG HARRIS COLLEGE                                        ","2003-2004",39,"Total Participants",957749,957749,0,503470,503470,0,454279,454279,0,"58","47",142579,145482
"15522",101879,"UNIVERSITY OF NORTH ALABAMA                                 ","2003-2004",39,"Total Participants",1070813,1070813,0,486288,486288,0,584525,584525,0,"200","75",285896,162758
"15526",157359,"MID-CONTINENT COLLEGE                                       ","2003-2004",39,"Total Participants",558284,558284,0,364926,364926,0,193358,193358,0,"47","30",50914,43115
"15551",166647,"MASSACHUSETTS BAY COMMUNITY COLLEGE                         ","2003-2004",39,"Total Participants",35286,35286,0,25357,25357,0,9929,9929,0,"68","32",25478,7108
"15558",161077,"CENTRAL MAINE COMMUNITY COLLEGE                             ","2003-2004",39,"Total Participants",11000,11000,0,11000,11000,0,0,0,0,"29","12",21800,15000
"15562",146612,"LEWIS UNIVERSITY                                            ","2003-2004",39,"Total Participants",2025969,2025969,0,1147318,1147318,0,878651,878651,0,"198","146",339725,214629
"15571",177144,"CULVER-STOCKTON COLLEGE                                     ","2003-2004",39,"Total Participants",297547,297547,0,156817,156817,0,140730,140730,0,"172","105",166924,76197
"15575",199926,"WILKES COMMUNITY COLLEGE                                    ","2003-2004",39,"Total Participants",48680,48680,0,38204,38204,0,10476,10476,0,"41","15",2415,3860
"15581",101499,"JEFFERSON DAVIS COMMUNITY COLLEGE                           ","2003-2004",39,"Total Participants",211281,211281,0,96818,96818,0,114463,114463,0,"36","28",33500,18000
"15582",234173,"VIRGINIA WESLEYAN COLLEGE                                   ","2003-2004",39,"Total Participants",370439,370439,0,221346,221346,0,149093,149093,0,"139","137",91121,70620
"15589",106485,"UNIVERSITY OF ARKANSAS AT MONTICELLO                        ","2003-2004",39,"Total Participants",226099,226099,0,113800,113800,0,112299,112299,0,"143","43",175121,67172
"15597",399212,"SANTIAGO CANYON COLLEGE                                     ","2003-2004",39,"Total Participants",156502,156502,0,77956,77956,0,78546,78546,0,"66","53",21956,17546
"15601",113096,"COSUMNES RIVER COLLEGE                                      ","2003-2004",39,"Total Participants",91901,91901,0,47088,47088,0,44813,44813,0,"61","56",59063,64728
"15602",122436,"UNIVERSITY OF SAN DIEGO                                     ","2003-2004",39,"Total Participants",4439139,4439139,0,2041259,2041259,0,2397880,2397880,0,"206","187",953560,461048
"15603",226152,"TEXAS A &amp; M INTERNATIONAL UNIVERSITY                        ","2003-2004",39,"Total Participants",269325,269325,0,104825,104825,0,164500,164500,0,"64","71",96599,102813
"15615",130891,"DELAWARE TECHNICAL AND COMMUNITY COLLEGE-OWENS              ","2003-2004",39,"Total Participants",237482,237482,0,123910,123910,0,113572,113572,0,"32","22",31080,29000
"15628",193308,"MONROE COLLEGE-MAIN CAMPUS                                  ","2003-2004",39,"Total Participants",97010,97010,0,44989,44989,0,52021,52021,0,"34","36",183593,95625
"15629",156745,"GEORGETOWN COLLEGE                                          ","2003-2004",39,"Total Participants",521436,521436,0,166247,166247,0,355189,355189,0,"211","100",167765,95299
"15631",196291,"SUNY MARITIME COLLEGE                                       ","2003-2004",39,"Total Participants",246601,246601,0,201752,201752,0,44849,44849,0,"275","53",155767,37019
"15635",183080,"PLYMOUTH STATE UNIVERSITY                                   ","2003-2004",39,"Total Participants",691873,691873,0,341416,341416,0,350457,350457,0,"236","159",263611,188961
"15650",218724,"COASTAL CAROLINA UNIVERSITY                                 ","2003-2004",39,"Total Participants",3236159,3236159,0,1559516,1559516,0,1676643,1676643,0,"268","117",844517,419051
"15651",118718,"MERCED COLLEGE                                              ","2003-2004",39,"Total Participants",92469,92469,0,49795,49795,0,42674,42674,0,"159","57",64391,31465
"15655",130253,"SACRED HEART UNIVERSITY                                     ","2003-2004",39,"Total Participants",4356089,4356089,0,2098438,2098438,0,2257651,2257651,0,"484","335",707775,530209
"15658",226806,"MIDLAND COLLEGE                                             ","2003-2004",39,"Total Participants",440731,440731,0,235496,235496,0,205235,205235,0,"52","40",90614,89523
"15660",161138,"EASTERN MAINE COMMUNITY COLLEGE                             ","2003-2004",39,"Total Participants",10500,10500,0,10500,10500,0,0,0,0,"30","8",15000,4000
"15663",149365,"SOUTH SUBURBAN COLLEGE                                      ","2003-2004",39,"Total Participants",108800,108800,0,57000,57000,0,51800,51800,0,"64","51",59814,48708
"15665",122791,"COLLEGE OF SAN MATEO                                        ","2003-2004",39,"Total Participants",192832,192832,0,87746,87746,0,105086,105086,0,"134","71",45346,31448
"15669",154855,"CENTRAL CHRISTIAN COLLEGE OF KANSAS                         ","2003-2004",39,"Total Participants",94560,94560,0,51342,51342,0,43218,43218,0,"77","79",47465,37613
"15670",144971,"EUREKA COLLEGE                                              ","2003-2004",39,"Total Participants",103536,103536,0,43451,43451,0,60085,60085,0,"107","52",61847,30537
"15672",120254,"OCCIDENTAL COLLEGE                                          ","2003-2004",39,"Total Participants",597168,597168,0,329962,329962,0,267206,267206,0,"227","139",230700,100392
"15681",215798,"SAINT VINCENT COLLEGE                                       ","2003-2004",39,"Total Participants",1168899,1168899,0,618633,618633,0,550266,550266,0,"130","131",222650,203168
"15695",122375,"SAN DIEGO MESA COLLEGE                                      ","2003-2004",39,"Total Participants",311212,311212,0,148938,148938,0,162274,162274,0,"228","134",76018,55396
"15700",101480,"JACKSONVILLE STATE UNIVERSITY                               ","2003-2004",39,"Total Participants",2116036,2116036,0,813583,813583,0,1302453,1302453,0,"207","112",3131587,1800691
"15701",169248,"CENTRAL MICHIGAN UNIVERSITY                                 ","2003-2004",39,"Total Participants",3651184,3651184,0,1235196,1235196,0,2415988,2415988,0,"315","219",641182,402436
"15703",155900,"SOUTHWESTERN COLLEGE                                        ","2003-2004",39,"Total Participants",304254,304254,0,120436,120436,0,183818,183818,0,"147","94",163637,149078
"15718",219198,"MOUNT MARTY COLLEGE                                         ","2003-2004",39,"Total Participants",522420,522420,0,252542,252542,0,269878,269878,0,"104","95",64942,72503
"15720",227386,"PANOLA COLLEGE                                              ","2003-2004",39,"Total Participants",294140,294140,0,187470,187470,0,106670,106670,0,"40","27",27126,23000
"15724",174491,"NORTHWESTERN COLLEGE                                        ","2003-2004",39,"Total Participants",216504,216504,0,101617,101617,0,114887,114887,0,"167","98",122942,84212
"15725",101602,"LURLEEN B WALLACE COMMUNITY COLLEGE-ANDALUSIA CAMPUS        ","2003-2004",39,"Total Participants",271139,271139,0,144772,144772,0,126367,126367,0,"42","32",58000,57000
"15726",100760,"CENTRAL ALABAMA COMMUNITY COLLEGE                           ","2003-2004",39,"Total Participants",255992,255992,0,153588,153588,0,102404,102404,0,"50","33",54959,39858
"15741",144157,"CITY COLLEGES OF CHICAGO-KENNEDY-KING COLLEGE               ","2003-2004",39,"Total Participants",52893,52893,0,39638,39638,0,13255,13255,0,"43","21",64535,45771
"15746",190725,"DAEMEN COLLEGE                                              ","2003-2004",39,"Total Participants",407565,407565,0,161061,161061,0,246504,246504,0,"54","50",86704,105704
"15757",132851,"CENTRAL FLORIDA COMMUNITY COLLEGE                           ","2003-2004",39,"Total Participants",364725,364725,0,158250,158250,0,206475,206475,0,"41","43",50700,67150
"15759",161004,"BOWDOIN COLLEGE                                             ","2003-2004",39,"Total Participants",1624455,1624455,0,720532,720532,0,903923,903923,0,"330","234",192318,214306
"15763",232025,"EMORY AND HENRY COLLEGE                                     ","2003-2004",39,"Total Participants",236344,236344,0,87606,87606,0,148738,148738,0,"190","61",147004,72310
"15764",158477,"CENTENARY COLLEGE OF LOUISIANA                              ","2003-2004",39,"Total Participants",3043774,3043774,0,1400458,1400458,0,1643316,1643316,0,"112","110",450699,452769
"15765",198251,"CENTRAL CAROLINA COMMUNITY COLLEGE                          ","2003-2004",39,"Total Participants",7500,7500,0,0,0,0,7500,7500,0,"14","8",14450,6250
"15767",107460,"NORTH ARKANSAS COLLEGE                                      ","2003-2004",39,"Total Participants",42344,42344,0,25584,25584,0,16760,16760,0,"50","28",22643,14360
"15768",225575,"HUSTON-TILLOTSON COLLEGE                                    ","2003-2004",39,"Total Participants",176620,176620,0,95559,95559,0,81061,81061,0,"50","52",78580,74200
"15769",202134,"CLEVELAND STATE UNIVERSITY                                  ","2003-2004",39,"Total Participants",2480609,2480609,0,1303767,1303767,0,1176842,1176842,0,"165","113",422189,320271
"15770",184205,"CUMBERLAND COUNTY COLLEGE                                   ","2003-2004",39,"Total Participants",85798,85798,0,42899,42899,0,42899,42899,0,"40","28",27989,27989
"15780",145682,"ILLINOIS CENTRAL COLLEGE                                    ","2003-2004",39,"Total Participants",439991,439991,0,183264,183264,0,256727,256727,0,"83","60",89200,111785
"15782",131098,"WESLEY COLLEGE                                              ","2003-2004",39,"Total Participants",310500,310500,0,132241,132241,0,178259,178259,0,"231","101",178986,99914
"15783",237899,"WEST VIRGINIA STATE COLLEGE                                 ","2003-2004",39,"Total Participants",373916,373916,0,137107,137107,0,236809,236809,0,"203","86",207305,110359
"15786",146506,"LAKE LAND COLLEGE                                           ","2003-2004",39,"Total Participants",200102,200102,0,84546,84546,0,115556,115556,0,"50","52",62320,81622
"15789",251260,"SOUTHERN UNION STATE COMMUNITY COLLEGE                      ","2003-2004",39,"Total Participants",379295,379295,0,240023,240023,0,139272,139272,0,"63","57",117074,73015
"15794",179715,"NORTH CENTRAL MISSOURI COLLEGE                              ","2003-2004",39,"Total Participants",99961,99961,0,38425,38425,0,61536,61536,0,"35","24",28459,30786
"15797",141644,"HAWAII PACIFIC UNIVERSITY                                   ","2003-2004",39,"Total Participants",1368873,1368873,0,606084,606084,0,762789,762789,0,"45","42",334546,170997
"15808",200217,"UNIVERSITY OF MARY                                          ","2003-2004",39,"Total Participants",1621455,1621455,0,830095,830095,0,791360,791360,0,"286","158",340609,251618
"15823",190655,"CUNY NEW YORK CITY COLLEGE OF TECHNOLOGY                    ","2003-2004",39,"Total Participants",61736,61736,0,30423,30423,0,31313,31313,0,"97","79",51637,49467
"15831",243586,"PONTIFICAL CATHOLIC UNIV OF PUERTO RICO-MAYAGUEZ            ","2003-2004",39,"Total Participants",20122,20122,0,12555,12555,0,7567,7567,0,"52","22",6784,2909
"15836",177339,"EVANGEL UNIVERSITY                                          ","2003-2004",39,"Total Participants",719911,719911,0,294741,294741,0,425170,425170,0,"150","82",176900,154070
"15842",229841,"WHARTON COUNTY JUNIOR COLLEGE                               ","2003-2004",39,"Total Participants",148073,148073,0,98778,98778,0,49295,49295,0,"57","10",64924,25281
"15847",214759,"PENNSYLVANIA STATE UNIVERSITY-PENN STATE FAYETTE            ","2003-2004",39,"Total Participants",43510,43510,0,25785,25785,0,17725,17725,0,"23","8",12500,4800
"15854",170657,"LANSING COMMUNITY COLLEGE                                   ","2003-2004",39,"Total Participants",294216,294216,0,132483,132483,0,161733,161733,0,"98","67",66299,70674
"15861",155414,"KANSAS WESLEYAN UNIVERSITY                                  ","2003-2004",39,"Total Participants",300642,300642,0,144628,144628,0,156014,156014,0,"194","102",141684,85718
"15865",166133,"HOLYOKE COMMUNITY COLLEGE                                   ","2003-2004",39,"Total Participants",60000,60000,0,27000,27000,0,33000,33000,0,"52","68",14500,16700
"15878",205966,"SOUTHERN STATE COMMUNITY COLLEGE                            ","2003-2004",39,"Total Participants",34582,34582,0,12100,12100,0,22482,22482,0,"22","28",19102,24532
"15880",176965,"CENTRAL MISSOURI STATE UNIVERSITY                           ","2003-2004",39,"Total Participants",1854918,1854918,0,861871,861871,0,993047,993047,0,"258","132",473113,197484
"15882",104160,"ARIZONA WESTERN COLLEGE                                     ","2003-2004",39,"Total Participants",393158,393158,0,182447,182447,0,210711,210711,0,"133","40",189064,122072
"15886",219204,"NATIONAL AMERICAN UNIVERSITY                                ","2003-2004",39,"Total Participants",393914,393914,0,156146,156146,0,237768,237768,0,"21","23",23486,30463
"15890",149532,"TRITON COLLEGE                                              ","2003-2004",39,"Total Participants",111226,111226,0,76811,76811,0,34415,34415,0,"70","33",44951,19638
"15891",145646,"ILLINOIS WESLEYAN UNIVERSITY                                ","2003-2004",39,"Total Participants",534289,534289,0,270082,270082,0,264207,264207,0,"251","169",159786,114420
"15898",170037,"CORNERSTONE UNIVERSITY                                      ","2003-2004",39,"Total Participants",350084,350084,0,124651,124651,0,225433,225433,0,"105","113",97162,120893
"15906",130493,"SOUTHERN CONNECTICUT STATE UNIVERSITY                       ","2003-2004",39,"Total Participants",1357479,1357479,0,673323,673323,0,684156,684156,0,"238","194",403571,343406
"15911",207722,"UNIVERSITY OF SCIENCE AND ARTS OF OKLAHOMA                  ","2003-2004",39,"Total Participants",196049,196049,0,92624,92624,0,103425,103425,0,"73","47",78929,87837
"15913",139311,"CLAYTON COLLEGE AND STATE UNIVERSITY                        ","2003-2004",39,"Total Participants",567647,567647,0,261191,261191,0,306456,306456,0,"66","50",361806,384744
"15916",211291,"BUCKNELL UNIVERSITY                                         ","2003-2004",39,"Total Participants",5111176,5111176,0,1612675,1612675,0,3498501,3498501,0,"428","437",732779,711838
"15922",159416,"LOUISIANA STATE UNIVERSITY-SHREVEPORT                       ","2003-2004",39,"Total Participants",239156,239156,0,239156,239156,0,0,0,0,"50","15",293463,114181
"15924",198835,"LENOIR-RHYNE COLLEGE                                        ","2003-2004",39,"Total Participants",1061474,1061474,0,514840,514840,0,546634,546634,0,"200","79",735802,409348
"15928",137953,"TRINITY BAPTIST COLLEGE                                     ","2003-2004",39,"Total Participants",4800,4800,0,0,0,0,4800,4800,0,"15","10",4900,3800
"15930",197294,"SUNY WESTCHESTER COMMMUNITY COLLEGE                         ","2003-2004",39,"Total Participants",68877,68877,0,43912,43912,0,24965,24965,0,"63","39",26365,11085
"15933",213400,"LANCASTER BIBLE COLLEGE                                     ","2003-2004",39,"Total Participants",45849,45849,0,22301,22301,0,23548,23548,0,"52","54",34655,33302
"15936",220978,"MIDDLE TENNESSEE STATE UNIVERSITY                           ","2003-2004",39,"Total Participants",3312940,3312940,0,1267055,1267055,0,2045885,2045885,0,"270","146",1205355,667840
"15937",213996,"MESSIAH COLLEGE                                             ","2003-2004",39,"Total Participants",587423,587423,0,278094,278094,0,309329,309329,0,"228","223",165751,170237
"15938",207281,"NORTHERN OKLAHOMA COLLEGE                                   ","2003-2004",39,"Total Participants",217235,217235,0,127530,127530,0,89705,89705,0,"93","72",80345,77527
"15947",243577,"UNIVERSIDAD POLITECNICA DE PUERTO RICO                      ","2003-2004",39,"Total Participants",66000,66000,0,43000,43000,0,23000,23000,0,"87","36",6800,2850
"15948",175883,"JONES COUNTY JUNIOR COLLEGE                                 ","2003-2004",39,"Total Participants",302034,302034,0,202878,202878,0,99156,99156,0,"142","69",181660,58918
"15949",143288,"BLACKBURN COLLEGE                                           ","2003-2004",39,"Total Participants",181710,181710,0,94491,94491,0,87219,87219,0,"132","67",101555,41238
"15955",129525,"UNIVERSITY OF HARTFORD                                      ","2003-2004",39,"Total Participants",3044603,3044603,0,1539065,1539065,0,1505538,1505538,0,"144","124",382246,311867
"15960",189459,"BRIARCLIFFE COLLEGE                                         ","2003-2004",39,"Total Participants",1230729,1230729,0,716560,716560,0,514169,514169,0,"58","44",160871,111792
"15965",193973,"NIAGARA UNIVERSITY                                          ","2003-2004",39,"Total Participants",3386849,3386849,0,1698435,1698435,0,1688414,1688414,0,"134","158",491887,382448
"15968",176008,"MISSISSIPPI DELTA COMMUNITY COLLEGE                         ","2003-2004",39,"Total Participants",178368,178368,0,116176,116176,0,62192,62192,0,"107","39",116788,43364
"15982",162760,"HOOD COLLEGE                                                ","2003-2004",39,"Total Participants",111028,111028,0,8131,8131,0,102897,102897,0,"17","98",40538,66465
"15985",135160,"LAKE CITY COMMUNITY COLLEGE                                 ","2003-2004",39,"Total Participants",362879,362879,0,183237,183237,0,179642,179642,0,"21","23",116109,126491
"15986",118772,"MERRITT COLLEGE                                             ","2003-2004",39,"Total Participants",68205,68205,0,34998,34998,0,33207,33207,0,"23","24",17137,15745
"15987",178721,"PARK UNIVERSITY                                             ","2003-2004",39,"Total Participants",1137621,1137621,0,568035,568035,0,569586,569586,0,"92","71",128237,129811
"15992",138868,"ATLANTA CHRISTIAN COLLEGE                                   ","2003-2004",39,"Total Participants",47566,47566,0,34900,34900,0,12666,12666,0,"52","26",48000,29866
"15993",137315,"SOUTH FLORIDA COMMUNITY COLLEGE                             ","2003-2004",39,"Total Participants",259522,259522,0,157895,157895,0,101627,101627,0,"23","12",41739,24291
"16007",173258,"CARLETON COLLEGE                                            ","2003-2004",39,"Total Participants",684876,684876,0,283151,283151,0,401725,401725,0,"244","187",173350,143605
"16011",136145,"NORTH FLORIDA COMMUNITY COLLEGE                             ","2003-2004",39,"Total Participants",264937,264937,0,152156,152156,0,112781,112781,0,"24","32",35702,44475
"16016",214801,"PENNSYLVANIA STATE UNIVERSITY-PENN STATE ABINGTON           ","2003-2004",39,"Total Participants",66103,66103,0,37292,37292,0,28811,28811,0,"62","43",30747,19338
"16023",101189,"FAULKNER UNIVERSITY                                         ","2003-2004",39,"Total Participants",865484,865484,0,416057,416057,0,449427,449427,0,"58","34",200713,146270
"16039",215770,"SAINT JOSEPHS UNIVERSITY                                    ","2003-2004",39,"Total Participants",3607436,3607436,0,1630316,1630316,0,1977120,1977120,0,"216","185",1795910,1064899
"16044",136233,"OKALOOSA-WALTON COMMUNITY COLLEGE                           ","2003-2004",39,"Total Participants",61695,61695,0,30370,30370,0,31325,31325,0,"33","36",20000,20000
"16053",127565,"METROPOLITAN STATE COLLEGE OF DENVER                        ","2003-2004",39,"Total Participants",1007073,1007073,0,447193,447193,0,559880,559880,0,"96","68",191860,185418
"16056",190646,"CUNY MEDGAR EVERS COLLEGE                                   ","2003-2004",39,"Total Participants",64700,64700,0,26750,26750,0,37950,37950,0,"77","80",43200,53250
"16058",176354,"SOUTHWEST MISSISSIPPI COMMUNITY COLLEGE                     ","2003-2004",39,"Total Participants",318299,318299,0,243905,243905,0,74394,74394,0,"98","28",120439,27956
"16059",175856,"JACKSON STATE UNIVERSITY                                    ","2003-2004",39,"Total Participants",1528800,1528800,0,638412,638412,0,890388,890388,0,"172","107",909129,431231
"16076",140720,"PAINE COLLEGE                                               ","2003-2004",39,"Total Participants",384333,384333,0,178382,178382,0,205951,205951,0,"52","57",107509,109271
"16084",147800,"OAKTON COMMUNITY COLLEGE                                    ","2003-2004",39,"Total Participants",36870,36870,0,26228,26228,0,10642,10642,0,"78","49",31609,15830
"16089",166027,"HARVARD UNIVERSITY                                          ","2003-2004",39,"Total Participants",7823059,7823059,0,4125940,4125940,0,3697119,3697119,0,"809","679",1781469,1444650
"16098",163851,"SALISBURY UNIVERSITY                                        ","2003-2004",39,"Total Participants",309541,309541,0,142628,142628,0,166913,166913,0,"295","193",121703,97273
"16102",219790,"BRYAN COLLEGE                                               ","2003-2004",39,"Total Participants",82224,82224,0,52936,52936,0,29288,29288,0,"57","40",75794,52582
"16115",195173,"ST FRANCIS COLLEGE                                          ","2003-2004",39,"Total Participants",1074545,1074545,0,596662,596662,0,477883,477883,0,"156","124",238891,185976
"16129",214272,"NEUMANN COLLEGE                                             ","2003-2004",39,"Total Participants",387307,387307,0,196914,196914,0,190393,190393,0,"137","132",175620,160950
"16139",101949,"ALABAMA SOUTHERN COMMUNITY COLLEGE                          ","2003-2004",39,"Total Participants",208486,208486,0,100054,100054,0,108432,108432,0,"40","44",129688,136236
"16148",150534,"UNIVERSITY OF EVANSVILLE                                    ","2003-2004",39,"Total Participants",3251658,3251658,0,1436581,1436581,0,1815077,1815077,0,"126","114",596238,399482
"16156",168607,"ALPENA COMMUNITY COLLEGE                                    ","2003-2004",39,"Total Participants",51313,51313,0,15122,15122,0,36191,36191,0,"19","34",28442,38266
"16159",137759,"TALLAHASSEE COMMUNITY COLLEGE                               ","2003-2004",39,"Total Participants",348606,348606,0,191167,191167,0,157439,157439,0,"38","30",92696,68888
"16160",155195,"HUTCHINSON COMMUNITY COLLEGE                                ","2003-2004",39,"Total Participants",359345,359345,0,186922,186922,0,172423,172423,0,"141","70",121648,89384
"16181",133021,"CHIPOLA COLLEGE                                             ","2003-2004",39,"Total Participants",337095,337095,0,177673,177673,0,159422,159422,0,"38","31",112155,50899
"16184",155292,"KANSAS CITY KANSAS COMMUNITY COLLEGE                        ","2003-2004",39,"Total Participants",373450,373450,0,200450,200450,0,173000,173000,0,"79","54",121650,97200
"16185",157535,"PIKEVILLE COLLEGE                                           ","2003-2004",39,"Total Participants",219606,219606,0,113279,113279,0,106327,106327,0,"157","73",223514,107436
"16194",195544,"SAINT JOSEPHS COLLEGE-MAIN CAMPUS                           ","2003-2004",39,"Total Participants",84882,84882,0,0,0,0,84882,84882,0,"15","43",52000,122000
"16201",134343,"GULF COAST COMMUNITY COLLEGE                                ","2003-2004",39,"Total Participants",516901,516901,0,199333,199333,0,317568,317568,0,"34","49",83029,104367
"16213",228431,"STEPHEN F AUSTIN STATE UNIVERSITY                           ","2003-2004",39,"Total Participants",1481169,1481169,0,356601,356601,0,1124568,1124568,0,"211","161",452090,312748
"16216",165334,"CLARK UNIVERSITY                                            ","2003-2004",39,"Total Participants",420542,420542,0,169617,169617,0,250925,250925,0,"136","154",60300,88294
"16217",240596,"EASTERN WYOMING COLLEGE                                     ","2003-2004",39,"Total Participants",200426,200426,0,76371,76371,0,124055,124055,0,"67","13",72680,38631
"16230",218539,"PRESBYTERIAN COLLEGE                                        ","2003-2004",39,"Total Participants",1331478,1331478,0,700454,700454,0,631024,631024,0,"217","87",285144,119104
"16247",133702,"FLORIDA COMMUNITY COLLEGE AT JACKSONVILLE                   ","2003-2004",39,"Total Participants",645928,645928,0,213937,213937,0,431991,431991,0,"44","64",163664,259487
"16254",125471,"WEST LOS ANGELES COLLEGE                                    ","2003-2004",39,"Total Participants",218790,218790,0,43907,43907,0,174883,174883,0,"92","55",55480,118015
"16258",133809,"FLORIDA COLLEGE                                             ","2003-2004",39,"Total Participants",237015,237015,0,155234,155234,0,81781,81781,0,"35","12",65354,20399
"16260",213358,"LA ROCHE COLLEGE                                            ","2003-2004",39,"Total Participants",131268,131268,0,68906,68906,0,62362,62362,0,"71","62",53711,47480
"16273",152567,"TRI-STATE UNIVERSITY                                        ","2003-2004",39,"Total Participants",396417,396417,0,218045,218045,0,178372,178372,0,"222","91",113376,47136
"16288",162283,"COPPIN STATE COLLEGE                                        ","2003-2004",39,"Total Participants",1010638,1010638,0,397126,397126,0,613512,613512,0,"88","103",160488,184584
"16293",130590,"TRINITY COLLEGE                                             ","2003-2004",39,"Total Participants",1374617,1374617,0,716140,716140,0,658477,658477,0,"397","266",289674,226609
"16295",188465,"GLOBE INSTITUTE OF TECHNOLOGY                               ","2003-2004",39,"Total Participants",222451,222451,0,222451,222451,0,0,0,0,"48","9",175919,55174
"16300",159568,"LOUISIANA COLLEGE                                           ","2003-2004",39,"Total Participants",265616,265616,0,125994,125994,0,139622,139622,0,"162","65",184390,80040
"16301",201858,"CINCINNATI BIBLE COLLEGE AND SEMINARY                       ","2003-2004",39,"Total Participants",26770,26770,0,12417,12417,0,14353,14353,0,"41","35",22698,18826
"16303",104717,"GRAND CANYON UNIVERSITY                                     ","2003-2004",39,"Total Participants",1601636,1601636,0,708560,708560,0,893076,893076,0,"88","68",257032,318784
"16320",203368,"JOHN CARROLL UNIVERSITY                                     ","2003-2004",39,"Total Participants",672973,672973,0,374309,374309,0,298664,298664,0,"379","171",268530,144706
"16321",236133,"NORTHWEST COLLEGE OF THE ASSEMBLIES OF GOD                  ","2003-2004",39,"Total Participants",473399,473399,0,144198,144198,0,329201,329201,0,"32","34",51932,83532
"16324",184791,"GLOUCESTER COUNTY COLLEGE                                   ","2003-2004",39,"Total Participants",117115,117115,0,79887,79887,0,37228,37228,0,"88","54",104877,50428
"16334",194028,"NORTH COUNTRY COMMUNITY COLLEGE                             ","2003-2004",39,"Total Participants",142979,142979,0,72419,72419,0,70560,70560,0,"44","56",53237,36633
"16335",178624,"NORTHWEST MISSOURI STATE UNIVERSITY                         ","2003-2004",39,"Total Participants",1130444,1130444,0,431252,431252,0,699192,699192,0,"231","109",95306,65452
"16351",219091,"DAKOTA WESLEYAN UNIVERSITY                                  ","2003-2004",39,"Total Participants",593984,593984,0,334714,334714,0,259270,259270,0,"213","84",171925,90348
"16359",130934,"DELAWARE STATE UNIVERSITY                                   ","2003-2004",39,"Total Participants",1310177,1310177,0,619866,619866,0,690311,690311,0,"173","83",642484,286087
"16360",154712,"BENEDICTINE COLLEGE                                         ","2003-2004",39,"Total Participants",1257249,1257249,0,797629,797629,0,459620,459620,0,"390","159",168198,121300
"16366",226471,"UNIVERSITY OF MARY HARDIN-BAYLOR                            ","2003-2004",39,"Total Participants",490234,490234,0,218402,218402,0,271832,271832,0,"207","71",211047,128080
"16381",168148,"TUFTS UNIVERSITY                                            ","2003-2004",39,"Total Participants",1136192,1136192,0,564087,564087,0,572105,572105,0,"516","485",242563,188025
"16389",170055,"GRAND RAPIDS COMMUNITY COLLEGE                              ","2003-2004",39,"Total Participants",199907,199907,0,116562,116562,0,83345,83345,0,"145","52",76201,44490
"16391",168227,"WENTWORTH INSTITUTE OF TECHNOLOGY                           ","2003-2004",39,"Total Participants",357293,357293,0,231384,231384,0,125909,125909,0,"153","72",130834,53574
"16401",194578,"PRATT INSTITUTE-MAIN                                        ","2003-2004",39,"Total Participants",26178,26178,0,12486,12486,0,13692,13692,0,"46","38",3456,2196
"16402",127389,"LAMAR COMMUNITY COLLEGE                                     ","2003-2004",39,"Total Participants",447637,447637,0,256954,256954,0,190683,190683,0,"86","37",108659,45976
"16406",218061,"FRANCIS MARION UNIVERSITY                                   ","2003-2004",39,"Total Participants",1051869,1051869,0,577181,577181,0,474688,474688,0,"109","84",146123,120578
"16408",227146,"NAVARRO COLLEGE                                             ","2003-2004",39,"Total Participants",541367,541367,0,181488,181488,0,359879,359879,0,"127","52",91223,54402
"16425",110714,"UNIVERSITY OF CALIFORNIA-SANTA CRUZ                         ","2003-2004",39,"Total Participants",309558,309558,0,130485,130485,0,179073,179073,0,"117","130",128294,141436
"16442",190664,"CUNY QUEENS COLLEGE                                         ","2003-2004",39,"Total Participants",699401,699401,0,307094,307094,0,392307,392307,0,"100","102",62290,68870
"16450",169521,"DELTA COLLEGE                                               ","2003-2004",39,"Total Participants",34993,34993,0,14728,14728,0,20265,20265,0,"28","30",16949,20482
"16454",229887,"WILEY COLLEGE                                               ","2003-2004",39,"Total Participants",142813,142813,0,85060,85060,0,57753,57753,0,"47","46",45257,46982
"16461",176789,"CALVARY BIBLE COLLEGE AND THEOLOGICAL SEMINARY              ","2003-2004",39,"Total Participants",20598,20598,0,10914,10914,0,9684,9684,0,"22","16",11533,11849
"16467",111896,"CERRO COSO COMMUNITY COLLEGE                                ","2003-2004",39,"Total Participants",66146,66146,0,66146,66146,0,0,0,0,"22","10",39566,32388
"16469",153533,"IOWA LAKES COMMUNITY COLLEGE                                ","2003-2004",39,"Total Participants",180602,180602,0,83463,83463,0,97139,97139,0,"51","40",41281,58133
"16471",222822,"ANGELINA COLLEGE                                            ","2003-2004",39,"Total Participants",178023,178023,0,178023,178023,0,0,0,0,"42","16",13700,5200
"16478",227687,"RANGER COLLEGE                                              ","2003-2004",39,"Total Participants",327697,327697,0,153819,153819,0,173878,173878,0,"108","36",42943,19168
"16484",135717,"MIAMI DADE COLLEGE                                          ","2003-2004",39,"Total Participants",636385,636385,0,276775,276775,0,359610,359610,0,"37","46",40058,50271
"16489",101736,"NORTHWEST SHOALS COMMUNITY COLLEGE-MUSCLE SHOALS            ","2003-2004",39,"Total Participants",155346,155346,0,64471,64471,0,90875,90875,0,"53","66",62700,69700
"16494",183026,"SOUTHERN NEW HAMPSHIRE UNIVERSITY                           ","2003-2004",39,"Total Participants",1828827,1828827,0,971667,971667,0,857160,857160,0,"154","103",382040,215283
"16502",137476,"SAINT THOMAS UNIVERSITY                                     ","2003-2004",39,"Total Participants",1074430,1074430,0,544820,544820,0,529610,529610,0,"120","65",92000,73265
"16503",200226,"MAYVILLE STATE UNIVERSITY                                   ","2003-2004",39,"Total Participants",88773,88773,0,53305,53305,0,35468,35468,0,"94","40",120463,66783
"16505",123509,"SKYLINE COLLEGE                                             ","2003-2004",39,"Total Participants",73715,73715,0,47622,47622,0,26093,26093,0,"74","40",57512,26087
"16510",182005,"COMMUNITY COLLEGE OF SOUTHERN NEVADA                        ","2003-2004",39,"Total Participants",375000,375000,0,250000,250000,0,125000,125000,0,"24","16",130000,120000
"16514",227979,"SAN JACINTO COLLEGE-CENTRAL CAMPUS                          ","2003-2004",39,"Total Participants",115919,115919,0,0,0,0,115919,115919,0,"14","14",22480,20611
"16515",172635,"WAYNE COUNTY COMMUNITY COLLEGE DISTRICT                     ","2003-2004",39,"Total Participants",60000,60000,0,35000,35000,0,25000,25000,0,"28","26",41000,30000
"16520",190600,"CUNY JOHN JAY COLLEGE CRIMINAL JUSTICE                      ","2003-2004",39,"Total Participants",235813,235813,0,115097,115097,0,120716,120716,0,"80","76",82142,53752
"16524",193478,"NASSAU COMMUNITY COLLEGE                                    ","2003-2004",39,"Total Participants",297160,297160,0,175831,175831,0,121329,121329,0,"269","133",152651,66504
"16525",175810,"HOLMES COMMUNITY COLLEGE                                    ","2003-2004",39,"Total Participants",187642,187642,0,144392,144392,0,43250,43250,0,"129","34",256408,77178
"16528",195322,"SCHENECTADY COUNTY COMMUNITY COLLEGE                        ","2003-2004",39,"Total Participants",56730,56730,0,42159,42159,0,14571,14571,0,"37","14",41850,27900
"16532",154493,"UPPER IOWA UNIVERSITY                                       ","2003-2004",39,"Total Participants",1073835,1073835,0,609038,609038,0,464797,464797,0,"269","84",290429,147404
"16540",174914,"UNIVERSITY OF ST THOMAS                                     ","2003-2004",39,"Total Participants",1052534,1052534,0,532356,532356,0,520178,520178,0,"414","253",405773,284110
"16547",172963,"ANOKA-RAMSEY COMMUNITY COLLEGE-COON RAPIDS CAMPUS           ","2003-2004",39,"Total Participants",32603,32603,0,17660,17660,0,14943,14943,0,"26","20",17685,17911
"16548",164447,"AMERICAN INTERNATIONAL COLLEGE                              ","2003-2004",39,"Total Participants",420281,420281,0,286624,286624,0,133657,133657,0,"227","121",388750,171587
"16549",177551,"HARRIS-STOWE STATE COLLEGE                                  ","2003-2004",39,"Total Participants",231559,231559,0,106597,106597,0,124962,124962,0,"53","45",48066,48474
"16552",129242,"FAIRFIELD UNIVERSITY                                        ","2003-2004",39,"Total Participants",3563261,3563261,0,1575350,1575350,0,1987911,1987911,0,"159","205",548898,621147
"16553",221953,"TUSCULUM COLLEGE                                            ","2003-2004",39,"Total Participants",1279068,1279068,0,630228,630228,0,648840,648840,0,"245","108",283637,150513
"16556",192819,"MARIST COLLEGE                                              ","2003-2004",39,"Total Participants",3109463,3109463,0,1440820,1440818,2,1668643,1668645,-2,"424","273",685604,585796
"16571",165112,"BUNKER HILL COMMUNITY COLLEGE                               ","2003-2004",39,"Total Participants",57600,57600,0,32400,32400,0,25200,25200,0,"46","33",25911,16459
"16576",138691,"DARTON COLLEGE                                              ","2003-2004",39,"Total Participants",330495,330495,0,204948,204948,0,125547,125547,0,"74","44",51323,49088
"16577",117247,"LANEY COLLEGE                                               ","2003-2004",39,"Total Participants",99761,99761,0,36238,36238,0,63523,63523,0,"97","49",115873,63507
"16579",124113,"TAFT COLLEGE                                                ","2003-2004",39,"Total Participants",71527,71527,0,38971,38971,0,32556,32556,0,"46","34",24909,25776
"16581",133553,"EMBRY RIDDLE AERONAUTICAL UNIVERSITY-DAYTONA BEACH          ","2003-2004",39,"Total Participants",1592472,1592472,0,893212,893212,0,699260,699260,0,"90","48",1167241,657492
"16586",161572,"UNITY COLLEGE                                               ","2003-2004",39,"Total Participants",30100,30100,0,13800,13800,0,16300,16300,0,"36","44",12000,13000
"16597",173160,"BETHEL COLLEGE                                              ","2003-2004",39,"Total Participants",663767,663767,0,405618,405618,0,258149,258149,0,"385","203",458729,146613
"16598",163976,"ST JOHN'S COLLEGE                                           ","2003-2004",39,"Total Participants",16600,16600,0,8300,8300,0,8300,8300,0,"45","29",6450,6450
"16601",135391,"MANATEE COMMUNITY COLLEGE                                   ","2003-2004",39,"Total Participants",287283,287283,0,130812,130812,0,156471,156471,0,"38","35",108070,72069
"16602",111920,"CHABOT COLLEGE                                              ","2003-2004",39,"Total Participants",32026,32026,0,17363,17363,0,14663,14663,0,"219","113",55532,33081
"16603",173203,"CENTRAL LAKES COLLEGE-BRAINERD                              ","2003-2004",39,"Total Participants",60473,60473,0,21028,21028,0,39445,39445,0,"73","38",44751,37788
"16609",183938,"CAMDEN COUNTY COLLEGE                                       ","2003-2004",39,"Total Participants",231537,231537,0,138596,138596,0,92941,92941,0,"66","33",31586,12763
"16610",161864,"BALTIMORE CITY COMMUNITY COLLEGE                            ","2003-2004",39,"Total Participants",59700,59700,0,29850,29850,0,29850,29850,0,"27","22",39700,39700
"16611",138947,"CLARK ATLANTA UNIVERSITY                                    ","2003-2004",39,"Total Participants",555000,555000,0,187000,187000,0,368000,368000,0,"107","85",490000,225000
"16618",117706,"LOS ANGELES PIERCE COLLEGE                                  ","2003-2004",39,"Total Participants",223691,223691,0,104374,104374,0,119317,119317,0,"150","67",88640,51717
"16619",190770,"DOWLING COLLEGE                                             ","2003-2004",39,"Total Participants",1816985,1816985,0,1168004,1168004,0,648981,648981,0,"126","74",272418,126696
"16620",117715,"LOS ANGELES SOUTHWEST COLLEGE                               ","2003-2004",39,"Total Participants",45648,45648,0,22824,22824,0,22824,22824,0,"80","33",56200,16200
"16621",158662,"DELGADO COMMUNITY COLLEGE                                   ","2003-2004",39,"Total Participants",134279,134279,0,134279,134279,0,0,0,0,"63","18",159400,57829
"16628",119067,"MONTEREY PENINSULA COLLEGE                                  ","2003-2004",39,"Total Participants",143341,143341,0,71121,71121,0,72220,72220,0,"120","52",83004,26331
"16630",125499,"WEST VALLEY COLLEGE                                         ","2003-2004",39,"Total Participants",237124,237124,0,139215,139215,0,97909,97909,0,"228","83",36480,13280
"16635",139205,"BREWTON-PARKER COLLEGE                                      ","2003-2004",39,"Total Participants",744627,744627,0,381308,381308,0,363319,363319,0,"62","63",135594,107917
"16639",184481,"ESSEX COUNTY COLLEGE                                        ","2003-2004",39,"Total Participants",358929,358929,0,160132,160132,0,198797,198797,0,"39","43",58811,84127
"16648",214625,"PENNSYLVANIA STATE UNIV-PENN STATE NEW KENSINGTON           ","2003-2004",39,"Total Participants",41347,41347,0,18216,18216,0,23131,23131,0,"32","31",32170,14953
"16658",207847,"SOUTHEASTERN OKLAHOMA STATE UNIVERSITY                      ","2003-2004",39,"Total Participants",424172,424172,0,155734,155734,0,268438,268438,0,"168","67",120689,63694
"16663",149842,"WILLIAM RAINEY HARPER COLLEGE                               ","2003-2004",39,"Total Participants",227777,227777,0,150445,150445,0,77332,77332,0,"243","68",152135,40213
"16670",205203,"UNIVERSITY OF RIO GRANDE                                    ","2003-2004",39,"Total Participants",338441,338441,0,194929,194929,0,143512,143512,0,"139","96",60140,50363
"16674",126289,"ARAPAHOE COMMUNITY COLLEGE                                  ","2003-2004",39,"Total Participants",172500,172500,0,88157,88157,0,84343,84343,0,"27","21",42376,38562
"16677",105154,"MESA COMMUNITY COLLEGE                                      ","2003-2004",39,"Total Participants",274200,274200,0,114600,114600,0,159600,159600,0,"200","126",129900,81300
"16680",112686,"COMPTON COMMUNITY COLLEGE                                   ","2003-2004",39,"Total Participants",57000,57000,0,42750,42750,0,14250,14250,0,"195","30",86750,15250
"16683",101505,"JEFFERSON STATE COMMUNITY COLLEGE                           ","2003-2004",39,"Total Participants",426071,426071,0,209279,209279,0,216792,216792,0,"27","19",63207,82794
"16687",218399,"MORRIS COLLEGE                                              ","2003-2004",39,"Total Participants",107217,107217,0,51957,51957,0,55260,55260,0,"38","63",58555,56190
"16689",166823,"MASSASOIT COMMUNITY COLLEGE                                 ","2003-2004",39,"Total Participants",74237,74237,0,45712,45712,0,28525,28525,0,"55","36",35219,16257
"16696",105428,"PHOENIX COLLEGE                                             ","2003-2004",39,"Total Participants",417260,417260,0,148310,148310,0,268950,268950,0,"152","74",95860,70800
"16699",126669,"COLORADO CHRISTIAN UNIVERSITY                               ","2003-2004",39,"Total Participants",438569,438569,0,153206,153206,0,285363,285363,0,"70","54",54965,59242
"16700",243665,"UNIVERSITY OF THE VIRGIN ISLANDS                            ","2003-2004",39,"Total Participants",137000,137000,0,53000,53000,0,84000,84000,0,"43","48",73000,101000
"16704",217235,"JOHNSON &amp; WALES UNIVERSITY                                  ","2003-2004",39,"Total Participants",455795,455795,0,308633,308633,0,147162,147162,0,"165","106",250060,118008
"16711",166124,"COLLEGE OF THE HOLY CROSS                                   ","2003-2004",39,"Total Participants",4147724,4147724,0,1499236,1499236,0,2648488,2648488,0,"460","404",1053171,575416
"16718",126748,"COLORADO NORTHWESTERN COMMUNITY COLLEGE                     ","2003-2004",39,"Total Participants",363504,363504,0,142317,142317,0,221187,221187,0,"49","40",117124,113311
"16723",150172,"CALUMET COLLEGE OF SAINT JOSEPH                             ","2003-2004",39,"Total Participants",152097,152097,0,70185,70185,0,81912,81912,0,"58","56",68007,77191
"16724",165574,"DEAN COLLEGE                                                ","2003-2004",39,"Total Participants",238698,238698,0,128501,128501,0,110197,110197,0,"138","44",85888,26859
"16727",100937,"BIRMINGHAM SOUTHERN COLLEGE                                 ","2003-2004",39,"Total Participants",3827534,3827534,0,1690280,1690280,0,2137254,2137254,0,"104","105",318292,312229
"16731",126775,"COLORADO SCHOOL OF MINES                                    ","2003-2004",39,"Total Participants",929535,929535,0,582621,582621,0,346914,346914,0,"290","82",348983,152403
"16735",140997,"SOUTH GEORGIA COLLEGE                                       ","2003-2004",39,"Total Participants",232067,232067,0,130030,130030,0,102037,102037,0,"50","33",58175,55455
"16743",196121,"SUNY COLLEGE AT BROCKPORT                                   ","2003-2004",39,"Total Participants",422637,422637,0,245836,245836,0,176801,176801,0,"350","256",274928,156655
"16750",246354,"PALO ALTO COLLEGE                                           ","2003-2004",39,"Total Participants",9896,9896,0,4454,4454,0,5442,5442,0,"10","12",4454,5442
"16752",235103,"EDMONDS COMMUNITY COLLEGE                                   ","2003-2004",39,"Total Participants",107508,107508,0,49802,49802,0,57706,57706,0,"54","58",36977,42023
"16758",247834,"COLLIN COUNTY COMMUNITY COLLEGE DISTRICT                    ","2003-2004",39,"Total Participants",67552,67552,0,33776,33776,0,33776,33776,0,"22","21",48152,47914
"16764",212832,"GWYNEDD MERCY COLLEGE                                       ","2003-2004",39,"Total Participants",179810,179810,0,76349,76349,0,103461,103461,0,"101","125",54362,64944
"16769",104586,"EMBRY RIDDLE AERONAUTICAL UNIVERSITY-PRESCOTT               ","2003-2004",39,"Total Participants",510633,510633,0,321843,321843,0,188790,188790,0,"40","10",68262,31174
"16770",186867,"STEVENS INSTITUTE OF TECHNOLOGY                             ","2003-2004",39,"Total Participants",1233371,1233371,0,700033,700033,0,533338,533338,0,"177","124",275127,206986
"16779",229355,"TYLER JUNIOR COLLEGE                                        ","2003-2004",39,"Total Participants",650939,650939,0,398700,398700,0,252239,252239,0,"178","46",262065,120330
"16781",150668,"GOSHEN COLLEGE                                              ","2003-2004",39,"Total Participants",460788,460788,0,232348,232348,0,228440,228440,0,"92","83",95462,86034
"16784",136358,"PALM BEACH COMMUNITY COLLEGE                                ","2003-2004",39,"Total Participants",228910,228910,0,83967,83967,0,144943,144943,0,"38","47",63759,65751
"16791",156541,"CUMBERLAND COLLEGE                                          ","2003-2004",39,"Total Participants",2334424,2334424,0,1359899,1359899,0,974525,974525,0,"211","137",187621,139414
"16795",136400,"PASCO-HERNANDO COMMUNITY COLLEGE                            ","2003-2004",39,"Total Participants",425408,425408,0,111073,111073,0,314335,314335,0,"32","44",20307,40234
"16796",165015,"BRANDEIS UNIVERSITY                                         ","2003-2004",39,"Total Participants",986903,986903,0,479384,479384,0,507519,507519,0,"151","138",263168,274457
"16798",136473,"PENSACOLA JUNIOR COLLEGE                                    ","2003-2004",39,"Total Participants",410166,410166,0,161844,161844,0,248322,248322,0,"42","51",80457,101038
"16804",200572,"VALLEY CITY STATE UNIVERSITY                                ","2003-2004",39,"Total Participants",102653,102653,0,27604,27604,0,75049,75049,0,"126","42",77945,44620
"16823",128258,"TRINIDAD STATE JUNIOR COLLEGE                               ","2003-2004",39,"Total Participants",217723,217723,0,87088,87088,0,130635,130635,0,"40","27",79157,47952
"16829",108667,"COLLEGE OF ALAMEDA                                          ","2003-2004",39,"Total Participants",24897,24897,0,0,0,0,24897,24897,0,"13","8",13451,8471
"16831",156082,"WASHBURN UNIVERSITY OF TOPEKA                               ","2003-2004",39,"Total Participants",182174,182174,0,63916,63916,0,118258,118258,0,"169","76",214531,158703
"16845",101709,"UNIVERSITY OF MONTEVALLO                                    ","2003-2004",39,"Total Participants",618845,618845,0,303654,303654,0,315191,315191,0,"74","64",183795,118044
"16849",107080,"HENDRIX COLLEGE                                             ","2003-2004",39,"Total Participants",486200,486200,0,207300,207300,0,278900,278900,0,"87","102",121050,143250
"16852",222983,"AUSTIN COLLEGE                                              ","2003-2004",39,"Total Participants",291955,291955,0,155785,155785,0,136170,136170,0,"157","82",161667,99797
"16853",238458,"CARROLL COLLEGE                                             ","2003-2004",39,"Total Participants",274677,274677,0,129505,129505,0,145172,145172,0,"217","162",86910,64098
"16873",198756,"JOHNSON C SMITH UNIVERSITY                                  ","2003-2004",39,"Total Participants",337839,337839,0,97483,97483,0,240356,240356,0,"98","76",160121,93122
"16883",243212,"UNIVERSITY OF PUERTO RICO-PONCE                             ","2003-2004",39,"Total Participants",126930,126930,0,80269,80269,0,46661,46661,0,"91","56",21974,12001
"16890",192466,"SOUTHAMPTON COLLEGE OF LONG ISLAND UNIVERSITY               ","2003-2004",39,"Total Participants",858340,858340,0,469751,469751,0,388589,388589,0,"78","63",80328,92232
"16895",190619,"CUNY KINGSBOROUGH COMMUNITY COLLEGE                         ","2003-2004",39,"Total Participants",89132,89132,0,59739,59739,0,29393,29393,0,"86","52",51982,28379
"16898",241836,"ELECTRONIC DATA PROCESSING COL OF PR INC-SAN SBSTN          ","2003-2004",39,"Total Participants",5100,5100,0,3300,3300,0,1800,1800,0,"28","16",500,300
"16904",191126,"FASHION INSTITUTE OF TECHNOLOGY                             ","2003-2004",39,"Total Participants",91095,91095,0,30545,30545,0,60550,60550,0,"27","71",40017,59752
"16912",239017,"LAWRENCE UNIVERSITY                                         ","2003-2004",39,"Total Participants",649956,649956,0,398523,398523,0,251433,251433,0,"262","164",322803,166299
"16917",366252,"PENNSYLVANIA COLLEGE OF TECHNOLOGY                          ","2003-2004",39,"Total Participants",131942,131942,0,84691,84691,0,47251,47251,0,"146","53",68254,27880
"16922",117104,"LIFE PACIFIC COLLEGE                                        ","2003-2004",39,"Total Participants",13000,13000,0,0,0,0,13000,13000,0,"12","12",15360,12048
"16923",187198,"UNION COUNTY COLLEGE                                        ","2003-2004",39,"Total Participants",90500,90500,0,90500,90500,0,0,0,0,"54","16",75000,24000
"16936",183743,"BERGEN COMMUNITY COLLEGE                                    ","2003-2004",39,"Total Participants",131585,131585,0,78800,78800,0,52785,52785,0,"124","63",70000,54500
"16945",162706,"HARFORD COMMUNITY COLLEGE                                   ","2003-2004",39,"Total Participants",137367,137367,0,69796,69796,0,67571,67571,0,"73","59",21472,16056
"16953",193283,"MOHAWK VALLEY COMMUNITY COLLEGE-UTICA BRANCH                ","2003-2004",39,"Total Participants",234684,234684,0,141903,141903,0,92781,92781,0,"173","94",85041,56293
"16954",155070,"BARCLAY COLLEGE                                             ","2003-2004",39,"Total Participants",15400,15400,0,8225,8225,0,7175,7175,0,"43","35",8345,7870
"16957",183877,"BURLINGTON COUNTY COLLEGE                                   ","2003-2004",39,"Total Participants",30890,30890,0,21665,21665,0,9225,9225,0,"63","13",55140,15743
"16961",210775,"ALVERNIA COLLEGE                                            ","2003-2004",39,"Total Participants",168736,168736,0,73956,73956,0,94780,94780,0,"105","114",46658,61499
"16975",232706,"MARYMOUNT UNIVERSITY                                        ","2003-2004",39,"Total Participants",189874,189874,0,85160,85160,0,104714,104714,0,"85","97",100865,108799
"16978",203775,"MALONE COLLEGE                                              ","2003-2004",39,"Total Participants",1496826,1496826,0,765767,765767,0,731059,731059,0,"238","144",448194,220581
"16981",107141,"JOHN BROWN UNIVERSITY                                       ","2003-2004",39,"Total Participants",660492,660492,0,305602,305602,0,354890,354890,0,"61","71",76699,93365
"16983",154235,"SAINT AMBROSE UNIVERSITY                                    ","2003-2004",39,"Total Participants",1043507,1043507,0,579755,579755,0,463752,463752,0,"324","166",155904,98148
"16985",146472,"COLLEGE OF LAKE COUNTY                                      ","2003-2004",39,"Total Participants",131369,131369,0,60312,60312,0,71057,71057,0,"75","57",62421,64892
"16997",160630,"SOUTHERN UNIVERSITY AT NEW ORLEANS                          ","2003-2004",39,"Total Participants",235998,235998,0,117999,117999,0,117999,117999,0,"22","18",176716,176716
"17001",139250,"COASTAL GEORGIA COMMUNITY COLLEGE                           ","2003-2004",39,"Total Participants",72427,72427,0,0,0,0,72427,72427,0,"12","12",89307,67778
"17009",104577,"EASTERN ARIZONA COLLEGE                                     ","2003-2004",39,"Total Participants",348838,348838,0,130311,130311,0,218527,218527,0,"138","54",303600,127303
"17017",201973,"CLARK STATE COMMUNITY COLLEGE                               ","2003-2004",39,"Total Participants",90841,90841,0,26558,26558,0,64283,64283,0,"27","33",30394,43299
"17022",160904,"XAVIER UNIVERSITY OF LOUISIANA                              ","2003-2004",39,"Total Participants",793353,793353,0,329163,329163,0,464190,464190,0,"46","66",143585,239953
"17024",243346,"UNIVERSIDAD DEL ESTE                                        ","2003-2004",39,"Total Participants",179807,179807,0,99447,99447,0,80360,80360,0,"59","52",107339,91575
"17030",195474,"SIENA COLLEGE                                               ","2003-2004",39,"Total Participants",2832506,2832506,0,1093208,1093208,0,1739298,1739298,0,"217","188",1432723,860134
"17049",213525,"LEHIGH CARBON COMMUNITY COLLEGE                             ","2003-2004",39,"Total Participants",17680,17680,0,9807,9807,0,7873,7873,0,"48","29",3430,1430
"17051",167905,"SPRINGFIELD TECHNICAL COMMUNITY COLLEGE                     ","2003-2004",39,"Total Participants",55775,55775,0,34650,34650,0,21125,21125,0,"79","31",27920,20395
"17054",133492,"ECKERD COLLEGE                                              ","2003-2004",39,"Total Participants",891720,891720,0,544641,544641,0,347079,347079,0,"100","75",162280,108385
"17061",154642,"ALLEN COUNTY COMMUNITY COLLEGE                              ","2003-2004",39,"Total Participants",178776,178776,0,97112,97112,0,81664,81664,0,"85","60",78941,68250
"17070",148627,"SAINT XAVIER UNIVERSITY                                     ","2003-2004",39,"Total Participants",488305,488305,0,215807,215807,0,272498,272498,0,"166","91",212272,120693
"17083",182865,"HESSER COLLEGE                                              ","2003-2004",39,"Total Participants",52015,52015,0,19716,19716,0,32299,32299,0,"40","45",11688,15294
"17084",208646,"EASTERN OREGON UNIVERSITY                                   ","2003-2004",39,"Total Participants",446048,446048,0,149259,149259,0,296789,296789,0,"220","113",197682,138458
"17091",185536,"MIDDLESEX COUNTY COLLEGE                                    ","2003-2004",39,"Total Participants",150310,150310,0,98080,98080,0,52230,52230,0,"104","45",41801,22627
"17093",213659,"LUZERNE COUNTY COMMUNITY COLLEGE                            ","2003-2004",39,"Total Participants",55000,55000,0,24250,24250,0,30750,30750,0,"46","53",26050,23450
"17095",223922,"CLARENDON COLLEGE                                           ","2003-2004",39,"Total Participants",228620,228620,0,128560,128560,0,100060,100060,0,"70","61",65001,67379
"17106",163046,"LOYOLA COLLEGE IN MARYLAND                                  ","2003-2004",39,"Total Participants",4024753,4024753,0,2050333,2050333,0,1974420,1974420,0,"146","181",563885,413842
"17108",240514,"CENTRAL WYOMING COLLEGE                                     ","2003-2004",39,"Total Participants",104064,104064,0,69237,69237,0,34827,34827,0,"21","10",27850,13262
"17112",214768,"PENNSYLVANIA STATE UNIVERSITY-PENN STATE HAZLETON           ","2003-2004",39,"Total Participants",25800,25800,0,13800,13800,0,12000,12000,0,"56","40",15350,14750
"17114",161484,"NORTHERN MAINE TECHNICAL COLLEGE                            ","2003-2004",39,"Total Participants",15968,15968,0,14647,14647,0,1321,1321,0,"52","10",13479,1268
"17115",181853,"YORK COLLEGE                                                ","2003-2004",39,"Total Participants",134126,134126,0,71466,71466,0,62660,62660,0,"112","44",53799,39202
"17121",122977,"SANTA MONICA COLLEGE                                        ","2003-2004",39,"Total Participants",279074,279074,0,93908,93908,0,185166,185166,0,"130","103",53728,56335
"17122",202523,"DENISON UNIVERSITY                                          ","2003-2004",39,"Total Participants",1275627,1275627,0,640133,640133,0,635494,635494,0,"276","202",357573,292556
"17125",186645,"RARITAN VALLEY COMMUNITY COLLEGE                            ","2003-2004",39,"Total Participants",46772,46772,0,33616,33616,0,13156,13156,0,"41","28",17412,9236
"17126",213826,"MARYWOOD UNIVERSITY                                         ","2003-2004",39,"Total Participants",154849,154849,0,62611,62611,0,92238,92238,0,"61","99",45290,65189
"17138",190549,"CUNY BROOKLYN COLLEGE                                       ","2003-2004",39,"Total Participants",108680,108680,0,56642,56642,0,52038,52038,0,"82","88",43861,42813
"17141",227191,"NORTH LAKE COLLEGE                                          ","2003-2004",39,"Total Participants",108224,108224,0,77884,77884,0,30340,30340,0,"39","17",48000,11200
"17143",193584,"NAZARETH COLLEGE OF ROCHESTER                               ","2003-2004",39,"Total Participants",682464,682464,0,288682,288682,0,393782,393782,0,"147","249",204244,282897
"17146",162557,"FREDERICK COMMUNITY COLLEGE                                 ","2003-2004",39,"Total Participants",46517,46517,0,22585,22585,0,23932,23932,0,"52","40",10043,11527
"17149",198552,"FORSYTH TECHNICAL COMMUNITY COLLEGE                         ","2003-2004",39,"Total Participants",7604,7604,0,0,0,0,7604,7604,0,"10","20",7510,2869
"17151",240505,"CASPER COLLEGE                                              ","2003-2004",39,"Total Participants",222741,222741,0,81894,81894,0,140847,140847,0,"35","37",61903,56296
"17155",116439,"IRVINE VALLEY COLLEGE                                       ","2003-2004",39,"Total Participants",252602,252602,0,154394,154394,0,98208,98208,0,"104","45",70412,32315
"17158",193399,"COLLEGE OF MOUNT SAINT VINCENT                              ","2003-2004",39,"Total Participants",0,0,0,0,0,0,0,0,0,"65","99",51500,66500
"17164",133386,"DAYTONA BEACH COMMUNITY COLLEGE                             ","2003-2004",39,"Total Participants",219345,219345,0,32433,32433,0,186912,186912,0,"39","46",67940,89689
"17166",106467,"ARKANSAS TECH UNIVERSITY                                    ","2003-2004",39,"Total Participants",656844,656844,0,211769,211769,0,445075,445075,0,"199","65",173067,141273
"17182",210669,"ALLEGHENY COLLEGE                                           ","2003-2004",39,"Total Participants",681052,681052,0,318222,318222,0,362830,362830,0,"332","186",216635,180040
"17202",181127,"HASTINGS COLLEGE                                            ","2003-2004",39,"Total Participants",2326997,2326997,0,1277659,1277659,0,1049338,1049338,0,"348","142",192749,116763
"17206",185509,"MERCER COUNTY COMMUNITY COLLEGE                             ","2003-2004",39,"Total Participants",70000,70000,0,35000,35000,0,35000,35000,0,"72","54",48987,48978
"17236",366395,"SUFFOLK COUNTY COMMUNITY COLLEGE                            ","2003-2004",39,"Total Participants",123730,123730,0,73634,73634,0,50096,50096,0,"75","48",52659,38725
"17238",107600,"PHILANDER SMITH COLLEGE                                     ","2003-2004",39,"Total Participants",12154,12154,0,0,0,0,12154,12154,0,"13","24",29576,24635
"17239",243179,"UNIVERSITY OF PUERTO RICO-HUMACAO                           ","2003-2004",39,"Total Participants",89407,89407,0,46999,46999,0,42408,42408,0,"86","89",24662,23050
"17246",191533,"HARTWICK COLLEGE                                            ","2003-2004",39,"Total Participants",2088941,2088941,0,938732,938732,0,1150209,1150209,0,"288","240",189670,201783
"17250",196042,"FARMINGDALE STATE UNIVERSITY OF NEW YORK                    ","2003-2004",39,"Total Participants",242450,242450,0,141425,141425,0,101025,101025,0,"148","79",95900,71500
"17256",110538,"CALIFORNIA STATE UNIVERSITY-CHICO                           ","2003-2004",39,"Total Participants",1576609,1576609,0,905828,905828,0,670781,670781,0,"177","167",340848,189187
"17269",206491,"WILBERFORCE UNIVERSITY                                      ","2003-2004",39,"Total Participants",8540,8540,0,4270,4270,0,4270,4270,0,"24","19",35028,35793
"17270",189705,"CANISIUS COLLEGE                                            ","2003-2004",39,"Total Participants",2265099,2265099,0,1097262,1097262,0,1167837,1167837,0,"167","129",469996,311340
"17285",186432,"SAINT PETERS COLLEGE                                        ","2003-2004",39,"Total Participants",1710507,1710507,0,1015693,1015693,0,694814,694814,0,"243","148",490701,162335
"17291",237640,"OHIO VALLEY COLLEGE                                         ","2003-2004",39,"Total Participants",406754,406754,0,233976,233976,0,172778,172778,0,"83","68",54965,42554
"17293",173124,"BEMIDJI STATE UNIVERSITY                                    ","2003-2004",39,"Total Participants",1817282,1817282,0,872808,872808,0,944474,944474,0,"236","130",580018,444350
"17301",200484,"TRINITY BIBLE COLLEGE                                       ","2003-2004",39,"Total Participants",27159,27159,0,0,0,0,27159,27159,0,"37","17",42202,23421
"17309",238333,"BELOIT COLLEGE                                              ","2003-2004",39,"Total Participants",154631,154631,0,70834,70834,0,83797,83797,0,"179","172",117984,102109
"17312",175652,"EAST MISSISSIPPI COMMUNITY COLLEGE                          ","2003-2004",39,"Total Participants",146845,146845,0,94041,94041,0,52804,52804,0,"131","60",91736,27658
"17315",130916,"DELAWARE TECHNICAL &amp; COMM COLL-STANTON-WILMINGTON           ","2003-2004",39,"Total Participants",35031,35031,0,9817,9817,0,25214,25214,0,"27","19",17413,14737
"17317",214829,"PENNSYLVANIA STATE UNIVERSITY-PENN STATE YORK               ","2003-2004",39,"Total Participants",33950,33950,0,23770,23770,0,10180,10180,0,"49","20",32828,17359
"17325",210155,"SOUTHWESTERN OREGON COMMUNITY COLLEGE                       ","2003-2004",39,"Total Participants",441028,441028,0,240521,240521,0,200507,200507,0,"96","68",189470,154608
"17332",215947,"SETON HILL UNIVERSITY                                       ","2003-2004",39,"Total Participants",875227,875227,0,404925,404925,0,470302,470302,0,"171","166",226700,188300
"17346",214810,"PENNSYLVANIA STATE UNIVERSITY-PENN STATE SCHUYLKIL          ","2003-2004",39,"Total Participants",10000,10000,0,4500,4500,0,5500,5500,0,"49","33",10498,5502
"17351",217420,"RHODE ISLAND COLLEGE                                        ","2003-2004",39,"Total Participants",510064,510064,0,249621,249621,0,260443,260443,0,"161","135",146326,106157
"17352",222053,"VOLUNTEER STATE COMMUNITY COLLEGE                           ","2003-2004",39,"Total Participants",297403,297403,0,181064,181064,0,116339,116339,0,"48","30",61645,53928
"1",100654,"ALABAMA A &amp; M UNIVERSITY                                    ","2003-2004",1,"Baseball",222503,222504,-1,222503,222504,-1,0,0,0,"27",".",62410,0
"242",151360,"INDIANA UNIVERSITY-NORTHWEST                                ","2003-2004",1,"Baseball",10186,10187,-1,10186,10187,-1,0,0,0,"16",".",10186,0
"260",102234,"SPRING HILL COLLEGE                                         ","2003-2004",1,"Baseball",35000,35001,-1,35000,35001,-1,0,0,0,"31",".",35000,0
"410",167987,"UNIVERSITY OF MASSACHUSETTS-DARTMOUTH                       ","2003-2004",1,"Baseball",75365,75366,-1,75365,75366,-1,0,0,0,"27",".",29042,0
"952",180151,"DAWSON COMMUNITY COLLEGE                                    ","2003-2004",1,"Baseball",34662,34663,-1,34662,34663,-1,0,0,0,"23",".",34662,0
"1494",211291,"BUCKNELL UNIVERSITY                                         ","2003-2004",1,"Baseball",262859,262860,-1,262859,262860,-1,0,0,0,"33",".",70257,0
"2511",173203,"CENTRAL LAKES COLLEGE-BRAINERD                              ","2003-2004",2,"Basketball",58685,58686,-1,29165,29166,-1,29520,29520,0,"15","9",19360,17675
"2529",167358,"NORTHEASTERN UNIVERSITY                                     ","2003-2004",2,"Basketball",2049478,2049479,-1,1004183,1004183,0,1045295,1045296,-1,"15","14",114219,52745
"3466",211291,"BUCKNELL UNIVERSITY                                         ","2003-2004",2,"Basketball",1438758,1438759,-1,839242,839243,-1,599516,599516,0,"16","17",143556,91274
"3524",204024,"MIAMI UNIVERSITY-OXFORD                                     ","2003-2004",3,"All Track Combined",1181932,1181933,-1,484406,484406,0,697526,697527,-1,"54","88",76854,114430
"3605",100654,"ALABAMA A &amp; M UNIVERSITY                                    ","2003-2004",3,"All Track Combined",296167,296168,-1,171484,171485,-1,124683,124683,0,"48","40",33397,31500
"3933",122658,"SAN JOAQUIN DELTA COLLEGE                                   ","2003-2004",3,"All Track Combined",37437,37438,-1,20535,20535,0,16902,16903,-1,"21","16",8633,9935
"4860",211291,"BUCKNELL UNIVERSITY                                         ","2003-2004",7,"Football",2500395,2500396,-1,2500395,2500396,-1,0,0,0,"90",".",187071,0
"5895",207856,"SOUTHWESTERN CHRISTIAN UNIVERSITY                           ","2003-2004",8,"Golf",4465,4466,-1,4465,4466,-1,0,0,0,"6",".",4465,0
"6197",227429,"PAUL QUINN COLLEGE                                          ","2003-2004",8,"Golf",12784,12785,-1,6792,6792,0,5992,5993,-1,"10","10",3450,3325
"6454",167358,"NORTHEASTERN UNIVERSITY                                     ","2003-2004",10,"Ice Hockey",2073530,2073531,-1,1160743,1160743,0,912787,912788,-1,"29","24",70809,52820
"6698",214069,"COLLEGE MISERICORDIA                                        ","2003-2004",11,"Lacrosse",22867,22868,-1,14738,14739,-1,8129,8129,0,"25","17",3077,2618
"6785",213668,"LYCOMING COLLEGE                                            ","2003-2004",11,"Lacrosse",123676,123677,-1,64404,64404,0,59272,59273,-1,"35","18",23163,19550
"7250",110404,"CALIFORNIA INSTITUTE OF TECHNOLOGY                          ","2003-2004",15,"Soccer",43197,43198,-1,43197,43198,-1,0,0,0,"32",".",8430,0
"7719",167358,"NORTHEASTERN UNIVERSITY                                     ","2003-2004",15,"Soccer",588164,588165,-1,179247,179247,0,408917,408918,-1,"27","26",31365,33249
"7895",192819,"MARIST COLLEGE                                              ","2003-2004",15,"Soccer",583450,583451,-1,275975,275976,-1,307475,307475,0,"24","31",46250,43104
"8032",154013,"MOUNT MERCY COLLEGE                                         ","2003-2004",15,"Soccer",22909,22910,-1,11335,11336,-1,11574,11574,0,"21","15",10770,10991
"8604",102234,"SPRING HILL COLLEGE                                         ","2003-2004",16,"Softball",28000,28001,-1,0,0,0,28000,28001,-1,".","15",0,28000
"9279",155098,"FORT SCOTT COMMUNITY COLLEGE                                ","2003-2004",16,"Softball",60003,60004,-1,0,0,0,60003,60004,-1,".","16",0,15635
"9455",153311,"EASTERN IOWA COMMUNITY COLLEGE DISTRICT                     ","2003-2004",16,"Softball",55753,55754,-1,0,0,0,55753,55754,-1,".","19",0,14054
"9582",159568,"LOUISIANA COLLEGE                                           ","2003-2004",16,"Softball",95674,95675,-1,0,0,0,95674,95675,-1,".","19",0,27753
"9661",180151,"DAWSON COMMUNITY COLLEGE                                    ","2003-2004",16,"Softball",33065,33066,-1,0,0,0,33065,33066,-1,".","15",0,33065
"10108",192819,"MARIST COLLEGE                                              ","2003-2004",18,"Swimming and Diving",467640,467641,-1,229899,229899,0,237741,237742,-1,"23","21",41959,39259
"10470",192703,"MANHATTAN COLLEGE                                           ","2003-2004",19,"Swimming",57780,57781,-1,0,0,0,57780,57781,-1,".","19",0,15816
"10857",209056,"LEWIS &amp; CLARK COLLEGE                                       ","2003-2004",22,"Tennis",64210,64211,-1,34924,34925,-1,29286,29286,0,"7","10",10091,4460
"10995",132709,"BROWARD COMMUNITY COLLEGE                                   ","2003-2004",22,"Tennis",79479,79480,-1,0,0,0,79479,79480,-1,".","12",0,42052
"11381",192749,"MANHATTANVILLE COLLEGE                                      ","2003-2004",22,"Tennis",6734,6735,-1,967,968,-1,5767,5767,0,"10","8",967,1192
"11587",243443,"UNIVERSITY OF SACRED HEART                                  ","2003-2004",22,"Tennis",19795,19796,-1,12070,12070,0,7725,7726,-1,"5","3",12070,7725
"11836",110486,"CALIFORNIA STATE UNIVERSITY-BAKERSFIELD                     ","2003-2004",23,"Track and Field, Indoor",5578,5579,-1,2894,2894,0,2684,2685,-1,"16","21",1210,1510
"12315",199281,"UNIVERSITY OF NORTH CAROLINA AT PEMBROKE                    ","2003-2004",25,"Track and Field, X-Country",23461,23462,-1,11796,11796,0,11665,11666,-1,"10","6",11095,9116
"12338",231420,"AVERETT UNIVERSITY                                          ","2003-2004",25,"Track and Field, X-Country",15960,15961,-1,7980,7980,0,7980,7981,-1,"2","6",5000,7980
"12954",110051,"BETHANY COLLEGE OF THE ASSEMBLIES OF GOD                    ","2003-2004",25,"Track and Field, X-Country",1740,1741,-1,0,0,0,1740,1741,-1,".","2",0,1740
"13195",153296,"ELLSWORTH COMMUNITY COLLEGE                                 ","2003-2004",26,"Volleyball",13304,13305,-1,0,0,0,13304,13305,-1,".","12",0,10082
"13385",151360,"INDIANA UNIVERSITY-NORTHWEST                                ","2003-2004",26,"Volleyball",17561,17562,-1,0,0,0,17561,17562,-1,".","14",0,17561
"14019",207856,"SOUTHWESTERN CHRISTIAN UNIVERSITY                           ","2003-2004",26,"Volleyball",6805,6806,-1,0,0,0,6805,6806,-1,".","11",0,6805
"14270",163426,"MONTGOMERY COLLEGE                                          ","2003-2004",26,"Volleyball",8210,8211,-1,0,0,0,8210,8211,-1,".","8",0,3066
"14338",168528,"ADRIAN COLLEGE                                              ","2003-2004",26,"Volleyball",17809,17810,-1,0,0,0,17809,17810,-1,".","12",0,17809
"14363",211291,"BUCKNELL UNIVERSITY                                         ","2003-2004",26,"Volleyball",339442,339443,-1,0,0,0,339442,339443,-1,".","18",0,43737
"14365",132709,"BROWARD COMMUNITY COLLEGE                                   ","2003-2004",26,"Volleyball",54990,54991,-1,0,0,0,54990,54991,-1,".","12",0,43602
"14389",102234,"SPRING HILL COLLEGE                                         ","2003-2004",26,"Volleyball",17000,17001,-1,0,0,0,17000,17001,-1,".","16",0,17000
"14611",237057,"WHITMAN COLLEGE                                             ","2003-2004",26,"Volleyball",49952,49953,-1,0,0,0,49952,49953,-1,".","12",0,22594
"14817",153296,"ELLSWORTH COMMUNITY COLLEGE                                 ","2003-2004",28,"Wrestling",22375,22376,-1,22375,22376,-1,0,0,0,"25",".",17891,0
"15129",214069,"COLLEGE MISERICORDIA                                        ","2003-2004",29,"Other Sports",3912,3913,-1,0,0,0,3912,3913,-1,".","18",0,1531
"15443",167987,"UNIVERSITY OF MASSACHUSETTS-DARTMOUTH                       ","2003-2004",39,"Total Participants",650168,650169,-1,339702,339703,-1,310466,310466,0,"300","236",211087,154277
"15796",122658,"SAN JOAQUIN DELTA COLLEGE                                   ","2003-2004",39,"Total Participants",305785,305786,-1,150614,150614,0,155171,155172,-1,"215","105",102611,71717
"16355",110051,"BETHANY COLLEGE OF THE ASSEMBLIES OF GOD                    ","2003-2004",39,"Total Participants",566779,566780,-1,231313,231313,0,335466,335467,-1,"47","61",57234,93553
"16651",110404,"CALIFORNIA INSTITUTE OF TECHNOLOGY                          ","2003-2004",39,"Total Participants",338361,338362,-1,204492,204493,-1,133869,133869,0,"180","89",66949,57183
"17098",155098,"FORT SCOTT COMMUNITY COLLEGE                                ","2003-2004",39,"Total Participants",390145,390146,-1,220702,220702,0,169443,169444,-1,"220","53",140020,63155
"1842",207856,"SOUTHWESTERN CHRISTIAN UNIVERSITY                           ","2003-2004",2,"Basketball",26757,26759,-2,16851,16852,-1,9906,9907,-1,"17","11",16851,9906
"2447",102234,"SPRING HILL COLLEGE                                         ","2003-2004",2,"Basketball",66050,66052,-2,36050,36051,-1,30000,30001,-1,"13","15",36050,30000
"3333",144166,"CITY COLLEGES OF CHICAGO-MALCOLM X COLLEGE                  ","2003-2004",2,"Basketball",148122,148124,-2,74061,74062,-1,74061,74062,-1,"11","10",74061,74061
"5167",237057,"WHITMAN COLLEGE                                             ","2003-2004",8,"Golf",35780,35782,-2,17890,17891,-1,17890,17891,-1,"6","6",5727,5727
"5650",102234,"SPRING HILL COLLEGE                                         ","2003-2004",8,"Golf",12000,12002,-2,6000,6001,-1,6000,6001,-1,"11","7",6000,6000
"6641",216339,"TEMPLE UNIVERSITY                                           ","2003-2004",11,"Lacrosse",461725,461727,-2,0,0,0,461725,461727,-2,".","22",0,61226
"6876",240365,"UNIVERSITY OF WISCONSIN-OSHKOSH                             ","2003-2004",12,"Rifle",2,4,-2,1,2,-1,1,2,-1,"8",".",1,1
"7077",102234,"SPRING HILL COLLEGE                                         ","2003-2004",15,"Soccer",44000,44002,-2,22000,22001,-1,22000,22001,-1,"27","19",22000,22000
"10610",102234,"SPRING HILL COLLEGE                                         ","2003-2004",19,"Swimming",24000,24002,-2,12000,12001,-1,12000,12001,-1,"10","12",12000,12000
"10616",243443,"UNIVERSITY OF SACRED HEART                                  ","2003-2004",19,"Swimming",57976,57978,-2,46420,46420,0,11556,11558,-2,"11","4",46420,11556
"11628",102234,"SPRING HILL COLLEGE                                         ","2003-2004",22,"Tennis",20000,20002,-2,10000,10001,-1,10000,10001,-1,"11","11",10000,10000
"11861",217402,"PROVIDENCE COLLEGE                                          ","2003-2004",23,"Track and Field, Indoor",2,4,-2,1,2,-1,1,2,-1,"24","23",1,1
"12064",217402,"PROVIDENCE COLLEGE                                          ","2003-2004",24,"Track and Field, Outdoor",2,4,-2,1,2,-1,1,2,-1,"23","21",1,1
"12079",243443,"UNIVERSITY OF SACRED HEART                                  ","2003-2004",24,"Track and Field, Outdoor",9924,9926,-2,9924,9926,-2,0,0,0,"3","0",9924,0
"12645",144564,"DANVILLE AREA COMMUNITY COLLEGE                             ","2003-2004",25,"Track and Field, X-Country",29150,29152,-2,14575,14576,-1,14575,14576,-1,"17","15",14575,14574
"12652",102234,"SPRING HILL COLLEGE                                         ","2003-2004",25,"Track and Field, X-Country",6760,6762,-2,3380,3381,-1,3380,3381,-1,"10","8",3380,3380
"12864",146481,"LAKE FOREST COLLEGE                                         ","2003-2004",25,"Track and Field, X-Country",19339,19341,-2,9670,9670,0,9669,9671,-2,"9","7",4645,4646
"15791",151360,"INDIANA UNIVERSITY-NORTHWEST                                ","2003-2004",39,"Total Participants",36697,36699,-2,14661,14662,-1,22036,22037,-1,"41","32",31417,36098
"15900",167358,"NORTHEASTERN UNIVERSITY                                     ","2003-2004",39,"Total Participants",6979048,6979050,-2,2419990,2419990,0,4559058,4559060,-2,"255","224",561116,340073
"16661",207856,"SOUTHWESTERN CHRISTIAN UNIVERSITY                           ","2003-2004",39,"Total Participants",11270,11272,-2,4465,4466,-1,6805,6806,-1,"23","22",21316,16711
"16757",216339,"TEMPLE UNIVERSITY                                           ","2003-2004",39,"Total Participants",5282343,5282345,-2,1496901,1496901,0,3785442,3785444,-2,"308","229",2426666,874357
"11759",168528,"ADRIAN COLLEGE                                              ","2003-2004",22,"Tennis",6701,6705,-4,4917,4920,-3,1784,1785,-1,"7","7",4917,1784
"1715",200314,"MINOT STATE UNIVERSITY-BOTTINEAU CAMPUS                     ","2003-2004",2,"Basketball",30139,30144,-5,18520,18475,45,11619,11669,-50,"11","8",16906,10801
"11892",192439,"LONG ISLAND UNIVERSITY-BROOKLYN CAMPUS                      ","2003-2004",23,"Track and Field, Indoor",398017,398022,-5,198343,198348,-5,199674,199674,0,"19","17",44702,43543
"12002",192439,"LONG ISLAND UNIVERSITY-BROOKLYN CAMPUS                      ","2003-2004",24,"Track and Field, Outdoor",398017,398022,-5,198343,198348,-5,199674,199674,0,"19","16",44702,43543
"12718",165644,"EASTERN NAZARENE COLLEGE                                    ","2003-2004",25,"Track and Field, X-Country",6481,6486,-5,3241,3243,-2,3240,3243,-3,"9","6",1865,1865
"12",100663,"UNIVERSITY OF ALABAMA AT BIRMINGHAM                         ","2003-2004",1,"Baseball",520440,520446,-6,520440,520446,-6,0,0,0,"31",".",132277,0
"609",132709,"BROWARD COMMUNITY COLLEGE                                   ","2003-2004",1,"Baseball",129483,129490,-7,129483,129490,-7,0,0,0,"30",".",92808,0
"11719",237057,"WHITMAN COLLEGE                                             ","2003-2004",22,"Tennis",82145,82153,-8,43096,43116,-20,39049,39037,12,"13","13",19336,22060
"5520",181312,"MID PLAINS COMMUNITY COLLEGE AREA                           ","2003-2004",8,"Golf",20248,20257,-9,20248,20257,-9,0,0,0,"8","0",9873,0
"11071",206914,"CAMERON UNIVERSITY                                          ","2003-2004",22,"Tennis",27995,28004,-9,14534,14543,-9,13461,13461,0,"9","7",12249,10903
"1720",243443,"UNIVERSITY OF SACRED HEART                                  ","2003-2004",2,"Basketball",59532,59542,-10,40920,40924,-4,18612,18618,-6,"11","9",40920,18612
"2067",132709,"BROWARD COMMUNITY COLLEGE                                   ","2003-2004",2,"Basketball",154160,154170,-10,70379,70380,-1,83781,83790,-9,"13","15",53693,66798
"9316",121044,"PASADENA CITY COLLEGE                                       ","2003-2004",16,"Softball",69766,69776,-10,0,0,0,69766,69776,-10,".","13",0,4000
"9441",132709,"BROWARD COMMUNITY COLLEGE                                   ","2003-2004",16,"Softball",81350,81360,-10,0,0,0,81350,81360,-10,".","20",0,62512
"16158",121044,"PASADENA CITY COLLEGE                                       ","2003-2004",39,"Total Participants",484715,484725,-10,162808,162808,0,321907,321917,-10,"185","106",31500,23000
"6270",191649,"HOFSTRA UNIVERSITY                                          ","2003-2004",8,"Golf",224962,224973,-11,103787,103166,621,121175,121807,-632,"9","10",21523,21523
"11319",186399,"RUTGERS UNIVERSITY-NEWARK                                   ","2003-2004",22,"Tennis",45076,45088,-12,24089,24090,-1,20987,20998,-11,"12","10",5681,3460
"8432",168528,"ADRIAN COLLEGE                                              ","2003-2004",15,"Soccer",29377,29390,-13,13444,13450,-6,15933,15940,-7,"14","19",13444,15933
"9768",168528,"ADRIAN COLLEGE                                              ","2003-2004",16,"Softball",34987,35000,-13,0,0,0,34987,35000,-13,".","18",0,29476
"16906",102234,"SPRING HILL COLLEGE                                         ","2003-2004",39,"Total Participants",186760,186773,-13,88380,88386,-6,98380,98387,-7,"113","103",124430,128380
"9164",167288,"MASSACHUSETTS COLLEGE OF LIBERAL ARTS                       ","2003-2004",16,"Softball",32192,32206,-14,0,0,0,32192,32206,-14,".","11",0,19706
"495",145725,"ILLINOIS INSTITUTE OF TECHNOLOGY                            ","2003-2004",1,"Baseball",84668,84684,-16,84668,84684,-16,0,0,0,"26",".",31684,0
"12520",168528,"ADRIAN COLLEGE                                              ","2003-2004",25,"Track and Field, X-Country",38464,38480,-16,19232,19240,-8,19232,19240,-8,"28","24",16247,16247
"14377",200314,"MINOT STATE UNIVERSITY-BOTTINEAU CAMPUS                     ","2003-2004",26,"Volleyball",9209,9225,-16,0,0,0,9209,9225,-16,".","11",0,7939
"6046",228802,"THE UNIVERSITY OF TEXAS AT TYLER                            ","2003-2004",8,"Golf",17500,17517,-17,8750,10324,-1574,8750,7193,1557,"9","5",7943,2961
"14681",128902,"CONNECTICUT COLLEGE                                         ","2003-2004",27,"Water Polo",28748,28766,-18,17491,17491,0,11257,11275,-18,"18","11",12191,5975
"16511",128902,"CONNECTICUT COLLEGE                                         ","2003-2004",39,"Total Participants",1404570,1404588,-18,647277,647277,0,757293,757311,-18,"252","289",197521,223498
"1489",138761,"ANDREW COLLEGE                                              ","2003-2004",1,"Baseball",25597,25616,-19,25597,25616,-19,0,0,0,"25",".",24414,0
"14834",196006,"SUNY COLLEGE OF TECHNOLOGY AT ALFRED                        ","2003-2004",28,"Wrestling",17086,17105,-19,17086,17105,-19,0,0,0,"15",".",9793,0
"16522",132709,"BROWARD COMMUNITY COLLEGE                                   ","2003-2004",39,"Total Participants",345302,345321,-19,129483,129490,-7,215819,215831,-12,"43","59",146501,214964
"9620",216038,"SLIPPERY ROCK UNIVERSITY OF PENNSYLVANIA                    ","2003-2004",16,"Softball",98212,98232,-20,0,0,0,98212,98232,-20,".","27",0,36154
"9832",228787,"THE UNIVERSITY OF TEXAS AT DALLAS                           ","2003-2004",16,"Softball",25350,25370,-20,0,0,0,25350,25370,-20,".","16",0,25350
"14045",208275,"BLUE MOUNTAIN COMMUNITY COLLEGE                             ","2003-2004",26,"Volleyball",43591,43612,-21,0,0,0,43591,43612,-21,".","9",0,15111
"573",168528,"ADRIAN COLLEGE                                              ","2003-2004",1,"Baseball",52576,52600,-24,52576,52600,-24,0,0,0,"40",".",44326,0
"12898",196219,"SUNY COLLEGE AT PURCHASE                                    ","2003-2004",25,"Track and Field, X-Country",9400,9424,-24,4700,4712,-12,4700,4712,-12,"4","3",4700,4700
"2314",153296,"ELLSWORTH COMMUNITY COLLEGE                                 ","2003-2004",2,"Basketball",48174,48199,-25,32190,32211,-21,15984,15988,-4,"15","10",27051,14008
"7890",153922,"MARSHALLTOWN COMMUNITY COLLEGE                              ","2003-2004",15,"Soccer",13724,13749,-25,13724,13749,-25,0,0,0,"18",".",12215,0
"5301",233912,"VIRGINIA INTERMONT COLLEGE                                  ","2003-2004",8,"Golf",6900,6926,-26,6900,6926,-26,0,0,0,"8",".",6900,0
"3983",232423,"JAMES MADISON UNIVERSITY                                    ","2003-2004",5,"Fencing",29062,29091,-29,0,0,0,29062,29091,-29,"0","12",0,9983
"10827",237792,"SHEPHERD COLLEGE                                            ","2003-2004",22,"Tennis",38238,38267,-29,18919,19343,-424,19319,18924,395,"11","8",9073,8117
"12399",220613,"LEE UNIVERSITY                                              ","2003-2004",25,"Track and Field, X-Country",60491,60521,-30,30241,29598,643,30250,30923,-673,"10","8",7023,7023
"6191",108807,"ALLAN HANCOCK COLLEGE                                       ","2003-2004",8,"Golf",11308,11339,-31,11308,11339,-31,0,0,0,"10",".",5974,0
"10244",215929,"UNIVERSITY OF SCRANTON                                      ","2003-2004",18,"Swimming and Diving",63973,64004,-31,29048,29063,-15,34925,34941,-16,"14","23",7599,13403
"6863",230995,"NORWICH UNIVERSITY                                          ","2003-2004",12,"Rifle",12959,12993,-34,10603,10630,-27,2356,2363,-7,"9","2",8368,1860
"7045",190044,"CLARKSON UNIVERSITY                                         ","2003-2004",14,"Skiing",64722,64757,-35,43364,43387,-23,21358,21370,-12,"16","8",27280,13436
"9890",215442,"POINT PARK UNIVERSITY                                       ","2003-2004",16,"Softball",107865,107902,-37,0,0,0,107865,107902,-37,".","16",0,17440
"9997",191649,"HOFSTRA UNIVERSITY                                          ","2003-2004",16,"Softball",634565,634602,-37,0,0,0,634565,634602,-37,".","19",0,126260
"232",223524,"BROOKHAVEN COLLEGE                                          ","2003-2004",1,"Baseball",28957,28996,-39,28957,28996,-39,0,0,0,"31",".",20790,0
"11183",129941,"UNIVERSITY OF NEW HAVEN                                     ","2003-2004",22,"Tennis",20665,20704,-39,0,0,0,20665,20704,-39,".","17",0,5499
"8209",151786,"MARIAN COLLEGE                                              ","2003-2004",15,"Soccer",166900,166941,-41,93150,93187,-37,73750,73754,-4,"22","22",7287,5124
"7596",214379,"NORTHAMPTON COUNTY AREA COMMUNITY COLLEGE                   ","2003-2004",15,"Soccer",9618,9660,-42,9618,9660,-42,0,0,0,"18","0",4210,0
"7160",113980,"EL CAMINO COLLEGE                                           ","2003-2004",15,"Soccer",34694,34738,-44,16547,16569,-22,18147,18169,-22,"29","23",6553,6553
"12669",231086,"SOUTHERN VERMONT COLLEGE                                    ","2003-2004",25,"Track and Field, X-Country",6410,6455,-45,3205,3205,0,3205,3250,-45,"9","8",1331,1331
"16999",200253,"MINOT STATE UNIVERSITY                                      ","2003-2004",39,"Total Participants",115991,116036,-45,52025,52146,-121,63966,63890,76,"155","67",110536,80316
"17011",231086,"SOUTHERN VERMONT COLLEGE                                    ","2003-2004",39,"Total Participants",96025,96070,-45,34525,34525,0,61500,61545,-45,"73","72",35835,25841
"1828",165112,"BUNKER HILL COMMUNITY COLLEGE                               ","2003-2004",2,"Basketball",42250,42300,-50,21100,21150,-50,21150,21150,0,"15","9",14906,10603
"7765",181376,"NEBRASKA CHRISTIAN COLLEGE                                  ","2003-2004",15,"Soccer",6700,6750,-50,6700,6750,-50,0,0,0,"18",".",5575,0
"10135",107512,"OUACHITA BAPTIST UNIVERSITY                                 ","2003-2004",18,"Swimming and Diving",248686,248736,-50,154240,154290,-50,94446,94446,0,"21","15",15491,18164
"17355",107512,"OUACHITA BAPTIST UNIVERSITY                                 ","2003-2004",39,"Total Participants",1375641,1375691,-50,689050,689100,-50,686591,686591,0,"181","91",295664,149094
"10393",117724,"LOS ANGELES TRADE TECHNICAL COLLEGE                         ","2003-2004",18,"Swimming and Diving",13948,14000,-52,6974,7000,-26,6974,7000,-26,"19","12",6974,6974
"14974",212106,"DUQUESNE UNIVERSITY                                         ","2003-2004",28,"Wrestling",192169,192224,-55,192169,192224,-55,0,0,0,"15",".",31425,0
"1413",241410,"PONTIFICAL CATHOLIC UNIV OF PUERTO RICO-PONCE               ","2003-2004",1,"Baseball",3976,4032,-56,3976,4032,-56,0,0,0,"19",".",3976,0
"10074",230959,"MIDDLEBURY COLLEGE                                          ","2003-2004",17,"Squash",45190,45247,-57,0,0,0,45190,45247,-57,".","16",0,8198
"12642",219833,"CHRISTIAN BROTHERS UNIVERSITY                               ","2003-2004",25,"Track and Field, X-Country",5500,5559,-59,2750,2806,-56,2750,2753,-3,"8","12",2750,2750
"10554",195304,"SARAH LAWRENCE COLLEGE                                      ","2003-2004",19,"Swimming",7000,7060,-60,0,0,0,7000,7060,-60,".","12",0,3460
"15180",160621,"SOUTHERN UNIVERSITY AND A &amp; M COLLEGE                       ","2003-2004",33,"Bowling",30006,30066,-60,0,0,0,30006,30066,-60,".","7",0,3758
"5916",114789,"FRESNO CITY COLLEGE                                         ","2003-2004",8,"Golf",9044,9105,-61,4572,4872,-300,4472,4233,239,"8","9",3208,1790
"6773",131520,"HOWARD UNIVERSITY                                           ","2003-2004",11,"Lacrosse",278467,278530,-63,0,0,0,278467,278530,-63,".","22",0,46859
"10669",115861,"IMPERIAL VALLEY COLLEGE                                     ","2003-2004",22,"Tennis",33264,33327,-63,15911,15658,253,17353,17669,-316,"9","6",15660,17670
"4616",196866,"UNION COLLEGE                                               ","2003-2004",7,"Football",362908,362974,-66,362908,362974,-66,0,0,0,"97",".",63964,0
"5698",226231,"LETOURNEAU UNIVERSITY                                       ","2003-2004",8,"Golf",47642,47712,-70,23821,23856,-35,23821,23856,-35,"12","7",18897,18000
"6227",224572,"EASTFIELD COLLEGE                                           ","2003-2004",8,"Golf",12990,13060,-70,12990,13060,-70,0,0,0,"6",".",4808,0
"7736",113698,"DOMINICAN UNIVERSITY OF CALIFORNIA                          ","2003-2004",15,"Soccer",27100,27170,-70,14050,13970,80,13050,13200,-150,"21","20",12480,13050
"1575",153296,"ELLSWORTH COMMUNITY COLLEGE                                 ","2003-2004",1,"Baseball",50357,50429,-72,50357,50429,-72,0,0,0,"35",".",46559,0
"5567",216038,"SLIPPERY ROCK UNIVERSITY OF PENNSYLVANIA                    ","2003-2004",8,"Golf",40984,41058,-74,40984,41058,-74,0,0,0,"12",".",11857,0
"1120",178411,"UNIVERSITY OF MISSOURI-ROLLA                                ","2003-2004",1,"Baseball",94333,94409,-76,94333,94409,-76,0,0,0,"35",".",22497,0
"1238",151786,"MARIAN COLLEGE                                              ","2003-2004",1,"Baseball",81500,81576,-76,81500,81576,-76,0,0,0,"27",".",12256,0
"8567",154688,"BAKER UNIVERSITY COLLEGE OF ARTS AND SCIENCES               ","2003-2004",16,"Softball",58612,58688,-76,0,0,0,58612,58688,-76,".","12",0,16557
"15057",214041,"MILLERSVILLE UNIVERSITY OF PENNSYLVANIA                     ","2003-2004",28,"Wrestling",101353,101432,-79,101353,101432,-79,0,0,0,"24",".",47693,0
"17130",113698,"DOMINICAN UNIVERSITY OF CALIFORNIA                          ","2003-2004",39,"Total Participants",64870,64950,-80,17350,16870,480,47520,48080,-560,"43","75",37310,62825
"10852",175643,"EAST CENTRAL COMMUNITY COLLEGE                              ","2003-2004",22,"Tennis",29171,29256,-85,13913,13880,33,15258,15376,-118,"6","7",4645,6140
"5161",169080,"CALVIN COLLEGE                                              ","2003-2004",8,"Golf",39415,39503,-88,23809,23942,-133,15606,15561,45,"10","6",12798,5388
"7611",153278,"UNIVERSITY OF DUBUQUE                                       ","2003-2004",15,"Soccer",80319,80407,-88,38023,37786,237,42296,42621,-325,"36","19",14730,19975
"4209",195526,"SKIDMORE COLLEGE                                            ","2003-2004",6,"Field hocky",48475,48564,-89,0,0,0,48475,48564,-89,".","23",0,26061
"1668",217776,"SOUTHERN WESLEYAN UNIVERSITY                                ","2003-2004",2,"Basketball",296551,296641,-90,187533,187533,0,109018,109108,-90,"17","13",33633,29689
"9557",113698,"DOMINICAN UNIVERSITY OF CALIFORNIA                          ","2003-2004",16,"Softball",13750,13840,-90,0,0,0,13750,13840,-90,".","15",0,12925
"14326",105792,"SOUTH MOUNTAIN COMMUNITY COLLEGE                            ","2003-2004",26,"Volleyball",14897,14987,-90,0,0,0,14897,14987,-90,".","12",0,7114
"367",167534,"QUINSIGAMOND COMMUNITY COLLEGE                              ","2003-2004",1,"Baseball",19341,19432,-91,19341,19432,-91,0,0,0,"23",".",14398,0
"15915",167534,"QUINSIGAMOND COMMUNITY COLLEGE                              ","2003-2004",39,"Total Participants",25385,25476,-91,19341,19432,-91,6044,6044,0,"44","31",28539,19685
"12780",151786,"MARIAN COLLEGE                                              ","2003-2004",25,"Track and Field, X-Country",142468,142561,-93,107000,107093,-93,35468,35468,0,"18","17",5067,5068
"3118",166391,"LASELL COLLEGE                                              ","2003-2004",2,"Basketball",51797,51894,-97,28571,29836,-1265,23226,22058,1168,"16","11",19516,12208
"492",199722,"SOUTHEASTERN COMMUNITY COLLEGE                              ","2003-2004",1,"Baseball",22870,22970,-100,22870,22970,-100,0,0,0,"18",".",22870,0
"3625",238616,"CONCORDIA UNIVERSITY-WISCONSIN                              ","2003-2004",3,"All Track Combined",22900,23000,-100,11450,11500,-50,11450,11500,-50,"15","12",11450,11450
"6753",161563,"THOMAS COLLEGE                                              ","2003-2004",11,"Lacrosse",21692,21792,-100,12462,12462,0,9230,9330,-100,"19","11",7462,1730
"9553",144865,"COLLEGE OF DUPAGE                                           ","2003-2004",16,"Softball",48700,48800,-100,0,0,0,48700,48800,-100,".","15",0,24700
"14098",121901,"RIVERSIDE COMMUNITY COLLEGE                                 ","2003-2004",26,"Volleyball",6100,6200,-100,0,0,0,6100,6200,-100,".","12",0,6000
"15837",199722,"SOUTHEASTERN COMMUNITY COLLEGE                              ","2003-2004",39,"Total Participants",39670,39770,-100,22870,22970,-100,16800,16800,0,"18","23",22870,13900
"16706",161563,"THOMAS COLLEGE                                              ","2003-2004",39,"Total Participants",171212,171312,-100,101904,101904,0,69308,69408,-100,"103","81",79627,48357
"5668",141574,"UNIVERSITY OF HAWAII AT MANOA                               ","2003-2004",8,"Golf",358670,358771,-101,166752,166853,-101,191918,191918,0,"12","9",111904,131565
"7381",150604,"FRANKLIN COLLEGE                                            ","2003-2004",15,"Soccer",40672,40774,-102,20336,20387,-51,20336,20387,-51,"15","14",12772,12772
"7783",216010,"SHIPPENSBURG UNIVERSITY OF PENNSYLVANIA                     ","2003-2004",15,"Soccer",155583,155686,-103,74125,73309,816,81458,82377,-919,"22","22",24226,25108
"9252",190442,"CORNING COMMUNITY COLLEGE                                   ","2003-2004",16,"Softball",9500,9608,-108,0,0,0,9500,9608,-108,".","16",0,4808
"11833",165820,"FITCHBURG STATE COLLEGE                                     ","2003-2004",23,"Track and Field, Indoor",4500,4608,-108,2250,2304,-54,2250,2304,-54,"27","14",1764,1663
"13245",180106,"CARROLL COLLEGE                                             ","2003-2004",26,"Volleyball",241007,241115,-108,0,0,0,241007,241115,-108,".","14",0,37846
"4157",214157,"MORAVIAN COLLEGE AND THEOLOGICAL SEMINARY                   ","2003-2004",6,"Field hocky",30292,30401,-109,0,0,0,30292,30401,-109,".","21",0,12002
"1678",225876,"JACKSONVILLE COLLEGE-MAIN CAMPUS                            ","2003-2004",2,"Basketball",98025,98135,-110,51900,59700,-7800,46125,38435,7690,"14","13",14400,7100
"5685",157809,"THOMAS MORE COLLEGE                                         ","2003-2004",8,"Golf",6758,6868,-110,5910,4410,1500,848,2458,-1610,"10","2",2810,848
"2426",241410,"PONTIFICAL CATHOLIC UNIV OF PUERTO RICO-PONCE               ","2003-2004",2,"Basketball",3982,4094,-112,3697,3753,-56,285,341,-56,"13","1",3697,285
"6352",173665,"HAMLINE UNIVERSITY                                          ","2003-2004",9,"Gymnastics",24142,24254,-112,0,0,0,24142,24254,-112,".","19",0,6718
"11475",241410,"PONTIFICAL CATHOLIC UNIV OF PUERTO RICO-PONCE               ","2003-2004",22,"Tennis",2426,2538,-112,1078,1134,-56,1348,1404,-56,"4","5",1078,1348
"15092",241410,"PONTIFICAL CATHOLIC UNIV OF PUERTO RICO-PONCE               ","2003-2004",29,"Other Sports",1437,1549,-112,616,672,-56,821,877,-56,"3","4",616,821
"15394",241410,"PONTIFICAL CATHOLIC UNIV OF PUERTO RICO-PONCE               ","2003-2004",37,"Table Tennis",2056,2168,-112,1142,1198,-56,914,970,-56,"5","4",1142,914
"15404",241410,"PONTIFICAL CATHOLIC UNIV OF PUERTO RICO-PONCE               ","2003-2004",38,"Weight Lifting",5076,5188,-112,2307,2363,-56,2769,2825,-56,"5","6",2307,2769
"4215",216038,"SLIPPERY ROCK UNIVERSITY OF PENNSYLVANIA                    ","2003-2004",6,"Field hocky",60828,60941,-113,0,0,0,60828,60941,-113,".","18",0,18065
"16746",230995,"NORWICH UNIVERSITY                                          ","2003-2004",39,"Total Participants",561787,561900,-113,439500,446718,-7218,122287,115182,7105,"372","141",295139,92287
"4192",166513,"UNIVERSITY OF MASSACHUSETTS-LOWELL                          ","2003-2004",6,"Field hocky",118335,118451,-116,0,0,0,118335,118451,-116,".","20",0,25384
"9343",151786,"MARIAN COLLEGE                                              ","2003-2004",16,"Softball",69700,69817,-117,0,0,0,69700,69817,-117,".","20",0,7357
"5844",219833,"CHRISTIAN BROTHERS UNIVERSITY                               ","2003-2004",8,"Golf",8800,8918,-118,8800,8918,-118,0,0,0,"7",".",8080,0
"1257",150941,"HUNTINGTON COLLEGE                                          ","2003-2004",1,"Baseball",68098,68217,-119,68098,68217,-119,0,0,0,"22",".",17702,0
"11279",114789,"FRESNO CITY COLLEGE                                         ","2003-2004",22,"Tennis",15188,15307,-119,8055,7866,189,7133,7441,-308,"12","8",5438,3951
"10700",234669,"BELLEVUE COMMUNITY COLLEGE                                  ","2003-2004",22,"Tennis",1880,2000,-120,0,0,0,1880,2000,-120,".","8",0,1500
"15155",113980,"EL CAMINO COLLEGE                                           ","2003-2004",31,"Badminton",11606,11726,-120,0,0,0,11606,11726,-120,".","11",0,4526
"7155",162122,"COLLEGE OF SOUTHERN MARYLAND                                ","2003-2004",15,"Soccer",28792,28914,-122,13708,13602,106,15084,15312,-228,"17","13",7102,8812
"14678",120342,"ORANGE COAST COLLEGE                                        ","2003-2004",27,"Water Polo",24786,24910,-124,12812,12955,-143,11974,11955,19,"15","13",11909,11311
"10647",150066,"ANDERSON UNIVERSITY                                         ","2003-2004",22,"Tennis",16766,16894,-128,8826,8790,36,7940,8104,-164,"13","7",5390,4704
"6635",127060,"UNIVERSITY OF DENVER                                        ","2003-2004",11,"Lacrosse",1331310,1331439,-129,880918,878612,2306,450392,452827,-2435,"37","28",135818,113577
"14676",111887,"CERRITOS COLLEGE                                            ","2003-2004",27,"Water Polo",72097,72226,-129,34465,34465,0,37632,37761,-129,"16","12",4793,4903
"16585",111887,"CERRITOS COLLEGE                                            ","2003-2004",39,"Total Participants",530360,530489,-129,264136,264136,0,266224,266353,-129,"285","137",49267,34370
"16952",117274,"LASSEN COMMUNITY COLLEGE                                    ","2003-2004",39,"Total Participants",478378,478507,-129,239923,240143,-220,238455,238364,91,"151","106",107750,79750
"8714",153296,"ELLSWORTH COMMUNITY COLLEGE                                 ","2003-2004",16,"Softball",17699,17829,-130,0,0,0,17699,17829,-130,".","18",0,13275
"5250",151786,"MARIAN COLLEGE                                              ","2003-2004",8,"Golf",76800,76932,-132,76800,76932,-132,0,0,0,"8",".",18232,0
"1606",170532,"KALAMAZOO COLLEGE                                           ","2003-2004",2,"Basketball",106139,106272,-133,50908,52763,-1855,55231,53509,1722,"19","11",19284,12747
"11002",219000,"AUGUSTANA COLLEGE                                           ","2003-2004",22,"Tennis",10900,11034,-134,5450,5517,-67,5450,5517,-67,"7","13",3332,3332
"8524",164614,"BOSTON BAPTIST COLLEGE                                      ","2003-2004",15,"Soccer",9000,9137,-137,9000,9137,-137,0,0,0,"14","0",1500,0
"9359",114789,"FRESNO CITY COLLEGE                                         ","2003-2004",16,"Softball",22609,22749,-140,0,0,0,22609,22749,-140,".","12",0,9629
"13369",157447,"NORTHERN KENTUCKY UNIVERSITY                                ","2003-2004",26,"Volleyball",187472,187612,-140,0,0,0,187472,187612,-140,".","12",0,44421
"1536",173063,"RIVERLAND COMMUNITY COLLEGE                                 ","2003-2004",1,"Baseball",24001,24144,-143,24001,24144,-143,0,0,0,"15",".",6950,0
"13945",224572,"EASTFIELD COLLEGE                                           ","2003-2004",26,"Volleyball",29877,30020,-143,0,0,0,29877,30020,-143,".","9",0,3030
"14146",181376,"NEBRASKA CHRISTIAN COLLEGE                                  ","2003-2004",26,"Volleyball",5415,5560,-145,0,0,0,5415,5560,-145,".","8",0,4385
"11671",113236,"CYPRESS COLLEGE                                             ","2003-2004",22,"Tennis",13744,13902,-158,7065,7226,-161,6679,6676,3,"5","5",2092,1542
"12956",130183,"TEIKYO POST UNIVERSITY                                      ","2003-2004",25,"Track and Field, X-Country",200,358,-158,200,358,-158,0,0,0,"27","0",312,0
"14532",165024,"BRIDGEWATER STATE COLLEGE                                   ","2003-2004",26,"Volleyball",18340,18498,-158,0,0,0,18340,18498,-158,".","12",0,18340
"7135",186399,"RUTGERS UNIVERSITY-NEWARK                                   ","2003-2004",15,"Soccer",107447,107609,-162,31528,31528,0,75919,76081,-162,"22","19",17423,19138
"7096",160977,"BATES COLLEGE                                               ","2003-2004",15,"Soccer",149288,149452,-164,74286,74120,166,75002,75332,-330,"33","22",19848,20512
"9686",161299,"MAINE MARITIME ACADEMY                                      ","2003-2004",16,"Softball",42978,43143,-165,0,0,0,42978,43143,-165,".","16",0,11760
"12275",145725,"ILLINOIS INSTITUTE OF TECHNOLOGY                            ","2003-2004",25,"Track and Field, X-Country",19086,19252,-166,9543,9626,-83,9543,9626,-83,"17","12",7751,7751
"13894",168263,"WESTFIELD STATE COLLEGE                                     ","2003-2004",26,"Volleyball",13308,13474,-166,0,0,0,13308,13474,-166,".","15",0,7485
"5524",192749,"MANHATTANVILLE COLLEGE                                      ","2003-2004",8,"Golf",9065,9232,-167,9065,9232,-167,0,0,0,"11",".",6811,0
"386",130697,"WESLEYAN UNIVERSITY                                         ","2003-2004",1,"Baseball",76821,76998,-177,76821,76998,-177,0,0,0,"25",".",44789,0
"9345",153922,"MARSHALLTOWN COMMUNITY COLLEGE                              ","2003-2004",16,"Softball",31688,31865,-177,0,0,0,31688,31865,-177,".","16",0,27574
"7389",155812,"UNIVERSITY OF SAINT MARY                                    ","2003-2004",15,"Soccer",30595,30773,-178,15157,14905,252,15438,15868,-430,"20","19",11352,11760
"3908",196051,"MORRISVILLE STATE COLLEGE                                   ","2003-2004",3,"All Track Combined",50790,50970,-180,25395,25485,-90,25395,25485,-90,"36","13",4594,4595
"11384",121691,"UNIVERSITY OF REDLANDS                                      ","2003-2004",22,"Tennis",105018,105198,-180,43778,43958,-180,61240,61240,0,"15","12",9257,16330
"13659",151786,"MARIAN COLLEGE                                              ","2003-2004",26,"Volleyball",65000,65181,-181,0,0,0,65000,65181,-181,".","12",0,7836
"7153",107044,"HARDING UNIVERSITY                                          ","2003-2004",15,"Soccer",45998,46180,-182,22999,22361,638,22999,23819,-820,"26","22",20819,20819
"2664",144865,"COLLEGE OF DUPAGE                                           ","2003-2004",2,"Basketball",102117,102300,-183,48458,48500,-42,53659,53800,-141,"15","13",25000,22600
"15018",206941,"UNIVERSITY OF CENTRAL OKLAHOMA                              ","2003-2004",28,"Wrestling",36037,36220,-183,36037,36220,-183,0,0,0,"40",".",35620,0
"6494",182980,"NEW ENGLAND COLLEGE                                         ","2003-2004",10,"Ice Hockey",173570,173755,-185,105489,107451,-1962,68081,66304,1777,"29","27",48970,37982
"13764",240170,"WESTERN WISCONSIN TECHNICAL COLLEGE                         ","2003-2004",26,"Volleyball",14360,14547,-187,0,0,0,14360,14547,-187,".","10",0,9047
"8682",185572,"MONMOUTH UNIVERSITY                                         ","2003-2004",16,"Softball",259458,259650,-192,0,0,0,259458,259650,-192,".","14",0,50653
"13268",219976,"DAVID LIPSCOMB UNIVERSITY                                   ","2003-2004",26,"Volleyball",170235,170428,-193,0,0,0,170235,170428,-193,".","14",0,47170
"16",170301,"HOPE COLLEGE                                                ","2003-2004",1,"Baseball",63309,63503,-194,63309,63503,-194,0,0,0,"29",".",32086,0
"15813",170301,"HOPE COLLEGE                                                ","2003-2004",39,"Total Participants",651127,651321,-194,330652,330846,-194,320475,320475,0,"301","200",156182,127686
"16665",181376,"NEBRASKA CHRISTIAN COLLEGE                                  ","2003-2004",39,"Total Participants",12115,12310,-195,6700,6750,-50,5415,5560,-145,"30","19",12490,11305
"9898",196219,"SUNY COLLEGE AT PURCHASE                                    ","2003-2004",16,"Softball",22850,23049,-199,0,0,0,22850,23049,-199,".","19",0,22850
"10658",238263,"MADISON AREA TECHNICAL COLLEGE                              ","2003-2004",22,"Tennis",10210,10409,-199,5105,6036,-931,5105,4373,732,"2","4",3846,2183
"2957",167905,"SPRINGFIELD TECHNICAL COMMUNITY COLLEGE                     ","2003-2004",2,"Basketball",33340,33540,-200,16670,16770,-100,16670,16770,-100,"15","10",10270,10270
"5300",168430,"WORCESTER STATE COLLEGE                                     ","2003-2004",8,"Golf",13359,13559,-200,13359,13559,-200,0,0,0,"11",".",11359,0
"10637",192192,"KEUKA COLLEGE                                               ","2003-2004",20,"Synchronized swimming",42100,42300,-200,0,0,0,42100,42300,-200,".","15",0,22100
"10793",150604,"FRANKLIN COLLEGE                                            ","2003-2004",22,"Tennis",14274,14474,-200,7137,7237,-100,7137,7237,-100,"9","10",5087,5087
"11035",121363,"PORTERVILLE COLLEGE                                         ","2003-2004",22,"Tennis",1400,1600,-200,700,800,-100,700,800,-100,"8","8",562,562
"11805",178369,"MISSOURI VALLEY COLLEGE                                     ","2003-2004",23,"Track and Field, Indoor",7300,7500,-200,3700,4000,-300,3600,3500,100,"26","19",3200,3200
"11943",178369,"MISSOURI VALLEY COLLEGE                                     ","2003-2004",24,"Track and Field, Outdoor",7300,7500,-200,3700,4000,-300,3600,3500,100,"26","19",3200,3200
"12731",183822,"BLOOMFIELD COLLEGE                                          ","2003-2004",25,"Track and Field, X-Country",4000,4200,-200,4000,4200,-200,0,0,0,"7",".",3742,0
"15336",178369,"MISSOURI VALLEY COLLEGE                                     ","2003-2004",35,"Rodeo",27800,28000,-200,14000,14100,-100,13800,13900,-100,"42","31",12397,9000
"15372",163912,"ST MARY'S COLLEGE OF MARYLAND                               ","2003-2004",36,"Sailing",10000,10200,-200,5000,5100,-100,5000,5100,-100,"16","19",5000,5000
"15395",243221,"UNIVERSITY OF PUERTO RICO-RIO PIEDRAS CAMPUS                ","2003-2004",37,"Table Tennis",6000,6200,-200,2900,3000,-100,3100,3200,-100,"7","8",2900,3100
"15692",112260,"CLAREMONT MCKENNA COLLEGE                                   ","2003-2004",39,"Total Participants",861744,861944,-200,392407,393871,-1464,469337,468073,1264,"230","164",249768,168931
"6730",199962,"WINGATE UNIVERSITY                                          ","2003-2004",11,"Lacrosse",30591,30793,-202,30591,30793,-202,0,0,0,"30",".",20950,0
"11470",231059,"SAINT MICHAELS COLLEGE                                      ","2003-2004",22,"Tennis",30297,30501,-204,14737,15085,-348,15560,15416,144,"7","8",4487,4710
"12068",234933,"CLARK COLLEGE                                               ","2003-2004",24,"Track and Field, Outdoor",34144,34356,-212,17072,17178,-106,17072,17178,-106,"18","18",9400,9400
"11299",199069,"MOUNT OLIVE COLLEGE                                         ","2003-2004",22,"Tennis",99459,99673,-214,47261,47086,175,52198,52587,-389,"8","6",12607,11996
"10898",174358,"MINNESOTA STATE UNIVERSITY-MOORHEAD                         ","2003-2004",22,"Tennis",14620,14835,-215,0,0,0,14620,14835,-215,".","10",0,8030
"11523",117140,"UNIVERSITY OF LA VERNE                                      ","2003-2004",22,"Tennis",34868,35083,-215,13990,14204,-214,20878,20879,-1,"10","11",3506,4078
"2578",181376,"NEBRASKA CHRISTIAN COLLEGE                                  ","2003-2004",2,"Basketball",17834,18050,-216,8915,8995,-80,8919,9055,-136,"12","11",6915,6920
"17278",239220,"MID-STATE TECHNICAL COLLEGE                                 ","2003-2004",39,"Total Participants",30435,30653,-218,15217,14862,355,15218,15791,-573,"16","15",27362,23308
"15366",120342,"ORANGE COAST COLLEGE                                        ","2003-2004",36,"Sailing",18220,18440,-220,9110,9220,-110,9110,9220,-110,"11","0",9110,9110
"2058",174206,"CROSSROADS COLLEGE                                          ","2003-2004",2,"Basketball",13850,14080,-230,13850,14080,-230,0,0,0,"17",".",7150,0
"5423",206525,"WITTENBERG UNIVERSITY                                       ","2003-2004",8,"Golf",102471,102705,-234,54577,55719,-1142,47894,46986,908,"10","12",6139,4229
"9020",202222,"COLUMBUS STATE COMMUNITY COLLEGE                            ","2003-2004",16,"Softball",18350,18584,-234,0,0,0,18350,18584,-234,".","14",0,11834
"6101",206604,"WRIGHT STATE UNIVERSITY-MAIN CAMPUS                         ","2003-2004",8,"Golf",160472,160710,-238,160472,160710,-238,0,0,0,"8",".",46890,0
"10878",191649,"HOFSTRA UNIVERSITY                                          ","2003-2004",22,"Tennis",306181,306421,-240,145256,145496,-240,160925,160925,0,"8","11",33173,27595
"2030",234933,"CLARK COLLEGE                                               ","2003-2004",2,"Basketball",37724,37966,-242,18862,18991,-129,18862,18975,-113,"10","10",11120,11120
"5109",200253,"MINOT STATE UNIVERSITY                                      ","2003-2004",8,"Golf",4000,4242,-242,2000,2121,-121,2000,2121,-121,"8","5",1619,1619
"13538",119331,"NAPA VALLEY COLLEGE                                         ","2003-2004",26,"Volleyball",20726,20972,-246,0,0,0,20726,20972,-246,".","10",0,3371
"548",153524,"IOWA CENTRAL COMMUNITY COLLEGE                              ","2003-2004",1,"Baseball",71938,72186,-248,71938,72186,-248,0,0,0,"36",".",37874,0
"10316",110653,"UNIVERSITY OF CALIFORNIA-IRVINE                             ","2003-2004",18,"Swimming and Diving",557119,557367,-248,278560,254565,23995,278559,302802,-24243,"32","29",30565,30565
"16257",237109,"YAKIMA VALLEY COMMUNITY COLLEGE                             ","2003-2004",39,"Total Participants",171815,172063,-248,89848,90098,-250,81967,81965,2,"56","34",67906,66872
"8332",188526,"ALBANY COLLEGE OF PHARMACY                                  ","2003-2004",15,"Soccer",11300,11550,-250,5300,5550,-250,6000,6000,0,"20","21",5207,5915
"10830",165024,"BRIDGEWATER STATE COLLEGE                                   ","2003-2004",22,"Tennis",4800,5050,-250,2300,2400,-100,2500,2650,-150,"9","14",2100,2300
"14936",237109,"YAKIMA VALLEY COMMUNITY COLLEGE                             ","2003-2004",28,"Wrestling",37083,37333,-250,37083,37333,-250,0,0,0,"15",".",17229,0
"16664",188526,"ALBANY COLLEGE OF PHARMACY                                  ","2003-2004",39,"Total Participants",11300,11550,-250,5300,5550,-250,6000,6000,0,"32","32",11557,14125
"8318",145725,"ILLINOIS INSTITUTE OF TECHNOLOGY                            ","2003-2004",15,"Soccer",105836,106092,-256,52918,52627,291,52918,53465,-547,"20","15",18377,19215
"13352",161165,"HUSSON COLLEGE                                              ","2003-2004",26,"Volleyball",9593,9852,-259,0,0,0,9593,9852,-259,".","10",0,6043
"16069",114716,"FOOTHILL COLLEGE                                            ","2003-2004",39,"Total Participants",53049,53308,-259,24308,22095,2213,28741,31213,-2472,"129","66",40813,36517
"15186",211477,"CENTRAL PENNSYLVANIA COLLEGE                                ","2003-2004",33,"Bowling",2050,2310,-260,0,0,0,2050,2310,-260,".","9",0,1310
"5871",153278,"UNIVERSITY OF DUBUQUE                                       ","2003-2004",8,"Golf",30163,30425,-262,17575,17490,85,12588,12935,-347,"15","6",5721,3953
"14633",235431,"HIGHLINE COMMUNITY COLLEGE                                  ","2003-2004",26,"Volleyball",32815,33079,-264,0,0,0,32815,33079,-264,".","11",0,10290
"15093",243142,"UNIVERSITY OF PUERTO RICO IN CAROLINA                       ","2003-2004",29,"Other Sports",842,1106,-264,421,553,-132,421,553,-132,"2","2",361,361
"5254",133881,"FLORIDA INSTITUTE OF TECHNOLOGY-MELBOURNE                   ","2003-2004",8,"Golf",206214,206480,-266,108400,109567,-1167,97814,96913,901,"9","7",13675,9914
"5346",229027,"THE UNIVERSITY OF TEXAS AT SAN ANTONIO                      ","2003-2004",8,"Golf",188701,188967,-266,188701,188967,-266,0,0,0,"8",".",36809,0
"10813",215743,"SAINT FRANCIS UNIVERSITY                                    ","2003-2004",22,"Tennis",80287,80553,-266,33327,33476,-149,46960,47077,-117,"9","8",6144,7607
"6130",216287,"SWARTHMORE COLLEGE                                          ","2003-2004",8,"Golf",5495,5763,-268,5495,5763,-268,0,0,0,"10",".",5439,0
"8615",195234,"THE COLLEGE OF SAINT ROSE                                   ","2003-2004",16,"Softball",146580,146848,-268,0,0,0,146580,146848,-268,".","17",0,23598
"11228",165699,"ENDICOTT COLLEGE                                            ","2003-2004",22,"Tennis",22680,22950,-270,7535,7535,0,15145,15415,-270,"12","11",2500,7900
"14443",194222,"ONONDAGA COMMUNITY COLLEGE                                  ","2003-2004",26,"Volleyball",21515,21785,-270,0,0,0,21515,21785,-270,".","9",0,13645
"1177",229063,"TEXAS SOUTHERN UNIVERSITY                                   ","2003-2004",1,"Baseball",180381,180671,-290,180381,180671,-290,0,0,0,"39",".",68322,0
"9696",187444,"WILLIAM PATERSON UNIVERSITY OF NEW JERSEY                   ","2003-2004",16,"Softball",86783,87076,-293,0,0,0,86783,87076,-293,".","21",0,41024
"5242",139861,"GEORGIA COLLEGE AND STATE UNIVERSITY                        ","2003-2004",8,"Golf",51286,51581,-295,51286,51581,-295,0,0,0,"11",".",22000,0
"14262",209506,"OREGON INSTITUTE OF TECHNOLOGY                              ","2003-2004",26,"Volleyball",71499,71795,-296,0,0,0,71499,71795,-296,".","13",0,26383
"5551",201928,"CINCINNATI STATE TECHNICAL AND COMMUNITY COLLEGE            ","2003-2004",8,"Golf",7700,8000,-300,6500,7000,-500,1200,1000,200,"8",".",5250,750
"9436",243221,"UNIVERSITY OF PUERTO RICO-RIO PIEDRAS CAMPUS                ","2003-2004",16,"Softball",7500,7800,-300,0,0,0,7500,7800,-300,".","13",0,7500
"10483",140234,"LAGRANGE COLLEGE                                            ","2003-2004",19,"Swimming",15950,16250,-300,7975,8125,-150,7975,8125,-150,"4","5",4975,4975
"11361",243221,"UNIVERSITY OF PUERTO RICO-RIO PIEDRAS CAMPUS                ","2003-2004",22,"Tennis",7645,7945,-300,3745,3945,-200,3900,4000,-100,"7","6",3745,3900
"14701",197045,"UTICA COLLEGE                                               ","2003-2004",27,"Water Polo",28625,28925,-300,0,0,0,28625,28925,-300,".","15",0,8900
"15305",180151,"DAWSON COMMUNITY COLLEGE                                    ","2003-2004",35,"Rodeo",39153,39453,-300,26102,26302,-200,13051,13151,-100,"22","11",21415,10707
"10881",112190,"CITY COLLEGE OF SAN FRANCISCO                               ","2003-2004",22,"Tennis",5933,6235,-302,0,0,0,5933,6235,-302,"0","9",0,2952
"16745",180151,"DAWSON COMMUNITY COLLEGE                                    ","2003-2004",39,"Total Participants",106880,107182,-302,60764,60965,-201,46116,46217,-101,"62","42",78008,62497
"7803",120342,"ORANGE COAST COLLEGE                                        ","2003-2004",15,"Soccer",61340,61647,-307,32289,32493,-204,29051,29154,-103,"20","21",30651,27355
"5900",225627,"UNIVERSITY OF THE INCARNATE WORD                            ","2003-2004",8,"Golf",177802,178118,-316,100829,108987,-8158,76973,69131,7842,"11","5",11375,11375
"6231",190716,"D'YOUVILLE COLLEGE                                          ","2003-2004",8,"Golf",3000,3316,-316,2999,1658,1341,1,1658,-1657,"8",".",1000,213
"8180",121707,"COLLEGE OF THE REDWOODS                                     ","2003-2004",15,"Soccer",18572,18888,-316,0,0,0,18572,18888,-316,".","14",0,9716
"11090",133711,"FLAGLER COLLEGE                                             ","2003-2004",22,"Tennis",80300,80621,-321,39650,41723,-2073,40650,38898,1752,"10","8",12073,9248
"15383",243142,"UNIVERSITY OF PUERTO RICO IN CAROLINA                       ","2003-2004",37,"Table Tennis",1840,2162,-322,759,1081,-322,1081,1081,0,"3","3",361,361
"15337",104346,"CENTRAL ARIZONA COLLEGE                                     ","2003-2004",35,"Rodeo",106117,106441,-324,73627,75274,-1647,32490,31167,1323,"43","11",23515,12381
"4155",197045,"UTICA COLLEGE                                               ","2003-2004",6,"Field hocky",46700,47025,-325,0,0,0,46700,47025,-325,".","18",0,14800
"5031",150604,"FRANKLIN COLLEGE                                            ","2003-2004",7,"Football",200249,200577,-328,200249,200577,-328,0,0,0,"98",".",110277,0
"888",154998,"DODGE CITY COMMUNITY COLLEGE                                ","2003-2004",1,"Baseball",75271,75606,-335,75271,75606,-335,0,0,0,"30",".",15830,0
"4266",213367,"LA SALLE UNIVERSITY                                         ","2003-2004",7,"Football",255904,256241,-337,255904,256241,-337,0,0,0,"82",".",94707,0
"1966",119331,"NAPA VALLEY COLLEGE                                         ","2003-2004",2,"Basketball",44452,44799,-347,21726,23012,-1286,22726,21787,939,"14","11",5411,4186
"10870",115001,"GLENDALE COMMUNITY COLLEGE                                  ","2003-2004",22,"Tennis",23608,23955,-347,9323,9313,10,14285,14642,-357,"7","10",4376,3619
"15171",243142,"UNIVERSITY OF PUERTO RICO IN CAROLINA                       ","2003-2004",32,"Beach Volleyball",1120,1468,-348,560,740,-180,560,728,-168,"5","5",405,405
"5299",148131,"QUINCY UNIVERSITY                                           ","2003-2004",8,"Golf",105520,105870,-350,62232,64176,-1944,43288,41694,1594,"11","5",7404,8806
"8658",186201,"RAMAPO COLLEGE OF NEW JERSEY                                ","2003-2004",16,"Softball",57028,57381,-353,0,0,0,57028,57381,-353,".","19",0,47456
"261",192749,"MANHATTANVILLE COLLEGE                                      ","2003-2004",1,"Baseball",25201,25555,-354,25201,25555,-354,0,0,0,"20",".",10295,0
"8030",111461,"COLLEGE OF THE CANYONS                                      ","2003-2004",15,"Soccer",29690,30049,-359,14920,17586,-2666,14770,12463,2307,"25","19",12677,12004
"6829",163426,"MONTGOMERY COLLEGE                                          ","2003-2004",11,"Lacrosse",21567,21927,-360,21567,21927,-360,0,0,0,"16",".",9503,0
"9027",148131,"QUINCY UNIVERSITY                                           ","2003-2004",16,"Softball",165589,165955,-366,0,0,0,165589,165955,-366,".","18",0,38584
"9211",203085,"HEIDELBERG COLLEGE                                          ","2003-2004",16,"Softball",41981,42348,-367,0,0,0,41981,42348,-367,".","20",0,10571
"13964",234933,"CLARK COLLEGE                                               ","2003-2004",26,"Volleyball",16449,16819,-370,0,0,0,16449,16819,-370,".","12",0,8917
"7385",154509,"VENNARD COLLEGE                                             ","2003-2004",15,"Soccer",8201,8573,-372,8201,8573,-372,0,0,0,"16",".",8207,0
"10619",241410,"PONTIFICAL CATHOLIC UNIV OF PUERTO RICO-PONCE               ","2003-2004",19,"Swimming",5126,5498,-372,2957,3143,-186,2169,2355,-186,"15","11",2957,2169
"13117",154509,"VENNARD COLLEGE                                             ","2003-2004",26,"Volleyball",7073,7445,-372,0,0,0,7073,7445,-372,".","8",0,7073
"12537",237792,"SHEPHERD COLLEGE                                            ","2003-2004",25,"Track and Field, X-Country",17568,17945,-377,8730,9511,-781,8838,8434,404,"5","6",3115,2932
"5166",113236,"CYPRESS COLLEGE                                             ","2003-2004",8,"Golf",15213,15592,-379,15213,15592,-379,0,0,0,"9",".",3483,0
"3968",163268,"UNIVERSITY OF MARYLAND-BALTIMORE COUNTY                     ","2003-2004",3,"All Track Combined",179068,179450,-382,67619,93583,-25964,111449,85867,25582,"89","70",60115,54708
"3293",172264,"SIENA HEIGHTS UNIVERSITY                                    ","2003-2004",2,"Basketball",87161,87544,-383,42586,41771,815,44575,45773,-1198,"28","21",17511,17511
"6223",168528,"ADRIAN COLLEGE                                              ","2003-2004",8,"Golf",10666,11050,-384,7666,7650,16,3000,3400,-400,"10","5",6106,3250
"5879",172644,"WAYNE STATE UNIVERSITY                                      ","2003-2004",8,"Golf",77875,78260,-385,77875,78260,-385,0,0,0,"11",".",30516,0
"12118",243142,"UNIVERSITY OF PUERTO RICO IN CAROLINA                       ","2003-2004",24,"Track and Field, Outdoor",14505,14890,-385,8255,8080,175,6250,6810,-560,"20","15",4300,3225
"12293",195234,"THE COLLEGE OF SAINT ROSE                                   ","2003-2004",25,"Track and Field, X-Country",58247,58633,-386,23171,23364,-193,35076,35269,-193,"7","10",4928,4928
"8424",154721,"BETHANY COLLEGE                                             ","2003-2004",15,"Soccer",104239,104626,-387,52978,54303,-1325,51261,50323,938,"13","12",8115,9504
"14900",121886,"RIO HONDO COLLEGE                                           ","2003-2004",28,"Wrestling",18020,18414,-394,18020,18414,-394,0,0,0,"15",".",4443,0
"5994",117751,"THE MASTER'S COLLEGE AND SEMINARY                           ","2003-2004",8,"Golf",85931,86331,-400,85931,86331,-400,0,0,0,"9",".",40305,0
"13125",169080,"CALVIN COLLEGE                                              ","2003-2004",26,"Volleyball",42414,42814,-400,0,0,0,42414,42814,-400,".","12",0,23359
"13738",111948,"CHAPMAN UNIVERSITY                                          ","2003-2004",26,"Volleyball",50000,50400,-400,0,0,0,50000,50400,-400,".","13",0,16000
"14828",243221,"UNIVERSITY OF PUERTO RICO-RIO PIEDRAS CAMPUS                ","2003-2004",28,"Wrestling",4500,4900,-400,4500,4900,-400,0,0,0,"7",".",4500,0
"11128",217059,"YORK COLLEGE PENNSYLVANIA                                   ","2003-2004",22,"Tennis",27500,27901,-401,15720,15721,-1,11780,12180,-400,"10","11",4121,4520
"3874",241410,"PONTIFICAL CATHOLIC UNIV OF PUERTO RICO-PONCE               ","2003-2004",3,"All Track Combined",15246,15648,-402,8434,8650,-216,6812,6998,-186,"26","21",8434,6812
"8757",162690,"HAGERSTOWN COMMUNITY COLLEGE                                ","2003-2004",16,"Softball",11275,11678,-403,0,0,0,11275,11678,-403,".","14",0,7269
"12336",160977,"BATES COLLEGE                                               ","2003-2004",25,"Track and Field, X-Country",67875,68278,-403,30184,30810,-626,37691,37468,223,"20","18",11475,13150
"6180",191621,"HILBERT COLLEGE                                             ","2003-2004",8,"Golf",5357,5763,-406,5357,5763,-406,0,0,0,"9",".",1801,0
"9214",169080,"CALVIN COLLEGE                                              ","2003-2004",16,"Softball",38552,38958,-406,0,0,0,38552,38958,-406,".","16",0,17245
"9572",122339,"SAN DIEGO CITY COLLEGE                                      ","2003-2004",16,"Softball",31613,32022,-409,0,0,0,31613,32022,-409,".","16",0,9847
"10885",143118,"AURORA UNIVERSITY                                           ","2003-2004",22,"Tennis",13469,13880,-411,9189,8591,598,4280,5289,-1009,"6","13",3050,4457
"8546",166683,"MASSACHUSETTS INSTITUTE OF TECHNOLOGY                       ","2003-2004",16,"Softball",37425,37838,-413,0,0,0,37425,37838,-413,".","21",0,24580
"8563",154022,"THE FRANCISCAN UNIVERSITY                                   ","2003-2004",16,"Softball",11000,11420,-420,0,0,0,11000,11420,-420,".","14",0,9000
"14138",110413,"CALIFORNIA LUTHERAN UNIVERSITY                              ","2003-2004",26,"Volleyball",37822,38242,-420,0,0,0,37822,38242,-420,".","13",0,20326
"14596",113698,"DOMINICAN UNIVERSITY OF CALIFORNIA                          ","2003-2004",26,"Volleyball",15020,15440,-420,0,0,0,15020,15440,-420,".","14",0,14775
"1925",206507,"WILMINGTON COLLEGE                                          ","2003-2004",2,"Basketball",176859,177283,-424,106845,105684,1161,70014,71599,-1585,"18","26",105678,71578
"11739",113980,"EL CAMINO COLLEGE                                           ","2003-2004",22,"Tennis",24158,24584,-426,12079,12292,-213,12079,12292,-213,"8","7",3956,3956
"6283",192022,"JEFFERSON COMMUNITY COLLEGE                                 ","2003-2004",8,"Golf",5000,5430,-430,5000,5430,-430,0,0,0,"5",".",4230,0
"6569",161299,"MAINE MARITIME ACADEMY                                      ","2003-2004",11,"Lacrosse",20734,21172,-438,20734,21172,-438,0,0,0,"25",".",15727,0
"9858",219833,"CHRISTIAN BROTHERS UNIVERSITY                               ","2003-2004",16,"Softball",11150,11592,-442,0,0,0,11150,11592,-442,".","13",0,10592
"9402",128744,"UNIVERSITY OF BRIDGEPORT                                    ","2003-2004",16,"Softball",162201,162648,-447,0,0,0,162201,162648,-447,".","16",0,9931
"2169",178369,"MISSOURI VALLEY COLLEGE                                     ","2003-2004",2,"Basketball",42450,42900,-450,23800,23800,0,18650,19100,-450,"44","29",21999,17234
"3445",148007,"PRAIRIE STATE COLLEGE                                       ","2003-2004",2,"Basketball",41500,41950,-450,21500,21550,-50,20000,20400,-400,"18","20",18800,17950
"1779",161165,"HUSSON COLLEGE                                              ","2003-2004",2,"Basketball",73094,73546,-452,43481,41255,2226,29613,32291,-2678,"14","12",18638,16794
"3168",166683,"MASSACHUSETTS INSTITUTE OF TECHNOLOGY                       ","2003-2004",2,"Basketball",105370,105822,-452,66907,67478,-571,38463,38344,119,"14","15",20430,15835
"17223",168528,"ADRIAN COLLEGE                                              ","2003-2004",39,"Total Participants",190580,191035,-455,97835,97860,-25,92745,93175,-430,"238","100",295147,114812
"2294",179265,"ST LOUIS COLLEGE OF PHARMACY                                ","2003-2004",2,"Basketball",30620,31077,-457,15580,16101,-521,15040,14976,64,"10","9",15301,14326
"5196",164492,"ANNA MARIA COLLEGE                                          ","2003-2004",8,"Golf",580,1038,-458,580,1038,-458,0,0,0,"8",".",580,0
"5570",174358,"MINNESOTA STATE UNIVERSITY-MOORHEAD                         ","2003-2004",8,"Golf",13268,13728,-460,0,0,0,13268,13728,-460,".","5",0,7167
"86",215442,"POINT PARK UNIVERSITY                                       ","2003-2004",1,"Baseball",170780,171248,-468,170780,171248,-468,0,0,0,"25",".",43518,0
"4234",216524,"URSINUS COLLEGE                                             ","2003-2004",6,"Field hocky",68000,68469,-469,0,0,0,68000,68469,-469,".","20",0,29500
"13804",164492,"ANNA MARIA COLLEGE                                          ","2003-2004",26,"Volleyball",11395,11864,-469,0,0,0,11395,11864,-469,".","9",0,11395
"4072",213020,"INDIANA UNIVERSITY OF PENNSYLVANIA-MAIN CAMPUS              ","2003-2004",6,"Field hocky",76102,76574,-472,0,0,0,76102,76574,-472,".","23",0,17460
"1891",156125,"WICHITA STATE UNIVERSITY                                    ","2003-2004",2,"Basketball",2716809,2717290,-481,2632416,1898134,734282,84393,819156,-734763,"16","15",418649,187311
"1421",178244,"MISSOURI BAPTIST UNIVERSITY                                 ","2003-2004",1,"Baseball",373022,373504,-482,373022,373504,-482,0,0,0,"40",".",43058,0
"13623",223524,"BROOKHAVEN COLLEGE                                          ","2003-2004",26,"Volleyball",13479,13966,-487,0,0,0,13479,13966,-487,".","9",0,7366
"10104",120971,"PALOMAR COLLEGE                                             ","2003-2004",18,"Swimming and Diving",10578,11066,-488,5289,5533,-244,5289,5533,-244,"20","19",1835,1835
"8104",161299,"MAINE MARITIME ACADEMY                                      ","2003-2004",15,"Soccer",82453,82945,-492,41265,41531,-266,41188,41414,-226,"21","17",14111,16244
"15073",199865,"WARREN WILSON COLLEGE                                       ","2003-2004",29,"Other Sports",15850,16344,-494,7925,8172,-247,7925,8172,-247,"11","8",5000,5000
"3801",102049,"SAMFORD UNIVERSITY                                          ","2003-2004",3,"All Track Combined",648332,648830,-498,256834,244194,12640,391498,404636,-13138,"43","49",25932,38897
"7580",146427,"KNOX COLLEGE                                                ","2003-2004",15,"Soccer",44950,45449,-499,18771,18771,0,26179,26678,-499,"25","14",13321,9051
"1467",190673,"CUNY QUEENSBOROUGH COMMUNITY COLLEGE                        ","2003-2004",1,"Baseball",7000,7500,-500,7000,7500,-500,0,0,0,"27",".",7000,0
"1662",183655,"ATLANTIC CAPE COMMUNITY COLLEGE                             ","2003-2004",2,"Basketball",20000,20500,-500,20000,20500,-500,0,0,0,"15",".",13000,0
"2900",190840,"DUTCHESS COMMUNITY COLLEGE                                  ","2003-2004",2,"Basketball",26500,27000,-500,13250,13750,-500,13250,13250,0,"12","10",5250,5250
"6646",166692,"MASSACHUSETTS MARITIME ACADEMY                              ","2003-2004",11,"Lacrosse",15000,15500,-500,15000,15500,-500,0,0,0,"30",".",6500,0
"7547",190673,"CUNY QUEENSBOROUGH COMMUNITY COLLEGE                        ","2003-2004",15,"Soccer",4000,4500,-500,4000,4500,-500,0,0,0,"25",".",4000,0
"9370",190673,"CUNY QUEENSBOROUGH COMMUNITY COLLEGE                        ","2003-2004",16,"Softball",7000,7500,-500,0,0,0,7000,7500,-500,".","17",0,7000
"11841",211352,"CABRINI COLLEGE                                             ","2003-2004",23,"Track and Field, Indoor",1000,1500,-500,500,750,-250,500,750,-250,"4","3",500,500
"13057",190673,"CUNY QUEENSBOROUGH COMMUNITY COLLEGE                        ","2003-2004",26,"Volleyball",3000,3500,-500,0,0,0,3000,3500,-500,".","15",0,3000
"13360",197045,"UTICA COLLEGE                                               ","2003-2004",26,"Volleyball",17300,17800,-500,0,0,0,17300,17800,-500,".","16",0,11200
"14249",243221,"UNIVERSITY OF PUERTO RICO-RIO PIEDRAS CAMPUS                ","2003-2004",26,"Volleyball",74100,74600,-500,25300,25500,-200,48800,49100,-300,"17","16",25300,48800
"15406",243221,"UNIVERSITY OF PUERTO RICO-RIO PIEDRAS CAMPUS                ","2003-2004",38,"Weight Lifting",7100,7600,-500,3500,3700,-200,3600,3900,-300,"11","10",3500,3600
"7706",181783,"WAYNE STATE COLLEGE                                         ","2003-2004",15,"Soccer",86321,86823,-502,0,0,0,86321,86823,-502,".","20",0,24964
"11026",196699,"SUNY ULSTER COUNTY COMMUNITY COLLEGE                        ","2003-2004",22,"Tennis",1000,1505,-505,1000,1505,-505,0,0,0,"7",".",505,0
"11014",206604,"WRIGHT STATE UNIVERSITY-MAIN CAMPUS                         ","2003-2004",22,"Tennis",302741,303249,-508,109231,156208,-46977,193510,147041,46469,"11","11",33517,20903
"8967",115861,"IMPERIAL VALLEY COLLEGE                                     ","2003-2004",16,"Softball",32062,32573,-511,0,0,0,32062,32573,-511,".","14",0,32578
"14736",149781,"WHEATON COLLEGE                                             ","2003-2004",27,"Water Polo",31487,32000,-513,0,0,0,31487,32000,-513,".","13",0,10623
"15271",217518,"ROGER WILLIAMS UNIVERSITY                                   ","2003-2004",34,"Equestrian",23501,24014,-513,940,961,-21,22561,23053,-492,".","26",180,4315
"2430",227997,"SAN JACINTO COLLEGE-NORTH CAMPUS                            ","2003-2004",2,"Basketball",83216,83730,-514,0,0,0,83216,83730,-514,".","12",0,725
"12224",228787,"THE UNIVERSITY OF TEXAS AT DALLAS                           ","2003-2004",25,"Track and Field, X-Country",9600,10115,-515,4800,5190,-390,4800,4925,-125,"9","9",4800,4800
"7576",237057,"WHITMAN COLLEGE                                             ","2003-2004",15,"Soccer",98217,98733,-516,46463,46979,-516,51754,51754,0,"30","22",32011,29148
"1141",208275,"BLUE MOUNTAIN COMMUNITY COLLEGE                             ","2003-2004",1,"Baseball",82558,83076,-518,82558,83076,-518,0,0,0,"30",".",36466,0
"14652",110574,"CALIFORNIA STATE UNIVERSITY-HAYWARD                         ","2003-2004",27,"Water Polo",77792,78310,-518,0,0,0,77792,78310,-518,".","17",0,39221
"12259",117724,"LOS ANGELES TRADE TECHNICAL COLLEGE                         ","2003-2004",25,"Track and Field, X-Country",15479,16000,-521,5833,6000,-167,9646,10000,-354,"17","19",5833,9646
"12877",190044,"CLARKSON UNIVERSITY                                         ","2003-2004",25,"Track and Field, X-Country",28622,29144,-522,17746,18069,-323,10876,11075,-199,"18","11",5164,3165
"3349",236595,"SEATTLE UNIVERSITY                                          ","2003-2004",2,"Basketball",815111,815644,-533,450545,409521,41024,364566,406123,-41557,"17","18",77052,64148
"7260",217536,"SALVE REGINA UNIVERSITY                                     ","2003-2004",15,"Soccer",55628,56163,-535,23500,25639,-2139,32128,30524,1604,"23","20",19639,17036
"14500",134079,"FLORIDA SOUTHERN COLLEGE                                    ","2003-2004",26,"Volleyball",140822,141357,-535,0,0,0,140822,141357,-535,".","15",0,44570
"6472",196015,"SUNY COLLEGE OF TECHNOLOGY AT CANTON                        ","2003-2004",10,"Ice Hockey",83386,83923,-537,83386,83923,-537,0,0,0,"31",".",40949,0
"14660",117724,"LOS ANGELES TRADE TECHNICAL COLLEGE                         ","2003-2004",27,"Water Polo",8460,9000,-540,4390,4500,-110,4070,4500,-430,"16","14",4070,4390
"13600",150400,"DEPAUW UNIVERSITY                                           ","2003-2004",26,"Volleyball",58087,58636,-549,0,0,0,58087,58636,-549,".","17",0,23119
"10085",186131,"PRINCETON UNIVERSITY                                        ","2003-2004",17,"Squash",246908,247458,-550,138983,139258,-275,107925,108200,-275,"20","24",45929,31446
"3719",224642,"EL PASO COMMUNITY COLLEGE                                   ","2003-2004",3,"All Track Combined",50000,50552,-552,25000,25276,-276,25000,25276,-276,"11","11",13524,13525
"664",169716,"UNIVERSITY OF DETROIT MERCY                                 ","2003-2004",1,"Baseball",337608,338164,-556,337608,338164,-556,0,0,0,"26",".",102291,0
"3369",150400,"DEPAUW UNIVERSITY                                           ","2003-2004",2,"Basketball",296957,297517,-560,154923,157462,-2539,142034,140055,1979,"16","23",59084,55527
"5683",154013,"MOUNT MERCY COLLEGE                                         ","2003-2004",8,"Golf",15630,16192,-562,7595,7595,0,8035,8597,-562,"15","7",7216,8168
"11611",184603,"FAIRLEIGH DICKINSON UNIVERSITY-METROPOLITAN CAMPUS          ","2003-2004",22,"Tennis",129297,129864,-567,71842,71373,469,57455,58491,-1036,"9","8",12639,5117
"12806",112190,"CITY COLLEGE OF SAN FRANCISCO                               ","2003-2004",25,"Track and Field, X-Country",44693,45264,-571,25295,25295,0,19398,19969,-571,"42","29",10991,5795
"12478",164492,"ANNA MARIA COLLEGE                                          ","2003-2004",25,"Track and Field, X-Country",4280,4853,-573,4280,4853,-573,0,0,0,"10",".",4280,0
"13688",239220,"MID-STATE TECHNICAL COLLEGE                                 ","2003-2004",26,"Volleyball",15218,15791,-573,0,0,0,15218,15791,-573,"0","7",0,8614
"14491",194240,"ORANGE COUNTY COMMUNITY COLLEGE                             ","2003-2004",26,"Volleyball",11938,12513,-575,0,0,0,11938,12513,-575,".","10",0,8651
"5276",176628,"AVILA UNIVERSITY                                            ","2003-2004",8,"Golf",33003,33586,-583,0,0,0,33003,33586,-583,".","6",0,8632
"9479",150941,"HUNTINGTON COLLEGE                                          ","2003-2004",16,"Softball",51344,51927,-583,0,0,0,51344,51927,-583,".","18",0,11179
"16453",176628,"AVILA UNIVERSITY                                            ","2003-2004",39,"Total Participants",617500,618083,-583,266555,266555,0,350945,351528,-583,"198","98",147747,99121
"6182",219879,"CLEVELAND STATE COMMUNITY COLLEGE                           ","2003-2004",8,"Golf",15415,16000,-585,15415,16000,-585,0,0,0,"9",".",14472,0
"1959",153311,"EASTERN IOWA COMMUNITY COLLEGE DISTRICT                     ","2003-2004",2,"Basketball",33045,33638,-593,33045,33638,-593,0,0,0,"14",".",19418,0
"4094",167394,"COLLEGE OF OUR LADY OF THE ELMS                             ","2003-2004",6,"Field hocky",25542,26136,-594,0,0,0,25542,26136,-594,".","17",0,11072
"5653",171456,"NORTHERN MICHIGAN UNIVERSITY                                ","2003-2004",8,"Golf",46650,47245,-595,46650,47245,-595,0,0,0,"7","0",14510,0
"11818",219976,"DAVID LIPSCOMB UNIVERSITY                                   ","2003-2004",23,"Track and Field, Indoor",39724,40319,-595,0,0,0,39724,40319,-595,".","18",0,9979
"12123",219976,"DAVID LIPSCOMB UNIVERSITY                                   ","2003-2004",24,"Track and Field, Outdoor",39724,40319,-595,0,0,0,39724,40319,-595,".","19",0,9979
"1671",169992,"GOGEBIC COMMUNITY COLLEGE                                   ","2003-2004",2,"Basketball",99352,99950,-598,48976,50553,-1577,50376,49397,979,"10","10",20929,20403
"1303",115126,"GOLDEN WEST COLLEGE                                         ","2003-2004",1,"Baseball",47207,47807,-600,47207,47807,-600,0,0,0,"29",".",18584,0
"10781",188641,"ALFRED UNIVERSITY                                           ","2003-2004",22,"Tennis",14250,14850,-600,7125,6925,200,7125,7925,-800,"12","12",3000,3000
"11846",236230,"PACIFIC LUTHERAN UNIVERSITY                                 ","2003-2004",23,"Track and Field, Indoor",1000,1600,-600,500,800,-300,500,800,-300,"12","13",500,500
"12364",178369,"MISSOURI VALLEY COLLEGE                                     ","2003-2004",25,"Track and Field, X-Country",4000,4600,-600,2000,2300,-300,2000,2300,-300,"7","7",1700,1500
"10436",195216,"ST LAWRENCE UNIVERSITY                                      ","2003-2004",18,"Swimming and Diving",96894,97498,-604,48447,48749,-302,48447,48749,-302,"13","15",11993,11993
"9911",192749,"MANHATTANVILLE COLLEGE                                      ","2003-2004",16,"Softball",18359,18970,-611,0,0,0,18359,18970,-611,".","13",0,10799
"8047",117274,"LASSEN COMMUNITY COLLEGE                                    ","2003-2004",15,"Soccer",94146,94762,-616,39258,39874,-616,54888,54888,0,"15","28",16400,20000
"10275",118976,"MODESTO JUNIOR COLLEGE                                      ","2003-2004",18,"Swimming and Diving",66448,67066,-618,54001,55242,-1241,12447,11824,623,"15","7",4731,3674
"10409",212601,"GANNON UNIVERSITY                                           ","2003-2004",18,"Swimming and Diving",198800,199418,-618,88893,89470,-577,109907,109948,-41,"17","27",18303,17444
"11110",162168,"CHESAPEAKE COLLEGE                                          ","2003-2004",22,"Tennis",1212,1830,-618,606,915,-309,606,915,-309,".","7",122,122
"12140",364016,"PARADISE VALLEY COMMUNITY COLLEGE                           ","2003-2004",24,"Track and Field, Outdoor",24396,25014,-618,12198,12585,-387,12198,12429,-231,"26","18",8424,8424
"12330",199865,"WARREN WILSON COLLEGE                                       ","2003-2004",25,"Track and Field, X-Country",7650,8271,-621,3825,4135,-310,3825,4136,-311,"10","13",3500,3500
"4576",161299,"MAINE MARITIME ACADEMY                                      ","2003-2004",7,"Football",145268,145891,-623,145268,145891,-623,0,0,0,"50",".",42069,0
"10775",233541,"SHENANDOAH UNIVERSITY                                       ","2003-2004",22,"Tennis",26019,26652,-633,13119,13326,-207,12900,13326,-426,"10","8",7061,7023
"1670",206002,"TEMPLE BAPTIST COLLEGE                                      ","2003-2004",2,"Basketball",20000,20636,-636,10000,10121,-121,10000,10515,-515,"12","8",7029,7422
"10956",191968,"ITHACA COLLEGE                                              ","2003-2004",22,"Tennis",80878,81514,-636,42417,42986,-569,38461,38528,-67,"14","12",17920,13457
"11973",209038,"LANE COMMUNITY COLLEGE                                      ","2003-2004",24,"Track and Field, Outdoor",55198,55838,-640,27599,27914,-315,27599,27924,-325,"17","15",9486,9048
"15820",151786,"MARIAN COLLEGE                                              ","2003-2004",39,"Total Participants",758842,759482,-640,464497,464835,-338,294345,294647,-302,"109","98",83291,41630
"6563",161457,"UNIVERSITY OF NEW ENGLAND                                   ","2003-2004",11,"Lacrosse",58457,59098,-641,29139,29170,-31,29318,29928,-610,"24","18",14703,8984
"14831",216524,"URSINUS COLLEGE                                             ","2003-2004",28,"Wrestling",31417,32062,-645,31417,32062,-645,0,0,0,"28",".",21847,0
"10486",216010,"SHIPPENSBURG UNIVERSITY OF PENNSYLVANIA                     ","2003-2004",19,"Swimming",155373,156020,-647,76184,75903,281,79189,80117,-928,"23","24",25413,25581
"5365",122746,"SAN JOSE CITY COLLEGE                                       ","2003-2004",8,"Golf",78487,79135,-648,78487,79135,-648,0,0,0,"8",".",648,0
"11591",206507,"WILMINGTON COLLEGE                                          ","2003-2004",22,"Tennis",21101,21749,-648,10414,10513,-99,10687,11236,-549,"9","5",10512,11235
"12995",147004,"MCHENRY COUNTY COLLEGE                                      ","2003-2004",26,"Volleyball",24350,24998,-648,0,0,0,24350,24998,-648,".","10",0,11891
"5815",219082,"DAKOTA STATE UNIVERSITY                                     ","2003-2004",8,"Golf",7420,8072,-652,4078,4379,-301,3342,3693,-351,"7","5",2287,1551
"3182",236887,"WALLA WALLA COMMUNITY COLLEGE                               ","2003-2004",2,"Basketball",58109,58771,-662,29824,30212,-388,28285,28559,-274,"14","14",18712,17059
"5170",213367,"LA SALLE UNIVERSITY                                         ","2003-2004",8,"Golf",46560,47224,-664,46560,47224,-664,0,0,0,"8",".",17954,0
"648",146278,"JOHN WOOD COMMUNITY COLLEGE                                 ","2003-2004",1,"Baseball",48917,49588,-671,48917,49588,-671,0,0,0,"28",".",14282,0
"12937",166391,"LASELL COLLEGE                                              ","2003-2004",25,"Track and Field, X-Country",10920,11592,-672,5460,5796,-336,5460,5796,-336,"5","6",3371,3371
"14358",241410,"PONTIFICAL CATHOLIC UNIV OF PUERTO RICO-PONCE               ","2003-2004",26,"Volleyball",6306,6978,-672,2890,3226,-336,3416,3752,-336,"11","13",2890,3416
"14998",186131,"PRINCETON UNIVERSITY                                        ","2003-2004",28,"Wrestling",178016,178688,-672,178016,178688,-672,0,0,0,"36",".",47297,0
"4239",191649,"HOFSTRA UNIVERSITY                                          ","2003-2004",6,"Field hocky",469173,469847,-674,0,0,0,469173,469847,-674,".","21",0,58420
"4118",192749,"MANHATTANVILLE COLLEGE                                      ","2003-2004",6,"Field hocky",43899,44577,-678,0,0,0,43899,44577,-678,".","17",0,8978
"13554",146278,"JOHN WOOD COMMUNITY COLLEGE                                 ","2003-2004",26,"Volleyball",17492,18170,-678,0,0,0,17492,18170,-678,".","13",0,10590
"9002",164492,"ANNA MARIA COLLEGE                                          ","2003-2004",16,"Softball",20395,21074,-679,0,0,0,20395,21074,-679,".","13",0,20395
"9337",210429,"WESTERN OREGON UNIVERSITY                                   ","2003-2004",16,"Softball",83408,84091,-683,0,0,0,83408,84091,-683,".","17",0,33219
"1534",164492,"ANNA MARIA COLLEGE                                          ","2003-2004",1,"Baseball",18740,19427,-687,18740,19427,-687,0,0,0,"12",".",18740,0
"11481",190983,"ELMIRA COLLEGE                                              ","2003-2004",22,"Tennis",45165,45857,-692,18714,19567,-853,26451,26290,161,"10","16",4306,7957
"14473",140234,"LAGRANGE COLLEGE                                            ","2003-2004",26,"Volleyball",56573,57265,-692,0,0,0,56573,57265,-692,".","13",0,28165
"15138",228325,"SOUTHWESTERN ASSEMBLIES OF GOD UNIVERSITY                   ","2003-2004",29,"Other Sports",23749,24441,-692,0,0,0,23749,24441,-692,".","11",0,12852
"12194",184612,"FELICIAN COLLEGE                                            ","2003-2004",25,"Track and Field, X-Country",161869,162562,-693,76084,76431,-347,85785,86131,-346,"6","8",17785,17786
"14111",240055,"UNIVERSITY OF WISCONSIN COLLEGES                            ","2003-2004",26,"Volleyball",52496,53190,-694,0,0,0,52496,53190,-694,".","123",0,42026
"5785",174437,"NORTH CENTRAL UNIVERSITY                                    ","2003-2004",8,"Golf",850,1550,-700,850,1550,-700,0,0,0,"5",".",1325,0
"11936",243221,"UNIVERSITY OF PUERTO RICO-RIO PIEDRAS CAMPUS                ","2003-2004",24,"Track and Field, Outdoor",69700,70400,-700,36500,36900,-400,33200,33500,-300,"27","21",36500,33200
"12551",243221,"UNIVERSITY OF PUERTO RICO-RIO PIEDRAS CAMPUS                ","2003-2004",25,"Track and Field, X-Country",8800,9500,-700,4500,4800,-300,4300,4700,-400,"8","7",4500,4300
"8244",221892,"TREVECCA NAZARENE UNIVERSITY                                ","2003-2004",15,"Soccer",249998,250702,-704,129252,131421,-2169,120746,119281,1465,"22","15",17845,22189
"10604",240471,"UNIVERSITY OF WISCONSIN-RIVER FALLS                         ","2003-2004",19,"Swimming",49073,49778,-705,22235,22503,-268,26838,27275,-437,"8","13",6778,11058
"13967",110653,"UNIVERSITY OF CALIFORNIA-IRVINE                             ","2003-2004",26,"Volleyball",627461,628178,-717,203029,208689,-5660,424432,419489,4943,"26","13",63914,69458
"12167",108807,"ALLAN HANCOCK COLLEGE                                       ","2003-2004",25,"Track and Field, X-Country",34646,35364,-718,17323,17682,-359,17323,17682,-359,"30","18",8677,8677
"5278",134079,"FLORIDA SOUTHERN COLLEGE                                    ","2003-2004",8,"Golf",273610,274330,-720,149624,143386,6238,123986,130944,-6958,"10","10",35537,36529
"14465",191621,"HILBERT COLLEGE                                             ","2003-2004",26,"Volleyball",26680,27400,-720,15148,16052,-904,11532,11348,184,"13","11",6137,5228
"734",217059,"YORK COLLEGE PENNSYLVANIA                                   ","2003-2004",1,"Baseball",132580,133305,-725,132580,133305,-725,0,0,0,"31",".",67302,0
"1056",197045,"UTICA COLLEGE                                               ","2003-2004",1,"Baseball",19500,20225,-725,19500,20225,-725,0,0,0,"25",".",11600,0
"9409",197045,"UTICA COLLEGE                                               ","2003-2004",16,"Softball",20150,20875,-725,0,0,0,20150,20875,-725,".","17",0,12400
"11637",178059,"MARYVILLE UNIVERSITY OF SAINT LOUIS                         ","2003-2004",22,"Tennis",5840,6567,-727,2531,3015,-484,3309,3552,-243,"8","6",2555,3405
"11799",201371,"BLUFFTON COLLEGE                                            ","2003-2004",22,"Tennis",22224,22951,-727,12596,11369,1227,9628,11582,-1954,"6","7",1781,2557
"12733",191621,"HILBERT COLLEGE                                             ","2003-2004",25,"Track and Field, X-Country",9738,10469,-731,4871,5235,-364,4867,5234,-367,"21","19",1581,1581
"732",228769,"THE UNIVERSITY OF TEXAS AT ARLINGTON                        ","2003-2004",1,"Baseball",403439,404172,-733,403439,404172,-733,0,0,0,"36",".",135825,0
"14534",199458,"ROANOKE BIBLE COLLEGE                                       ","2003-2004",26,"Volleyball",1,734,-733,0,0,0,1,734,-733,".","10",0,534
"17090",199458,"ROANOKE BIBLE COLLEGE                                       ","2003-2004",39,"Total Participants",1,734,-733,0,0,0,1,734,-733,"14","19",3927,3094
"2576",188641,"ALFRED UNIVERSITY                                           ","2003-2004",2,"Basketball",150767,151503,-736,79900,81298,-1398,70867,70205,662,"12","14",17280,14900
"16901",154509,"VENNARD COLLEGE                                             ","2003-2004",39,"Total Participants",15274,16018,-744,8201,8573,-372,7073,7445,-372,"28","16",18333,16359
"28",173647,"GUSTAVUS ADOLPHUS COLLEGE                                   ","2003-2004",1,"Baseball",93397,94148,-751,93397,94148,-751,0,0,0,"30",".",41624,0
"12356",237215,"BLUEFIELD STATE COLLEGE                                     ","2003-2004",25,"Track and Field, X-Country",17838,18599,-761,8919,9680,-761,8919,8919,0,"14","11",6575,6575
"14954",216038,"SLIPPERY ROCK UNIVERSITY OF PENNSYLVANIA                    ","2003-2004",28,"Wrestling",98517,99279,-762,98517,99279,-762,0,0,0,"23",".",19246,0
"6973",195216,"ST LAWRENCE UNIVERSITY                                      ","2003-2004",13,"Rowing",95438,96202,-764,47719,48101,-382,47719,48101,-382,"14","34",19337,19337
"6587",224323,"UNIVERSITY OF DALLAS                                        ","2003-2004",11,"Lacrosse",37918,38683,-765,0,0,0,37918,38683,-765,".","23",0,31949
"7965",213774,"MANOR COLLEGE                                               ","2003-2004",15,"Soccer",27160,27925,-765,14660,15535,-875,12500,12390,110,"17","12",8200,4800
"16744",213774,"MANOR COLLEGE                                               ","2003-2004",39,"Total Participants",27160,27925,-765,14660,15535,-875,12500,12390,110,"28","19",21300,16700
"13888",145725,"ILLINOIS INSTITUTE OF TECHNOLOGY                            ","2003-2004",26,"Volleyball",69668,70436,-768,0,0,0,69668,70436,-768,".","11",0,17436
"8825",196200,"SUNY-POTSDAM                                                ","2003-2004",16,"Softball",59799,60569,-770,0,0,0,59799,60569,-770,".","16",0,39470
"15003",230995,"NORWICH UNIVERSITY                                          ","2003-2004",28,"Wrestling",73665,74442,-777,73665,74442,-777,0,0,0,"33","0",41289,0
"5615",231059,"SAINT MICHAELS COLLEGE                                      ","2003-2004",8,"Golf",14092,14871,-779,14092,14871,-779,0,0,0,"8",".",4041,0
"12499",240338,"WISCONSIN LUTHERAN COLLEGE                                  ","2003-2004",25,"Track and Field, X-Country",53002,53782,-780,26501,26891,-390,26501,26891,-390,"20","32",12095,12095
"1573",186469,"SALEM COMMUNITY COLLEGE                                     ","2003-2004",1,"Baseball",31309,32094,-785,31309,32094,-785,0,0,0,"14",".",7029,0
"14015",115861,"IMPERIAL VALLEY COLLEGE                                     ","2003-2004",26,"Volleyball",18842,19628,-786,0,0,0,18842,19628,-786,".","11",0,19624
"6941",210401,"WILLAMETTE UNIVERSITY                                       ","2003-2004",13,"Rowing",48559,49346,-787,0,0,0,48559,49346,-787,".","40",0,28846
"10911",199962,"WINGATE UNIVERSITY                                          ","2003-2004",22,"Tennis",14141,14929,-788,7980,8057,-77,6161,6872,-711,"8","8",7980,5721
"14375",128744,"UNIVERSITY OF BRIDGEPORT                                    ","2003-2004",26,"Volleyball",134203,134995,-792,0,0,0,134203,134995,-792,".","15",0,10119
"13934",190442,"CORNING COMMUNITY COLLEGE                                   ","2003-2004",26,"Volleyball",8350,9143,-793,0,0,0,8350,9143,-793,".","14",0,5143
"10680",195526,"SKIDMORE COLLEGE                                            ","2003-2004",22,"Tennis",69551,70346,-795,42033,42033,0,27518,28313,-795,"12","8",6203,13023
"209",174817,"SAINT MARY'S UNIVERSITY OF MINNESOTA                        ","2003-2004",1,"Baseball",73906,74703,-797,73906,74703,-797,0,0,0,"30",".",30051,0
"3078",200554,"UNITED TRIBES TECHNICAL COLLEGE                             ","2003-2004",2,"Basketball",123754,124551,-797,69060,69759,-699,54694,54792,-98,"16","11",58703,46082
"12174",239071,"MARANATHA BAPTIST BIBLE COLLEGE INC                         ","2003-2004",25,"Track and Field, X-Country",2269,3067,-798,1159,1573,-414,1110,1494,-384,"11","5",839,760
"832",206507,"WILMINGTON COLLEGE                                          ","2003-2004",1,"Baseball",35055,35855,-800,35055,35855,-800,0,0,0,"28",".",35840,0
"3777",212911,"HAVERFORD COLLEGE                                           ","2003-2004",3,"All Track Combined",81823,82623,-800,42037,42837,-800,39786,39786,0,"46","38",40665,35546
"9180",206507,"WILMINGTON COLLEGE                                          ","2003-2004",16,"Softball",34168,34968,-800,0,0,0,34168,34968,-800,".","15",0,34965
"10501",197045,"UTICA COLLEGE                                               ","2003-2004",19,"Swimming",56550,57350,-800,23800,24100,-300,32750,33250,-500,"11","16",4800,11400
"12985",178369,"MISSOURI VALLEY COLLEGE                                     ","2003-2004",26,"Volleyball",22500,23300,-800,11000,11100,-100,11500,12200,-700,"26","24",8999,10699
"15811",212911,"HAVERFORD COLLEGE                                           ","2003-2004",39,"Total Participants",342387,343187,-800,164317,165117,-800,178070,178070,0,"221","188",178273,186111
"4163",231059,"SAINT MICHAELS COLLEGE                                      ","2003-2004",6,"Field hocky",102544,103345,-801,0,0,0,102544,103345,-801,".","35",0,26733
"17282",220701,"MARTIN METHODIST COLLEGE                                    ","2003-2004",39,"Total Participants",1282157,1282958,-801,607857,601992,5865,674300,680966,-6666,"80","60",84673,78325
"446",153162,"CORNELL COLLEGE                                             ","2003-2004",1,"Baseball",57898,58701,-803,57898,58701,-803,0,0,0,"27",".",41665,0
"16709",409698,"CALIFORNIA STATE UNIVERSITY-MONTEREY BAY                    ","2003-2004",39,"Total Participants",156078,156883,-805,77655,76345,1310,78423,80538,-2115,"78","66",68342,75495
"16176",218070,"FURMAN UNIVERSITY                                           ","2003-2004",39,"Total Participants",3467013,3467820,-807,1383041,1485401,-102360,2083972,1982419,101553,"254","164",679827,343390
"10413",230995,"NORWICH UNIVERSITY                                          ","2003-2004",18,"Swimming and Diving",41567,42377,-810,26452,26967,-515,15115,15410,-295,"21","12",10363,10363
"1968",199865,"WARREN WILSON COLLEGE                                       ","2003-2004",2,"Basketball",26500,27320,-820,13500,14320,-820,13000,13000,0,"12","14",13500,8969
"14646",145521,"HIGHLAND COMMUNITY COLLEGE                                  ","2003-2004",26,"Volleyball",7488,8311,-823,0,0,0,7488,8311,-823,".","10",0,5704
"1872",134495,"HILLSBOROUGH COMMUNITY COLLEGE                              ","2003-2004",2,"Basketball",25600,26428,-828,12800,13214,-414,12800,13214,-414,"16","16",12800,12800
"11830",230959,"MIDDLEBURY COLLEGE                                          ","2003-2004",23,"Track and Field, Indoor",64762,65590,-828,32294,32698,-404,32468,32892,-424,"33","29",6183,6267
"13286",198862,"LIVINGSTONE COLLEGE                                         ","2003-2004",26,"Volleyball",90449,91277,-828,0,0,0,90449,91277,-828,".","7",0,9387
"12254",190716,"D'YOUVILLE COLLEGE                                          ","2003-2004",25,"Track and Field, X-Country",3000,3836,-836,0,0,0,3000,3836,-836,".","6",0,1836
"14381",153311,"EASTERN IOWA COMMUNITY COLLEGE DISTRICT                     ","2003-2004",26,"Volleyball",25175,26011,-836,0,0,0,25175,26011,-836,".","9",0,16157
"16171",153311,"EASTERN IOWA COMMUNITY COLLEGE DISTRICT                     ","2003-2004",39,"Total Participants",262996,263833,-837,126518,126518,0,136478,137315,-837,"72","49",73839,66201
"9788",403487,"ILLINOIS EASTERN COMMUNITY COLLS-WABASH VLY COLL            ","2003-2004",16,"Softball",106476,107314,-838,0,0,0,106476,107314,-838,".","19",0,51030
"3493",181020,"DOANE COLLEGE                                               ","2003-2004",3,"All Track Combined",670906,671750,-844,338077,338499,-422,332829,333251,-422,"60","60",66553,64365
"9420",196024,"SUNY COLLEGE OF TECHNOLOGY AT DELHI                         ","2003-2004",16,"Softball",8160,9008,-848,0,0,0,8160,9008,-848,".","15",0,6509
"14336",153621,"IOWA WESLEYAN COLLEGE                                       ","2003-2004",26,"Volleyball",14518,15366,-848,0,0,0,14518,15366,-848,".","14",0,13325
"4196",160977,"BATES COLLEGE                                               ","2003-2004",6,"Field hocky",57614,58467,-853,0,0,0,57614,58467,-853,".","17",0,20914
"4437",198303,"CHOWAN COLLEGE                                              ","2003-2004",7,"Football",182565,183423,-858,182565,183423,-858,0,0,0,"105",".",64456,0
"11542",153126,"CLARKE COLLEGE                                              ","2003-2004",22,"Tennis",23558,24418,-860,10535,11382,-847,13023,13036,-13,"10","11",3668,5322
"13174",146676,"LINCOLN COLLEGE                                             ","2003-2004",26,"Volleyball",56876,57758,-882,0,0,0,56876,57758,-882,".","14",0,13355
"12226",228802,"THE UNIVERSITY OF TEXAS AT TYLER                            ","2003-2004",25,"Track and Field, X-Country",10364,11254,-890,5182,5627,-445,5182,5627,-445,"5","5",3842,3842
"3658",155104,"GARDEN CITY COMMUNITY COLLEGE                               ","2003-2004",3,"All Track Combined",25460,26352,-892,25460,26352,-892,0,0,0,"45","0",23060,0
"6438",231059,"SAINT MICHAELS COLLEGE                                      ","2003-2004",10,"Ice Hockey",340416,341308,-892,229467,230422,-955,110949,110886,63,"30","24",51868,32755
"13742",195234,"THE COLLEGE OF SAINT ROSE                                   ","2003-2004",26,"Volleyball",120258,121150,-892,0,0,0,120258,121150,-892,".","12",0,24609
"11856",236328,"UNIVERSITY OF PUGET SOUND                                   ","2003-2004",23,"Track and Field, Indoor",150,1048,-898,72,498,-426,78,550,-472,"41","43",477,539
"10488",206507,"WILMINGTON COLLEGE                                          ","2003-2004",19,"Swimming",58387,59287,-900,29194,29673,-479,29193,29614,-421,"13","15",29666,29610
"10509",243221,"UNIVERSITY OF PUERTO RICO-RIO PIEDRAS CAMPUS                ","2003-2004",19,"Swimming",17850,18750,-900,7650,7850,-200,10200,10900,-700,"18","19",7650,10200
"14266",166948,"MOUNT IDA COLLEGE                                           ","2003-2004",26,"Volleyball",56829,57729,-900,26662,26662,0,30167,31067,-900,"10","10",18962,22467
"6362",240365,"UNIVERSITY OF WISCONSIN-OSHKOSH                             ","2003-2004",9,"Gymnastics",20747,21651,-904,0,0,0,20747,21651,-904,".","14",0,21634
"11038",228042,"SCHREINER UNIVERSITY                                        ","2003-2004",22,"Tennis",61638,62550,-912,30819,33808,-2989,30819,28742,2077,"6","6",8361,8361
"10500",154350,"SIMPSON COLLEGE                                             ","2003-2004",19,"Swimming",9350,10265,-915,0,0,0,9350,10265,-915,".","14",0,4665
"13452",101675,"MILES COLLEGE                                               ","2003-2004",26,"Volleyball",13841,14757,-916,0,0,0,13841,14757,-916,"0","12",0,1230
"5974",186469,"SALEM COMMUNITY COLLEGE                                     ","2003-2004",8,"Golf",3700,4617,-917,3700,4617,-917,0,0,0,"4",".",750,0
"9713",145831,"ILLINOIS VALLEY COMMUNITY COLLEGE                           ","2003-2004",16,"Softball",18650,19568,-918,0,0,0,18650,19568,-918,".","13",0,11134
"5985",133085,"CLEARWATER CHRISTIAN COLLEGE                                ","2003-2004",8,"Golf",6866,7786,-920,3433,3893,-460,3433,3893,-460,"9","0",3802,3802
"5280",166683,"MASSACHUSETTS INSTITUTE OF TECHNOLOGY                       ","2003-2004",8,"Golf",36814,37743,-929,36814,37743,-929,0,0,0,"19",".",21937,0
"5700",240338,"WISCONSIN LUTHERAN COLLEGE                                  ","2003-2004",8,"Golf",19068,20007,-939,10614,11157,-543,8454,8850,-396,"9","7",6299,2190
"7060",230959,"MIDDLEBURY COLLEGE                                          ","2003-2004",14,"Skiing",321367,322311,-944,153815,166119,-12304,167552,156192,11360,"27","27",81222,71246
"6882",134945,"JACKSONVILLE UNIVERSITY                                     ","2003-2004",13,"Rowing",211833,212779,-946,110772,112312,-1540,101061,100467,594,"21","18",27869,28463
"950",175643,"EAST CENTRAL COMMUNITY COLLEGE                              ","2003-2004",1,"Baseball",110489,111438,-949,110489,111438,-949,0,0,0,"29",".",22785,0
"10756",240268,"UNIVERSITY OF WISCONSIN-EAU CLAIRE                          ","2003-2004",22,"Tennis",49246,50196,-950,24562,25099,-537,24684,25097,-413,"14","11",14551,14381
"5999",238980,"LAKELAND COLLEGE                                            ","2003-2004",8,"Golf",8987,9938,-951,7338,7288,50,1649,2650,-1001,"12","5",4888,1650
"11118",145707,"ILLINOIS EASTERN COMMUNITY COLLS-OLNEY CTRL COLL            ","2003-2004",22,"Tennis",15035,15991,-956,0,0,0,15035,15991,-956,".","7",0,2969
"16527",100654,"ALABAMA A &amp; M UNIVERSITY                                    ","2003-2004",39,"Total Participants",1592824,1593783,-959,702201,699703,2498,890623,894080,-3457,"216","129",759135,323137
"9815",237066,"WHITWORTH COLLEGE                                           ","2003-2004",16,"Softball",75478,76440,-962,0,0,0,75478,76440,-962,".","16",0,51650
"13009",155496,"MANHATTAN CHRISTIAN COLLEGE                                 ","2003-2004",26,"Volleyball",11478,12441,-963,0,0,0,11478,12441,-963,".","13",0,11206
"11378",216524,"URSINUS COLLEGE                                             ","2003-2004",22,"Tennis",21190,22156,-966,10595,11251,-656,10595,10905,-310,"9","13",6695,6695
"5319",233541,"SHENANDOAH UNIVERSITY                                       ","2003-2004",8,"Golf",28347,29315,-968,28347,29315,-968,0,0,0,"8",".",10978,0
"6836",195216,"ST LAWRENCE UNIVERSITY                                      ","2003-2004",11,"Lacrosse",122245,123214,-969,70938,70818,120,51307,52396,-1089,"34","29",26363,13885
"9286",174817,"SAINT MARY'S UNIVERSITY OF MINNESOTA                        ","2003-2004",16,"Softball",66350,67321,-971,0,0,0,66350,67321,-971,".","21",0,25198
"7702",118976,"MODESTO JUNIOR COLLEGE                                      ","2003-2004",15,"Soccer",41996,42969,-973,17477,18253,-776,24519,24716,-197,"22","22",5545,4979
"14212",196219,"SUNY COLLEGE AT PURCHASE                                    ","2003-2004",26,"Volleyball",27400,28375,-975,13700,14100,-400,13700,14275,-575,"8","9",13700,13700
"14410",117140,"UNIVERSITY OF LA VERNE                                      ","2003-2004",26,"Volleyball",80768,81748,-980,21111,21324,-213,59657,60424,-767,"14","18",9984,29693
"6206",228769,"THE UNIVERSITY OF TEXAS AT ARLINGTON                        ","2003-2004",8,"Golf",138047,139028,-981,138047,139028,-981,0,0,0,"12",".",44214,0
"12493",230931,"LYNDON STATE COLLEGE                                        ","2003-2004",25,"Track and Field, X-Country",8174,9156,-982,4425,5407,-982,3749,3749,0,"10","7",5406,2812
"2751",192192,"KEUKA COLLEGE                                               ","2003-2004",2,"Basketball",88304,89287,-983,44152,44152,0,44152,45135,-983,"14","15",21152,21153
"5536",119331,"NAPA VALLEY COLLEGE                                         ","2003-2004",8,"Golf",41552,42537,-985,20826,22172,-1346,20726,20365,361,"8","6",4571,2764
"7143",220941,"CRICHTON COLLEGE                                            ","2003-2004",15,"Soccer",4625,5610,-985,0,0,0,4625,5610,-985,".","15",0,540
"245",238980,"LAKELAND COLLEGE                                            ","2003-2004",1,"Baseball",50412,51399,-987,50412,51399,-987,0,0,0,"38",".",26633,0
"14316",230047,"BRIGHAM YOUNG UNIVERSITY-HAWAII CAMPUS                      ","2003-2004",26,"Volleyball",73000,73990,-990,0,0,0,73000,73990,-990,".","14",0,73000
"4102",164492,"ANNA MARIA COLLEGE                                          ","2003-2004",6,"Field hocky",22480,23471,-991,0,0,0,22480,23471,-991,".","19",0,22480
"15280",196200,"SUNY-POTSDAM                                                ","2003-2004",34,"Equestrian",27841,28833,-992,0,0,0,27841,28833,-992,".","18",0,19471
"16060",150677,"GRACE COLLEGE AND THEOLOGICAL SEMINARY                      ","2003-2004",39,"Total Participants",613552,614551,-999,309992,310991,-999,303560,303560,0,"92","98",115296,102010
"92",101073,"CONCORDIA COLLEGE                                           ","2003-2004",1,"Baseball",14500,15500,-1000,14500,15500,-1000,0,0,0,"30",".",12000,0
"746",196051,"MORRISVILLE STATE COLLEGE                                   ","2003-2004",1,"Baseball",30692,31692,-1000,30692,31692,-1000,0,0,0,"17",".",20276,0
"1237",150677,"GRACE COLLEGE AND THEOLOGICAL SEMINARY                      ","2003-2004",1,"Baseball",84993,85993,-1000,84993,85993,-1000,0,0,0,"20",".",32939,0
"1638",233912,"VIRGINIA INTERMONT COLLEGE                                  ","2003-2004",2,"Basketball",52500,53500,-1000,26600,26600,0,25900,26900,-1000,"12","17",24070,24168
"1736",210146,"SOUTHERN OREGON UNIVERSITY                                  ","2003-2004",2,"Basketball",140090,141090,-1000,76167,74367,1800,63923,66723,-2800,"13","13",36500,47900
"2192",181242,"LINCOLN SCHOOL OF COMMERCE                                  ","2003-2004",2,"Basketball",4000,5000,-1000,2000,2500,-500,2000,2500,-500,"15","15",2000,2000
"2724",190673,"CUNY QUEENSBOROUGH COMMUNITY COLLEGE                        ","2003-2004",2,"Basketball",12500,13500,-1000,6500,7000,-500,6000,6500,-500,"15","12",6500,6000
"3451",115126,"GOLDEN WEST COLLEGE                                         ","2003-2004",2,"Basketball",51608,52608,-1000,28852,29852,-1000,22756,22756,0,"21","12",7176,11254
"4067",168430,"WORCESTER STATE COLLEGE                                     ","2003-2004",6,"Field hocky",15529,16529,-1000,0,0,0,15529,16529,-1000,".","17",0,15529
"5763",173452,"MARTIN LUTHER COLLEGE                                       ","2003-2004",8,"Golf",3500,4500,-1000,3500,4500,-1000,0,0,0,"10",".",3500,0
"5942",126182,"ADAMS STATE COLLEGE                                         ","2003-2004",8,"Golf",9400,10400,-1000,9400,10400,-1000,0,0,0,"8",".",1000,0
"6175",211352,"CABRINI COLLEGE                                             ","2003-2004",8,"Golf",5800,6800,-1000,5800,6800,-1000,0,0,0,"7",".",5800,0
"6772",168430,"WORCESTER STATE COLLEGE                                     ","2003-2004",11,"Lacrosse",11155,12155,-1000,0,0,0,11155,12155,-1000,".","16",0,11155
"7251",243221,"UNIVERSITY OF PUERTO RICO-RIO PIEDRAS CAMPUS                ","2003-2004",15,"Soccer",9650,10650,-1000,9650,10650,-1000,0,0,0,"20",".",9650,0
"7951",101073,"CONCORDIA COLLEGE                                           ","2003-2004",15,"Soccer",14500,15500,-1000,14500,15500,-1000,0,0,0,"22",".",12000,0
"8627",211024,"BAPTIST BIBLE COLLEGE AND SEMINARY                          ","2003-2004",16,"Softball",7408,8408,-1000,0,0,0,7408,8408,-1000,".","26",0,6708
"8912",192192,"KEUKA COLLEGE                                               ","2003-2004",16,"Softball",21836,22836,-1000,0,0,0,21836,22836,-1000,".","21",0,14836
"8923",230597,"SNOW COLLEGE                                                ","2003-2004",16,"Softball",23000,24000,-1000,0,0,0,23000,24000,-1000,".","18",0,23000
"9165",101073,"CONCORDIA COLLEGE                                           ","2003-2004",16,"Softball",14000,15000,-1000,0,0,0,14000,15000,-1000,".","15",0,12000
"9956",117140,"UNIVERSITY OF LA VERNE                                      ","2003-2004",16,"Softball",33326,34326,-1000,0,0,0,33326,34326,-1000,".","13",0,20871
"10570",190673,"CUNY QUEENSBOROUGH COMMUNITY COLLEGE                        ","2003-2004",19,"Swimming",3000,4000,-1000,1500,2000,-500,1500,2000,-500,"10","10",1500,1500
"10579",111948,"CHAPMAN UNIVERSITY                                          ","2003-2004",19,"Swimming",13500,14500,-1000,0,0,0,13500,14500,-1000,".","14",0,9500
"10711",210146,"SOUTHERN OREGON UNIVERSITY                                  ","2003-2004",22,"Tennis",17289,18289,-1000,0,0,0,17289,18289,-1000,".","10",0,12889
"11743",179946,"WESTMINSTER COLLEGE                                         ","2003-2004",22,"Tennis",15000,16000,-1000,7500,8000,-500,7500,8000,-500,"8","8",6000,6000
"11869",170790,"MACOMB COMMUNITY COLLEGE                                    ","2003-2004",23,"Track and Field, Indoor",2000,3000,-1000,1000,1500,-500,1000,1500,-500,"15","18",1,1
"11893",168430,"WORCESTER STATE COLLEGE                                     ","2003-2004",23,"Track and Field, Indoor",8427,9427,-1000,4027,4527,-500,4400,4900,-500,"23","20",4027,4400
"11920",190673,"CUNY QUEENSBOROUGH COMMUNITY COLLEGE                        ","2003-2004",23,"Track and Field, Indoor",4000,5000,-1000,2000,2500,-500,2000,2500,-500,"15","15",2000,2000
"12030",190673,"CUNY QUEENSBOROUGH COMMUNITY COLLEGE                        ","2003-2004",24,"Track and Field, Outdoor",4000,5000,-1000,2000,2500,-500,2000,2500,-500,"15","15",2000,2000
"12437",214795,"PENNSYLVANIA STATE UNIVERSITY-PENN STATE MONT ALTO          ","2003-2004",25,"Track and Field, X-Country",2000,3000,-1000,1000,1500,-500,1000,1500,-500,"6",".",1000,1000
"12891",196237,"SUNY COLLEGE AT OLD WESTBURY                                ","2003-2004",25,"Track and Field, X-Country",3000,4000,-1000,1500,2000,-500,1500,2000,-500,"5","5",1500,1500
"12965",182661,"DANIEL WEBSTER COLLEGE                                      ","2003-2004",25,"Track and Field, X-Country",1845,2845,-1000,825,1325,-500,1020,1520,-500,"6","6",825,1025
"12972",190673,"CUNY QUEENSBOROUGH COMMUNITY COLLEGE                        ","2003-2004",25,"Track and Field, X-Country",4000,5000,-1000,2000,2500,-500,2000,2500,-500,"15","15",2000,2000
"12981",203580,"LAKE ERIE COLLEGE                                           ","2003-2004",25,"Track and Field, X-Country",5246,6246,-1000,2587,3087,-500,2659,3159,-500,"6","8",1587,1659
"13848",230597,"SNOW COLLEGE                                                ","2003-2004",26,"Volleyball",22000,23000,-1000,0,0,0,22000,23000,-1000,".","14",0,22000
"14151",211352,"CABRINI COLLEGE                                             ","2003-2004",26,"Volleyball",8065,9065,-1000,0,0,0,8065,9065,-1000,".","16",0,8065
"14201",168430,"WORCESTER STATE COLLEGE                                     ","2003-2004",26,"Volleyball",11138,12138,-1000,0,0,0,11138,12138,-1000,".","10",0,11138
"15074",168430,"WORCESTER STATE COLLEGE                                     ","2003-2004",29,"Other Sports",10919,11919,-1000,0,0,0,10919,11919,-1000,".","23",0,10919
"15103",196237,"SUNY COLLEGE AT OLD WESTBURY                                ","2003-2004",29,"Other Sports",1000,2000,-1000,0,0,0,1000,2000,-1000,".","15",0,1500
"15108",243115,"UNIVERSITY OF PUERTO RICO-ARECIBO                           ","2003-2004",29,"Other Sports",9881,10881,-1000,3368,4368,-1000,6513,6513,0,"4","9",468,1053
"15576",126182,"ADAMS STATE COLLEGE                                         ","2003-2004",39,"Total Participants",855569,856569,-1000,310733,311733,-1000,544836,544836,0,"241","118",144471,101109
"5735",215743,"SAINT FRANCIS UNIVERSITY                                    ","2003-2004",8,"Golf",129873,130879,-1006,70767,69072,1695,59106,61807,-2701,"12","6",16915,15470
"13187",240268,"UNIVERSITY OF WISCONSIN-EAU CLAIRE                          ","2003-2004",26,"Volleyball",59510,60518,-1008,0,0,0,59510,60518,-1008,".","17",0,16185
"6480",191515,"HAMILTON COLLEGE                                            ","2003-2004",10,"Ice Hockey",179877,180887,-1010,108481,110302,-1821,71396,70585,811,"22","18",41644,31891
"14341",202514,"DEFIANCE COLLEGE                                            ","2003-2004",26,"Volleyball",59262,60272,-1010,0,0,0,59262,60272,-1010,".","12",0,20643
"11301",157076,"KENTUCKY WESLEYAN COLLEGE                                   ","2003-2004",22,"Tennis",19183,20198,-1015,0,0,0,19183,20198,-1015,".","10",0,4223
"4164",215743,"SAINT FRANCIS UNIVERSITY                                    ","2003-2004",6,"Field hocky",84424,85442,-1018,0,0,0,84424,85442,-1018,".","18",0,27244
"5424",178059,"MARYVILLE UNIVERSITY OF SAINT LOUIS                         ","2003-2004",8,"Golf",7892,8914,-1022,7892,8914,-1022,0,0,0,"9",".",8759,0
"2609",113193,"CUESTA COLLEGE                                              ","2003-2004",2,"Basketball",23491,24515,-1024,13282,13577,-295,10209,10938,-729,"14","11",7281,4425
"7669",166850,"MERRIMACK COLLEGE                                           ","2003-2004",15,"Soccer",351811,352835,-1024,220578,219507,1071,131233,133328,-2095,"35","34",24187,26548
"9038",169974,"GLEN OAKS COMMUNITY COLLEGE                                 ","2003-2004",16,"Softball",39062,40089,-1027,0,0,0,39062,40089,-1027,".","14",0,15264
"4788",153296,"ELLSWORTH COMMUNITY COLLEGE                                 ","2003-2004",7,"Football",38911,39945,-1034,38911,39945,-1034,0,0,0,"65",".",27846,0
"1180",118976,"MODESTO JUNIOR COLLEGE                                      ","2003-2004",1,"Baseball",88190,89237,-1047,88190,89237,-1047,0,0,0,"33",".",8083,0
"1783",191968,"ITHACA COLLEGE                                              ","2003-2004",2,"Basketball",227736,228786,-1050,93257,94599,-1342,134479,134187,292,"14","15",27851,52099
"6157",155061,"FORT HAYS STATE UNIVERSITY                                  ","2003-2004",8,"Golf",24108,25159,-1051,19720,16762,2958,4388,8397,-4009,"9","7",12893,6401
"10828",212054,"DREXEL UNIVERSITY                                           ","2003-2004",22,"Tennis",158770,159828,-1058,102938,103501,-563,55832,56327,-495,"9","9",8835,7454
"15192",100654,"ALABAMA A &amp; M UNIVERSITY                                    ","2003-2004",33,"Bowling",41440,42498,-1058,0,0,0,41440,42498,-1058,".","11",0,15789
"3103",194091,"NEW YORK INSTITUTE OF TECHNOLOGY-OLD WESTBURY               ","2003-2004",2,"Basketball",489567,490627,-1060,265947,264175,1772,223620,226452,-2832,"14","11",41129,22348
"11999",143118,"AURORA UNIVERSITY                                           ","2003-2004",24,"Track and Field, Outdoor",32544,33607,-1063,16646,17162,-516,15898,16445,-547,"13","10",7743,7024
"15816",234164,"VIRGINIA UNION UNIVERSITY                                   ","2003-2004",39,"Total Participants",260828,261891,-1063,83208,86573,-3365,177620,175318,2302,"116","53",95652,43123
"1486",153922,"MARSHALLTOWN COMMUNITY COLLEGE                              ","2003-2004",1,"Baseball",49737,50802,-1065,49737,50802,-1065,0,0,0,"45",".",47026,0
"3178",211343,"BUTLER COUNTY COMMUNITY COLLEGE                             ","2003-2004",2,"Basketball",13865,14931,-1066,8118,8444,-326,5747,6487,-740,"14","8",6714,4757
"2455",151786,"MARIAN COLLEGE                                              ","2003-2004",2,"Basketball",281387,282454,-1067,152616,153676,-1060,128771,128778,-7,"14","15",15416,14771
"11150",186201,"RAMAPO COLLEGE OF NEW JERSEY                                ","2003-2004",22,"Tennis",21786,22854,-1068,9610,11383,-1773,12176,11471,705,"8","10",4983,5071
"626",177542,"HANNIBAL-LAGRANGE COLLEGE                                   ","2003-2004",1,"Baseball",106738,107808,-1070,106738,107808,-1070,0,0,0,"26",".",16658,0
"7586",149514,"TRINITY INTERNATIONAL UNIVERSITY                            ","2003-2004",15,"Soccer",643304,644376,-1072,269894,275061,-5167,373410,369315,4095,"23","27",22358,36339
"6202",189848,"CAZENOVIA COLLEGE                                           ","2003-2004",8,"Golf",8100,9175,-1075,8100,9175,-1075,0,0,0,"7","0",9075,0
"12188",172440,"FINLANDIA UNIVERSITY                                        ","2003-2004",25,"Track and Field, X-Country",17434,18510,-1076,8717,8775,-58,8717,9735,-1018,"5","8",1575,2205
"16336",211477,"CENTRAL PENNSYLVANIA COLLEGE                                ","2003-2004",39,"Total Participants",17600,18677,-1077,9850,8974,876,7750,9703,-1953,"26","24",6321,15343
"10346",113333,"DE ANZA COLLEGE                                             ","2003-2004",18,"Swimming and Diving",28690,29769,-1079,14345,15640,-1295,14345,14129,216,"10","11",3995,2484
"13202",182670,"DARTMOUTH COLLEGE                                           ","2003-2004",26,"Volleyball",187159,188256,-1097,0,0,0,187159,188256,-1097,".","13",0,43612
"374",199768,"SURRY COMMUNITY COLLEGE                                     ","2003-2004",1,"Baseball",19528,20626,-1098,19528,20626,-1098,0,0,0,"25",".",15062,0
"900",179867,"WASHINGTON UNIVERSITY IN ST LOUIS                           ","2003-2004",1,"Baseball",74266,75364,-1098,74266,75364,-1098,0,0,0,"34",".",30772,0
"15435",199768,"SURRY COMMUNITY COLLEGE                                     ","2003-2004",39,"Total Participants",27080,28178,-1098,19528,20626,-1098,7552,7552,0,"35","9",21168,3522
"12277",214740,"PENNSYLVANIA STATE UNIVERSITY-PENN STATE DUBOIS             ","2003-2004",25,"Track and Field, X-Country",1377,2476,-1099,861,1548,-687,516,928,-412,"5","3",861,516
"14469",204200,"COLLEGE OF MOUNT SAINT JOSEPH                               ","2003-2004",26,"Volleyball",65980,67079,-1099,0,0,0,65980,67079,-1099,".","12",0,22996
"5606",121901,"RIVERSIDE COMMUNITY COLLEGE                                 ","2003-2004",8,"Golf",4000,5100,-1100,4000,5100,-1100,0,0,0,"10",".",3500,0
"8169",195234,"THE COLLEGE OF SAINT ROSE                                   ","2003-2004",15,"Soccer",426328,427432,-1104,183735,184837,-1102,242593,242595,-2,"23","26",22964,22530
"3979",110680,"UNIVERSITY OF CALIFORNIA-SAN DIEGO                          ","2003-2004",5,"Fencing",68330,69436,-1106,34515,34500,15,33815,34936,-1121,"15","17",18143,18589
"16263",117724,"LOS ANGELES TRADE TECHNICAL COLLEGE                         ","2003-2004",39,"Total Participants",37887,39000,-1113,17197,17500,-303,20690,21500,-810,"68","45",29333,21010
"14126",237181,"BETHANY COLLEGE                                             ","2003-2004",26,"Volleyball",16480,17599,-1119,0,0,0,16480,17599,-1119,".","15",0,10995
"13855",190044,"CLARKSON UNIVERSITY                                         ","2003-2004",26,"Volleyball",49689,50812,-1123,0,0,0,49689,50812,-1123,".","12",0,26136
"3911",169798,"EASTERN MICHIGAN UNIVERSITY                                 ","2003-2004",3,"All Track Combined",885138,886262,-1124,432352,419361,12991,452786,466901,-14115,"58","37",60136,61199
"13723",149514,"TRINITY INTERNATIONAL UNIVERSITY                            ","2003-2004",26,"Volleyball",134832,135959,-1127,0,0,0,134832,135959,-1127,"0","13",0,12651
"5643",143118,"AURORA UNIVERSITY                                           ","2003-2004",8,"Golf",16578,17706,-1128,11316,12479,-1163,5262,5227,35,"7","2",5879,427
"5503",175421,"BELHAVEN COLLEGE                                            ","2003-2004",8,"Golf",37380,38511,-1131,37380,38511,-1131,0,0,0,"7",".",7652,0
"13004",141185,"TOCCOA FALLS COLLEGE                                        ","2003-2004",26,"Volleyball",20330,21463,-1133,0,0,0,20330,21463,-1133,".","10",0,10768
"12958",217059,"YORK COLLEGE PENNSYLVANIA                                   ","2003-2004",25,"Track and Field, X-Country",64647,65781,-1134,32323,32250,73,32324,33531,-1207,"35","33",12450,13731
"15939",228787,"THE UNIVERSITY OF TEXAS AT DALLAS                           ","2003-2004",39,"Total Participants",136724,137863,-1139,70812,72666,-1854,65912,65197,715,"106","80",97674,90876
"14034",138293,"WEBBER INTERNATIONAL UNIVERSITY                             ","2003-2004",26,"Volleyball",76426,77568,-1142,0,0,0,76426,77568,-1142,".","14",0,10922
"9976",182980,"NEW ENGLAND COLLEGE                                         ","2003-2004",16,"Softball",43664,44810,-1146,0,0,0,43664,44810,-1146,".","14",0,9405
"11346",186584,"SETON HALL UNIVERSITY                                       ","2003-2004",22,"Tennis",303373,304520,-1147,0,0,0,303373,304520,-1147,".","8",0,25913
"11259",215929,"UNIVERSITY OF SCRANTON                                      ","2003-2004",22,"Tennis",26153,27302,-1149,12903,13915,-1012,13250,13387,-137,"13","11",5688,6076
"10600",239628,"RIPON COLLEGE                                               ","2003-2004",19,"Swimming",10500,11650,-1150,5250,5825,-575,5250,5825,-575,"15","19",5250,5250
"12040",199281,"UNIVERSITY OF NORTH CAROLINA AT PEMBROKE                    ","2003-2004",24,"Track and Field, Outdoor",20989,22143,-1154,10782,10708,74,10207,11435,-1228,"30","11",6966,8278
"14713",118976,"MODESTO JUNIOR COLLEGE                                      ","2003-2004",27,"Water Polo",68152,69309,-1157,55196,55998,-802,12956,13311,-355,"14","12",5487,5161
"8105",140234,"LAGRANGE COLLEGE                                            ","2003-2004",15,"Soccer",92760,93920,-1160,46380,47785,-1405,46380,46135,245,"18","14",20500,20500
"7753",119216,"MT SAN JACINTO COLLEGE                                      ","2003-2004",15,"Soccer",19025,20192,-1167,0,0,0,19025,20192,-1167,".","18",0,8116
"11457",202514,"DEFIANCE COLLEGE                                            ","2003-2004",22,"Tennis",14930,16097,-1167,8302,9727,-1425,6628,6370,258,"8","9",7122,3555
"10996",144351,"CONCORDIA UNIVERSITY                                        ","2003-2004",22,"Tennis",5142,6319,-1177,2744,3577,-833,2398,2742,-344,"8","9",2120,1976
"6064",161086,"COLBY COLLEGE                                               ","2003-2004",8,"Golf",2433,3613,-1180,1235,1991,-756,1198,1622,-424,"13",".",1596,1352
"11021",153366,"GRACELAND UNIVERSITY-LAMONI                                 ","2003-2004",22,"Tennis",107373,108555,-1182,65764,66355,-591,41609,42200,-591,"11","12",4441,4441
"11621",186876,"THE RICHARD STOCKTON COLLEGE OF NEW JERSEY                  ","2003-2004",22,"Tennis",23778,24960,-1182,0,0,0,23778,24960,-1182,".","12",0,10813
"11705",162104,"CECIL COMMUNITY COLLEGE                                     ","2003-2004",22,"Tennis",553,1737,-1184,0,0,0,553,1737,-1184,".","3",0,695
"10069",191241,"FORDHAM UNIVERSITY                                          ","2003-2004",17,"Squash",9378,10563,-1185,9378,10563,-1185,0,0,0,"16","0",6121,0
"1012",138354,"THE UNIVERSITY OF WEST FLORIDA                              ","2003-2004",1,"Baseball",249836,251026,-1190,249836,251026,-1190,0,0,0,"30",".",55619,0
"15514",199281,"UNIVERSITY OF NORTH CAROLINA AT PEMBROKE                    ","2003-2004",39,"Total Participants",278179,279376,-1197,151759,148999,2760,126420,130377,-3957,"162","94",152199,138880
"773",201964,"CIRCLEVILLE BIBLE COLLEGE                                   ","2003-2004",1,"Baseball",4229,5429,-1200,4229,5429,-1200,0,0,0,"13",".",4229,0
"1098",173452,"MARTIN LUTHER COLLEGE                                       ","2003-2004",1,"Baseball",7000,8200,-1200,7000,8200,-1200,0,0,0,"20",".",6700,0
"5716",211927,"DELAWARE COUNTY COMMUNITY COLLEGE                           ","2003-2004",8,"Golf",2000,3200,-1200,1000,1600,-600,1000,1600,-600,"1",".",200,0
"5848",153621,"IOWA WESLEYAN COLLEGE                                       ","2003-2004",8,"Golf",7971,9171,-1200,4222,5222,-1000,3749,3949,-200,"6","6",4222,3749
"9414",216825,"WESTMORELAND COUNTY COMMUNITY COLLEGE                       ","2003-2004",16,"Softball",3500,4700,-1200,0,0,0,3500,4700,-1200,".","14",0,2100
"10299",114716,"FOOTHILL COLLEGE                                            ","2003-2004",18,"Swimming and Diving",7250,8450,-1200,3000,4064,-1064,4250,4386,-136,"8","6",2814,4286
"10801",146418,"KISHWAUKEE COLLEGE                                          ","2003-2004",22,"Tennis",3581,4781,-1200,0,0,0,3581,4781,-1200,".","7",0,2246
"14451",201964,"CIRCLEVILLE BIBLE COLLEGE                                   ","2003-2004",26,"Volleyball",6115,7315,-1200,0,0,0,6115,7315,-1200,".","11",0,6115
"567",216287,"SWARTHMORE COLLEGE                                          ","2003-2004",1,"Baseball",14750,15951,-1201,14750,15951,-1201,0,0,0,"17",".",15766,0
"1252",177940,"LINCOLN UNIVERSITY                                          ","2003-2004",1,"Baseball",81730,82935,-1205,81730,82935,-1205,0,0,0,"21",".",31341,0
"430",240338,"WISCONSIN LUTHERAN COLLEGE                                  ","2003-2004",1,"Baseball",44677,45884,-1207,44677,45884,-1207,0,0,0,"14",".",28343,0
"7560",224554,"TEXAS A &amp; M UNIVERSITY-COMMERCE                             ","2003-2004",15,"Soccer",38792,40000,-1208,0,0,0,38792,40000,-1208,".","20",0,38791
"7624",112190,"CITY COLLEGE OF SAN FRANCISCO                               ","2003-2004",15,"Soccer",13102,14312,-1210,13102,14312,-1210,0,0,0,"25",".",7724,0
"15233",131520,"HOWARD UNIVERSITY                                           ","2003-2004",33,"Bowling",112605,113815,-1210,0,0,0,112605,113815,-1210,".","6",0,14000
"13317",149781,"WHEATON COLLEGE                                             ","2003-2004",26,"Volleyball",77471,78685,-1214,0,0,0,77471,78685,-1214,".","12",0,19736
"13815",183822,"BLOOMFIELD COLLEGE                                          ","2003-2004",26,"Volleyball",8000,9218,-1218,0,0,0,8000,9218,-1218,".","8",0,8000
"11241",173665,"HAMLINE UNIVERSITY                                          ","2003-2004",22,"Tennis",29748,30969,-1221,15217,16599,-1382,14531,14370,161,"13","10",9678,4048
"161",174473,"NORTHLAND COMMUNITY AND TECHNICAL COLLEGE                   ","2003-2004",1,"Baseball",18563,19790,-1227,18563,19790,-1227,0,0,0,"21",".",19284,0
"1068",155520,"MIDAMERICA NAZARENE UNIVERSITY                              ","2003-2004",1,"Baseball",124445,125680,-1235,124445,125680,-1235,0,0,0,"30",".",34391,0
"11772",145619,"BENEDICTINE UNIVERSITY                                      ","2003-2004",22,"Tennis",15323,16562,-1239,0,0,0,15323,16562,-1239,".","8",0,748
"1565",137564,"SOUTHEASTERN COLLEGE ASSEMBLIES OF GOD                      ","2003-2004",1,"Baseball",15750,17000,-1250,15750,17000,-1250,0,0,0,"19",".",15500,0
"7892",111188,"CALIFORNIA MARITIME ACADEMY                                 ","2003-2004",15,"Soccer",21200,22459,-1259,21200,22459,-1259,0,0,0,"18",".",15326,0
"11791",125727,"WESTMONT COLLEGE                                            ","2003-2004",22,"Tennis",114765,116030,-1265,52918,55476,-2558,61847,60554,1293,"10","8",10199,7438
"15822",153922,"MARSHALLTOWN COMMUNITY COLLEGE                              ","2003-2004",39,"Total Participants",119508,120775,-1267,73059,74149,-1090,46449,46626,-177,"85","38",87462,64296
"349",104346,"CENTRAL ARIZONA COLLEGE                                     ","2003-2004",1,"Baseball",156775,158045,-1270,156775,158045,-1270,0,0,0,"33",".",41803,0
"8143",150941,"HUNTINGTON COLLEGE                                          ","2003-2004",15,"Soccer",116476,117750,-1274,57787,60354,-2567,58689,57396,1293,"20","16",9660,11646
"10955",176053,"MISSISSIPPI COLLEGE                                         ","2003-2004",22,"Tennis",77720,78998,-1278,58638,41187,17451,19082,37811,-18729,"9","6",22104,18728
"5804",121619,"SANTA ANA COLLEGE                                           ","2003-2004",8,"Golf",9000,10281,-1281,4500,6272,-1772,4500,4009,491,"13","7",4986,3106
"14216",118976,"MODESTO JUNIOR COLLEGE                                      ","2003-2004",26,"Volleyball",26585,27868,-1283,0,0,0,26585,27868,-1283,".","11",0,7324
"1429",186876,"THE RICHARD STOCKTON COLLEGE OF NEW JERSEY                  ","2003-2004",1,"Baseball",72766,74054,-1288,72766,74054,-1288,0,0,0,"24",".",54088,0
"10086",130697,"WESLEYAN UNIVERSITY                                         ","2003-2004",17,"Squash",58062,59350,-1288,0,0,0,58062,59350,-1288,".","15",0,6008
"13368",198695,"HIGH POINT UNIVERSITY                                       ","2003-2004",26,"Volleyball",240038,241335,-1297,0,0,0,240038,241335,-1297,".","11",0,31925
"711",178369,"MISSOURI VALLEY COLLEGE                                     ","2003-2004",1,"Baseball",15700,17000,-1300,15700,17000,-1300,0,0,0,"35",".",13300,0
"9064",220701,"MARTIN METHODIST COLLEGE                                    ","2003-2004",16,"Softball",192982,194282,-1300,0,0,0,192982,194282,-1300,".","16",0,29872
"13090",106306,"ARKANSAS BAPTIST COLLEGE                                    ","2003-2004",26,"Volleyball",3700,5000,-1300,0,0,0,3700,5000,-1300,"0","8",0,5000
"14459",216825,"WESTMORELAND COUNTY COMMUNITY COLLEGE                       ","2003-2004",26,"Volleyball",2500,3800,-1300,0,0,0,2500,3800,-1300,".","11",0,1320
"15656",106306,"ARKANSAS BAPTIST COLLEGE                                    ","2003-2004",39,"Total Participants",3700,5000,-1300,0,0,0,3700,5000,-1300,"12","20",15000,20000
"14227",165866,"FRAMINGHAM STATE COLLEGE                                    ","2003-2004",26,"Volleyball",12940,14244,-1304,0,0,0,12940,14244,-1304,".","11",0,6812
"1191",164173,"VILLA JULIE COLLEGE                                         ","2003-2004",1,"Baseball",31265,32573,-1308,31265,32573,-1308,0,0,0,"21",".",19690,0
"2582",153922,"MARSHALLTOWN COMMUNITY COLLEGE                              ","2003-2004",2,"Basketball",74871,76181,-1310,44071,45020,-949,30800,31161,-361,"12","12",21833,23589
"8348",117140,"UNIVERSITY OF LA VERNE                                      ","2003-2004",15,"Soccer",94396,95712,-1316,38059,36468,1591,56337,59244,-2907,"15","17",13201,17295
"9738",240329,"UNIVERSITY OF WISCONSIN-LA CROSSE                           ","2003-2004",16,"Softball",41332,42655,-1323,0,0,0,41332,42655,-1323,".","18",0,21239
"4220",166391,"LASELL COLLEGE                                              ","2003-2004",6,"Field hocky",24981,26305,-1324,0,0,0,24981,26305,-1324,".","24",0,16249
"1380",208035,"WESTERN OKLAHOMA STATE COLLEGE                              ","2003-2004",1,"Baseball",92853,94183,-1330,92853,94183,-1330,0,0,0,"30",".",32975,0
"2570",184694,"FAIRLEIGH DICKINSON UNIVERSITY-COLLEGE AT FLORHAM           ","2003-2004",2,"Basketball",108361,109691,-1330,54224,53570,654,54137,56121,-1984,"19","13",22182,17520
"1091",117751,"THE MASTER'S COLLEGE AND SEMINARY                           ","2003-2004",1,"Baseball",205205,206540,-1335,205205,206540,-1335,0,0,0,"22",".",39312,0
"11473",213367,"LA SALLE UNIVERSITY                                         ","2003-2004",22,"Tennis",83673,85013,-1340,36414,37084,-670,47259,47929,-670,"8","10",13577,8433
"5212",191986,"JAMESTOWN COMMUNITY COLLEGE                                 ","2003-2004",8,"Golf",8007,9350,-1343,7857,8350,-493,150,1000,-850,"9","0",4769,150
"4227",163268,"UNIVERSITY OF MARYLAND-BALTIMORE COUNTY                     ","2003-2004",6,"Field hocky",54214,55559,-1345,0,0,0,54214,55559,-1345,".","23",0,23955
"13885",210401,"WILLAMETTE UNIVERSITY                                       ","2003-2004",26,"Volleyball",61085,62431,-1346,0,0,0,61085,62431,-1346,".","18",0,15457
"1343",133979,"FLORIDA MEMORIAL COLLEGE                                    ","2003-2004",1,"Baseball",64470,65820,-1350,64470,65820,-1350,0,0,0,"26",".",20700,0
"10087",195526,"SKIDMORE COLLEGE                                            ","2003-2004",18,"Swimming and Diving",60710,62062,-1352,24075,24526,-451,36635,37536,-901,"9","18",13009,26019
"10291",171456,"NORTHERN MICHIGAN UNIVERSITY                                ","2003-2004",18,"Swimming and Diving",331330,332682,-1352,0,0,0,331330,332682,-1352,"0","13",0,44374
"12308",150604,"FRANKLIN COLLEGE                                            ","2003-2004",25,"Track and Field, X-Country",97022,98376,-1354,48511,49188,-677,48511,49188,-677,"26","41",29188,29188
"3541",178411,"UNIVERSITY OF MISSOURI-ROLLA                                ","2003-2004",3,"All Track Combined",175261,176616,-1355,96081,97046,-965,79180,79570,-390,"41","27",33907,24780
"14210",105899,"SOUTHWESTERN CONSERVATIVE BAPTIST BIBLE COLLEGE             ","2003-2004",26,"Volleyball",21700,23059,-1359,0,0,0,21700,23059,-1359,".","13",0,16931
"16004",105899,"SOUTHWESTERN CONSERVATIVE BAPTIST BIBLE COLLEGE             ","2003-2004",39,"Total Participants",21700,23059,-1359,0,0,0,21700,23059,-1359,"17","23",40887,23881
"3715",172051,"SAGINAW VALLEY STATE UNIVERSITY                             ","2003-2004",3,"All Track Combined",217505,218868,-1363,126034,126784,-750,91471,92084,-613,"68","38",51605,37144
"5888",240189,"UNIVERSITY OF WISCONSIN-WHITEWATER                          ","2003-2004",8,"Golf",21308,22680,-1372,0,0,0,21308,22680,-1372,".","7",0,10592
"6718",215743,"SAINT FRANCIS UNIVERSITY                                    ","2003-2004",11,"Lacrosse",112561,113941,-1380,0,0,0,112561,113941,-1380,".","16",0,25697
"1838",170301,"HOPE COLLEGE                                                ","2003-2004",2,"Basketball",306110,307492,-1382,186550,187932,-1382,119560,119560,0,"14","15",15420,15964
"14727",117140,"UNIVERSITY OF LA VERNE                                      ","2003-2004",27,"Water Polo",85239,86628,-1389,42334,42335,-1,42905,44293,-1388,"12","11",5358,6489
"14924",212577,"FRANKLIN AND MARSHALL COLLEGE                               ","2003-2004",28,"Wrestling",84454,85844,-1390,84454,85844,-1390,0,0,0,"18",".",22599,0
"6756",184694,"FAIRLEIGH DICKINSON UNIVERSITY-COLLEGE AT FLORHAM           ","2003-2004",11,"Lacrosse",85455,86851,-1396,38506,41030,-2524,46949,45821,1128,"32","17",17525,17576
"5687",199032,"MONTREAT COLLEGE                                            ","2003-2004",8,"Golf",5800,7199,-1399,5800,7199,-1399,0,0,0,"5","0",4199,0
"8813",178369,"MISSOURI VALLEY COLLEGE                                     ","2003-2004",16,"Softball",11400,12800,-1400,0,0,0,11400,12800,-1400,".","30",0,9199
"9084",155715,"PRATT COMMUNITY COLLEGE                                     ","2003-2004",16,"Softball",60572,61977,-1405,0,0,0,60572,61977,-1405,".","15",0,6180
"11998",182634,"COLBY-SAWYER COLLEGE                                        ","2003-2004",24,"Track and Field, Outdoor",40030,41436,-1406,20015,20718,-703,20015,20718,-703,"6","10",7773,7773
"10661",236610,"SHORELINE COMMUNITY COLLEGE                                 ","2003-2004",22,"Tennis",13914,15324,-1410,6957,7662,-705,6957,7662,-705,"7","8",3885,3885
"10621",199962,"WINGATE UNIVERSITY                                          ","2003-2004",19,"Swimming",19535,20961,-1426,0,0,0,19535,20961,-1426,".","20",0,15030
"15150",216287,"SWARTHMORE COLLEGE                                          ","2003-2004",31,"Badminton",2650,4077,-1427,0,0,0,2650,4077,-1427,".","16",0,3705
"10256",190099,"COLGATE UNIVERSITY                                          ","2003-2004",18,"Swimming and Diving",677971,679400,-1429,298852,296156,2696,379119,383244,-4125,"28","31",39279,40668
"4688",180522,"MONTANA STATE UNIVERSITY-NORTHERN                           ","2003-2004",7,"Football",242442,243873,-1431,242442,243873,-1431,0,0,0,"84",".",76553,0
"14832",204200,"COLLEGE OF MOUNT SAINT JOSEPH                               ","2003-2004",28,"Wrestling",53879,55312,-1433,53879,55312,-1433,0,0,0,"23",".",27016,0
"7012",186131,"PRINCETON UNIVERSITY                                        ","2003-2004",13,"Rowing",853898,855332,-1434,435207,435891,-684,418691,419441,-750,"97","89",161941,161584
"11731",243142,"UNIVERSITY OF PUERTO RICO IN CAROLINA                       ","2003-2004",22,"Tennis",1620,3060,-1440,810,1530,-720,810,1530,-720,"4","4",1480,1480
"1903",186399,"RUTGERS UNIVERSITY-NEWARK                                   ","2003-2004",2,"Basketball",141732,143175,-1443,92524,94780,-2256,49208,48395,813,"17","10",19885,11308
"14989",153278,"UNIVERSITY OF DUBUQUE                                       ","2003-2004",28,"Wrestling",71260,72703,-1443,71260,72703,-1443,0,0,0,"38",".",27525,0
"9371",138558,"ABRAHAM BALDWIN AGRICULTURAL COLLEGE                        ","2003-2004",16,"Softball",69162,70615,-1453,0,0,0,69162,70615,-1453,".","17",0,56162
"8918",199281,"UNIVERSITY OF NORTH CAROLINA AT PEMBROKE                    ","2003-2004",16,"Softball",42596,44050,-1454,0,0,0,42596,44050,-1454,".","23",0,27760
"10103",182634,"COLBY-SAWYER COLLEGE                                        ","2003-2004",18,"Swimming and Diving",63488,64945,-1457,31489,32223,-734,31999,32722,-723,"4","29",9096,9096
"13289",158802,"DILLARD UNIVERSITY                                          ","2003-2004",26,"Volleyball",189174,190636,-1462,0,0,0,189174,190636,-1462,"0","15",0,12709
"6343",216764,"WEST CHESTER UNIVERSITY OF PENNSYLVANIA                     ","2003-2004",9,"Gymnastics",18085,19550,-1465,0,0,0,18085,19550,-1465,".","10",0,17719
"13476",215442,"POINT PARK UNIVERSITY                                       ","2003-2004",26,"Volleyball",105122,106589,-1467,0,0,0,105122,106589,-1467,".","13",0,11822
"12869",131469,"GEORGE WASHINGTON UNIVERSITY                                ","2003-2004",25,"Track and Field, X-Country",213442,214913,-1471,111556,112423,-867,101886,102490,-604,"13","20",6446,7832
"2495",152248,"PURDUE UNIVERSITY-CALUMET CAMPUS                            ","2003-2004",2,"Basketball",109516,111005,-1489,54379,54135,244,55137,56870,-1733,"15","10",54135,56870
"7784",191968,"ITHACA COLLEGE                                              ","2003-2004",15,"Soccer",161507,162999,-1492,67952,76216,-8264,93555,86783,6772,"24","25",32887,30730
"12037",191968,"ITHACA COLLEGE                                              ","2003-2004",24,"Track and Field, Outdoor",80554,82049,-1495,40914,41740,-826,39640,40309,-669,"45","55",19005,25384
"1358",190169,"COLUMBIA-GREENE COMMUNITY COLLEGE                           ","2003-2004",1,"Baseball",24000,25500,-1500,24000,25500,-1500,0,0,0,"17",".",25000,0
"1482",207050,"EASTERN OKLAHOMA STATE COLLEGE                              ","2003-2004",1,"Baseball",84000,85500,-1500,84000,85500,-1500,0,0,0,"29",".",82500,0
"5654",196565,"TOMPKINS-CORTLAND COMMUNITY COLLEGE                         ","2003-2004",8,"Golf",7838,9338,-1500,3919,4669,-750,3919,4669,-750,"10","3",4304,1844
"6165",118541,"MARYMOUNT COLLEGE                                           ","2003-2004",8,"Golf",1500,3000,-1500,1500,3000,-1500,0,0,0,"10","0",1500,0
"11485",140234,"LAGRANGE COLLEGE                                            ","2003-2004",22,"Tennis",14500,16000,-1500,7250,8000,-750,7250,8000,-750,"12","6",4000,4000
"13408",218919,"VOORHEES COLLEGE                                            ","2003-2004",26,"Volleyball",7000,8500,-1500,0,0,0,7000,8500,-1500,".","10",0,7000
"14494",220604,"LE MOYNE-OWEN COLLEGE                                       ","2003-2004",26,"Volleyball",49000,50500,-1500,0,0,0,49000,50500,-1500,"0","12",0,49000
"17195",196565,"TOMPKINS-CORTLAND COMMUNITY COLLEGE                         ","2003-2004",39,"Total Participants",66562,68062,-1500,20840,21590,-750,45722,46472,-750,"43","57",26101,42052
"4076",184694,"FAIRLEIGH DICKINSON UNIVERSITY-COLLEGE AT FLORHAM           ","2003-2004",6,"Field hocky",58952,60459,-1507,0,0,0,58952,60459,-1507,".","27",0,23580
"1119",236887,"WALLA WALLA COMMUNITY COLLEGE                               ","2003-2004",1,"Baseball",35000,36512,-1512,35000,36512,-1512,0,0,0,"35",".",25012,0
"12450",183211,"RIVIER COLLEGE                                              ","2003-2004",25,"Track and Field, X-Country",500,2016,-1516,250,1008,-758,250,1008,-758,"8","9",1008,1008
"15308",207290,"NORTHEASTERN OKLAHOMA AGRICULTURAL AND MECH COLL            ","2003-2004",35,"Rodeo",11600,13120,-1520,5800,6560,-760,5800,6560,-760,"25",".",5050,5050
"5771",113980,"EL CAMINO COLLEGE                                           ","2003-2004",8,"Golf",11704,13230,-1526,11704,13230,-1526,0,0,0,"8",".",6526,0
"9222",196167,"SUNY COLLEGE AT GENESEO                                     ","2003-2004",16,"Softball",58440,59967,-1527,0,0,0,58440,59967,-1527,".","17",0,39986
"7239",204024,"MIAMI UNIVERSITY-OXFORD                                     ","2003-2004",15,"Soccer",607886,609416,-1530,0,0,0,607886,609416,-1530,".","33",0,120977
"5181",107044,"HARDING UNIVERSITY                                          ","2003-2004",8,"Golf",12680,14218,-1538,12680,14218,-1538,0,0,0,"9",".",14152,0
"6183",172264,"SIENA HEIGHTS UNIVERSITY                                    ","2003-2004",8,"Golf",7179,8725,-1546,7179,8725,-1546,0,0,0,"11",".",5700,0
"14773",178369,"MISSOURI VALLEY COLLEGE                                     ","2003-2004",28,"Wrestling",64200,65750,-1550,32300,33030,-730,31900,32720,-820,"33","29",29070,29098
"11515",219471,"UNIVERSITY OF SOUTH DAKOTA                                  ","2003-2004",22,"Tennis",5420,6974,-1554,0,0,0,5420,6974,-1554,".","10",0,3183
"13584",209825,"UNIVERSITY OF PORTLAND                                      ","2003-2004",26,"Volleyball",459468,461023,-1555,0,0,0,459468,461023,-1555,"0","15",0,88136
"12810",198862,"LIVINGSTONE COLLEGE                                         ","2003-2004",25,"Track and Field, X-Country",167473,169042,-1569,83815,83165,650,83658,85877,-2219,"17","11",17,13365
"5812",153472,"INDIAN HILLS COMMUNITY COLLEGE                              ","2003-2004",8,"Golf",64141,65719,-1578,64141,65719,-1578,0,0,0,"9",".",20471,0
"10720",235097,"EASTERN WASHINGTON UNIVERSITY                               ","2003-2004",22,"Tennis",147261,148839,-1578,56111,39074,17037,91150,109765,-18615,"7","12",8995,16897
"15243",167996,"STONEHILL COLLEGE                                           ","2003-2004",34,"Equestrian",37798,39376,-1578,0,0,0,37798,39376,-1578,".","36",0,27211
"7476",237792,"SHEPHERD COLLEGE                                            ","2003-2004",15,"Soccer",126494,128087,-1593,60869,61695,-826,65625,66392,-767,"23","22",18784,23809
"13351",211024,"BAPTIST BIBLE COLLEGE AND SEMINARY                          ","2003-2004",26,"Volleyball",20231,21829,-1598,8108,8108,0,12123,13721,-1598,"18","22",6908,11921
"13760",155681,"PITTSBURG STATE UNIVERSITY                                  ","2003-2004",26,"Volleyball",156993,158592,-1599,0,0,0,156993,158592,-1599,".","15",0,23386
"5947",179946,"WESTMINSTER COLLEGE                                         ","2003-2004",8,"Golf",5400,7000,-1600,2700,3500,-800,2700,3500,-800,"10","5",2500,2500
"7979",194569,"PRACTICAL BIBLE COLLEGE                                     ","2003-2004",15,"Soccer",6809,8409,-1600,6809,8409,-1600,0,0,0,"20",".",6809,0
"13070",111188,"CALIFORNIA MARITIME ACADEMY                                 ","2003-2004",26,"Volleyball",18000,19600,-1600,0,0,0,18000,19600,-1600,".","12",0,8233
"14533",181765,"NEBRASKA COLLEGE OF TECHNICAL AGRICULTURE                   ","2003-2004",26,"Volleyball",2100,3700,-1600,0,0,0,2100,3700,-1600,".","8",0,2100
"991",206604,"WRIGHT STATE UNIVERSITY-MAIN CAMPUS                         ","2003-2004",1,"Baseball",347230,348832,-1602,347230,348832,-1602,0,0,0,"34",".",105064,0
"12896",121886,"RIO HONDO COLLEGE                                           ","2003-2004",25,"Track and Field, X-Country",13876,15484,-1608,4188,7742,-3554,9688,7742,1946,"3","8",3195,3195
"500",215929,"UNIVERSITY OF SCRANTON                                      ","2003-2004",1,"Baseball",38127,39738,-1611,38127,39738,-1611,0,0,0,"37",".",18741,0
"644",109208,"AMERICAN RIVER COLLEGE                                      ","2003-2004",1,"Baseball",14315,15944,-1629,14315,15944,-1629,0,0,0,"30",".",12349,0
"9722",169275,"MOTT COMMUNITY COLLEGE                                      ","2003-2004",16,"Softball",4000,5637,-1637,0,0,0,4000,5637,-1637,".","16",0,4637
"9005",233541,"SHENANDOAH UNIVERSITY                                       ","2003-2004",16,"Softball",50404,52043,-1639,0,0,0,50404,52043,-1639,".","13",0,21421
"3977",118347,"COLLEGE OF MARIN                                            ","2003-2004",4,"Diving",100,1741,-1641,50,1451,-1401,50,290,-240,"1","0",571,285
"6992",169798,"EASTERN MICHIGAN UNIVERSITY                                 ","2003-2004",13,"Rowing",398543,400187,-1644,0,0,0,398543,400187,-1644,".","72",0,84319
"8632",181312,"MID PLAINS COMMUNITY COLLEGE AREA                           ","2003-2004",16,"Softball",45560,47204,-1644,0,0,0,45560,47204,-1644,".","18",0,20042
"11576",110246,"BUTTE COLLEGE                                               ","2003-2004",22,"Tennis",14897,16547,-1650,7448,10875,-3427,7449,5672,1777,"14","5",10007,5671
"2309",229267,"TRINITY UNIVERSITY                                          ","2003-2004",2,"Basketball",244797,246451,-1654,131777,131273,504,113020,115178,-2158,"16","16",65987,65695
"6340",175272,"WINONA STATE UNIVERSITY                                     ","2003-2004",9,"Gymnastics",75223,76877,-1654,0,0,0,75223,76877,-1654,".","10",0,8114
"8128",119331,"NAPA VALLEY COLLEGE                                         ","2003-2004",15,"Soccer",20726,22382,-1656,20726,22382,-1656,0,0,0,"23",".",4781,0
"4595",237385,"GLENVILLE STATE COLLEGE                                     ","2003-2004",7,"Football",343689,345347,-1658,343689,345347,-1658,0,0,0,"80",".",63271,0
"14132",235316,"GONZAGA UNIVERSITY                                          ","2003-2004",26,"Volleyball",552150,553809,-1659,0,0,0,552150,553809,-1659,".","19",0,98540
"5200",200846,"UNIVERSITY OF AKRON-WAYNE COLLEGE                           ","2003-2004",8,"Golf",5000,6660,-1660,5000,6660,-1660,0,0,0,"5",".",785,0
"10721",230931,"LYNDON STATE COLLEGE                                        ","2003-2004",22,"Tennis",3238,4898,-1660,975,2347,-1372,2263,2551,-288,"8","7",2346,2550
"15412",243142,"UNIVERSITY OF PUERTO RICO IN CAROLINA                       ","2003-2004",38,"Weight Lifting",6670,8332,-1662,3500,4362,-862,3170,3970,-800,"12","11",2046,1860
"14191",107044,"HARDING UNIVERSITY                                          ","2003-2004",26,"Volleyball",30066,31731,-1665,0,0,0,30066,31731,-1665,".","14",0,27836
"5378",114716,"FOOTHILL COLLEGE                                            ","2003-2004",8,"Golf",10781,12449,-1668,4340,3908,432,6441,8541,-2100,"8","9",3708,7550
"14440",161688,"ALLEGANY COLLEGE OF MARYLAND                                ","2003-2004",26,"Volleyball",18147,19816,-1669,0,0,0,18147,19816,-1669,".","10",0,3600
"739",122339,"SAN DIEGO CITY COLLEGE                                      ","2003-2004",1,"Baseball",46460,48132,-1672,46460,48132,-1672,0,0,0,"29",".",11967,0
"10895",182634,"COLBY-SAWYER COLLEGE                                        ","2003-2004",22,"Tennis",48258,49933,-1675,24031,24728,-697,24227,25205,-978,"9","12",10218,10689
"15184",190840,"DUTCHESS COMMUNITY COLLEGE                                  ","2003-2004",33,"Bowling",4200,5875,-1675,4200,5875,-1675,0,0,0,"8",".",3250,0
"17348",190840,"DUTCHESS COMMUNITY COLLEGE                                  ","2003-2004",39,"Total Participants",68850,70525,-1675,42650,44325,-1675,26200,26200,0,"108","43",24250,15500
"12871",217518,"ROGER WILLIAMS UNIVERSITY                                   ","2003-2004",25,"Track and Field, X-Country",29004,30684,-1680,13748,14150,-402,15256,16534,-1278,"15","18",7333,8731
"10968",195216,"ST LAWRENCE UNIVERSITY                                      ","2003-2004",22,"Tennis",66128,67812,-1684,33064,33906,-842,33064,33906,-842,"11","12",8127,8127
"6819",182634,"COLBY-SAWYER COLLEGE                                        ","2003-2004",11,"Lacrosse",27861,29553,-1692,0,0,0,27861,29553,-1692,".","16",0,10942
"7201",214652,"PENNSYLVANIA STATE UNIV-PENN ST WORTHINGTON SCRNTN          ","2003-2004",15,"Soccer",7500,9200,-1700,7500,9200,-1700,0,0,0,"18",".",700,0
"14335",191649,"HOFSTRA UNIVERSITY                                          ","2003-2004",26,"Volleyball",612821,614524,-1703,0,0,0,612821,614524,-1703,".","13",0,105399
"12622",175421,"BELHAVEN COLLEGE                                            ","2003-2004",25,"Track and Field, X-Country",25625,27329,-1704,9562,10414,-852,16063,16915,-852,"5","9",5463,5463
"15414",243443,"UNIVERSITY OF SACRED HEART                                  ","2003-2004",38,"Weight Lifting",8664,10373,-1709,1707,3415,-1708,6957,6958,-1,"2","3",3414,6957
"13233",185129,"NEW JERSEY CITY UNIVERSITY                                  ","2003-2004",26,"Volleyball",19000,20711,-1711,9500,10496,-996,9500,10215,-715,"9","11",8149,5788
"14213",219833,"CHRISTIAN BROTHERS UNIVERSITY                               ","2003-2004",26,"Volleyball",13300,15013,-1713,0,0,0,13300,15013,-1713,".","9",0,14088
"1484",233541,"SHENANDOAH UNIVERSITY                                       ","2003-2004",1,"Baseball",61715,63436,-1721,61715,63436,-1721,0,0,0,"17",".",33016,0
"10692",228149,"ST MARYS UNIVERSITY                                         ","2003-2004",22,"Tennis",14325,16046,-1721,7037,8077,-1040,7288,7969,-681,"10","7",4944,5660
"14768",240189,"UNIVERSITY OF WISCONSIN-WHITEWATER                          ","2003-2004",28,"Wrestling",62761,64488,-1727,62761,64488,-1727,0,0,0,"29",".",20480,0
"6659",127918,"REGIS UNIVERSITY                                            ","2003-2004",11,"Lacrosse",96953,98694,-1741,0,0,0,96953,98694,-1741,".","20",0,29610
"7962",439288,"JOHNSON &amp; WALES UNIVERSITY-DENVER                           ","2003-2004",15,"Soccer",37966,39714,-1748,20135,22885,-2750,17831,16829,1002,"13","19",17885,11829
"11169",121619,"SANTA ANA COLLEGE                                           ","2003-2004",22,"Tennis",4500,6248,-1748,0,0,0,4500,6248,-1748,".","6",0,4462
"12921",162779,"HOWARD COMMUNITY COLLEGE                                    ","2003-2004",25,"Track and Field, X-Country",20940,22688,-1748,15422,15838,-416,5518,6850,-1332,"27","5",14194,4290
"13996",137564,"SOUTHEASTERN COLLEGE ASSEMBLIES OF GOD                      ","2003-2004",26,"Volleyball",13250,15000,-1750,13250,15000,-1750,0,0,0,"12","0",13250,0
"13616",148380,"ROCK VALLEY COLLEGE                                         ","2003-2004",26,"Volleyball",9000,10757,-1757,0,0,0,9000,10757,-1757,"0","12",0,5378
"13515",161299,"MAINE MARITIME ACADEMY                                      ","2003-2004",26,"Volleyball",4082,5840,-1758,0,0,0,4082,5840,-1758,".","7",0,4740
"13974",236577,"SEATTLE PACIFIC UNIVERSITY                                  ","2003-2004",26,"Volleyball",243060,244820,-1760,0,0,0,243060,244820,-1760,".","15",0,52983
"9029",138789,"ARMSTRONG ATLANTIC STATE UNIVERSITY                         ","2003-2004",16,"Softball",177021,178782,-1761,0,0,0,177021,178782,-1761,".","17",0,105304
"10527",237066,"WHITWORTH COLLEGE                                           ","2003-2004",19,"Swimming",100197,101963,-1766,47313,49981,-2668,52884,51982,902,"14","19",25416,30987
"2052",141185,"TOCCOA FALLS COLLEGE                                        ","2003-2004",2,"Basketball",41431,43199,-1768,20569,21704,-1135,20862,21495,-633,"12","10",10914,10874
"12422",211024,"BAPTIST BIBLE COLLEGE AND SEMINARY                          ","2003-2004",25,"Track and Field, X-Country",13756,15528,-1772,6878,7764,-886,6878,7764,-886,"12","12",5624,5624
"2738",222178,"ABILENE CHRISTIAN UNIVERSITY                                ","2003-2004",2,"Basketball",727502,729276,-1774,364916,369103,-4187,362586,360173,2413,"15","13",48190,53735
"12684",143118,"AURORA UNIVERSITY                                           ","2003-2004",25,"Track and Field, X-Country",22178,23952,-1774,11043,11990,-947,11135,11962,-827,"5","6",4080,4035
"7938",198154,"CAPE FEAR COMMUNITY COLLEGE                                 ","2003-2004",15,"Soccer",15000,16779,-1779,15000,16779,-1779,0,0,0,"20",".",10788,0
"6085",169974,"GLEN OAKS COMMUNITY COLLEGE                                 ","2003-2004",8,"Golf",16623,18404,-1781,16623,18404,-1781,0,0,0,"6",".",7431,0
"13056",178341,"MISSOURI SOUTHERN STATE UNIVERSITY                          ","2003-2004",26,"Volleyball",156366,158147,-1781,0,0,0,156366,158147,-1781,".","17",0,26056
"17263",194222,"ONONDAGA COMMUNITY COLLEGE                                  ","2003-2004",39,"Total Participants",122238,124025,-1787,70790,78933,-8143,51448,45092,6356,"77","31",69864,27224
"6293",146427,"KNOX COLLEGE                                                ","2003-2004",8,"Golf",27812,29600,-1788,16429,18679,-2250,11383,10921,462,"13","6",10151,8632
"15106",243188,"UNIVERSITY OF PUERTO RICO-UTUADO                            ","2003-2004",29,"Other Sports",200,1990,-1790,100,1205,-1105,100,785,-685,"2","2",107,107
"8053",190521,"CUNY BOROUGH OF MANHATTAN COMMUNITY COLLEGE                 ","2003-2004",15,"Soccer",21678,23473,-1795,21678,23473,-1795,0,0,0,"22",".",16823,0
"701",121901,"RIVERSIDE COMMUNITY COLLEGE                                 ","2003-2004",1,"Baseball",14000,15800,-1800,14000,15800,-1800,0,0,0,"35",".",14000,0
"7819",210146,"SOUTHERN OREGON UNIVERSITY                                  ","2003-2004",15,"Soccer",30707,32507,-1800,0,0,0,30707,32507,-1800,".","18",0,24007
"11199",211927,"DELAWARE COUNTY COMMUNITY COLLEGE                           ","2003-2004",22,"Tennis",2600,4400,-1800,1300,2200,-900,1300,2200,-900,"5",".",250,0
"979",231165,"VERMONT TECHNICAL COLLEGE                                   ","2003-2004",1,"Baseball",5205,7006,-1801,5205,7006,-1801,0,0,0,"13",".",5205,0
"11750",204635,"OHIO NORTHERN UNIVERSITY                                    ","2003-2004",22,"Tennis",36046,37876,-1830,17057,23473,-6416,18989,14403,4586,"8","9",7708,8851
"14609",121619,"SANTA ANA COLLEGE                                           ","2003-2004",26,"Volleyball",6500,8333,-1833,0,0,0,6500,8333,-1833,".","11",0,6763
"8669",161165,"HUSSON COLLEGE                                              ","2003-2004",16,"Softball",27245,29080,-1835,0,0,0,27245,29080,-1835,".","24",0,17191
"12401",240374,"UNIVERSITY OF WISCONSIN-PARKSIDE                            ","2003-2004",25,"Track and Field, X-Country",324785,326620,-1835,191328,193122,-1794,133457,133498,-41,"25","17",14008,11499
"11023",243106,"UNIVERSITY OF PUERTO RICO-AGUADILLA                         ","2003-2004",22,"Tennis",3493,5329,-1836,698,1066,-368,2795,4263,-1468,"1","4",795,3181
"5528",186131,"PRINCETON UNIVERSITY                                        ","2003-2004",8,"Golf",151916,153753,-1837,75880,76798,-918,76036,76955,-919,"11","9",41021,51423
"10271",145725,"ILLINOIS INSTITUTE OF TECHNOLOGY                            ","2003-2004",18,"Swimming and Diving",77962,79800,-1838,38981,39900,-919,38981,39900,-919,"13","6",8775,8775
"14788",232423,"JAMES MADISON UNIVERSITY                                    ","2003-2004",28,"Wrestling",95577,97430,-1853,95577,97430,-1853,0,0,0,"28",".",35243,0
"1888",240338,"WISCONSIN LUTHERAN COLLEGE                                  ","2003-2004",2,"Basketball",132187,134048,-1861,73255,75779,-2524,58932,58269,663,"14","12",26150,29228
"4517",148380,"ROCK VALLEY COLLEGE                                         ","2003-2004",7,"Football",24439,26305,-1866,24439,26305,-1866,0,0,0,"80",".",13152,0
"13720",240365,"UNIVERSITY OF WISCONSIN-OSHKOSH                             ","2003-2004",26,"Volleyball",109013,110880,-1867,0,0,0,109013,110880,-1867,".","14",0,22339
"3004",199485,"ROCKINGHAM COMMUNITY COLLEGE                                ","2003-2004",2,"Basketball",27845,29714,-1869,27845,29714,-1869,0,0,0,"15","0",18529,0
"353",117733,"LOS ANGELES VALLEY COLLEGE                                  ","2003-2004",1,"Baseball",32439,34309,-1870,32439,34309,-1870,0,0,0,"28",".",10850,0
"5165",174075,"UNIVERSITY OF MINNESOTA-CROOKSTON                           ","2003-2004",8,"Golf",56102,57978,-1876,18910,22349,-3439,37192,35629,1563,"15","5",15089,7437
"7319",202222,"COLUMBUS STATE COMMUNITY COLLEGE                            ","2003-2004",15,"Soccer",15750,17626,-1876,15750,17626,-1876,0,0,0,"15",".",8794,0
"1367",195526,"SKIDMORE COLLEGE                                            ","2003-2004",1,"Baseball",54680,56560,-1880,54680,56560,-1880,0,0,0,"21",".",32507,0
"8872",161545,"SOUTHERN MAINE COMMUNITY COLLEGE                            ","2003-2004",16,"Softball",8000,9900,-1900,0,0,0,8000,9900,-1900,".","11",0,9800
"9619",183822,"BLOOMFIELD COLLEGE                                          ","2003-2004",16,"Softball",9533,11433,-1900,0,0,0,9533,11433,-1900,".","13",0,9533
"10845",194310,"PACE UNIVERSITY-NEW YORK                                    ","2003-2004",22,"Tennis",113500,115405,-1905,52000,52000,0,61500,63405,-1905,"8","6",12083,11905
"14478",237330,"CONCORD COLLEGE                                             ","2003-2004",26,"Volleyball",51709,53615,-1906,0,0,0,51709,53615,-1906,".","12",0,9306
"6267",200341,"WILLISTON STATE COLLEGE                                     ","2003-2004",8,"Golf",6848,8765,-1917,6848,8765,-1917,0,0,0,"10",".",1065,0
"7667",164492,"ANNA MARIA COLLEGE                                          ","2003-2004",15,"Soccer",54485,56402,-1917,13105,14135,-1030,41380,42267,-887,"18","17",13105,41380
"9780",110246,"BUTTE COLLEGE                                               ","2003-2004",16,"Softball",29024,30945,-1921,0,0,0,29024,30945,-1921,".","12",0,23248
"9003",134495,"HILLSBOROUGH COMMUNITY COLLEGE                              ","2003-2004",16,"Softball",13501,15429,-1928,0,0,0,13501,15429,-1928,".","22",0,13501
"440",240365,"UNIVERSITY OF WISCONSIN-OSHKOSH                             ","2003-2004",1,"Baseball",77525,79455,-1930,77525,79455,-1930,0,0,0,"33",".",40823,0
"5113",199582,"SAINT AUGUSTINES COLLEGE                                    ","2003-2004",8,"Golf",51777,53711,-1934,51777,53711,-1934,0,0,0,"6",".",16543,0
"2679",122889,"SANTA BARBARA CITY COLLEGE                                  ","2003-2004",2,"Basketball",85128,87065,-1937,50419,53802,-3383,34709,33263,1446,"13","12",22341,12404
"4026",232423,"JAMES MADISON UNIVERSITY                                    ","2003-2004",6,"Field hocky",433555,435494,-1939,0,0,0,433555,435494,-1939,".","25",0,51659
"5509",219347,"SOUTH DAKOTA SCHOOL OF MINES AND TECHNOLOGY                 ","2003-2004",8,"Golf",5000,6939,-1939,3000,4058,-1058,2000,2881,-881,"8","5",3533,2536
"7101",240338,"WISCONSIN LUTHERAN COLLEGE                                  ","2003-2004",15,"Soccer",72425,74371,-1946,32707,34539,-1832,39718,39832,-114,"20","18",17776,21332
"15790",241410,"PONTIFICAL CATHOLIC UNIV OF PUERTO RICO-PONCE               ","2003-2004",39,"Total Participants",41649,43599,-1950,23400,24418,-1018,18249,19181,-932,"101","65",27097,18534
"11174",139861,"GEORGIA COLLEGE AND STATE UNIVERSITY                        ","2003-2004",22,"Tennis",117375,119328,-1953,52645,53664,-1019,64730,65664,-934,"9","7",15703,15100
"9298",236595,"SEATTLE UNIVERSITY                                          ","2003-2004",16,"Softball",129328,131288,-1960,0,0,0,129328,131288,-1960,".","20",0,42360
"10472",210401,"WILLAMETTE UNIVERSITY                                       ","2003-2004",19,"Swimming",52489,54449,-1960,26244,27224,-980,26245,27225,-980,"11","18",11324,11325
"16612",215442,"POINT PARK UNIVERSITY                                       ","2003-2004",39,"Total Participants",608050,610022,-1972,297453,297921,-468,310597,312101,-1504,"63","64",92621,68136
"11688",228529,"TARLETON STATE UNIVERSITY                                   ","2003-2004",22,"Tennis",46543,48516,-1973,0,0,0,46543,48516,-1973,".","7",0,12808
"14634",229027,"THE UNIVERSITY OF TEXAS AT SAN ANTONIO                      ","2003-2004",26,"Volleyball",357404,359377,-1973,0,0,0,357404,359377,-1973,".","14",0,43813
"1798",170000,"GRACE BIBLE COLLEGE                                         ","2003-2004",2,"Basketball",30948,32927,-1979,14095,15602,-1507,16853,17325,-472,"12","10",11003,14601
"11619",198862,"LIVINGSTONE COLLEGE                                         ","2003-2004",22,"Tennis",2331,4311,-1980,0,0,0,2331,4311,-1980,".","5",0,2310
"7089",240268,"UNIVERSITY OF WISCONSIN-EAU CLAIRE                          ","2003-2004",15,"Soccer",53758,55739,-1981,0,0,0,53758,55739,-1981,".","26",0,22328
"5243",206048,"TIFFIN UNIVERSITY                                           ","2003-2004",8,"Golf",21311,23294,-1983,16080,16080,0,5231,7214,-1983,"19","2",8682,2418
"16988",236975,"WENATCHEE VALLEY COLLEGE                                    ","2003-2004",39,"Total Participants",116533,118519,-1986,63658,65170,-1512,52875,53349,-474,"66","42",102864,81677
"13316",171128,"MICHIGAN TECHNOLOGICAL UNIVERSITY                           ","2003-2004",26,"Volleyball",326855,328850,-1995,0,0,0,326855,328850,-1995,".","13",0,61864
"5813",196194,"SUNY COLLEGE AT OSWEGO                                      ","2003-2004",8,"Golf",16583,18581,-1998,16583,18581,-1998,0,0,0,"9","0",9915,0
"9985",192439,"LONG ISLAND UNIVERSITY-BROOKLYN CAMPUS                      ","2003-2004",16,"Softball",556964,558962,-1998,0,0,0,556964,558962,-1998,".","14",0,143624
"11939",211352,"CABRINI COLLEGE                                             ","2003-2004",24,"Track and Field, Outdoor",2866,4864,-1998,1433,2432,-999,1433,2432,-999,"4","3",1433,1433
"1917",101073,"CONCORDIA COLLEGE                                           ","2003-2004",2,"Basketball",28500,30500,-2000,14500,15500,-1000,14000,15000,-1000,"20","18",12000,12000
"2534",117724,"LOS ANGELES TRADE TECHNICAL COLLEGE                         ","2003-2004",2,"Basketball",12456,14456,-2000,12456,14456,-2000,0,0,0,"16",".",12456,0
"2765",230597,"SNOW COLLEGE                                                ","2003-2004",2,"Basketball",77000,79000,-2000,41000,42000,-1000,36000,37000,-1000,"14","14",41000,36000
"5730",111948,"CHAPMAN UNIVERSITY                                          ","2003-2004",8,"Golf",13000,15000,-2000,13000,15000,-2000,0,0,0,"8",".",9000,0
"6870",166692,"MASSACHUSETTS MARITIME ACADEMY                              ","2003-2004",12,"Rifle",11000,13000,-2000,5500,10000,-4500,5500,3000,2500,"6","4",3000,1500
"8905",168430,"WORCESTER STATE COLLEGE                                     ","2003-2004",16,"Softball",37002,39002,-2000,0,0,0,37002,39002,-2000,".","15",0,37002
"9145",179946,"WESTMINSTER COLLEGE                                         ","2003-2004",16,"Softball",18000,20000,-2000,0,0,0,18000,20000,-2000,".","12",0,15000
"10838",173452,"MARTIN LUTHER COLLEGE                                       ","2003-2004",22,"Tennis",7000,9000,-2000,3500,4500,-1000,3500,4500,-1000,"12","18",3500,4000
"11408",157809,"THOMAS MORE COLLEGE                                         ","2003-2004",22,"Tennis",6020,8020,-2000,2948,3948,-1000,3072,4072,-1000,"11","8",1936,2048
"12077",168430,"WORCESTER STATE COLLEGE                                     ","2003-2004",24,"Track and Field, Outdoor",19199,21199,-2000,8884,9884,-1000,10315,11315,-1000,"18","9",8884,10315
"12682",168786,"AQUINAS COLLEGE                                             ","2003-2004",25,"Track and Field, X-Country",12000,14000,-2000,6000,7000,-1000,6000,7000,-1000,"22","16",8998,9008
"12874",168430,"WORCESTER STATE COLLEGE                                     ","2003-2004",25,"Track and Field, X-Country",14195,16195,-2000,6911,7911,-1000,7284,8284,-1000,"11","11",6911,7284
"13666",196699,"SUNY ULSTER COUNTY COMMUNITY COLLEGE                        ","2003-2004",26,"Volleyball",2200,4200,-2000,0,0,0,2200,4200,-2000,".","9",0,2200
"15349",206817,"BACONE COLLEGE                                              ","2003-2004",35,"Rodeo",135000,137000,-2000,81000,82000,-1000,54000,55000,-1000,"25","9",13820,13820
"16126",230597,"SNOW COLLEGE                                                ","2003-2004",39,"Total Participants",45000,47000,-2000,0,0,0,45000,47000,-2000,"112","46",130000,81000
"17069",196237,"SUNY COLLEGE AT OLD WESTBURY                                ","2003-2004",39,"Total Participants",50000,52000,-2000,24500,25000,-500,25500,27000,-1500,"78","88",25500,27000
"3575",185572,"MONMOUTH UNIVERSITY                                         ","2003-2004",3,"All Track Combined",651085,653092,-2007,316745,317753,-1008,334340,335339,-999,"57","48",81307,77472
"3688",187444,"WILLIAM PATERSON UNIVERSITY OF NEW JERSEY                   ","2003-2004",3,"All Track Combined",58752,60760,-2008,29376,30380,-1004,29376,30380,-1004,"53","40",14881,14881
"15895",192439,"LONG ISLAND UNIVERSITY-BROOKLYN CAMPUS                      ","2003-2004",39,"Total Participants",4042904,4044912,-2008,1460988,1460998,-10,2581916,2583914,-1998,"112","133",488425,727294
"3617",153621,"IOWA WESLEYAN COLLEGE                                       ","2003-2004",3,"All Track Combined",22948,24958,-2010,11474,12479,-1005,11474,12479,-1005,"12","11",11474,11474
"9500",139861,"GEORGIA COLLEGE AND STATE UNIVERSITY                        ","2003-2004",16,"Softball",102671,104685,-2014,0,0,0,102671,104685,-2014,".","16",0,37020
"10079",195216,"ST LAWRENCE UNIVERSITY                                      ","2003-2004",17,"Squash",91304,93322,-2018,45652,46661,-1009,45652,46661,-1009,"16","21",14198,14198
"12613",216694,"WAYNESBURG COLLEGE                                          ","2003-2004",25,"Track and Field, X-Country",18600,20620,-2020,9300,10310,-1010,9300,10310,-1010,"6","10",9560,9560
"15666",212054,"DREXEL UNIVERSITY                                           ","2003-2004",39,"Total Participants",3755748,3757772,-2024,1892698,1974715,-82017,1863050,1783057,79993,"194","157",501158,349669
"9753",137096,"SANTA FE COMMUNITY COLLEGE                                  ","2003-2004",16,"Softball",118945,120980,-2035,0,0,0,118945,120980,-2035,".","22",0,120000
"6515",196158,"SUNY COLLEGE AT FREDONIA                                    ","2003-2004",10,"Ice Hockey",134472,136523,-2051,134472,136523,-2051,0,0,0,"28",".",58645,0
"16371",161226,"UNIVERSITY OF MAINE AT FARMINGTON                           ","2003-2004",39,"Total Participants",72953,75007,-2054,31009,29394,1615,41944,45613,-3669,"75","89",35422,48582
"8025",176479,"WILLIAM CAREY COLLEGE                                       ","2003-2004",15,"Soccer",402605,404673,-2068,225100,234816,-9716,177505,169857,7648,"28","17",30753,20615
"15156",210571,"ALBRIGHT COLLEGE                                            ","2003-2004",31,"Badminton",1065,3145,-2080,0,0,0,1065,3145,-2080,".","6",0,1065
"16294",112190,"CITY COLLEGE OF SAN FRANCISCO                               ","2003-2004",39,"Total Participants",115076,117159,-2083,55129,56339,-1210,59947,60820,-873,"179","93",69067,38580
"9717",161688,"ALLEGANY COLLEGE OF MARYLAND                                ","2003-2004",16,"Softball",22684,24770,-2086,0,0,0,22684,24770,-2086,".","15",0,4500
"13994",214591,"PENNSYLVANIA STATE UNIV-PENN ST ERIE-BEHREND COLL           ","2003-2004",26,"Volleyball",29411,31501,-2090,0,0,0,29411,31501,-2090,".","16",0,17146
"6177",216825,"WESTMORELAND COUNTY COMMUNITY COLLEGE                       ","2003-2004",8,"Golf",2000,4100,-2100,2000,4100,-2100,0,0,0,"7",".",770,0
"6896",195304,"SARAH LAWRENCE COLLEGE                                      ","2003-2004",13,"Rowing",20000,22109,-2109,4000,3158,842,16000,18951,-2951,"2","12",1275,7834
"4633",153621,"IOWA WESLEYAN COLLEGE                                       ","2003-2004",7,"Football",91413,93525,-2112,91413,93525,-2112,0,0,0,"82",".",89871,0
"14808",173300,"CONCORDIA COLLEGE AT MOORHEAD                               ","2003-2004",28,"Wrestling",41538,43661,-2123,41538,43661,-2123,0,0,0,"14",".",1944,0
"13359",214795,"PENNSYLVANIA STATE UNIVERSITY-PENN STATE MONT ALTO          ","2003-2004",26,"Volleyball",4000,6128,-2128,0,0,0,4000,6128,-2128,".","10",0,4000
"4253",186876,"THE RICHARD STOCKTON COLLEGE OF NEW JERSEY                  ","2003-2004",6,"Field hocky",69533,71664,-2131,0,0,0,69533,71664,-2131,".","27",0,16088
"1103",240170,"WESTERN WISCONSIN TECHNICAL COLLEGE                         ","2003-2004",1,"Baseball",12500,14636,-2136,12500,14636,-2136,0,0,0,"18",".",9136,0
"2700",239071,"MARANATHA BAPTIST BIBLE COLLEGE INC                         ","2003-2004",2,"Basketball",35121,37257,-2136,19286,20848,-1562,15835,16409,-574,"16","12",6566,8250
"13304",238661,"EDGEWOOD COLLEGE                                            ","2003-2004",26,"Volleyball",30105,32241,-2136,0,0,0,30105,32241,-2136,".","13",0,13781
"5883",157401,"MURRAY STATE UNIVERSITY                                     ","2003-2004",8,"Golf",247604,249746,-2142,77861,82597,-4736,169743,167149,2594,"9","9",29395,31634
"8458",138761,"ANDREW COLLEGE                                              ","2003-2004",15,"Soccer",25330,27472,-2142,12714,13554,-840,12616,13918,-1302,"24","15",12425,11954
"7660",199281,"UNIVERSITY OF NORTH CAROLINA AT PEMBROKE                    ","2003-2004",15,"Soccer",46819,48964,-2145,24294,24293,1,22525,24671,-2146,"23","22",21028,19246
"9247",213251,"JUNIATA COLLEGE                                             ","2003-2004",16,"Softball",22923,25076,-2153,0,0,0,22923,25076,-2153,".","16",0,20694
"9044",220613,"LEE UNIVERSITY                                              ","2003-2004",16,"Softball",136621,138780,-2159,0,0,0,136621,138780,-2159,".","16",0,35112
"14298",213251,"JUNIATA COLLEGE                                             ","2003-2004",26,"Volleyball",138706,140865,-2159,54446,54294,152,84260,86571,-2311,"18","17",26549,36676
"541",145521,"HIGHLAND COMMUNITY COLLEGE                                  ","2003-2004",1,"Baseball",11000,13161,-2161,11000,13161,-2161,0,0,0,"16",".",9983,0
"5770",152637,"VINCENNES UNIVERSITY                                        ","2003-2004",8,"Golf",7778,9940,-2162,7778,9940,-2162,0,0,0,"6",".",7778,0
"3708",169716,"UNIVERSITY OF DETROIT MERCY                                 ","2003-2004",3,"All Track Combined",497419,499589,-2170,207997,209082,-1085,289422,290507,-1085,"24","29",29198,29198
"12482",224527,"EAST TEXAS BAPTIST UNIVERSITY                               ","2003-2004",25,"Track and Field, X-Country",15990,18164,-2174,7995,9082,-1087,7995,9082,-1087,"8","16",3276,3276
"5838",140988,"SHORTER COLLEGE                                             ","2003-2004",8,"Golf",158668,160844,-2176,68370,67877,493,90298,92967,-2669,"10","6",14133,15719
"3474",197045,"UTICA COLLEGE                                               ","2003-2004",2,"Basketball",156795,158975,-2180,79725,80675,-950,77070,78300,-1230,"14","10",19700,19200
"11443",146427,"KNOX COLLEGE                                                ","2003-2004",22,"Tennis",38154,40338,-2184,7469,9930,-2461,30685,30408,277,"11","15",4087,9538
"3925",149781,"WHEATON COLLEGE                                             ","2003-2004",3,"All Track Combined",121850,124040,-2190,60925,62020,-1095,60925,62020,-1095,"105","86",14795,14795
"14787",239071,"MARANATHA BAPTIST BIBLE COLLEGE INC                         ","2003-2004",28,"Wrestling",10706,12902,-2196,10706,12902,-2196,0,0,0,"8",".",5282,0
"1661",243221,"UNIVERSITY OF PUERTO RICO-RIO PIEDRAS CAMPUS                ","2003-2004",2,"Basketball",43000,45200,-2200,23500,24600,-1100,19500,20600,-1100,"15","18",23300,19600
"7344",214795,"PENNSYLVANIA STATE UNIVERSITY-PENN STATE MONT ALTO          ","2003-2004",15,"Soccer",5500,7700,-2200,5500,7700,-2200,0,0,0,"22",".",5500,0
"13005",214740,"PENNSYLVANIA STATE UNIVERSITY-PENN STATE DUBOIS             ","2003-2004",26,"Volleyball",4506,6706,-2200,0,0,0,4506,6706,-2200,".","11",0,4506
"14323",210146,"SOUTHERN OREGON UNIVERSITY                                  ","2003-2004",26,"Volleyball",49460,51660,-2200,0,0,0,49460,51660,-2200,".","13",0,28860
"6025",228787,"THE UNIVERSITY OF TEXAS AT DALLAS                           ","2003-2004",8,"Golf",11600,13804,-2204,5800,7319,-1519,5800,6485,-685,"8","7",5800,5800
"13654",113980,"EL CAMINO COLLEGE                                           ","2003-2004",26,"Volleyball",38840,41048,-2208,18449,19608,-1159,20391,21440,-1049,"14","13",5704,7536
"4218",150400,"DEPAUW UNIVERSITY                                           ","2003-2004",6,"Field hocky",58999,61211,-2212,0,0,0,58999,61211,-2212,".","19",0,28820
"10149",187444,"WILLIAM PATERSON UNIVERSITY OF NEW JERSEY                   ","2003-2004",18,"Swimming and Diving",41087,43302,-2215,20335,21447,-1112,20752,21855,-1103,"20","16",11419,11836
"2065",110680,"UNIVERSITY OF CALIFORNIA-SAN DIEGO                          ","2003-2004",2,"Basketball",312762,314979,-2217,156240,157679,-1439,156522,157300,-778,"15","17",49103,63301
"7642",188641,"ALFRED UNIVERSITY                                           ","2003-2004",15,"Soccer",112193,114410,-2217,70206,72792,-2586,41987,41618,369,"22","21",15380,13970
"4189",164739,"BENTLEY COLLEGE                                             ","2003-2004",6,"Field hocky",124513,126732,-2219,0,0,0,124513,126732,-2219,".","26",0,18329
"8421",174862,"CROWN COLLEGE                                               ","2003-2004",15,"Soccer",31785,34006,-2221,18368,21908,-3540,13417,12098,1319,"15","19",16450,11181
"10693",165529,"CURRY COLLEGE                                               ","2003-2004",22,"Tennis",10998,13221,-2223,5359,6545,-1186,5639,6676,-1037,"8","7",2186,2317
"6027",121345,"POMONA COLLEGE                                              ","2003-2004",8,"Golf",13832,16062,-2230,13832,16062,-2230,0,0,0,"9",".",14179,0
"3357",118912,"MIRACOSTA COLLEGE                                           ","2003-2004",2,"Basketball",88099,90333,-2234,88099,90333,-2234,0,0,0,"13","0",550,0
"136",113980,"EL CAMINO COLLEGE                                           ","2003-2004",1,"Baseball",44075,46313,-2238,44075,46313,-2238,0,0,0,"26",".",35120,0
"14116",199148,"UNIVERSITY OF NORTH CAROLINA AT GREENSBORO                  ","2003-2004",26,"Volleyball",252987,255226,-2239,0,0,0,252987,255226,-2239,".","14",0,31349
"9575",235334,"GRAYS HARBOR COLLEGE                                        ","2003-2004",16,"Softball",19054,21303,-2249,0,0,0,19054,21303,-2249,".","15",0,11539
"13877",194569,"PRACTICAL BIBLE COLLEGE                                     ","2003-2004",26,"Volleyball",8204,10454,-2250,1395,2145,-750,6809,8309,-1500,"12","8",1395,6809
"5765",170240,"HENRY FORD COMMUNITY COLLEGE                                ","2003-2004",8,"Golf",6770,9025,-2255,6770,9025,-2255,0,0,0,"4",".",4450,0
"5266",168254,"WESTERN NEW ENGLAND COLLEGE                                 ","2003-2004",8,"Golf",8075,10335,-2260,8075,10335,-2260,0,0,0,"7",".",2500,0
"12783",235431,"HIGHLINE COMMUNITY COLLEGE                                  ","2003-2004",25,"Track and Field, X-Country",24648,26910,-2262,12201,13532,-1331,12447,13378,-931,"12","7",1750,1750
"7480",141185,"TOCCOA FALLS COLLEGE                                        ","2003-2004",15,"Soccer",39430,41696,-2266,21149,22282,-1133,18281,19414,-1133,"16","14",11205,9740
"14171",102377,"TUSKEGEE UNIVERSITY                                         ","2003-2004",26,"Volleyball",63016,65285,-2269,0,0,0,63016,65285,-2269,".","11",0,10230
"15845",233541,"SHENANDOAH UNIVERSITY                                       ","2003-2004",39,"Total Participants",453304,455573,-2269,207296,213572,-6276,246008,242001,4007,"205","95",203807,133210
"16169",200314,"MINOT STATE UNIVERSITY-BOTTINEAU CAMPUS                     ","2003-2004",39,"Total Participants",72735,75008,-2273,63526,65783,-2257,9209,9225,-16,"51","19",76641,18740
"1334",236638,"SKAGIT VALLEY COLLEGE                                       ","2003-2004",1,"Baseball",15500,17776,-2276,15500,17776,-2276,0,0,0,"25",".",15500,0
"9561",236638,"SKAGIT VALLEY COLLEGE                                       ","2003-2004",16,"Softball",13500,15776,-2276,0,0,0,13500,15776,-2276,".","15",0,13500
"13754",236638,"SKAGIT VALLEY COLLEGE                                       ","2003-2004",26,"Volleyball",8991,11267,-2276,0,0,0,8991,11267,-2276,"0","12",0,8991
"2798",145707,"ILLINOIS EASTERN COMMUNITY COLLS-OLNEY CTRL COLL            ","2003-2004",2,"Basketball",248801,251078,-2277,157746,159883,-2137,91055,91195,-140,"12","11",34247,24010
"15068",186131,"PRINCETON UNIVERSITY                                        ","2003-2004",29,"Other Sports",72321,74603,-2282,72321,74603,-2282,0,0,0,"45","0",28801,0
"2687",113980,"EL CAMINO COLLEGE                                           ","2003-2004",2,"Basketball",58234,60522,-2288,25618,27144,-1526,32616,33378,-762,"16","14",8026,14961
"13083",198066,"BREVARD COLLEGE                                             ","2003-2004",26,"Volleyball",46000,48291,-2291,0,0,0,46000,48291,-2291,".","12",0,15291
"9054",198303,"CHOWAN COLLEGE                                              ","2003-2004",16,"Softball",54227,56523,-2296,0,0,0,54227,56523,-2296,".","17",0,22905
"13071",200846,"UNIVERSITY OF AKRON-WAYNE COLLEGE                           ","2003-2004",26,"Volleyball",2000,4299,-2299,0,0,0,2000,4299,-2299,".","9",0,236
"14564",196130,"SUNY COLLEGE AT BUFFALO                                     ","2003-2004",26,"Volleyball",47036,49336,-2300,0,0,0,47036,49336,-2300,".","12",0,32041
"635",145831,"ILLINOIS VALLEY COMMUNITY COLLEGE                           ","2003-2004",1,"Baseball",26900,29207,-2307,26900,29207,-2307,0,0,0,"30",".",11917,0
"5750",236638,"SKAGIT VALLEY COLLEGE                                       ","2003-2004",8,"Golf",11513,13820,-2307,8513,9971,-1458,3000,3849,-849,"6","6",8513,2000
"8520",202514,"DEFIANCE COLLEGE                                            ","2003-2004",15,"Soccer",61093,63402,-2309,27553,33358,-5805,33540,30044,3496,"24","18",12722,12923
"9672",190053,"CLINTON COMMUNITY COLLEGE                                   ","2003-2004",16,"Softball",6200,8514,-2314,0,0,0,6200,8514,-2314,".","12",0,6200
"15920",240170,"WESTERN WISCONSIN TECHNICAL COLLEGE                         ","2003-2004",39,"Total Participants",26860,29183,-2323,12500,14636,-2136,14360,14547,-187,"28","20",16546,16457
"5383",168005,"SUFFOLK UNIVERSITY                                          ","2003-2004",8,"Golf",4500,6825,-2325,4500,6825,-2325,0,0,0,"9",".",4500,0
"10043",243142,"UNIVERSITY OF PUERTO RICO IN CAROLINA                       ","2003-2004",16,"Softball",4732,7058,-2326,0,0,0,4732,7058,-2326,".","15",0,5068
"14321",187912,"NEW MEXICO MILITARY INSTITUTE                               ","2003-2004",26,"Volleyball",180798,183126,-2328,0,0,0,180798,183126,-2328,".","10",0,42315
"621",200314,"MINOT STATE UNIVERSITY-BOTTINEAU CAMPUS                     ","2003-2004",1,"Baseball",15332,17662,-2330,15332,17662,-2330,0,0,0,"16",".",15755,0
"1465",162690,"HAGERSTOWN COMMUNITY COLLEGE                                ","2003-2004",1,"Baseball",19978,22319,-2341,19978,22319,-2341,0,0,0,"24",".",16526,0
"2644",217475,"COMMUNITY COLLEGE OF RHODE ISLAND                           ","2003-2004",2,"Basketball",56000,58350,-2350,28000,28000,0,28000,30350,-2350,"16","12",23000,24000
"13646",170240,"HENRY FORD COMMUNITY COLLEGE                                ","2003-2004",26,"Volleyball",14375,16725,-2350,0,0,0,14375,16725,-2350,".","7",0,7000
"11924",186201,"RAMAPO COLLEGE OF NEW JERSEY                                ","2003-2004",23,"Track and Field, Indoor",16384,18737,-2353,9704,9520,184,6680,9217,-2537,"22","9",7030,6767
"12111",186201,"RAMAPO COLLEGE OF NEW JERSEY                                ","2003-2004",24,"Track and Field, Outdoor",16384,18737,-2353,9704,9520,184,6680,9217,-2537,"15","9",7030,6767
"12341",186201,"RAMAPO COLLEGE OF NEW JERSEY                                ","2003-2004",25,"Track and Field, X-Country",16384,18737,-2353,9704,9520,184,6680,9217,-2537,"11","9",7030,6767
"9867",164173,"VILLA JULIE COLLEGE                                         ","2003-2004",16,"Softball",22877,25261,-2384,0,0,0,22877,25261,-2384,".","16",0,15882
"13055",195216,"ST LAWRENCE UNIVERSITY                                      ","2003-2004",26,"Volleyball",55301,57688,-2387,0,0,0,55301,57688,-2387,".","11",0,16447
"15170",241739,"UNIVERSIDAD METROPOLITANA                                   ","2003-2004",32,"Beach Volleyball",2,2400,-2398,1,1200,-1199,1,1200,-1199,"3","3",1000,1000
"6852",140669,"NORTH GEORGIA COLLEGE AND STATE UNIVERSITY                  ","2003-2004",12,"Rifle",11056,13456,-2400,5528,6728,-1200,5528,6728,-1200,"7","6",5528,5528
"13765",100654,"ALABAMA A &amp; M UNIVERSITY                                    ","2003-2004",26,"Volleyball",260491,262891,-2400,0,0,0,260491,262891,-2400,".","12",0,41280
"16808",201964,"CIRCLEVILLE BIBLE COLLEGE                                   ","2003-2004",39,"Total Participants",10344,12744,-2400,4229,5429,-1200,6115,7315,-1200,"27","18",16996,12499
"9634",216278,"SUSQUEHANNA UNIVERSITY                                      ","2003-2004",16,"Softball",31983,34390,-2407,0,0,0,31983,34390,-2407,".","16",0,13154
"8737",240268,"UNIVERSITY OF WISCONSIN-EAU CLAIRE                          ","2003-2004",16,"Softball",54996,57416,-2420,0,0,0,54996,57416,-2420,".","20",0,30365
"5163",211477,"CENTRAL PENNSYLVANIA COLLEGE                                ","2003-2004",8,"Golf",4150,6574,-2424,4150,6574,-2424,0,0,0,"7",".",4074,0
"1205",172440,"FINLANDIA UNIVERSITY                                        ","2003-2004",1,"Baseball",33067,35512,-2445,33067,35512,-2445,0,0,0,"15",".",28312,0
"13036",186584,"SETON HALL UNIVERSITY                                       ","2003-2004",26,"Volleyball",464539,466985,-2446,0,0,0,464539,466985,-2446,".","14",0,57161
"9707",191986,"JAMESTOWN COMMUNITY COLLEGE                                 ","2003-2004",16,"Softball",9873,12321,-2448,0,0,0,9873,12321,-2448,".","11",0,5748
"6073",216278,"SUSQUEHANNA UNIVERSITY                                      ","2003-2004",8,"Golf",29707,32156,-2449,24672,20818,3854,5035,11338,-6303,"22","8",6011,1031
"6544",212133,"EASTERN UNIVERSITY                                          ","2003-2004",11,"Lacrosse",14710,17160,-2450,0,0,0,14710,17160,-2450,".","21",0,9840
"14263",153320,"FAITH BAPTIST BIBLE COLLEGE AND THEOLOGICAL SEM             ","2003-2004",26,"Volleyball",3450,5900,-2450,0,0,0,3450,5900,-2450,".","10",0,5900
"6204",227757,"RICE UNIVERSITY                                             ","2003-2004",8,"Golf",272606,275059,-2453,272606,275059,-2453,0,0,0,"9",".",42294,0
"12307",171535,"OAKLAND COMMUNITY COLLEGE                                   ","2003-2004",25,"Track and Field, X-Country",16496,18955,-2459,8248,11564,-3316,8248,7391,857,"11","7",7564,3391
"2726",236230,"PACIFIC LUTHERAN UNIVERSITY                                 ","2003-2004",2,"Basketball",30000,32465,-2465,15000,16000,-1000,15000,16465,-1465,"17","17",15000,15000
"5905",144962,"ELMHURST COLLEGE                                            ","2003-2004",8,"Golf",44538,47004,-2466,24350,27954,-3604,20188,19050,1138,"7","6",6792,10800
"14269",236887,"WALLA WALLA COMMUNITY COLLEGE                               ","2003-2004",26,"Volleyball",28790,31261,-2471,0,0,0,28790,31261,-2471,".","11",0,18461
"9927",195216,"ST LAWRENCE UNIVERSITY                                      ","2003-2004",16,"Softball",33327,35803,-2476,0,0,0,33327,35803,-2476,".","14",0,9373
"6190",167251,"NEWBURY COLLEGE-BROOKLINE                                   ","2003-2004",8,"Golf",100,2578,-2478,100,2578,-2478,0,0,0,"12","0",454,0
"13830",213613,"LOCK HAVEN UNIVERSITY OF PENNSYLVANIA                       ","2003-2004",26,"Volleyball",300040,302524,-2484,0,0,0,300040,302524,-2484,".","15",0,30305
"15330",154998,"DODGE CITY COMMUNITY COLLEGE                                ","2003-2004",35,"Rodeo",30157,32648,-2491,16991,16324,667,13166,16324,-3158,"13","7",11030,11030
"6257",179955,"WILLIAM JEWELL COLLEGE                                      ","2003-2004",8,"Golf",18517,21016,-2499,8102,3934,4168,10415,17082,-6667,"10","7",3934,11082
"276",166692,"MASSACHUSETTS MARITIME ACADEMY                              ","2003-2004",1,"Baseball",8500,11000,-2500,8500,11000,-2500,0,0,0,"31",".",7500,0
"3296",214740,"PENNSYLVANIA STATE UNIVERSITY-PENN STATE DUBOIS             ","2003-2004",2,"Basketball",17356,19856,-2500,17356,19856,-2500,0,0,0,"13",".",17356,0
"11577",141097,"SOUTHERN POLYTECHNIC STATE UNIVERSITY                       ","2003-2004",22,"Tennis",19500,22000,-2500,19500,22000,-2500,0,0,0,"6",".",4320,0
"12477",165820,"FITCHBURG STATE COLLEGE                                     ","2003-2004",25,"Track and Field, X-Country",9725,12225,-2500,4825,6132,-1307,4900,6093,-1193,"10","7",1932,1947
"4636",122746,"SAN JOSE CITY COLLEGE                                       ","2003-2004",7,"Football",92485,94993,-2508,92485,94993,-2508,0,0,0,"61",".",16506,0
"883",174437,"NORTH CENTRAL UNIVERSITY                                    ","2003-2004",1,"Baseball",2500,5010,-2510,2500,5010,-2510,0,0,0,"14",".",3285,0
"5566",145521,"HIGHLAND COMMUNITY COLLEGE                                  ","2003-2004",8,"Golf",6595,9106,-2511,6595,9106,-2511,0,0,0,"5",".",3993,0
"8869",199962,"WINGATE UNIVERSITY                                          ","2003-2004",16,"Softball",29749,32267,-2518,0,0,0,29749,32267,-2518,".","14",0,19250
"3498",130697,"WESLEYAN UNIVERSITY                                         ","2003-2004",3,"All Track Combined",193036,195560,-2524,98114,99418,-1304,94922,96142,-1220,"94","65",29696,26701
"9015",153524,"IOWA CENTRAL COMMUNITY COLLEGE                              ","2003-2004",16,"Softball",43679,46208,-2529,0,0,0,43679,46208,-2529,".","20",0,17608
"15004",217059,"YORK COLLEGE PENNSYLVANIA                                   ","2003-2004",28,"Wrestling",35050,37580,-2530,35050,37580,-2530,0,0,0,"38",".",13207,0
"12841",240365,"UNIVERSITY OF WISCONSIN-OSHKOSH                             ","2003-2004",25,"Track and Field, X-Country",25175,27709,-2534,14527,15703,-1176,10648,12006,-1358,"21","27",12833,11553
"7956",170000,"GRACE BIBLE COLLEGE                                         ","2003-2004",15,"Soccer",3098,5633,-2535,3098,5633,-2535,0,0,0,"14",".",2676,0
"12633",190761,"DOMINICAN COLLEGE OF BLAUVELT                               ","2003-2004",25,"Track and Field, X-Country",7200,9736,-2536,3600,5607,-2007,3600,4129,-529,"8","10",1107,1107
"13072",238263,"MADISON AREA TECHNICAL COLLEGE                              ","2003-2004",26,"Volleyball",19677,22214,-2537,0,0,0,19677,22214,-2537,".","10",0,11462
"15185",152637,"VINCENNES UNIVERSITY                                        ","2003-2004",33,"Bowling",10282,12824,-2542,5141,6412,-1271,5141,6412,-1271,"13","6",5141,5141
"12369",101675,"MILES COLLEGE                                               ","2003-2004",25,"Track and Field, X-Country",2691,5239,-2548,1829,3201,-1372,862,2038,-1176,"7","6",457,340
"6176",236230,"PACIFIC LUTHERAN UNIVERSITY                                 ","2003-2004",8,"Golf",12200,14750,-2550,6100,7850,-1750,6100,6900,-800,"8","4",6100,6100
"10543",212106,"DUQUESNE UNIVERSITY                                         ","2003-2004",19,"Swimming",478073,480623,-2550,202866,204504,-1638,275207,276119,-912,"20","24",38950,41555
"634",108807,"ALLAN HANCOCK COLLEGE                                       ","2003-2004",1,"Baseball",37003,39571,-2568,37003,39571,-2568,0,0,0,"27",".",26318,0
"12147",122746,"SAN JOSE CITY COLLEGE                                       ","2003-2004",24,"Track and Field, Outdoor",89986,92558,-2572,81486,83486,-2000,8500,9072,-572,"27","6",5204,572
"6398",193326,"MONROE COMMUNITY COLLEGE                                    ","2003-2004",10,"Ice Hockey",85205,87786,-2581,85205,87786,-2581,0,0,0,"24",".",45412,0
"3607",154907,"CLOUD COUNTY COMMUNITY COLLEGE                              ","2003-2004",3,"All Track Combined",159444,162028,-2584,74570,81714,-7144,84874,80314,4560,"20","21",535,505
"212",153621,"IOWA WESLEYAN COLLEGE                                       ","2003-2004",1,"Baseball",25832,28432,-2600,25832,28432,-2600,0,0,0,"24",".",25832,0
"747",146667,"LINCOLN CHRISTIAN COLLEGE AND SEMINARY                      ","2003-2004",1,"Baseball",12240,14840,-2600,12240,14840,-2600,0,0,0,"21",".",12240,0
"13449",146667,"LINCOLN CHRISTIAN COLLEGE AND SEMINARY                      ","2003-2004",26,"Volleyball",12240,14840,-2600,0,0,0,12240,14840,-2600,".","15",0,12240
"15196",195058,"ROCKLAND COMMUNITY COLLEGE                                  ","2003-2004",33,"Bowling",200,2800,-2600,100,1400,-1300,100,1400,-1300,"10",".",50,50
"2808",132879,"FLORIDA CHRISTIAN COLLEGE INC                               ","2003-2004",2,"Basketball",17000,19608,-2608,10000,11696,-1696,7000,7912,-912,"12","10",7951,6461
"11022",145831,"ILLINOIS VALLEY COMMUNITY COLLEGE                           ","2003-2004",22,"Tennis",5955,8563,-2608,2638,3842,-1204,3317,4721,-1404,"7","7",1,1
"13710",178059,"MARYVILLE UNIVERSITY OF SAINT LOUIS                         ","2003-2004",26,"Volleyball",9328,11937,-2609,0,0,0,9328,11937,-2609,".","13",0,9541
"13382",204024,"MIAMI UNIVERSITY-OXFORD                                     ","2003-2004",26,"Volleyball",516238,518848,-2610,0,0,0,516238,518848,-2610,".","18",0,75699
"7846",164739,"BENTLEY COLLEGE                                             ","2003-2004",15,"Soccer",238546,241160,-2614,110206,111581,-1375,128340,129579,-1239,"28","26",21081,18286
"15232",148380,"ROCK VALLEY COLLEGE                                         ","2003-2004",33,"Bowling",16000,18621,-2621,8000,9311,-1311,8000,9310,-1310,"5","5",4655,4655
"10722",131520,"HOWARD UNIVERSITY                                           ","2003-2004",22,"Tennis",312836,315461,-2625,122392,123705,-1313,190444,191756,-1312,"7","11",23173,23173
"8720",225548,"HOWARD PAYNE UNIVERSITY                                     ","2003-2004",16,"Softball",61976,64602,-2626,0,0,0,61976,64602,-2626,".","16",0,26300
"9811",155681,"PITTSBURG STATE UNIVERSITY                                  ","2003-2004",16,"Softball",144656,147284,-2628,0,0,0,144656,147284,-2628,".","21",0,27883
"12344",146719,"LOYOLA UNIVERSITY CHICAGO                                   ","2003-2004",25,"Track and Field, X-Country",787042,789682,-2640,418067,408699,9368,368975,380983,-12008,"29","24",51699,58109
"16221",230931,"LYNDON STATE COLLEGE                                        ","2003-2004",39,"Total Participants",60058,62700,-2642,32889,35243,-2354,27169,27457,-288,"73","58",34404,30781
"12610",137032,"SAINT LEO UNIVERSITY                                        ","2003-2004",25,"Track and Field, X-Country",12749,15394,-2645,7763,7263,500,4986,8131,-3145,"6","9",4142,4165
"15202",191083,"ERIE COMMUNITY COLLEGE                                      ","2003-2004",33,"Bowling",23960,26606,-2646,11980,14665,-2685,11980,11941,39,"10","7",13040,10316
"9109",174437,"NORTH CENTRAL UNIVERSITY                                    ","2003-2004",16,"Softball",1250,3900,-2650,0,0,0,1250,3900,-2650,".","15",0,2800
"5395",237215,"BLUEFIELD STATE COLLEGE                                     ","2003-2004",8,"Golf",13775,16428,-2653,13775,16428,-2653,0,0,0,"9","0",10950,0
"8276",196219,"SUNY COLLEGE AT PURCHASE                                    ","2003-2004",15,"Soccer",30442,33100,-2658,15600,15800,-200,14842,17300,-2458,"23","24",15600,14842
"5408",196246,"SUNY COLLEGE AT PLATTSBURGH                                 ","2003-2004",8,"Golf",21622,24282,-2660,10874,12481,-1607,10748,11801,-1053,"10","9",9134,8234
"6842",218973,"WOFFORD COLLEGE                                             ","2003-2004",12,"Rifle",10575,13236,-2661,10575,13236,-2661,0,0,0,"8",".",13235,0
"2385",417752,"MESSENGER COLLEGE                                           ","2003-2004",2,"Basketball",10299,12962,-2663,7780,8347,-567,2519,4615,-2096,"9","7",5347,1015
"11399",171535,"OAKLAND COMMUNITY COLLEGE                                   ","2003-2004",22,"Tennis",7862,10525,-2663,0,0,0,7862,10525,-2663,".","7",0,6525
"8035",187444,"WILLIAM PATERSON UNIVERSITY OF NEW JERSEY                   ","2003-2004",15,"Soccer",141817,144485,-2668,69808,69129,679,72009,75356,-3347,"22","19",18242,22039
"10110",130697,"WESLEYAN UNIVERSITY                                         ","2003-2004",18,"Swimming and Diving",109396,112083,-2687,57637,58991,-1354,51759,53092,-1333,"25","24",23247,17371
"1499",226383,"LUBBOCK CHRISTIAN UNIVERSITY                                ","2003-2004",1,"Baseball",331739,334434,-2695,331739,334434,-2695,0,0,0,"22",".",90961,0
"5669",212133,"EASTERN UNIVERSITY                                          ","2003-2004",8,"Golf",5000,7700,-2700,5000,7700,-2700,0,0,0,"7",".",3050,0
"16622",121901,"RIVERSIDE COMMUNITY COLLEGE                                 ","2003-2004",39,"Total Participants",1e+05,102700,-2700,50500,55200,-4700,49500,47500,2000,"252","104",71600,45900
"16282",145707,"ILLINOIS EASTERN COMMUNITY COLLS-OLNEY CTRL COLL            ","2003-2004",39,"Total Participants",229827,232538,-2711,133549,138604,-5055,96278,93934,2344,"42","40",86124,66924
"4522",154350,"SIMPSON COLLEGE                                             ","2003-2004",7,"Football",184801,187514,-2713,184801,187514,-2713,0,0,0,"107",".",57922,0
"5249",122180,"SACRAMENTO CITY COLLEGE                                     ","2003-2004",8,"Golf",1,2716,-2715,0,0,0,1,2716,-2715,".","7",0,1590
"11196",148131,"QUINCY UNIVERSITY                                           ","2003-2004",22,"Tennis",84749,87464,-2715,38526,41372,-2846,46223,46092,131,"8","9",9378,5852
"571",195216,"ST LAWRENCE UNIVERSITY                                      ","2003-2004",1,"Baseball",97674,100392,-2718,97674,100392,-2718,0,0,0,"27",".",20708,0
"922",137096,"SANTA FE COMMUNITY COLLEGE                                  ","2003-2004",1,"Baseball",98261,100980,-2719,98261,100980,-2719,0,0,0,"23",".",1e+05,0
"15040",118976,"MODESTO JUNIOR COLLEGE                                      ","2003-2004",28,"Wrestling",22708,25437,-2729,22708,25437,-2729,0,0,0,"16",".",8383,0
"5550",220312,"HIWASSEE COLLEGE                                            ","2003-2004",8,"Golf",2500,5230,-2730,1250,1705,-455,1250,3525,-2275,"5","3",430,433
"12026",231581,"BRIDGEWATER COLLEGE                                         ","2003-2004",24,"Track and Field, Outdoor",43250,45980,-2730,24348,26365,-2017,18902,19615,-713,"30","13",7335,2816
"6980",115755,"HUMBOLDT STATE UNIVERSITY                                   ","2003-2004",13,"Rowing",194339,197070,-2731,0,0,0,194339,197070,-2731,".","56",0,90362
"13618",142461,"NORTHWEST NAZARENE UNIVERSITY                               ","2003-2004",26,"Volleyball",161304,164037,-2733,0,0,0,161304,164037,-2733,".","12",0,46738
"3072",162609,"GARRETT COLLEGE                                             ","2003-2004",2,"Basketball",99210,101944,-2734,61401,60221,1180,37809,41723,-3914,"11","10",16338,23768
"3881",194541,"POLYTECHNIC UNIVERSITY                                      ","2003-2004",3,"All Track Combined",2000,4736,-2736,1000,2368,-1368,1000,2368,-1368,"8","7",1368,1368
"8363",190691,"CUNY YORK COLLEGE                                           ","2003-2004",15,"Soccer",8708,11445,-2737,8708,11445,-2737,0,0,0,"21",".",8708,0
"11483",122889,"SANTA BARBARA CITY COLLEGE                                  ","2003-2004",22,"Tennis",22962,25716,-2754,9361,11182,-1821,13601,14534,-933,"7","8",2497,3300
"1040",190716,"D'YOUVILLE COLLEGE                                          ","2003-2004",1,"Baseball",9001,11760,-2759,9001,11760,-2759,0,0,0,"17",".",6260,0
"6003",150604,"FRANKLIN COLLEGE                                            ","2003-2004",8,"Golf",60968,63734,-2766,37850,41244,-3394,23118,22490,628,"17","7",36444,19490
"6784",230995,"NORWICH UNIVERSITY                                          ","2003-2004",11,"Lacrosse",25281,28064,-2783,25281,28064,-2783,0,0,0,"28","0",15738,0
"6967",195526,"SKIDMORE COLLEGE                                            ","2003-2004",13,"Rowing",88441,91233,-2792,40150,41236,-1086,48291,49997,-1706,"14","22",19273,30284
"9090",211343,"BUTLER COUNTY COMMUNITY COLLEGE                             ","2003-2004",16,"Softball",2920,5712,-2792,0,0,0,2920,5712,-2792,".","13",0,3982
"9616",403478,"ILLINOIS EASTERN COMMUNITY COLLS-LINCOLN TR COLL            ","2003-2004",16,"Softball",52064,54859,-2795,0,0,0,52064,54859,-2795,".","13",0,10395
"5268",192323,"LE MOYNE COLLEGE                                            ","2003-2004",8,"Golf",8500,11300,-2800,8500,11300,-2800,0,0,0,"17",".",8500,0
"11491",214795,"PENNSYLVANIA STATE UNIVERSITY-PENN STATE MONT ALTO          ","2003-2004",22,"Tennis",3000,5800,-2800,1500,2900,-1400,1500,2900,-1400,"14",".",1500,1500
"6790",165529,"CURRY COLLEGE                                               ","2003-2004",11,"Lacrosse",51801,54605,-2804,29531,30118,-587,22270,24487,-2217,"29","20",18912,13281
"9820",173559,"MINNESOTA STATE COMM AND TECH COLLEGE-FERGUS FALLS          ","2003-2004",16,"Softball",28008,30814,-2806,0,0,0,28008,30814,-2806,".","18",0,12255
"15318",240620,"LARAMIE COUNTY COMMUNITY COLLEGE                            ","2003-2004",35,"Rodeo",30376,33189,-2813,30376,33189,-2813,0,0,0,"10",".",27785,0
"11520",183239,"SAINT ANSELM COLLEGE                                        ","2003-2004",22,"Tennis",15636,18454,-2818,0,0,0,15636,18454,-2818,"0","13",0,14329
"8138",161688,"ALLEGANY COLLEGE OF MARYLAND                                ","2003-2004",15,"Soccer",30700,33522,-2822,15350,16761,-1411,15350,16761,-1411,"16","16",3045,3045
"6150",196699,"SUNY ULSTER COUNTY COMMUNITY COLLEGE                        ","2003-2004",8,"Golf",1100,3925,-2825,1100,3925,-2825,0,0,0,"7",".",2225,0
"7717",206507,"WILMINGTON COLLEGE                                          ","2003-2004",15,"Soccer",70325,73155,-2830,39038,40038,-1000,31287,33117,-1830,"31","20",40021,33100
"15055",110565,"CALIFORNIA STATE UNIVERSITY-FULLERTON                       ","2003-2004",28,"Wrestling",150102,152938,-2836,150102,152938,-2836,0,0,0,"29",".",59319,0
"16289",143118,"AURORA UNIVERSITY                                           ","2003-2004",39,"Total Participants",328489,331335,-2846,151881,158438,-6557,176608,172897,3711,"219","115",132928,79872
"4001",184603,"FAIRLEIGH DICKINSON UNIVERSITY-METROPOLITAN CAMPUS          ","2003-2004",5,"Fencing",99532,102379,-2847,0,0,0,99532,102379,-2847,".","10",0,15022
"8709",133951,"FLORIDA INTERNATIONAL UNIVERSITY                            ","2003-2004",16,"Softball",394034,396881,-2847,0,0,0,394034,396881,-2847,".","19",0,91603
"7233",182634,"COLBY-SAWYER COLLEGE                                        ","2003-2004",15,"Soccer",79886,82735,-2849,47735,49116,-1381,32151,33619,-1468,"28","22",19310,15659
"10812",186131,"PRINCETON UNIVERSITY                                        ","2003-2004",22,"Tennis",357312,360162,-2850,171343,172818,-1475,185969,187344,-1375,"12","13",56651,45195
"16404",161299,"MAINE MARITIME ACADEMY                                      ","2003-2004",39,"Total Participants",219698,222551,-2853,113066,113770,-704,106632,108781,-2149,"185","58",105449,51438
"187",107044,"HARDING UNIVERSITY                                          ","2003-2004",1,"Baseball",31726,34584,-2858,31726,34584,-2858,0,0,0,"30",".",31684,0
"14197",417752,"MESSENGER COLLEGE                                           ","2003-2004",26,"Volleyball",2200,5060,-2860,0,0,0,2200,5060,-2860,".","9",0,1092
"17331",417752,"MESSENGER COLLEGE                                           ","2003-2004",39,"Total Participants",2200,5060,-2860,0,0,0,2200,5060,-2860,"9","16",5347,2107
"371",143118,"AURORA UNIVERSITY                                           ","2003-2004",1,"Baseball",68100,70962,-2862,68100,70962,-2862,0,0,0,"42",".",41012,0
"9294",186469,"SALEM COMMUNITY COLLEGE                                     ","2003-2004",16,"Softball",20170,23046,-2876,0,0,0,20170,23046,-2876,".","13",0,4063
"13652",236753,"TACOMA COMMUNITY COLLEGE                                    ","2003-2004",26,"Volleyball",11665,14545,-2880,0,0,0,11665,14545,-2880,".","8",0,8045
"10727",173647,"GUSTAVUS ADOLPHUS COLLEGE                                   ","2003-2004",22,"Tennis",318911,321794,-2883,173039,172497,542,145872,149297,-3425,"31","15",51378,32839
"12362",238263,"MADISON AREA TECHNICAL COLLEGE                              ","2003-2004",25,"Track and Field, X-Country",8850,11733,-2883,4425,8626,-4201,4425,3107,1318,"6","1",6264,744
"9082",136215,"NOVA SOUTHEASTERN UNIVERSITY                                ","2003-2004",16,"Softball",210228,213120,-2892,0,0,0,210228,213120,-2892,".","14",0,49314
"4436",206507,"WILMINGTON COLLEGE                                          ","2003-2004",7,"Football",228696,231591,-2895,228696,231591,-2895,0,0,0,"80",".",231520,0
"5178",193946,"NIAGARA COUNTY COMMUNITY COLLEGE                            ","2003-2004",8,"Golf",3092,5992,-2900,3092,5992,-2900,0,0,0,"8",".",3038,0
"9253",195058,"ROCKLAND COMMUNITY COLLEGE                                  ","2003-2004",16,"Softball",100,3000,-2900,0,0,0,100,3000,-2900,".","15",0,225
"14293",212878,"HARRISBURG AREA COMMUNITY COLLEGE-HARRISBURG                ","2003-2004",26,"Volleyball",10215,13115,-2900,6735,6735,0,3480,6380,-2900,"10","12",2380,3835
"16771",212878,"HARRISBURG AREA COMMUNITY COLLEGE-HARRISBURG                ","2003-2004",39,"Total Participants",22073,24973,-2900,16425,16425,0,5648,8548,-2900,"48","24",14980,10519
"13091",182634,"COLBY-SAWYER COLLEGE                                        ","2003-2004",26,"Volleyball",37244,40145,-2901,0,0,0,37244,40145,-2901,".","15",0,22046
"3439",137096,"SANTA FE COMMUNITY COLLEGE                                  ","2003-2004",2,"Basketball",185249,188153,-2904,103765,107136,-3371,81484,81017,467,"11","12",1e+05,80000
"2044",237792,"SHEPHERD COLLEGE                                            ","2003-2004",2,"Basketball",465834,468755,-2921,260089,258537,1552,205745,210218,-4473,"12","12",57568,47019
"5479",214795,"PENNSYLVANIA STATE UNIVERSITY-PENN STATE MONT ALTO          ","2003-2004",8,"Golf",4500,7424,-2924,4500,7424,-2924,0,0,0,"8",".",4500,0
"3743",239716,"SAINT NORBERT COLLEGE                                       ","2003-2004",3,"All Track Combined",104365,107297,-2932,56211,60589,-4378,48154,46708,1446,"59","58",26548,23508
"12438",236708,"SPOKANE FALLS COMMUNITY COLLEGE                             ","2003-2004",25,"Track and Field, X-Country",34627,37568,-2941,19508,20174,-666,15119,17394,-2275,"11","8",13491,9770
"7739",133951,"FLORIDA INTERNATIONAL UNIVERSITY                            ","2003-2004",15,"Soccer",834769,837716,-2947,395706,392261,3445,439063,445455,-6392,"33","29",56187,71726
"1281",215284,"UNIVERSITY OF PITTSBURGH-JOHNSTOWN                          ","2003-2004",1,"Baseball",80296,83245,-2949,80296,83245,-2949,0,0,0,"36",".",31907,0
"13658",186131,"PRINCETON UNIVERSITY                                        ","2003-2004",26,"Volleyball",170815,173765,-2950,67599,67599,0,103216,106166,-2950,"14","14",24334,35781
"13770",211343,"BUTLER COUNTY COMMUNITY COLLEGE                             ","2003-2004",26,"Volleyball",7462,10421,-2959,0,0,0,7462,10421,-2959,".","9",0,6421
"8480",153621,"IOWA WESLEYAN COLLEGE                                       ","2003-2004",15,"Soccer",32180,35140,-2960,19291,21291,-2000,12889,13849,-960,"26","16",19291,12889
"13402",157401,"MURRAY STATE UNIVERSITY                                     ","2003-2004",26,"Volleyball",284656,287616,-2960,0,0,0,284656,287616,-2960,".","14",0,39302
"3320",174817,"SAINT MARY'S UNIVERSITY OF MINNESOTA                        ","2003-2004",2,"Basketball",147862,150841,-2979,82921,84816,-1895,64941,66025,-1084,"18","12",23775,25519
"3995",166683,"MASSACHUSETTS INSTITUTE OF TECHNOLOGY                       ","2003-2004",5,"Fencing",94968,97949,-2981,47949,49361,-1412,47019,48588,-1569,"21","20",19918,19145
"10111",191968,"ITHACA COLLEGE                                              ","2003-2004",18,"Swimming and Diving",165843,168834,-2991,73671,77202,-3531,92172,91632,540,"26","30",35110,37728
"15094",241739,"UNIVERSIDAD METROPOLITANA                                   ","2003-2004",29,"Other Sports",2,3000,-2998,1,2000,-1999,1,1000,-999,"2","2",500,500
"328",214786,"PENNSYLVANIA STATE UNIVERSITY-PENN ST MCKEESPORT            ","2003-2004",1,"Baseball",7000,10000,-3000,7000,10000,-3000,0,0,0,"16",".",7000,0
"731",243221,"UNIVERSITY OF PUERTO RICO-RIO PIEDRAS CAMPUS                ","2003-2004",1,"Baseball",12545,15545,-3000,12545,15545,-3000,0,0,0,"27",".",11545,0
"2105",161545,"SOUTHERN MAINE COMMUNITY COLLEGE                            ","2003-2004",2,"Basketball",48000,51000,-3000,24000,25500,-1500,24000,25500,-1500,"15","9",24000,24000
"6288",214166,"MOUNT ALOYSIUS COLLEGE                                      ","2003-2004",8,"Golf",7200,10200,-3000,7200,10200,-3000,0,0,0,"6",".",7200,0
"7292",161545,"SOUTHERN MAINE COMMUNITY COLLEGE                            ","2003-2004",15,"Soccer",15500,18500,-3000,9500,11500,-2000,6000,7000,-1000,"18","10",11000,6800
"10008",214786,"PENNSYLVANIA STATE UNIVERSITY-PENN ST MCKEESPORT            ","2003-2004",16,"Softball",7000,10000,-3000,0,0,0,7000,10000,-3000,".","14",0,7000
"10101",112260,"CLAREMONT MCKENNA COLLEGE                                   ","2003-2004",18,"Swimming and Diving",84848,87848,-3000,39389,42389,-3000,45459,45459,0,"21","27",14181,17350
"12501",214166,"MOUNT ALOYSIUS COLLEGE                                      ","2003-2004",25,"Track and Field, X-Country",9800,12800,-3000,4900,6400,-1500,4900,6400,-1500,"2","6",4900,4900
"12843",189839,"CAYUGA COUNTY COMMUNITY COLLEGE                             ","2003-2004",25,"Track and Field, X-Country",2000,5000,-3000,1000,2500,-1500,1000,2500,-1500,"4","4",1000,1000
"13708",179946,"WESTMINSTER COLLEGE                                         ","2003-2004",26,"Volleyball",15000,18000,-3000,0,0,0,15000,18000,-3000,".","8",0,15000
"14455",214786,"PENNSYLVANIA STATE UNIVERSITY-PENN ST MCKEESPORT            ","2003-2004",26,"Volleyball",7000,10000,-3000,0,0,0,7000,10000,-3000,"0","10",0,7000
"16127",101073,"CONCORDIA COLLEGE                                           ","2003-2004",39,"Total Participants",43000,46000,-3000,29000,31000,-2000,14000,15000,-1000,"72","33",36000,24000
"13157",163657,"PRINCE GEORGES COMMUNITY COLLEGE                            ","2003-2004",26,"Volleyball",3350,6351,-3001,0,0,0,3350,6351,-3001,".","10",0,2471
"4525",204024,"MIAMI UNIVERSITY-OXFORD                                     ","2003-2004",7,"Football",4322822,4325824,-3002,4322822,4325824,-3002,0,0,0,"106",".",819544,0
"9091",141486,"CHAMINADE UNIVERSITY OF HONOLULU                            ","2003-2004",16,"Softball",24363,27366,-3003,0,0,0,24363,27366,-3003,".","13",0,22911
"13481",209038,"LANE COMMUNITY COLLEGE                                      ","2003-2004",26,"Volleyball",29145,32153,-3008,0,0,0,29145,32153,-3008,".","10",0,8653
"5613",206507,"WILMINGTON COLLEGE                                          ","2003-2004",8,"Golf",34951,37960,-3009,13483,13987,-504,21468,23973,-2505,"14","5",13986,23970
"882",212133,"EASTERN UNIVERSITY                                          ","2003-2004",1,"Baseball",19416,22440,-3024,19416,22440,-3024,0,0,0,"14",".",11950,0
"11252",171304,"MUSKEGON COMMUNITY COLLEGE                                  ","2003-2004",22,"Tennis",14264,17290,-3026,0,0,0,14264,17290,-3026,".","6",0,5732
"3352",180522,"MONTANA STATE UNIVERSITY-NORTHERN                           ","2003-2004",2,"Basketball",229718,232756,-3038,118321,117394,927,111397,115362,-3965,"17","14",42623,38942
"1201",190053,"CLINTON COMMUNITY COLLEGE                                   ","2003-2004",1,"Baseball",6200,9242,-3042,6200,9242,-3042,0,0,0,"16",".",6200,0
"15556",145725,"ILLINOIS INSTITUTE OF TECHNOLOGY                            ","2003-2004",39,"Total Participants",357220,360264,-3044,186110,186837,-727,171110,173427,-2317,"92","52",78890,68211
"2251",147013,"MCKENDREE COLLEGE                                           ","2003-2004",2,"Basketball",482904,485950,-3046,258655,264120,-5465,224249,221830,2419,"22","21",41703,34174
"14702",113333,"DE ANZA COLLEGE                                             ","2003-2004",27,"Water Polo",8150,11197,-3047,6650,9697,-3047,1500,1500,0,"12","11",4297,1500
"1009",196866,"UNION COLLEGE                                               ","2003-2004",1,"Baseball",37227,40276,-3049,37227,40276,-3049,0,0,0,"24",".",10984,0
"12386",192192,"KEUKA COLLEGE                                               ","2003-2004",25,"Track and Field, X-Country",28690,31741,-3051,14345,15356,-1011,14345,16385,-2040,"12","15",4345,4345
"8160",183822,"BLOOMFIELD COLLEGE                                          ","2003-2004",15,"Soccer",17600,20653,-3053,8800,10084,-1284,8800,10569,-1769,"16","16",8800,8800
"14349",128106,"COLORADO STATE UNIVERSITY-PUEBLO                            ","2003-2004",26,"Volleyball",137144,140199,-3055,0,0,0,137144,140199,-3055,".","16",0,30749
"4931",154998,"DODGE CITY COMMUNITY COLLEGE                                ","2003-2004",7,"Football",184720,187777,-3057,184720,187777,-3057,0,0,0,"128",".",51507,0
"5870",136206,"NORTHWOOD UNIVERSITY-FLORIDA EDUCATION CENTER               ","2003-2004",8,"Golf",229604,232663,-3059,112692,117615,-4923,116912,115048,1864,"20","12",13691,15111
"6230",224323,"UNIVERSITY OF DALLAS                                        ","2003-2004",8,"Golf",10926,13987,-3061,10926,13987,-3061,0,0,0,"9",".",8290,0
"14153",130697,"WESLEYAN UNIVERSITY                                         ","2003-2004",26,"Volleyball",83544,86608,-3064,0,0,0,83544,86608,-3064,".","13",0,22125
"2718",215266,"UNIVERSITY OF PITTSBURGH-BRADFORD                           ","2003-2004",2,"Basketball",152814,155895,-3081,89006,96671,-7665,63808,59224,4584,"17","8",27346,23475
"8448",165866,"FRAMINGHAM STATE COLLEGE                                    ","2003-2004",15,"Soccer",40837,43918,-3081,19750,22805,-3055,21087,21113,-26,"22","17",10184,6438
"11058",169716,"UNIVERSITY OF DETROIT MERCY                                 ","2003-2004",22,"Tennis",99923,103007,-3084,0,0,0,99923,103007,-3084,".","10",0,9279
"11639",209825,"UNIVERSITY OF PORTLAND                                      ","2003-2004",22,"Tennis",364722,367817,-3095,153263,151517,1746,211459,216300,-4841,"9","8",42634,42064
"8588",107877,"WILLIAMS BAPTIST COLLEGE                                    ","2003-2004",16,"Softball",56226,59322,-3096,0,0,0,56226,59322,-3096,".","13",0,18594
"8836",191968,"ITHACA COLLEGE                                              ","2003-2004",16,"Softball",96952,100051,-3099,0,0,0,96952,100051,-3099,".","18",0,40329
"546",106713,"CENTRAL BAPTIST COLLEGE                                     ","2003-2004",1,"Baseball",46924,50024,-3100,46924,50024,-3100,0,0,0,"23",".",17600,0
"9950",106713,"CENTRAL BAPTIST COLLEGE                                     ","2003-2004",16,"Softball",27229,30329,-3100,0,0,0,27229,30329,-3100,".","13",0,12745
"13942",106713,"CENTRAL BAPTIST COLLEGE                                     ","2003-2004",26,"Volleyball",22514,25614,-3100,0,0,0,22514,25614,-3100,"0","7",0,5630
"8879",143118,"AURORA UNIVERSITY                                           ","2003-2004",16,"Softball",49788,52889,-3101,0,0,0,49788,52889,-3101,".","22",0,26226
"10066",161086,"COLBY COLLEGE                                               ","2003-2004",17,"Squash",16263,19377,-3114,8000,9006,-1006,8263,10371,-2108,"12","13",7990,9723
"11537",211440,"CARNEGIE MELLON UNIVERSITY                                  ","2003-2004",22,"Tennis",92300,95416,-3116,47116,48913,-1797,45184,46503,-1319,"10","9",28087,25677
"498",186131,"PRINCETON UNIVERSITY                                        ","2003-2004",1,"Baseball",248040,251166,-3126,248040,251166,-3126,0,0,0,"28",".",109124,0
"5723",164720,"BECKER COLLEGE                                              ","2003-2004",8,"Golf",227,3355,-3128,227,3355,-3128,0,0,0,"6",".",855,0
"6737",212601,"GANNON UNIVERSITY                                           ","2003-2004",11,"Lacrosse",119732,122861,-3129,0,0,0,119732,122861,-3129,".","21",0,24434
"12870",117788,"LOS ANGELES CITY COLLEGE                                    ","2003-2004",25,"Track and Field, X-Country",4400,7532,-3132,0,0,0,4400,7532,-3132,".","4",0,2512
"14551",219718,"BETHEL COLLEGE                                              ","2003-2004",26,"Volleyball",26444,29587,-3143,0,0,0,26444,29587,-3143,".","12",0,21048
"9776",115755,"HUMBOLDT STATE UNIVERSITY                                   ","2003-2004",16,"Softball",175195,178348,-3153,0,0,0,175195,178348,-3153,".","22",0,60402
"4439",171456,"NORTHERN MICHIGAN UNIVERSITY                                ","2003-2004",7,"Football",1609416,1612584,-3168,1609416,1612584,-3168,0,0,0,"103",".",154373,0
"13010",122180,"SACRAMENTO CITY COLLEGE                                     ","2003-2004",26,"Volleyball",1644,4813,-3169,0,0,0,1644,4813,-3169,".","12",0,3628
"7792",131469,"GEORGE WASHINGTON UNIVERSITY                                ","2003-2004",15,"Soccer",996141,999311,-3170,504045,508435,-4390,492096,490876,1220,"24","23",53364,40743
"13400",181312,"MID PLAINS COMMUNITY COLLEGE AREA                           ","2003-2004",26,"Volleyball",70366,73543,-3177,0,0,0,70366,73543,-3177,"0","27",0,33693
"423",122597,"SAN FRANCISCO STATE UNIVERSITY                              ","2003-2004",1,"Baseball",153108,156290,-3182,153108,156290,-3182,0,0,0,"26",".",45538,0
"6442",230995,"NORWICH UNIVERSITY                                          ","2003-2004",10,"Ice Hockey",197802,200985,-3183,179554,185590,-6036,18248,15395,2853,"25","21",80232,12395
"13728",237066,"WHITWORTH COLLEGE                                           ","2003-2004",26,"Volleyball",47764,50951,-3187,0,0,0,47764,50951,-3187,".","12",0,28628
"9882",153278,"UNIVERSITY OF DUBUQUE                                       ","2003-2004",16,"Softball",58555,61743,-3188,0,0,0,58555,61743,-3188,".","25",0,25928
"13718",120865,"PACIFIC UNION COLLEGE                                       ","2003-2004",26,"Volleyball",14000,17190,-3190,0,0,0,14000,17190,-3190,".","10",0,13990
"10082",166683,"MASSACHUSETTS INSTITUTE OF TECHNOLOGY                       ","2003-2004",17,"Squash",32552,35746,-3194,32552,35746,-3194,0,0,0,"12",".",7407,0
"11416",236230,"PACIFIC LUTHERAN UNIVERSITY                                 ","2003-2004",22,"Tennis",9800,13000,-3200,4900,6200,-1300,4900,6800,-1900,"15","12",4900,4900
"12643",230995,"NORWICH UNIVERSITY                                          ","2003-2004",25,"Track and Field, X-Country",6635,9837,-3202,3791,5621,-1830,2844,4216,-1372,"20","15",4891,3669
"7151",240620,"LARAMIE COUNTY COMMUNITY COLLEGE                            ","2003-2004",15,"Soccer",84588,87796,-3208,42294,48122,-5828,42294,39674,2620,"23","16",17326,18820
"14560",137546,"STETSON UNIVERSITY                                          ","2003-2004",26,"Volleyball",214943,218153,-3210,0,0,0,214943,218153,-3210,".","13",0,29314
"5244",198066,"BREVARD COLLEGE                                             ","2003-2004",8,"Golf",37000,40219,-3219,37000,40219,-3219,0,0,0,"6",".",10219,0
"14750",141486,"CHAMINADE UNIVERSITY OF HONOLULU                            ","2003-2004",27,"Water Polo",17700,20922,-3222,17700,20922,-3222,0,0,0,"8",".",15652,0
"2281",199582,"SAINT AUGUSTINES COLLEGE                                    ","2003-2004",2,"Basketball",511191,514426,-3235,227699,255996,-28297,283492,258430,25062,"13","12",40565,57193
"5737",149727,"WAUBONSEE COMMUNITY COLLEGE                                 ","2003-2004",8,"Golf",4450,7689,-3239,4450,7689,-3239,0,0,0,"6",".",4639,0
"1030",183822,"BLOOMFIELD COLLEGE                                          ","2003-2004",1,"Baseball",15700,18940,-3240,15700,18940,-3240,0,0,0,"26",".",15700,0
"7431",122597,"SAN FRANCISCO STATE UNIVERSITY                              ","2003-2004",15,"Soccer",274559,277800,-3241,123612,125927,-2315,150947,151873,-926,"23","32",27605,28628
"9653",214795,"PENNSYLVANIA STATE UNIVERSITY-PENN STATE MONT ALTO          ","2003-2004",16,"Softball",5000,8245,-3245,0,0,0,5000,8245,-3245,".","24",0,5000
"5675",199999,"WINSTON-SALEM STATE UNIVERSITY                              ","2003-2004",8,"Golf",6770,10028,-3258,6770,10028,-3258,0,0,0,"7",".",4120,0
"10429",191339,"GENESEE COMMUNITY COLLEGE                                   ","2003-2004",18,"Swimming and Diving",15546,18806,-3260,7773,10746,-2973,7773,8060,-287,"5","15",8060,716
"8117",196158,"SUNY COLLEGE AT FREDONIA                                    ","2003-2004",15,"Soccer",150885,154150,-3265,82309,85205,-2896,68576,68945,-369,"31","24",31469,29188
"14766",210571,"ALBRIGHT COLLEGE                                            ","2003-2004",28,"Wrestling",6847,10117,-3270,6847,10117,-3270,0,0,0,"10",".",6847,0
"10249",162584,"FROSTBURG STATE UNIVERSITY                                  ","2003-2004",18,"Swimming and Diving",42699,45970,-3271,25111,25513,-402,17588,20457,-2869,"19","22",12845,10503
"10042",174473,"NORTHLAND COMMUNITY AND TECHNICAL COLLEGE                   ","2003-2004",16,"Softball",25653,28927,-3274,0,0,0,25653,28927,-3274,".","15",0,28682
"10810",154350,"SIMPSON COLLEGE                                             ","2003-2004",22,"Tennis",27868,31147,-3279,13934,16159,-2225,13934,14988,-1054,"10","13",6968,5796
"10712",173920,"MINNESOTA STATE UNVERSITY-MANKATO                           ","2003-2004",22,"Tennis",28458,31744,-3286,14409,14269,140,14049,17475,-3426,"7","8",5909,6093
"8668",239080,"MARIAN COLLEGE OF FOND DU LAC                               ","2003-2004",16,"Softball",64241,67536,-3295,0,0,0,64241,67536,-3295,".","16",0,13275
"16940",214740,"PENNSYLVANIA STATE UNIVERSITY-PENN STATE DUBOIS             ","2003-2004",39,"Total Participants",5883,9182,-3299,861,1548,-687,5022,7634,-2612,"18","14",18217,5022
"7626",173452,"MARTIN LUTHER COLLEGE                                       ","2003-2004",15,"Soccer",13500,16800,-3300,6500,8500,-2000,7000,8300,-1300,"22","18",6200,6000
"13643",204194,"MOUNT VERNON NAZARENE UNIVERSITY                            ","2003-2004",26,"Volleyball",20211,23519,-3308,0,0,0,20211,23519,-3308,".","12",0,20211
"8495",215266,"UNIVERSITY OF PITTSBURGH-BRADFORD                           ","2003-2004",15,"Soccer",75400,78709,-3309,37700,40698,-2998,37700,38011,-311,"22","16",15912,13388
"3645",217998,"ERSKINE COLLEGE AND SEMINARY                                ","2003-2004",3,"All Track Combined",6000,9315,-3315,3000,4500,-1500,3000,4815,-1815,"8","10",2500,2815
"9087",134079,"FLORIDA SOUTHERN COLLEGE                                    ","2003-2004",16,"Softball",188753,192084,-3331,0,0,0,188753,192084,-3331,".","15",0,68084
"4883",237792,"SHEPHERD COLLEGE                                            ","2003-2004",7,"Football",611198,614536,-3338,611198,614536,-3338,0,0,0,"97",".",95061,0
"5834",200156,"JAMESTOWN COLLEGE                                           ","2003-2004",8,"Golf",9476,12818,-3342,4838,6238,-1400,4638,6580,-1942,"8","4",1500,1342
"13111",162609,"GARRETT COLLEGE                                             ","2003-2004",26,"Volleyball",17988,21338,-3350,0,0,0,17988,21338,-3350,".","10",0,9206
"14677",121150,"PEPPERDINE UNIVERSITY                                       ","2003-2004",27,"Water Polo",325786,329145,-3359,325786,329145,-3359,0,0,0,"20",".",34283,0
"3008",153621,"IOWA WESLEYAN COLLEGE                                       ","2003-2004",2,"Basketball",41902,45262,-3360,20485,22363,-1878,21417,22899,-1482,"17","18",18331,19263
"2107",146278,"JOHN WOOD COMMUNITY COLLEGE                                 ","2003-2004",2,"Basketball",66931,70299,-3368,39246,39851,-605,27685,30448,-2763,"15","15",13757,14720
"15403",243188,"UNIVERSITY OF PUERTO RICO-UTUADO                            ","2003-2004",38,"Weight Lifting",4000,7384,-3384,2000,3692,-1692,2000,3692,-1692,"8","9",2192,2192
"6200",161341,"UNIVERSITY OF MAINE AT PRESQUE ISLE                         ","2003-2004",8,"Golf",612,4000,-3388,612,4000,-3388,0,0,0,"5","0",3628,0
"9140",234711,"BIG BEND COMMUNITY COLLEGE                                  ","2003-2004",16,"Softball",19812,23205,-3393,0,0,0,19812,23205,-3393,".","11",0,19800
"11237",236638,"SKAGIT VALLEY COLLEGE                                       ","2003-2004",22,"Tennis",11000,14398,-3398,5500,7199,-1699,5500,7199,-1699,"6","6",5500,5500
"5473",181765,"NEBRASKA COLLEGE OF TECHNICAL AGRICULTURE                   ","2003-2004",8,"Golf",2000,5400,-3400,1000,2700,-1700,1000,2700,-1700,"10","2",1000,1000
"6038",161545,"SOUTHERN MAINE COMMUNITY COLLEGE                            ","2003-2004",8,"Golf",4000,7400,-3400,2000,3700,-1700,2000,3700,-1700,"4",".",3500,3500
"4199",214041,"MILLERSVILLE UNIVERSITY OF PENNSYLVANIA                     ","2003-2004",6,"Field hocky",58845,62253,-3408,0,0,0,58845,62253,-3408,".","22",0,15823
"16239",186399,"RUTGERS UNIVERSITY-NEWARK                                   ","2003-2004",39,"Total Participants",574690,578098,-3408,379819,382900,-3081,194871,195198,-327,"102","69",166724,72203
"14047",215266,"UNIVERSITY OF PITTSBURGH-BRADFORD                           ","2003-2004",26,"Volleyball",30576,33985,-3409,0,0,0,30576,33985,-3409,".","11",0,14342
"10450",113193,"CUESTA COLLEGE                                              ","2003-2004",18,"Swimming and Diving",15374,18784,-3410,7687,9392,-1705,7687,9392,-1705,"22","15",3793,3796
"11386",212115,"EAST STROUDSBURG UNIVERSITY OF PENNSYLVANIA                 ","2003-2004",22,"Tennis",22543,25953,-3410,10800,12817,-2017,11743,13136,-1393,"8","9",2052,1539
"7248",239080,"MARIAN COLLEGE OF FOND DU LAC                               ","2003-2004",15,"Soccer",76690,80119,-3429,40931,45089,-4158,35759,35030,729,"19","16",14668,12382
"948",198695,"HIGH POINT UNIVERSITY                                       ","2003-2004",1,"Baseball",318879,322312,-3433,318879,322312,-3433,0,0,0,"33",".",48520,0
"3238",198154,"CAPE FEAR COMMUNITY COLLEGE                                 ","2003-2004",2,"Basketball",22683,26120,-3437,22683,26120,-3437,0,0,0,"12",".",25010,0
"13924",195562,"SAINT JOSEPHS COLLEGE-SUFFOLK CAMPUS                        ","2003-2004",26,"Volleyball",21837,25275,-3438,0,0,0,21837,25275,-3438,".","10",0,17200
"5162",162690,"HAGERSTOWN COMMUNITY COLLEGE                                ","2003-2004",8,"Golf",3786,7228,-3442,3786,7228,-3442,0,0,0,"5",".",4254,0
"3291",196219,"SUNY COLLEGE AT PURCHASE                                    ","2003-2004",2,"Basketball",41579,45036,-3457,21700,22990,-1290,19879,22046,-2167,"10","8",21700,19879
"12947",122746,"SAN JOSE CITY COLLEGE                                       ","2003-2004",25,"Track and Field, X-Country",86986,90446,-3460,78486,80949,-2463,8500,9497,-997,"9","2",2464,997
"14841",154350,"SIMPSON COLLEGE                                             ","2003-2004",28,"Wrestling",59490,62951,-3461,59490,62951,-3461,0,0,0,"28",".",41541,0
"7240",122180,"SACRAMENTO CITY COLLEGE                                     ","2003-2004",15,"Soccer",1,3463,-3462,0,0,0,1,3463,-3462,".","19",0,1878
"6731",194222,"ONONDAGA COMMUNITY COLLEGE                                  ","2003-2004",11,"Lacrosse",24022,27487,-3465,24022,27487,-3465,0,0,0,"25",".",19487,0
"8426",110653,"UNIVERSITY OF CALIFORNIA-IRVINE                             ","2003-2004",15,"Soccer",702505,705972,-3467,358425,354614,3811,344080,351358,-7278,"31","20",34693,42312
"12950",167251,"NEWBURY COLLEGE-BROOKLINE                                   ","2003-2004",25,"Track and Field, X-Country",216,3683,-3467,187,1909,-1722,29,1774,-1745,"9","11",594,594
"12370",173142,"BETHANY LUTHERAN COLLEGE                                    ","2003-2004",25,"Track and Field, X-Country",16332,19803,-3471,8026,9201,-1175,8306,10602,-2296,"2","7",1123,1123
"10937",171599,"OLIVET COLLEGE                                              ","2003-2004",22,"Tennis",19344,22817,-3473,0,0,0,19344,22817,-3473,".","12",0,9233
"9195",206525,"WITTENBERG UNIVERSITY                                       ","2003-2004",16,"Softball",39546,43027,-3481,0,0,0,39546,43027,-3481,".","24",0,13521
"13025",161341,"UNIVERSITY OF MAINE AT PRESQUE ISLE                         ","2003-2004",26,"Volleyball",519,4000,-3481,0,0,0,519,4000,-3481,"0","8",0,3819
"5211",200022,"BISMARCK STATE COLLEGE                                      ","2003-2004",8,"Golf",4000,7495,-3495,4000,7495,-3495,0,0,0,"6","0",7494,0
"6795",192749,"MANHATTANVILLE COLLEGE                                      ","2003-2004",11,"Lacrosse",47859,51358,-3499,19320,20355,-1035,28539,31003,-2464,"26","16",10261,6759
"259",214652,"PENNSYLVANIA STATE UNIV-PENN ST WORTHINGTON SCRNTN          ","2003-2004",1,"Baseball",7500,11000,-3500,7500,11000,-3500,0,0,0,"20",".",750,0
"4428",115126,"GOLDEN WEST COLLEGE                                         ","2003-2004",7,"Football",121667,125167,-3500,121667,125167,-3500,0,0,0,"82",".",35085,0
"5267",137564,"SOUTHEASTERN COLLEGE ASSEMBLIES OF GOD                      ","2003-2004",8,"Golf",8500,12000,-3500,8500,12000,-3500,0,0,0,"6",".",8500,0
"6134",211088,"ARCADIA UNIVERSITY                                          ","2003-2004",8,"Golf",1044,4544,-3500,1044,4544,-3500,0,0,0,"7",".",2044,0
"7976",231077,"COLLEGE OF ST JOSEPH                                        ","2003-2004",15,"Soccer",146769,150269,-3500,95807,95807,0,50962,54462,-3500,"16","12",92015,50962
"10001",231077,"COLLEGE OF ST JOSEPH                                        ","2003-2004",16,"Softball",36199,39699,-3500,0,0,0,36199,39699,-3500,".","12",0,36199
"11385",210571,"ALBRIGHT COLLEGE                                            ","2003-2004",22,"Tennis",10058,13558,-3500,4281,5281,-1000,5777,8277,-2500,"7","13",4281,5777
"12776",211088,"ARCADIA UNIVERSITY                                          ","2003-2004",25,"Track and Field, X-Country",1456,4956,-3500,728,2478,-1750,728,2478,-1750,"6","6",1228,1228
"5192",199962,"WINGATE UNIVERSITY                                          ","2003-2004",8,"Golf",39731,43234,-3503,21813,23596,-1783,17918,19638,-1720,"11","9",14269,12750
"11626",128106,"COLORADO STATE UNIVERSITY-PUEBLO                            ","2003-2004",22,"Tennis",83728,87237,-3509,31177,42956,-11779,52551,44281,8270,"8","7",12600,12925
"4211",216287,"SWARTHMORE COLLEGE                                          ","2003-2004",6,"Field hocky",16545,20057,-3512,0,0,0,16545,20057,-3512,".","26",0,19414
"5348",169275,"MOTT COMMUNITY COLLEGE                                      ","2003-2004",8,"Golf",500,4023,-3523,500,4023,-3523,0,0,0,"6",".",3523,0
"9478",177940,"LINCOLN UNIVERSITY                                          ","2003-2004",16,"Softball",86642,90174,-3532,0,0,0,86642,90174,-3532,".","15",0,32871
"13578",200022,"BISMARCK STATE COLLEGE                                      ","2003-2004",26,"Volleyball",13346,16879,-3533,0,0,0,13346,16879,-3533,"0","8",0,16880
"5648",215929,"UNIVERSITY OF SCRANTON                                      ","2003-2004",8,"Golf",17756,21295,-3539,17756,21295,-3539,0,0,0,"12",".",7938,0
"6169",191083,"ERIE COMMUNITY COLLEGE                                      ","2003-2004",8,"Golf",6835,10377,-3542,5495,7177,-1682,1340,3200,-1860,"10","1",6302,2325
"7522",178411,"UNIVERSITY OF MISSOURI-ROLLA                                ","2003-2004",15,"Soccer",201842,205385,-3543,107475,108512,-1037,94367,96873,-2506,"35","21",30185,21464
"15399",243188,"UNIVERSITY OF PUERTO RICO-UTUADO                            ","2003-2004",37,"Table Tennis",1000,4546,-3546,400,3338,-2938,600,1208,-608,"4","4",530,530
"6793",215929,"UNIVERSITY OF SCRANTON                                      ","2003-2004",11,"Lacrosse",88471,92018,-3547,39728,39728,0,48743,52290,-3547,"23","19",17162,21593
"5474",163657,"PRINCE GEORGES COMMUNITY COLLEGE                            ","2003-2004",8,"Golf",300,3854,-3554,300,3854,-3554,0,0,0,"5",".",704,0
"11047",218414,"NEWBERRY COLLEGE                                            ","2003-2004",22,"Tennis",9919,13474,-3555,6124,9679,-3555,3795,3795,0,"6","2",6126,3794
"3515",173045,"AUGSBURG COLLEGE                                            ","2003-2004",3,"All Track Combined",106414,109970,-3556,49369,54985,-5616,57045,54985,2060,"29","22",25760,25760
"12681",122889,"SANTA BARBARA CITY COLLEGE                                  ","2003-2004",25,"Track and Field, X-Country",47347,50908,-3561,22824,25630,-2806,24523,25278,-755,"18","12",11533,11180
"844",153278,"UNIVERSITY OF DUBUQUE                                       ","2003-2004",1,"Baseball",64827,68392,-3565,64827,68392,-3565,0,0,0,"55",".",28245,0
"9935",216287,"SWARTHMORE COLLEGE                                          ","2003-2004",16,"Softball",10745,14321,-3576,0,0,0,10745,14321,-3576,".","17",0,13636
"11879",151777,"MANCHESTER COLLEGE                                          ","2003-2004",23,"Track and Field, Indoor",22164,25740,-3576,11082,12870,-1788,11082,12870,-1788,"44","32",3700,3700
"11977",151777,"MANCHESTER COLLEGE                                          ","2003-2004",24,"Track and Field, Outdoor",22164,25740,-3576,11082,12870,-1788,11082,12870,-1788,"44","32",3700,3700
"15267",195526,"SKIDMORE COLLEGE                                            ","2003-2004",34,"Equestrian",15726,19305,-3579,0,0,0,15726,19305,-3579,".","25",0,11477
"8405",230038,"BRIGHAM YOUNG UNIVERSITY                                    ","2003-2004",15,"Soccer",570777,574358,-3581,0,0,0,570777,574358,-3581,".","29",0,130181
"5345",195988,"SULLIVAN COUNTY COMMUNITY COLLEGE                           ","2003-2004",8,"Golf",5915,9499,-3584,5915,9499,-3584,0,0,0,"5","0",9498,0
"14708",122180,"SACRAMENTO CITY COLLEGE                                     ","2003-2004",27,"Water Polo",1,3591,-3590,0,0,0,1,3591,-3590,".","17",0,2451
"13748",213367,"LA SALLE UNIVERSITY                                         ","2003-2004",26,"Volleyball",248315,251914,-3599,0,0,0,248315,251914,-3599,".","13",0,41531
"2852",243142,"UNIVERSITY OF PUERTO RICO IN CAROLINA                       ","2003-2004",2,"Basketball",6440,10040,-3600,3220,5020,-1800,3220,5020,-1800,"15","15",3250,3250
"10329",121901,"RIVERSIDE COMMUNITY COLLEGE                                 ","2003-2004",18,"Swimming and Diving",8000,11600,-3600,4000,5400,-1400,4000,6200,-2200,"15","10",2600,2700
"10887",194824,"RENSSELAER POLYTECHNIC INSTITUTE                            ","2003-2004",22,"Tennis",70971,74571,-3600,34814,36864,-2050,36157,37707,-1550,"12","12",7964,8807
"11352",238661,"EDGEWOOD COLLEGE                                            ","2003-2004",22,"Tennis",6615,10215,-3600,0,0,0,6615,10215,-3600,".","7",0,5615
"13327",234669,"BELLEVUE COMMUNITY COLLEGE                                  ","2003-2004",26,"Volleyball",22000,25600,-3600,0,0,0,22000,25600,-3600,".","15",0,7050
"13344",214698,"PENNSYLVANIA STATE UNIVERSITY-PENN STATE BEAVER             ","2003-2004",26,"Volleyball",100,3700,-3600,0,0,0,100,3700,-3600,"0","10",0,3600
"14308",243142,"UNIVERSITY OF PUERTO RICO IN CAROLINA                       ","2003-2004",26,"Volleyball",5640,9240,-3600,2820,4620,-1800,2820,4620,-1800,"12","12",3250,3250
"15389",241225,"BAYAMON CENTRAL UNIVERSITY                                  ","2003-2004",37,"Table Tennis",1000,4600,-3600,500,2300,-1800,500,2300,-1800,"4","4",1540,1540
"14433",127060,"UNIVERSITY OF DENVER                                        ","2003-2004",26,"Volleyball",728366,731969,-3603,0,0,0,728366,731969,-3603,".","15",0,115383
"15699",145831,"ILLINOIS VALLEY COMMUNITY COLLEGE                           ","2003-2004",39,"Total Participants",71198,74807,-3609,33431,36891,-3460,37767,37916,-149,"61","39",31910,30078
"1555",228325,"SOUTHWESTERN ASSEMBLIES OF GOD UNIVERSITY                   ","2003-2004",1,"Baseball",34148,37760,-3612,34148,37760,-3612,0,0,0,"15",".",11295,0
"14655",117733,"LOS ANGELES VALLEY COLLEGE                                  ","2003-2004",27,"Water Polo",33159,36771,-3612,16126,17932,-1806,17033,18839,-1806,"11","13",5750,6434
"2804",155201,"INDEPENDENCE COMMUNITY COLLEGE                              ","2003-2004",2,"Basketball",183840,187477,-3637,89968,93578,-3610,93872,93899,-27,"12","13",18745,20549
"11098",149727,"WAUBONSEE COMMUNITY COLLEGE                                 ","2003-2004",22,"Tennis",9200,12841,-3641,4600,7251,-2651,4600,5590,-990,"6","6",3801,1740
"4222",182670,"DARTMOUTH COLLEGE                                           ","2003-2004",6,"Field hocky",182740,186382,-3642,0,0,0,182740,186382,-3642,".","23",0,39162
"9700",216524,"URSINUS COLLEGE                                             ","2003-2004",16,"Softball",24975,28618,-3643,0,0,0,24975,28618,-3643,".","18",0,19010
"143",182634,"COLBY-SAWYER COLLEGE                                        ","2003-2004",1,"Baseball",67382,71029,-3647,67382,71029,-3647,0,0,0,"24",".",26558,0
"5173",170532,"KALAMAZOO COLLEGE                                           ","2003-2004",8,"Golf",11534,15182,-3648,5447,6555,-1108,6087,8627,-2540,"8","9",4402,5936
"11086",193326,"MONROE COMMUNITY COLLEGE                                    ","2003-2004",22,"Tennis",7047,10703,-3656,7047,10703,-3656,0,0,0,"5",".",5964,0
"11646",163657,"PRINCE GEORGES COMMUNITY COLLEGE                            ","2003-2004",22,"Tennis",300,3960,-3660,300,3960,-3660,0,0,0,"9",".",810,0
"11132",169080,"CALVIN COLLEGE                                              ","2003-2004",22,"Tennis",47347,51008,-3661,22939,24807,-1868,24408,26201,-1793,"7","8",8585,10115
"9887",172291,"ST CLAIR COUNTY COMMUNITY COLLEGE                           ","2003-2004",16,"Softball",23855,27517,-3662,0,0,0,23855,27517,-3662,".","15",0,16280
"10139",191986,"JAMESTOWN COMMUNITY COLLEGE                                 ","2003-2004",18,"Swimming and Diving",4135,7797,-3662,2135,4797,-2662,2000,3000,-1000,"10","4",1000,946
"13418",184694,"FAIRLEIGH DICKINSON UNIVERSITY-COLLEGE AT FLORHAM           ","2003-2004",26,"Volleyball",25284,28952,-3668,0,0,0,25284,28952,-3668,".","17",0,14744
"2697",209506,"OREGON INSTITUTE OF TECHNOLOGY                              ","2003-2004",2,"Basketball",179649,183319,-3670,105767,107493,-1726,73882,75826,-1944,"12","13",59788,34826
"14169",196866,"UNION COLLEGE                                               ","2003-2004",26,"Volleyball",63495,67185,-3690,0,0,0,63495,67185,-3690,".","15",0,12725
"5555",168342,"WILLIAMS COLLEGE                                            ","2003-2004",8,"Golf",23346,27041,-3695,23346,27041,-3695,0,0,0,"9","0",13709,0
"6974",186876,"THE RICHARD STOCKTON COLLEGE OF NEW JERSEY                  ","2003-2004",13,"Rowing",19908,23603,-3695,0,0,0,19908,23603,-3695,".","15",0,4765
"9817",229063,"TEXAS SOUTHERN UNIVERSITY                                   ","2003-2004",16,"Softball",288291,291986,-3695,0,0,0,288291,291986,-3695,".","15",0,118460
"12326",409698,"CALIFORNIA STATE UNIVERSITY-MONTEREY BAY                    ","2003-2004",25,"Track and Field, X-Country",17214,20910,-3696,9733,11774,-2041,7481,9136,-1655,"9","7",3197,2487
"11275",212133,"EASTERN UNIVERSITY                                          ","2003-2004",22,"Tennis",10742,14440,-3698,5328,7640,-2312,5414,6800,-1386,"8","8",3420,3020
"15354",217536,"SALVE REGINA UNIVERSITY                                     ","2003-2004",36,"Sailing",16310,20008,-3698,8155,10004,-1849,8155,10004,-1849,"10","10",4502,4502
"5291",190169,"COLUMBIA-GREENE COMMUNITY COLLEGE                           ","2003-2004",8,"Golf",100,3800,-3700,50,1900,-1850,50,1900,-1850,"3","0",1400,1400
"5621",186584,"SETON HALL UNIVERSITY                                       ","2003-2004",8,"Golf",133518,137223,-3705,133518,137223,-3705,0,0,0,"8",".",38005,0
"11032",154004,"MORNINGSIDE COLLEGE                                         ","2003-2004",22,"Tennis",1683,5389,-3706,0,0,0,1683,5389,-3706,".","4",0,1126
"5195",130183,"TEIKYO POST UNIVERSITY                                      ","2003-2004",8,"Golf",415,4126,-3711,415,4126,-3711,0,0,0,"8",".",4050,0
"12557",191612,"HERKIMER COUNTY COMMUNITY COLLEGE                           ","2003-2004",25,"Track and Field, X-Country",2100,5840,-3740,1050,2920,-1870,1050,2920,-1870,"6","6",1050,1050
"7865",154907,"CLOUD COUNTY COMMUNITY COLLEGE                              ","2003-2004",15,"Soccer",98401,102148,-3747,55554,57701,-2147,42847,44447,-1600,"25","14",334,596
"9102",188641,"ALFRED UNIVERSITY                                           ","2003-2004",16,"Softball",35987,39736,-3749,0,0,0,35987,39736,-3749,".","14",0,12100
"7676",236975,"WENATCHEE VALLEY COLLEGE                                    ","2003-2004",15,"Soccer",27894,31654,-3760,12852,15970,-3118,15042,15684,-642,"24","13",15969,15683
"2995",215309,"UNIVERSITY OF PITTSBURGH-TITUSVILLE                         ","2003-2004",2,"Basketball",36239,40002,-3763,36239,40002,-3763,0,0,0,"13",".",6002,0
"3190",235431,"HIGHLINE COMMUNITY COLLEGE                                  ","2003-2004",2,"Basketball",62328,66106,-3778,35648,38229,-2581,26680,27877,-1197,"14","12",14750,14750
"17056",128744,"UNIVERSITY OF BRIDGEPORT                                    ","2003-2004",39,"Total Participants",1091900,1095684,-3784,433203,431339,1864,658697,664345,-5648,"80","84",58103,61558
"659",149019,"SPRINGFIELD COLLEGE IN ILLINOIS                             ","2003-2004",1,"Baseball",68321,72108,-3787,68321,72108,-3787,0,0,0,"24",".",16681,0
"9694",170240,"HENRY FORD COMMUNITY COLLEGE                                ","2003-2004",16,"Softball",20355,24145,-3790,0,0,0,20355,24145,-3790,".","12",0,10000
"2987",209825,"UNIVERSITY OF PORTLAND                                      ","2003-2004",2,"Basketball",1859897,1863694,-3797,1111953,1092111,19842,747944,771583,-23639,"17","13",169579,137321
"5373",219259,"NORTHERN STATE UNIVERSITY                                   ","2003-2004",8,"Golf",3532,7329,-3797,3532,7329,-3797,0,0,0,"10",".",3797,0
"7118",178369,"MISSOURI VALLEY COLLEGE                                     ","2003-2004",15,"Soccer",17000,20800,-3800,8800,11800,-3000,8200,9000,-800,"35","28",8700,8396
"10952",157951,"WESTERN KENTUCKY UNIVERSITY                                 ","2003-2004",22,"Tennis",160043,163844,-3801,69118,75201,-6083,90925,88643,2282,"11","7",14558,17872
"11007",174251,"UNIVERSITY OF MINNESOTA-MORRIS                              ","2003-2004",22,"Tennis",6000,9805,-3805,3000,5568,-2568,3000,4237,-1237,"14","16",3056,2206
"1394",243142,"UNIVERSITY OF PUERTO RICO IN CAROLINA                       ","2003-2004",1,"Baseball",3892,7700,-3808,3892,7700,-3808,0,0,0,"18",".",5408,0
"16448",138558,"ABRAHAM BALDWIN AGRICULTURAL COLLEGE                        ","2003-2004",39,"Total Participants",223176,226985,-3809,127228,117680,9548,95948,109305,-13357,"55","41",133263,132948
"617",170240,"HENRY FORD COMMUNITY COLLEGE                                ","2003-2004",1,"Baseball",20335,24145,-3810,20335,24145,-3810,0,0,0,"16",".",10000,0
"11437",169798,"EASTERN MICHIGAN UNIVERSITY                                 ","2003-2004",22,"Tennis",208543,212357,-3814,0,0,0,208543,212357,-3814,".","7",0,23242
"15195",227526,"PRAIRIE VIEW A &amp; M UNIVERSITY                               ","2003-2004",33,"Bowling",37708,41523,-3815,0,0,0,37708,41523,-3815,".","7",0,37708
"3030",106342,"LYON COLLEGE                                                ","2003-2004",2,"Basketball",501184,505000,-3816,263410,257334,6076,237774,247666,-9892,"13","16",28856,18919
"16438",174473,"NORTHLAND COMMUNITY AND TECHNICAL COLLEGE                   ","2003-2004",39,"Total Participants",63159,66979,-3820,23363,24203,-840,39796,42776,-2980,"114","42",67955,55694
"15165",243188,"UNIVERSITY OF PUERTO RICO-UTUADO                            ","2003-2004",32,"Beach Volleyball",1100,4925,-3825,700,3914,-3214,400,1011,-611,"5","3",746,393
"12808",191676,"HOUGHTON COLLEGE                                            ","2003-2004",25,"Track and Field, X-Country",178534,182378,-3844,82967,84889,-1922,95567,97489,-1922,"32","40",19777,19777
"9017",151111,"INDIANA UNIVERSITY-PURDUE UNIVERSITY-INDIANAPOLIS           ","2003-2004",16,"Softball",11975,15820,-3845,0,0,0,11975,15820,-3845,".","18",0,8866
"16762",194569,"PRACTICAL BIBLE COLLEGE                                     ","2003-2004",39,"Total Participants",15013,18863,-3850,8204,10554,-2350,6809,8309,-1500,"45","18",15209,13814
"12020",239318,"MILWAUKEE SCHOOL OF ENGINEERING                             ","2003-2004",24,"Track and Field, Outdoor",11001,14853,-3852,7334,9297,-1963,3667,5556,-1889,"26","8",5312,1345
"5527",211343,"BUTLER COUNTY COMMUNITY COLLEGE                             ","2003-2004",8,"Golf",2200,6059,-3859,2200,6059,-3859,0,0,0,"7",".",4329,0
"3137",186469,"SALEM COMMUNITY COLLEGE                                     ","2003-2004",2,"Basketball",39525,43386,-3861,15105,16945,-1840,24420,26441,-2021,"14","7",7373,7088
"12379",238430,"CARDINAL STRITCH UNIVERSITY                                 ","2003-2004",25,"Track and Field, X-Country",2420,6287,-3867,1220,3086,-1866,1200,3201,-2001,"5","5",1009,992
"14997",113193,"CUESTA COLLEGE                                              ","2003-2004",28,"Wrestling",9110,12978,-3868,9110,12978,-3868,0,0,0,"27",".",7382,0
"5820",134945,"JACKSONVILLE UNIVERSITY                                     ","2003-2004",8,"Golf",184851,188723,-3872,91701,93220,-1519,93150,95503,-2353,"10","8",14213,13389
"13702",199069,"MOUNT OLIVE COLLEGE                                         ","2003-2004",26,"Volleyball",94787,98660,-3873,0,0,0,94787,98660,-3873,".","10",0,32966
"2915",162210,"COLUMBIA UNION COLLEGE                                      ","2003-2004",2,"Basketball",169859,173743,-3884,93298,92447,851,76561,81296,-4735,"13","12",30136,26247
"8413",240055,"UNIVERSITY OF WISCONSIN COLLEGES                            ","2003-2004",15,"Soccer",45102,48990,-3888,44290,47178,-2888,812,1812,-1000,"116",".",40091,812
"7993",224004,"CONCORDIA UNIVERSITY AT AUSTIN                              ","2003-2004",15,"Soccer",19640,23542,-3902,19640,23542,-3902,0,0,0,"19",".",10042,0
"10268",237181,"BETHANY COLLEGE                                             ","2003-2004",18,"Swimming and Diving",26780,30688,-3908,14640,16794,-2154,12140,13894,-1754,"13","12",5811,5748
"13053",108807,"ALLAN HANCOCK COLLEGE                                       ","2003-2004",26,"Volleyball",20569,24481,-3912,0,0,0,20569,24481,-3912,".","13",0,10279
"14251",172644,"WAYNE STATE UNIVERSITY                                      ","2003-2004",26,"Volleyball",194413,198325,-3912,0,0,0,194413,198325,-3912,".","10",0,27754
"1423",239628,"RIPON COLLEGE                                               ","2003-2004",1,"Baseball",41554,45467,-3913,41554,45467,-3913,0,0,0,"48",".",30500,0
"11827",126678,"COLORADO COLLEGE                                            ","2003-2004",23,"Track and Field, Indoor",3217,7139,-3922,0,0,0,3217,7139,-3922,".","10",0,1719
"12855",213321,"KINGS COLLEGE                                               ","2003-2004",25,"Track and Field, X-Country",2670,6600,-3930,1335,3300,-1965,1335,3300,-1965,"9","6",1335,1335
"10489",212115,"EAST STROUDSBURG UNIVERSITY OF PENNSYLVANIA                 ","2003-2004",19,"Swimming",80719,84653,-3934,0,0,0,80719,84653,-3934,"0","26",0,12680
"6048",110653,"UNIVERSITY OF CALIFORNIA-IRVINE                             ","2003-2004",8,"Golf",373822,377764,-3942,169473,174575,-5102,204349,203189,1160,"11","8",37836,47700
"15197",188438,"ADIRONDACK COMMUNITY COLLEGE                                ","2003-2004",33,"Bowling",252,4196,-3944,126,2098,-1972,126,2098,-1972,"6","6",1680,1680
"3897",227429,"PAUL QUINN COLLEGE                                          ","2003-2004",3,"All Track Combined",43452,47403,-3951,31202,35439,-4237,12250,11964,286,"15","15",20306,11005
"8312",194240,"ORANGE COUNTY COMMUNITY COLLEGE                             ","2003-2004",15,"Soccer",12252,16206,-3954,12252,16206,-3954,0,0,0,"15",".",11694,0
"15215",163657,"PRINCE GEORGES COMMUNITY COLLEGE                            ","2003-2004",33,"Bowling",804,4758,-3954,402,2379,-1977,402,2379,-1977,"2","5",865,865
"6907",212054,"DREXEL UNIVERSITY                                           ","2003-2004",13,"Rowing",287825,291781,-3956,134635,136663,-2028,153190,155118,-1928,"36","32",24833,24834
"10732",224004,"CONCORDIA UNIVERSITY AT AUSTIN                              ","2003-2004",22,"Tennis",12350,16308,-3958,6175,8154,-1979,6175,8154,-1979,"4","6",2154,2154
"17220",200846,"UNIVERSITY OF AKRON-WAYNE COLLEGE                           ","2003-2004",39,"Total Participants",7000,10959,-3959,5000,6660,-1660,2000,4299,-2299,"19","18",17471,12045
"14837",144218,"CITY COLLEGES OF CHICAGO-WILBUR WRIGHT COLLEGE              ","2003-2004",28,"Wrestling",5000,8960,-3960,5000,8960,-3960,0,0,0,"6",".",235,0
"16721",144218,"CITY COLLEGES OF CHICAGO-WILBUR WRIGHT COLLEGE              ","2003-2004",39,"Total Participants",5000,8960,-3960,5000,8960,-3960,0,0,0,"14","9",548,278
"6723",213367,"LA SALLE UNIVERSITY                                         ","2003-2004",11,"Lacrosse",290269,294231,-3962,0,0,0,290269,294231,-3962,".","24",0,41066
"15263",130183,"TEIKYO POST UNIVERSITY                                      ","2003-2004",34,"Equestrian",2493,6456,-3963,0,0,0,2493,6456,-3963,".","26",0,6236
"16625",236595,"SEATTLE UNIVERSITY                                          ","2003-2004",39,"Total Participants",1167550,1171514,-3964,511842,479120,32722,655708,692394,-36686,"78","115",204315,252852
"7011",110653,"UNIVERSITY OF CALIFORNIA-IRVINE                             ","2003-2004",13,"Rowing",286116,290086,-3970,143058,145043,-1985,143058,145043,-1985,"42","50",23079,23079
"11369",236708,"SPOKANE FALLS COMMUNITY COLLEGE                             ","2003-2004",22,"Tennis",30780,34750,-3970,15390,17756,-2366,15390,16994,-1604,"6","6",14764,14764
"15254",195562,"SAINT JOSEPHS COLLEGE-SUFFOLK CAMPUS                        ","2003-2004",34,"Equestrian",19396,23368,-3972,0,0,0,19396,23368,-3972,".","12",0,4776
"6110",203580,"LAKE ERIE COLLEGE                                           ","2003-2004",8,"Golf",5921,9911,-3990,5921,9911,-3990,0,0,0,"7",".",4976,0
"12173",196699,"SUNY ULSTER COUNTY COMMUNITY COLLEGE                        ","2003-2004",25,"Track and Field, X-Country",3000,6990,-3990,1500,3495,-1995,1500,3495,-1995,"7","5",1995,1995
"2308",140234,"LAGRANGE COLLEGE                                            ","2003-2004",2,"Basketball",171646,175642,-3996,82173,90760,-8587,89473,84882,4591,"12","10",39200,39200
"981",211307,"BUCKS COUNTY COMMUNITY COLLEGE                              ","2003-2004",1,"Baseball",6177,10177,-4000,6177,10177,-4000,0,0,0,"15",".",6177,0
"1530",214166,"MOUNT ALOYSIUS COLLEGE                                      ","2003-2004",1,"Baseball",13600,17600,-4000,13600,17600,-4000,0,0,0,"24",".",13600,0
"1716",220181,"FISK UNIVERSITY                                             ","2003-2004",2,"Basketball",38500,42500,-4000,25000,22500,2500,13500,20000,-6500,"15","15",10000,10000
"2295",106306,"ARKANSAS BAPTIST COLLEGE                                    ","2003-2004",2,"Basketball",134000,138000,-4000,67000,69000,-2000,67000,69000,-2000,"12","12",15000,15000
"3157",137564,"SOUTHEASTERN COLLEGE ASSEMBLIES OF GOD                      ","2003-2004",2,"Basketball",36000,40000,-4000,19500,22000,-2500,16500,18000,-1500,"16","12",19000,16500
"5504",174783,"SAINT CLOUD STATE UNIVERSITY                                ","2003-2004",8,"Golf",21950,25950,-4000,9635,9635,0,12315,16315,-4000,"9","8",4635,7315
"6187",176406,"TOUGALOO COLLEGE                                            ","2003-2004",8,"Golf",13700,17700,-4000,13700,17700,-4000,0,0,0,"5",".",4000,0
"7628",211307,"BUCKS COUNTY COMMUNITY COLLEGE                              ","2003-2004",15,"Soccer",13760,17760,-4000,13760,17760,-4000,0,0,0,"21",".",13760,0
"8010",179946,"WESTMINSTER COLLEGE                                         ","2003-2004",15,"Soccer",36000,40000,-4000,18000,20000,-2000,18000,20000,-2000,"25","15",15000,15000
"9474",196699,"SUNY ULSTER COUNTY COMMUNITY COLLEGE                        ","2003-2004",16,"Softball",3000,7000,-4000,0,0,0,3000,7000,-4000,".","11",0,3850
"9962",214166,"MOUNT ALOYSIUS COLLEGE                                      ","2003-2004",16,"Softball",11700,15700,-4000,0,0,0,11700,15700,-4000,".","14",0,11700
"10036",220604,"LE MOYNE-OWEN COLLEGE                                       ","2003-2004",16,"Softball",49000,53000,-4000,0,0,0,49000,53000,-4000,".","12",0,49000
"10384",191612,"HERKIMER COUNTY COMMUNITY COLLEGE                           ","2003-2004",18,"Swimming and Diving",6000,10000,-4000,3000,5000,-2000,3000,5000,-2000,"4","10",3000,3000
"10539",199865,"WARREN WILSON COLLEGE                                       ","2003-2004",19,"Swimming",10000,14000,-4000,5000,5500,-500,5000,8500,-3500,"4","14",3500,6500
"11129",211307,"BUCKS COUNTY COMMUNITY COLLEGE                              ","2003-2004",22,"Tennis",2576,6576,-4000,2576,6576,-4000,0,0,0,"6",".",2576,0
"12303",230834,"CASTLETON STATE COLLEGE                                     ","2003-2004",25,"Track and Field, X-Country",5134,9134,-4000,2567,4567,-2000,2567,4567,-2000,"8","8",2567,2567
"12355",173452,"MARTIN LUTHER COLLEGE                                       ","2003-2004",25,"Track and Field, X-Country",5000,9000,-4000,2500,4500,-2000,2500,4500,-2000,"18","16",2500,2500
"13285",183099,"NEW HAMPSHIRE TECHNICAL INSTITUTE                           ","2003-2004",26,"Volleyball",12000,16000,-4000,6000,8000,-2000,6000,8000,-2000,"8","9",3000,3000
"13911",182661,"DANIEL WEBSTER COLLEGE                                      ","2003-2004",26,"Volleyball",4263,8263,-4000,0,0,0,4263,8263,-4000,".","8",0,4263
"14520",214166,"MOUNT ALOYSIUS COLLEGE                                      ","2003-2004",26,"Volleyball",16500,20500,-4000,0,0,0,16500,20500,-4000,".","12",0,16500
"15411",242671,"INTER AMERICAN UNIV OF PUERTO RICO-CENTRAL OFFICE           ","2003-2004",38,"Weight Lifting",12400,16400,-4000,11216,11216,0,1184,5184,-4000,"8","8",4000,4000
"16667",242671,"INTER AMERICAN UNIV OF PUERTO RICO-CENTRAL OFFICE           ","2003-2004",39,"Total Participants",627293,631293,-4000,408513,408513,0,218780,222780,-4000,"130","61",107483,88477
"17193",183099,"NEW HAMPSHIRE TECHNICAL INSTITUTE                           ","2003-2004",39,"Total Participants",44000,48000,-4000,22000,24000,-2000,22000,24000,-2000,"61","55",17500,17000
"5562",204501,"OBERLIN COLLEGE                                             ","2003-2004",8,"Golf",16148,20150,-4002,16148,20150,-4002,0,0,0,"8",".",9887,0
"17247",196200,"SUNY-POTSDAM                                                ","2003-2004",39,"Total Participants",782740,786746,-4006,434495,438854,-4359,348245,347892,353,"128","152",258517,237942
"13343",214041,"MILLERSVILLE UNIVERSITY OF PENNSYLVANIA                     ","2003-2004",26,"Volleyball",82337,86344,-4007,0,0,0,82337,86344,-4007,".","15",0,16268
"17225",115126,"GOLDEN WEST COLLEGE                                         ","2003-2004",39,"Total Participants",460720,464730,-4010,255089,253699,1390,205631,211031,-5400,"260","98",105570,68736
"154",182661,"DANIEL WEBSTER COLLEGE                                      ","2003-2004",1,"Baseball",9877,13889,-4012,9877,13889,-4012,0,0,0,"17",".",6624,0
"15574",114433,"FEATHER RIVER COMMUNITY COLLEGE DISTRICT                    ","2003-2004",39,"Total Participants",170162,174175,-4013,134810,139524,-4714,35352,34651,701,"143","29",154422,44550
"6560",214041,"MILLERSVILLE UNIVERSITY OF PENNSYLVANIA                     ","2003-2004",11,"Lacrosse",89366,93388,-4022,0,0,0,89366,93388,-4022,".","19",0,16886
"14731",120290,"OHLONE COLLEGE                                              ","2003-2004",27,"Water Polo",35739,39774,-4035,31293,24375,6918,4446,15399,-10953,"10","11",7771,4688
"13445",233541,"SHENANDOAH UNIVERSITY                                       ","2003-2004",26,"Volleyball",52576,56617,-4041,0,0,0,52576,56617,-4041,".","12",0,19244
"8748",112172,"CITRUS COLLEGE                                              ","2003-2004",16,"Softball",13188,17237,-4049,0,0,0,13188,17237,-4049,".","10",0,7504
"3240",155496,"MANHATTAN CHRISTIAN COLLEGE                                 ","2003-2004",2,"Basketball",49442,53494,-4052,25200,27262,-2062,24242,26232,-1990,"14","12",24556,23628
"5726",185572,"MONMOUTH UNIVERSITY                                         ","2003-2004",8,"Golf",146028,150080,-4052,93716,97768,-4052,52312,52312,0,"10","6",26134,18988
"10464",152637,"VINCENNES UNIVERSITY                                        ","2003-2004",18,"Swimming and Diving",15712,19770,-4058,7856,9885,-2029,7856,9885,-2029,"9","3",7856,7856
"5878",215062,"UNIVERSITY OF PENNSYLVANIA                                  ","2003-2004",8,"Golf",102328,106388,-4060,49959,58660,-8701,52369,47728,4641,"8","9",32413,32414
"9914",178387,"MISSOURI WESTERN STATE COLLEGE                              ","2003-2004",16,"Softball",159583,163652,-4069,0,0,0,159583,163652,-4069,".","19",0,31477
"462",202514,"DEFIANCE COLLEGE                                            ","2003-2004",1,"Baseball",71898,75972,-4074,71898,75972,-4074,0,0,0,"35",".",44020,0
"831",240417,"UNIVERSITY OF WISCONSIN-STOUT                               ","2003-2004",1,"Baseball",68834,72911,-4077,68834,72911,-4077,0,0,0,"29",".",35409,0
"8372",168005,"SUFFOLK UNIVERSITY                                          ","2003-2004",15,"Soccer",9000,13081,-4081,9000,13081,-4081,0,0,0,"23",".",9000,0
"2887",209038,"LANE COMMUNITY COLLEGE                                      ","2003-2004",2,"Basketball",79678,83772,-4094,36370,39456,-3086,43308,44316,-1008,"13","11",18029,22212
"1250",162609,"GARRETT COLLEGE                                             ","2003-2004",1,"Baseball",48051,52147,-4096,48051,52147,-4096,0,0,0,"21",".",14209,0
"3789",171456,"NORTHERN MICHIGAN UNIVERSITY                                ","2003-2004",3,"All Track Combined",453140,457237,-4097,0,0,0,453140,457237,-4097,"0","60",0,77274
"8014",146685,"LINCOLN LAND COMMUNITY COLLEGE                              ","2003-2004",15,"Soccer",4320,8418,-4098,4320,8418,-4098,0,0,0,"19",".",6318,0
"494",194824,"RENSSELAER POLYTECHNIC INSTITUTE                            ","2003-2004",1,"Baseball",80140,84240,-4100,80140,84240,-4100,0,0,0,"50",".",26640,0
"4150",194824,"RENSSELAER POLYTECHNIC INSTITUTE                            ","2003-2004",6,"Field hocky",53900,58000,-4100,0,0,0,53900,58000,-4100,".","18",0,17480
"9213",194824,"RENSSELAER POLYTECHNIC INSTITUTE                            ","2003-2004",16,"Softball",48830,52930,-4100,0,0,0,48830,52930,-4100,".","16",0,12512
"5372",154350,"SIMPSON COLLEGE                                             ","2003-2004",8,"Golf",40520,44630,-4110,14443,23421,-8978,26077,21209,4868,"14","11",19270,13783
"9210",196158,"SUNY COLLEGE AT FREDONIA                                    ","2003-2004",16,"Softball",39863,43973,-4110,0,0,0,39863,43973,-4110,".","25",0,32255
"15852",176910,"CENTRAL CHRISTIAN COLLEGE OF THE BIBLE                      ","2003-2004",39,"Total Participants",14488,18602,-4114,12391,10865,1526,2097,7737,-5640,"31","19",15086,9564
"11250",217536,"SALVE REGINA UNIVERSITY                                     ","2003-2004",22,"Tennis",28346,32467,-4121,15721,18733,-3012,12625,13734,-1109,"11","12",13733,8734
"9791",174075,"UNIVERSITY OF MINNESOTA-CROOKSTON                           ","2003-2004",16,"Softball",32433,36562,-4129,0,0,0,32433,36562,-4129,".","14",0,17062
"7452",155496,"MANHATTAN CHRISTIAN COLLEGE                                 ","2003-2004",15,"Soccer",50491,54621,-4130,32478,35135,-2657,18013,19486,-1473,"21","16",31647,17552
"13281",209287,"MULTNOMAH BIBLE COLLEGE AND BIBLICAL SEMINARY               ","2003-2004",26,"Volleyball",24315,28447,-4132,0,0,0,24315,28447,-4132,".","9",0,2000
"16775",209287,"MULTNOMAH BIBLE COLLEGE AND BIBLICAL SEMINARY               ","2003-2004",39,"Total Participants",24315,28447,-4132,0,0,0,24315,28447,-4132,"10","9",2000,2000
"2001",174525,"OAK HILLS CHRISTIAN COLLEGE                                 ","2003-2004",2,"Basketball",23960,28095,-4135,12902,15128,-2226,11058,12967,-1909,"10","12",12398,10626
"12348",192925,"MEDAILLE COLLEGE                                            ","2003-2004",25,"Track and Field, X-Country",1,4136,-4135,0,0,0,1,4136,-4135,".","9",0,2136
"14101",162104,"CECIL COMMUNITY COLLEGE                                     ","2003-2004",26,"Volleyball",553,4697,-4144,0,0,0,553,4697,-4144,".","7",0,1045
"1000",196699,"SUNY ULSTER COUNTY COMMUNITY COLLEGE                        ","2003-2004",1,"Baseball",5000,9150,-4150,5000,9150,-4150,0,0,0,"15",".",8600,0
"8043",153126,"CLARKE COLLEGE                                              ","2003-2004",15,"Soccer",47119,51276,-4157,22556,24742,-2186,24563,26534,-1971,"19","17",12476,12267
"10398",227757,"RICE UNIVERSITY                                             ","2003-2004",18,"Swimming and Diving",592520,596711,-4191,0,0,0,592520,596711,-4191,".","20",0,88060
"4233",213367,"LA SALLE UNIVERSITY                                         ","2003-2004",6,"Field hocky",222011,226203,-4192,0,0,0,222011,226203,-4192,".","25",0,40179
"13118",236708,"SPOKANE FALLS COMMUNITY COLLEGE                             ","2003-2004",26,"Volleyball",48560,52752,-4192,0,0,0,48560,52752,-4192,".","16",0,38357
"5294",210571,"ALBRIGHT COLLEGE                                            ","2003-2004",8,"Golf",4442,8635,-4193,4442,8635,-4193,0,0,0,"10",".",4442,0
"12050",126678,"COLORADO COLLEGE                                            ","2003-2004",24,"Track and Field, Outdoor",55368,59564,-4196,29341,32129,-2788,26027,27435,-1408,"25","15",13777,11305
"5708",213321,"KINGS COLLEGE                                               ","2003-2004",8,"Golf",3868,8066,-4198,3868,8066,-4198,0,0,0,"9",".",3868,0
"8727",214652,"PENNSYLVANIA STATE UNIV-PENN ST WORTHINGTON SCRNTN          ","2003-2004",16,"Softball",5500,9700,-4200,0,0,0,5500,9700,-4200,".","9",0,600
"12775",121901,"RIVERSIDE COMMUNITY COLLEGE                                 ","2003-2004",25,"Track and Field, X-Country",19000,23200,-4200,12000,12900,-900,7000,10300,-3300,"40","20",7500,7500
"14300",236230,"PACIFIC LUTHERAN UNIVERSITY                                 ","2003-2004",26,"Volleyball",12600,16800,-4200,0,0,0,12600,16800,-4200,".","16",0,12600
"15117",235149,"EVERETT COMMUNITY COLLEGE                                   ","2003-2004",29,"Other Sports",400,4600,-4200,200,2300,-2100,200,2300,-2100,"6","14",600,600
"13380",196024,"SUNY COLLEGE OF TECHNOLOGY AT DELHI                         ","2003-2004",26,"Volleyball",4100,8305,-4205,0,0,0,4100,8305,-4205,".","9",0,3805
"9690",191083,"ERIE COMMUNITY COLLEGE                                      ","2003-2004",16,"Softball",13918,18126,-4208,0,0,0,13918,18126,-4208,".","10",0,14787
"8199",110246,"BUTTE COLLEGE                                               ","2003-2004",15,"Soccer",24506,28716,-4210,0,0,0,24506,28716,-4210,".","20",0,22348
"13252",156295,"BEREA COLLEGE                                               ","2003-2004",26,"Volleyball",7000,11211,-4211,0,0,0,7000,11211,-4211,".","15",0,7011
"12508",168005,"SUFFOLK UNIVERSITY                                          ","2003-2004",25,"Track and Field, X-Country",3600,7828,-4228,1800,3914,-2114,1800,3914,-2114,"5","5",1800,1800
"14686",186131,"PRINCETON UNIVERSITY                                        ","2003-2004",27,"Water Polo",206217,210465,-4248,100251,101422,-1171,105966,109043,-3077,"25","19",25294,42812
"7823",201371,"BLUFFTON COLLEGE                                            ","2003-2004",15,"Soccer",76260,80511,-4251,35515,35999,-484,40745,44512,-3767,"18","12",6665,9820
"11516",141574,"UNIVERSITY OF HAWAII AT MANOA                               ","2003-2004",22,"Tennis",377965,382216,-4251,193954,198573,-4619,184011,183643,368,"9","10",94309,74982
"14603",121707,"COLLEGE OF THE REDWOODS                                     ","2003-2004",26,"Volleyball",12072,16324,-4252,0,0,0,12072,16324,-4252,".","7",0,8652
"2648",196015,"SUNY COLLEGE OF TECHNOLOGY AT CANTON                        ","2003-2004",2,"Basketball",39985,44239,-4254,39985,44239,-4254,0,0,0,"12",".",29266,0
"12445",164739,"BENTLEY COLLEGE                                             ","2003-2004",25,"Track and Field, X-Country",147093,151348,-4255,70863,75867,-5004,76230,75481,749,"35","32",16441,13643
"5965",239628,"RIPON COLLEGE                                               ","2003-2004",8,"Golf",9348,13617,-4269,4674,8843,-4169,4674,4774,-100,"9","6",4674,4674
"14764",162928,"JOHNS HOPKINS UNIVERSITY                                    ","2003-2004",28,"Wrestling",39175,43445,-4270,39175,43445,-4270,0,0,0,"21",".",21642,0
"15128",243443,"UNIVERSITY OF SACRED HEART                                  ","2003-2004",29,"Other Sports",5890,10160,-4270,533,4800,-4267,5357,5360,-3,"9","11",4797,5357
"7337",144351,"CONCORDIA UNIVERSITY                                        ","2003-2004",15,"Soccer",21041,25314,-4273,11329,13020,-1691,9712,12294,-2582,"19","13",7481,6911
"5401",188438,"ADIRONDACK COMMUNITY COLLEGE                                ","2003-2004",8,"Golf",223,4499,-4276,223,4499,-4276,0,0,0,"5",".",3692,0
"17184",145521,"HIGHLAND COMMUNITY COLLEGE                                  ","2003-2004",39,"Total Participants",36083,40363,-4280,17595,22267,-4672,18488,18096,392,"33","29",31126,26284
"5979",173300,"CONCORDIA COLLEGE AT MOORHEAD                               ","2003-2004",8,"Golf",39376,43657,-4281,21982,24137,-2155,17394,19520,-2126,"24","8",400,480
"5293",213507,"LEBANON VALLEY COLLEGE                                      ","2003-2004",8,"Golf",9109,13401,-4292,9109,13401,-4292,0,0,0,"10",".",9109,0
"6105",163462,"MOUNT SAINT MARYS COLLEGE                                   ","2003-2004",8,"Golf",103892,108188,-4296,51698,56304,-4606,52194,51884,310,"9","12",18386,8958
"9194",212054,"DREXEL UNIVERSITY                                           ","2003-2004",16,"Softball",305264,309560,-4296,0,0,0,305264,309560,-4296,".","19",0,50832
"1266",213251,"JUNIATA COLLEGE                                             ","2003-2004",1,"Baseball",54418,58715,-4297,54418,58715,-4297,0,0,0,"24",".",44552,0
"3253",211307,"BUCKS COUNTY COMMUNITY COLLEGE                              ","2003-2004",2,"Basketball",10550,14850,-4300,10550,14850,-4300,0,0,0,"10",".",10550,0
"8751",240125,"WAUKESHA COUNTY TECHNICAL COLLEGE                           ","2003-2004",16,"Softball",50,4354,-4304,0,0,0,50,4354,-4304,".","12",0,1555
"9461",186131,"PRINCETON UNIVERSITY                                        ","2003-2004",16,"Softball",202157,206487,-4330,0,0,0,202157,206487,-4330,".","19",0,68577
"11941",235431,"HIGHLINE COMMUNITY COLLEGE                                  ","2003-2004",24,"Track and Field, Outdoor",40730,45075,-4345,20242,23132,-2890,20488,21943,-1455,"26","10",9500,9500
"14291",109208,"AMERICAN RIVER COLLEGE                                      ","2003-2004",26,"Volleyball",6663,11032,-4369,0,0,0,6663,11032,-4369,".","14",0,7657
"9939",121886,"RIO HONDO COLLEGE                                           ","2003-2004",16,"Softball",22354,26730,-4376,0,0,0,22354,26730,-4376,".","15",0,13302
"4013",186131,"PRINCETON UNIVERSITY                                        ","2003-2004",5,"Fencing",159937,164321,-4384,82467,84585,-2118,77470,79736,-2266,"21","19",29367,26287
"12175",115755,"HUMBOLDT STATE UNIVERSITY                                   ","2003-2004",25,"Track and Field, X-Country",184351,188737,-4386,92640,91301,1339,91711,97436,-5725,"19","19",19710,19710
"6265",127778,"OTERO JUNIOR COLLEGE                                        ","2003-2004",8,"Golf",22382,26772,-4390,11191,15386,-4195,11191,11386,-195,"8","1",7195,3195
"5419",201548,"CAPITAL UNIVERSITY                                          ","2003-2004",8,"Golf",56723,61116,-4393,26077,34612,-8535,30646,26504,4142,"10","10",6045,4690
"6581",212106,"DUQUESNE UNIVERSITY                                         ","2003-2004",11,"Lacrosse",386206,390599,-4393,0,0,0,386206,390599,-4393,".","26",0,74050
"11876",210571,"ALBRIGHT COLLEGE                                            ","2003-2004",23,"Track and Field, Indoor",5180,9577,-4397,2645,4890,-2245,2535,4687,-2152,"24","23",2645,2535
"14255",235334,"GRAYS HARBOR COLLEGE                                        ","2003-2004",26,"Volleyball",21596,25994,-4398,0,0,0,21596,25994,-4398,".","9",0,12027
"6278",195058,"ROCKLAND COMMUNITY COLLEGE                                  ","2003-2004",8,"Golf",100,4500,-4400,100,4500,-4400,0,0,0,"5",".",200,0
"7043",172440,"FINLANDIA UNIVERSITY                                        ","2003-2004",14,"Skiing",17343,21745,-4402,17343,21745,-4402,0,0,0,"9",".",14545,0
"6995",117946,"LOYOLA MARYMOUNT UNIVERSITY                                 ","2003-2004",13,"Rowing",721088,725500,-4412,128848,134321,-5473,592240,591179,1061,"15","47",29742,41680
"9775",137847,"THE UNIVERSITY OF TAMPA                                     ","2003-2004",16,"Softball",182371,186797,-4426,0,0,0,182371,186797,-4426,".","20",0,33818
"5289",240462,"UNIVERSITY OF WISCONSIN-PLATTEVILLE                         ","2003-2004",8,"Golf",8817,13244,-4427,0,0,0,8817,13244,-4427,".","7",0,7981
"7463",174817,"SAINT MARY'S UNIVERSITY OF MINNESOTA                        ","2003-2004",15,"Soccer",126290,130722,-4432,53513,58651,-5138,72777,72071,706,"25","23",23940,15270
"745",211343,"BUTLER COUNTY COMMUNITY COLLEGE                             ","2003-2004",1,"Baseball",10764,15197,-4433,10764,15197,-4433,0,0,0,"18",".",13467,0
"2931",231174,"UNIVERSITY OF VERMONT AND STATE AGRICULTURAL COLL           ","2003-2004",2,"Basketball",1800535,1804968,-4433,924998,890609,34389,875537,914359,-38822,"13","13",141100,132151
"6214",155627,"OTTAWA UNIVERSITY                                           ","2003-2004",8,"Golf",10950,15389,-4439,10950,15389,-4439,0,0,0,"14",".",12389,0
"9431",110565,"CALIFORNIA STATE UNIVERSITY-FULLERTON                       ","2003-2004",16,"Softball",396770,401210,-4440,0,0,0,396770,401210,-4440,".","17",0,90066
"15340",155715,"PRATT COMMUNITY COLLEGE                                     ","2003-2004",35,"Rodeo",102382,106824,-4442,51191,53412,-2221,51191,53412,-2221,"30","10",3000,3000
"3060",153320,"FAITH BAPTIST BIBLE COLLEGE AND THEOLOGICAL SEM             ","2003-2004",2,"Basketball",11500,15950,-4450,9200,8700,500,2300,7250,-4950,"12","10",8700,7250
"14168",187444,"WILLIAM PATERSON UNIVERSITY OF NEW JERSEY                   ","2003-2004",26,"Volleyball",30400,34883,-4483,0,0,0,30400,34883,-4483,".","13",0,12121
"14360",150561,"TAYLOR UNIVERSITY-FT WAYNE                                  ","2003-2004",26,"Volleyball",6147,10631,-4484,0,0,0,6147,10631,-4484,".","10",0,6764
"16561",204468,"NOTRE DAME COLLEGE                                          ","2003-2004",39,"Total Participants",273372,277866,-4494,103277,103273,4,170095,174593,-4498,"67","62",97196,110012
"12586",204468,"NOTRE DAME COLLEGE                                          ","2003-2004",25,"Track and Field, X-Country",72701,77199,-4498,36421,36421,0,36280,40778,-4498,"20","13",22630,22489
"12298",185828,"NEW JERSEY INSTITUTE OF TECHNOLOGY                          ","2003-2004",25,"Track and Field, X-Country",5000,9500,-4500,2500,4750,-2250,2500,4750,-2250,"14","8",2500,2500
"12651",241225,"BAYAMON CENTRAL UNIVERSITY                                  ","2003-2004",25,"Track and Field, X-Country",9250,13750,-4500,7000,8000,-1000,2250,5750,-3500,"6","5",2310,1925
"230",192448,"LONG ISLAND UNIVERSITY-C W POST CAMPUS                      ","2003-2004",1,"Baseball",268954,273458,-4504,268954,273458,-4504,0,0,0,"37",".",50462,0
"250",166683,"MASSACHUSETTS INSTITUTE OF TECHNOLOGY                       ","2003-2004",1,"Baseball",63093,67606,-4513,63093,67606,-4513,0,0,0,"20",".",26196,0
"12728",199032,"MONTREAT COLLEGE                                            ","2003-2004",25,"Track and Field, X-Country",6932,11452,-4520,3466,5726,-2260,3466,5726,-2260,"7","7",2726,2726
"13490",122746,"SAN JOSE CITY COLLEGE                                       ","2003-2004",26,"Volleyball",80487,85011,-4524,0,0,0,80487,85011,-4524,".","11",0,6524
"380",173559,"MINNESOTA STATE COMM AND TECH COLLEGE-FERGUS FALLS          ","2003-2004",1,"Baseball",55896,60428,-4532,55896,60428,-4532,0,0,0,"22",".",12137,0
"8838",236188,"OLYMPIC COLLEGE                                             ","2003-2004",16,"Softball",29850,34382,-4532,0,0,0,29850,34382,-4532,".","12",0,10631
"11842",239318,"MILWAUKEE SCHOOL OF ENGINEERING                             ","2003-2004",23,"Track and Field, Indoor",5499,10034,-4535,3666,5640,-1974,1833,4394,-2561,"17","8",2656,673
"14018",218070,"FURMAN UNIVERSITY                                           ","2003-2004",26,"Volleyball",386738,391279,-4541,0,0,0,386738,391279,-4541,".","12",0,48453
"11276",230834,"CASTLETON STATE COLLEGE                                     ","2003-2004",22,"Tennis",5230,9772,-4542,2886,4886,-2000,2344,4886,-2542,"10","11",2886,2344
"7351",111948,"CHAPMAN UNIVERSITY                                          ","2003-2004",15,"Soccer",73700,78250,-4550,37800,32800,5000,35900,45450,-9550,"21","22",14300,14300
"12955",236638,"SKAGIT VALLEY COLLEGE                                       ","2003-2004",25,"Track and Field, X-Country",6000,10552,-4552,3000,5276,-2276,3000,5276,-2276,"6","6",3000,3000
"7396",199865,"WARREN WILSON COLLEGE                                       ","2003-2004",15,"Soccer",21050,25603,-4553,11000,13349,-2349,10050,12254,-2204,"18","16",11000,10050
"3540",140696,"OGLETHORPE UNIVERSITY                                       ","2003-2004",3,"All Track Combined",8444,13000,-4556,4222,6500,-2278,4222,6500,-2278,"24","30",3038,3038
"10809",122180,"SACRAMENTO CITY COLLEGE                                     ","2003-2004",22,"Tennis",2,4558,-4556,1,1790,-1789,1,2768,-2767,"8","8",1636,1636
"12476",125763,"WHITTIER COLLEGE                                            ","2003-2004",25,"Track and Field, X-Country",55700,60257,-4557,24800,28990,-4190,30900,31267,-367,"16","23",4506,5600
"692",146427,"KNOX COLLEGE                                                ","2003-2004",1,"Baseball",16833,21409,-4576,16833,21409,-4576,0,0,0,"29",".",10586,0
"15809",186469,"SALEM COMMUNITY COLLEGE                                     ","2003-2004",39,"Total Participants",55179,59757,-4578,35009,36711,-1702,20170,23046,-2876,"32","20",15152,11151
"5756",240125,"WAUKESHA COUNTY TECHNICAL COLLEGE                           ","2003-2004",8,"Golf",100,4686,-4586,100,4686,-4586,0,0,0,"6",".",3536,0
"5521",211307,"BUCKS COUNTY COMMUNITY COLLEGE                              ","2003-2004",8,"Golf",8196,12796,-4600,8196,12796,-4600,0,0,0,"6",".",8196,0
"14011",211307,"BUCKS COUNTY COMMUNITY COLLEGE                              ","2003-2004",26,"Volleyball",2828,7428,-4600,0,0,0,2828,7428,-4600,".","10",0,2828
"10767",157447,"NORTHERN KENTUCKY UNIVERSITY                                ","2003-2004",22,"Tennis",102589,107194,-4605,52163,58998,-6835,50426,48196,2230,"8","9",8989,12678
"8646",122597,"SAN FRANCISCO STATE UNIVERSITY                              ","2003-2004",16,"Softball",146732,151348,-4616,0,0,0,146732,151348,-4616,".","26",0,46914
"5330",142461,"NORTHWEST NAZARENE UNIVERSITY                               ","2003-2004",8,"Golf",43017,47634,-4617,43017,47634,-4617,0,0,0,"8",".",12334,0
"15365",166683,"MASSACHUSETTS INSTITUTE OF TECHNOLOGY                       ","2003-2004",36,"Sailing",72807,77427,-4620,72807,77427,-4620,0,0,0,"49",".",15065,0
"8435",115126,"GOLDEN WEST COLLEGE                                         ","2003-2004",15,"Soccer",31881,36503,-4622,16377,13747,2630,15504,22756,-7252,"20","19",2740,3526
"15088",194541,"POLYTECHNIC UNIVERSITY                                      ","2003-2004",29,"Other Sports",10116,14750,-4634,10116,14750,-4634,0,0,0,"12",".",6750,0
"9112",193946,"NIAGARA COUNTY COMMUNITY COLLEGE                            ","2003-2004",16,"Softball",4770,9410,-4640,0,0,0,4770,9410,-4640,".","16",0,3371
"15270",164720,"BECKER COLLEGE                                              ","2003-2004",34,"Equestrian",3830,8470,-4640,0,0,0,3830,8470,-4640,".","17",0,7176
"520",199962,"WINGATE UNIVERSITY                                          ","2003-2004",1,"Baseball",55895,60545,-4650,55895,60545,-4650,0,0,0,"49",".",41400,0
"1036",200022,"BISMARCK STATE COLLEGE                                      ","2003-2004",1,"Baseball",13490,18143,-4653,13490,18143,-4653,0,0,0,"14",".",18144,0
"7272",171456,"NORTHERN MICHIGAN UNIVERSITY                                ","2003-2004",15,"Soccer",339461,344134,-4673,0,0,0,339461,344134,-4673,"0","40",0,77719
"16626",439288,"JOHNSON &amp; WALES UNIVERSITY-DENVER                           ","2003-2004",39,"Total Participants",108897,113582,-4685,55759,66379,-10620,53138,47203,5935,"64","54",77220,45587
"2302",153278,"UNIVERSITY OF DUBUQUE                                       ","2003-2004",2,"Basketball",164612,169302,-4690,100377,100959,-582,64235,68343,-4108,"17","16",26666,29252
"10694",178369,"MISSOURI VALLEY COLLEGE                                     ","2003-2004",22,"Tennis",4800,9500,-4700,2800,5200,-2400,2000,4300,-2300,"10","7",5000,3500
"10428",206525,"WITTENBERG UNIVERSITY                                       ","2003-2004",18,"Swimming and Diving",89129,93842,-4713,41558,44151,-2593,47571,49691,-2120,"18","22",13717,15572
"149",114433,"FEATHER RIVER COMMUNITY COLLEGE DISTRICT                    ","2003-2004",1,"Baseball",134810,139524,-4714,134810,139524,-4714,0,0,0,"39",".",56876,0
"15899",104346,"CENTRAL ARIZONA COLLEGE                                     ","2003-2004",39,"Total Participants",610446,615177,-4731,358753,361010,-2257,251693,254167,-2474,"144","65",121488,100312
"1043",213321,"KINGS COLLEGE                                               ","2003-2004",1,"Baseball",23796,28535,-4739,23796,28535,-4739,0,0,0,"33",".",21100,0
"13466",145619,"BENEDICTINE UNIVERSITY                                      ","2003-2004",26,"Volleyball",60887,65627,-4740,0,0,0,60887,65627,-4740,".","14",0,9944
"5040",216524,"URSINUS COLLEGE                                             ","2003-2004",7,"Football",161220,165968,-4748,161220,165968,-4748,0,0,0,"71",".",75220,0
"8330",190512,"CUNY BERNARD M BARUCH COLLEGE                               ","2003-2004",15,"Soccer",10500,15250,-4750,10500,15250,-4750,0,0,0,"20",".",9500,0
"16470",137096,"SANTA FE COMMUNITY COLLEGE                                  ","2003-2004",39,"Total Participants",217206,221960,-4754,98261,100980,-2719,118945,120980,-2035,"34","34",2e+05,2e+05
"9539",245953,"MID-AMERICA CHRISTIAN UNIVERSITY                            ","2003-2004",16,"Softball",16698,21457,-4759,0,0,0,16698,21457,-4759,".","12",0,10633
"10186",229267,"TRINITY UNIVERSITY                                          ","2003-2004",18,"Swimming and Diving",178030,182796,-4766,89015,91398,-2383,89015,91398,-2383,"21","28",37471,37471
"12103",104708,"GLENDALE COMMUNITY COLLEGE                                  ","2003-2004",24,"Track and Field, Outdoor",30110,34882,-4772,15973,18541,-2568,14137,16341,-2204,"30","20",2200,1800
"7504",165820,"FITCHBURG STATE COLLEGE                                     ","2003-2004",15,"Soccer",16214,20990,-4776,4465,5118,-653,11749,15872,-4123,"19","19",3407,7809
"9006",149019,"SPRINGFIELD COLLEGE IN ILLINOIS                             ","2003-2004",16,"Softball",11068,15849,-4781,0,0,0,11068,15849,-4781,".","14",0,8815
"16498",180106,"CARROLL COLLEGE                                             ","2003-2004",39,"Total Participants",449488,454279,-4791,27214,25737,1477,422274,428542,-6268,"126","58",283138,142422
"7213",236610,"SHORELINE COMMUNITY COLLEGE                                 ","2003-2004",15,"Soccer",44236,49033,-4797,23309,26457,-3148,20927,22576,-1649,"20","17",10878,8161
"5164",206817,"BACONE COLLEGE                                              ","2003-2004",8,"Golf",3200,8000,-4800,3200,8000,-4800,0,0,0,"7",".",7859,0
"6782",197045,"UTICA COLLEGE                                               ","2003-2004",11,"Lacrosse",145100,149900,-4800,91800,93200,-1400,53300,56700,-3400,"39","18",24600,18100
"16420",221892,"TREVECCA NAZARENE UNIVERSITY                                ","2003-2004",39,"Total Participants",802289,807094,-4805,389715,399318,-9603,412574,407776,4798,"66","65",100051,102084
"13726",193326,"MONROE COMMUNITY COLLEGE                                    ","2003-2004",26,"Volleyball",17006,21814,-4808,0,0,0,17006,21814,-4808,".","10",0,14722
"11769",121886,"RIO HONDO COLLEGE                                           ","2003-2004",22,"Tennis",8800,13616,-4816,0,0,0,8800,13616,-4816,".","8",0,3174
"9408",149514,"TRINITY INTERNATIONAL UNIVERSITY                            ","2003-2004",16,"Softball",142463,147282,-4819,0,0,0,142463,147282,-4819,".","18",0,23331
"280",239080,"MARIAN COLLEGE OF FOND DU LAC                               ","2003-2004",1,"Baseball",65213,70044,-4831,65213,70044,-4831,0,0,0,"28",".",16595,0
"3027",117733,"LOS ANGELES VALLEY COLLEGE                                  ","2003-2004",2,"Basketball",71936,76784,-4848,38712,41136,-2424,33224,35648,-2424,"13","12",15762,14949
"8196",104708,"GLENDALE COMMUNITY COLLEGE                                  ","2003-2004",15,"Soccer",27908,32762,-4854,13726,16732,-3006,14182,16030,-1848,"19","17",4100,2892
"1311",133711,"FLAGLER COLLEGE                                             ","2003-2004",1,"Baseball",74840,79696,-4856,74840,79696,-4856,0,0,0,"40",".",33256,0
"6707",166683,"MASSACHUSETTS INSTITUTE OF TECHNOLOGY                       ","2003-2004",11,"Lacrosse",95407,100265,-4858,54932,59007,-4075,40475,41258,-783,"32","18",31484,20785
"15276",154934,"COLBY COMMUNITY COLLEGE                                     ","2003-2004",34,"Equestrian",8171,13029,-4858,1389,2215,-826,6782,10814,-4032,"2","23",1570,7663
"4452",199962,"WINGATE UNIVERSITY                                          ","2003-2004",7,"Football",128511,133379,-4868,128511,133379,-4868,0,0,0,"95",".",118602,0
"5405",157447,"NORTHERN KENTUCKY UNIVERSITY                                ","2003-2004",8,"Golf",127937,132815,-4878,72314,76879,-4565,55623,55936,-313,"13","8",27882,18211
"14659",126678,"COLORADO COLLEGE                                            ","2003-2004",27,"Water Polo",19321,24202,-4881,0,0,0,19321,24202,-4881,".","14",0,21102
"12585",214041,"MILLERSVILLE UNIVERSITY OF PENNSYLVANIA                     ","2003-2004",25,"Track and Field, X-Country",157214,162098,-4884,78207,81449,-3242,79007,80649,-1642,"90","82",21160,21160
"9784",162104,"CECIL COMMUNITY COLLEGE                                     ","2003-2004",16,"Softball",553,5450,-4897,0,0,0,553,5450,-4897,".","9",0,1500
"5739",120971,"PALOMAR COLLEGE                                             ","2003-2004",8,"Golf",9868,14784,-4916,9868,14784,-4916,0,0,0,"8",".",4591,0
"3009",155104,"GARDEN CITY COMMUNITY COLLEGE                               ","2003-2004",2,"Basketball",63510,68433,-4923,31755,34333,-2578,31755,34100,-2345,"16","16",22377,22377
"5747",212054,"DREXEL UNIVERSITY                                           ","2003-2004",8,"Golf",127455,132385,-4930,127455,132385,-4930,0,0,0,"10",".",33714,0
"13827",202222,"COLUMBUS STATE COMMUNITY COLLEGE                            ","2003-2004",26,"Volleyball",17800,22733,-4933,0,0,0,17800,22733,-4933,".","10",0,15533
"11657",190558,"CUNY COLLEGE OF STATEN ISLAND                               ","2003-2004",22,"Tennis",19150,24102,-4952,9750,11421,-1671,9400,12681,-3281,"8","7",9750,9400
"14182",208406,"CLACKAMAS COMMUNITY COLLEGE                                 ","2003-2004",26,"Volleyball",14273,19236,-4963,0,0,0,14273,19236,-4963,".","11",0,9187
"7745",231165,"VERMONT TECHNICAL COLLEGE                                   ","2003-2004",15,"Soccer",9337,14303,-4966,9337,14303,-4966,0,0,0,"15",".",9337,0
"15731",196051,"MORRISVILLE STATE COLLEGE                                   ","2003-2004",39,"Total Participants",420685,425653,-4968,239853,242837,-2984,180832,182816,-1984,"276","165",296074,127194
"3186",154350,"SIMPSON COLLEGE                                             ","2003-2004",2,"Basketball",128028,133019,-4991,70458,69957,501,57570,63062,-5492,"40","31",38728,29352
"2395",120865,"PACIFIC UNION COLLEGE                                       ","2003-2004",2,"Basketball",31000,35993,-4993,15500,19488,-3988,15500,16505,-1005,"12","10",14440,12630
"6228",240365,"UNIVERSITY OF WISCONSIN-OSHKOSH                             ","2003-2004",8,"Golf",14381,19378,-4997,0,0,0,14381,19378,-4997,".","10",0,18859
"7400",235431,"HIGHLINE COMMUNITY COLLEGE                                  ","2003-2004",15,"Soccer",41893,46890,-4997,21256,23522,-2266,20637,23368,-2731,"25","16",9940,9940
"12260",176406,"TOUGALOO COLLEGE                                            ","2003-2004",25,"Track and Field, X-Country",50307,55306,-4999,24027,27653,-3626,26280,27653,-1373,"6","6",3600,3600
"262",220181,"FISK UNIVERSITY                                             ","2003-2004",1,"Baseball",6000,11000,-5000,6000,11000,-5000,0,0,0,"17",".",6000,0
"279",230834,"CASTLETON STATE COLLEGE                                     ","2003-2004",1,"Baseball",28492,33492,-5000,28492,33492,-5000,0,0,0,"24",".",28492,0
"338",216825,"WESTMORELAND COUNTY COMMUNITY COLLEGE                       ","2003-2004",1,"Baseball",4000,9000,-5000,4000,9000,-5000,0,0,0,"17",".",2400,0
"2271",181765,"NEBRASKA COLLEGE OF TECHNICAL AGRICULTURE                   ","2003-2004",2,"Basketball",6800,11800,-5000,6800,11800,-5000,0,0,0,"10",".",6800,0
"3553",220181,"FISK UNIVERSITY                                             ","2003-2004",3,"All Track Combined",10000,15000,-5000,5000,7500,-2500,5000,7500,-2500,"10","10",5000,5000
"4069",230834,"CASTLETON STATE COLLEGE                                     ","2003-2004",6,"Field hocky",19161,24161,-5000,0,0,0,19161,24161,-5000,".","18",0,19616
"5975",155140,"HASKELL INDIAN NATIONS UNIVERSITY                           ","2003-2004",8,"Golf",6000,11000,-5000,6000,11000,-5000,0,0,0,"5",".",6000,0
"6137",213303,"KEYSTONE COLLEGE                                            ","2003-2004",8,"Golf",7573,12573,-5000,7573,12573,-5000,0,0,0,"7",".",7573,0
"6690",192192,"KEUKA COLLEGE                                               ","2003-2004",11,"Lacrosse",31308,36308,-5000,31308,36308,-5000,0,0,0,"34",".",14308,0
"8291",220181,"FISK UNIVERSITY                                             ","2003-2004",15,"Soccer",12000,17000,-5000,6000,8500,-2500,6000,8500,-2500,"16","19",6000,6000
"9334",218919,"VOORHEES COLLEGE                                            ","2003-2004",16,"Softball",8000,13000,-5000,0,0,0,8000,13000,-5000,".","14",0,8000
"9667",220181,"FISK UNIVERSITY                                             ","2003-2004",16,"Softball",7000,12000,-5000,0,0,0,7000,12000,-5000,".","14",0,7000
"9864",190512,"CUNY BERNARD M BARUCH COLLEGE                               ","2003-2004",16,"Softball",12500,17500,-5000,0,0,0,12500,17500,-5000,".","20",0,10000
"10578",122597,"SAN FRANCISCO STATE UNIVERSITY                              ","2003-2004",19,"Swimming",98325,103325,-5000,44892,44893,-1,53433,58432,-4999,"12","22",10700,19140
"11667",203845,"MARIETTA COLLEGE                                            ","2003-2004",22,"Tennis",5596,10596,-5000,2951,5451,-2500,2645,5145,-2500,"6","12",2951,2643
"12543",112084,"CHRISTIAN HERITAGE COLLEGE                                  ","2003-2004",25,"Track and Field, X-Country",3500,8500,-5000,1750,4250,-2500,1750,4250,-2500,"8","8",1744,1744
"12687",218919,"VOORHEES COLLEGE                                            ","2003-2004",25,"Track and Field, X-Country",30000,35000,-5000,18000,20500,-2500,12000,14500,-2500,"15","15",18000,12000
"13694",198118,"CALDWELL COMMUNITY COLLEGE AND TECHNICAL INSTITUTE          ","2003-2004",26,"Volleyball",500,5500,-5000,0,0,0,500,5500,-5000,".","12",0,5000
"14348",220181,"FISK UNIVERSITY                                             ","2003-2004",26,"Volleyball",7000,12000,-5000,0,0,0,7000,12000,-5000,".","14",0,7000
"14556",213303,"KEYSTONE COLLEGE                                            ","2003-2004",26,"Volleyball",13753,18753,-5000,0,0,0,13753,18753,-5000,".","8",0,13753
"15688",198118,"CALDWELL COMMUNITY COLLEGE AND TECHNICAL INSTITUTE          ","2003-2004",39,"Total Participants",500,5500,-5000,0,0,0,500,5500,-5000,"16","12",20000,5000
"8621",230834,"CASTLETON STATE COLLEGE                                     ","2003-2004",16,"Softball",21835,26853,-5018,0,0,0,21835,26853,-5018,".","17",0,21835
"13558",181446,"NEBRASKA WESLEYAN UNIVERSITY                                ","2003-2004",26,"Volleyball",36780,41807,-5027,0,0,0,36780,41807,-5027,".","26",0,24184
"11801",163462,"MOUNT SAINT MARYS COLLEGE                                   ","2003-2004",22,"Tennis",90459,95490,-5031,45195,49614,-4419,45264,45876,-612,"8","9",9223,8640
"17287",109907,"BARSTOW COLLEGE                                             ","2003-2004",39,"Total Participants",28234,33270,-5036,15960,21890,-5930,12274,11380,894,"26","23",28982,19960
"10128",146676,"LINCOLN COLLEGE                                             ","2003-2004",18,"Swimming and Diving",106024,111063,-5039,66265,69414,-3149,39759,41649,-1890,"10","6",19248,11549
"400",193946,"NIAGARA COUNTY COMMUNITY COLLEGE                            ","2003-2004",1,"Baseball",5490,10530,-5040,5490,10530,-5040,0,0,0,"30",".",3511,0
"13470",195988,"SULLIVAN COUNTY COMMUNITY COLLEGE                           ","2003-2004",26,"Volleyball",5915,10955,-5040,0,0,0,5915,10955,-5040,".","7",0,10954
"13314",216010,"SHIPPENSBURG UNIVERSITY OF PENNSYLVANIA                     ","2003-2004",26,"Volleyball",92656,97701,-5045,0,0,0,92656,97701,-5045,".","14",0,23230
"13423",188641,"ALFRED UNIVERSITY                                           ","2003-2004",26,"Volleyball",19000,24050,-5050,0,0,0,19000,24050,-5050,".","10",0,14000
"3017",213774,"MANOR COLLEGE                                               ","2003-2004",2,"Basketball",31500,36552,-5052,15800,18357,-2557,15700,18195,-2495,"11","7",13100,11900
"611",145707,"ILLINOIS EASTERN COMMUNITY COLLS-OLNEY CTRL COLL            ","2003-2004",1,"Baseball",133549,138604,-5055,133549,138604,-5055,0,0,0,"30",".",51877,0
"10557",213783,"MANSFIELD UNIVERSITY OF PENNSYLVANIA                        ","2003-2004",19,"Swimming",85841,90908,-5067,0,0,0,85841,90908,-5067,".","15",0,9761
"7423",121619,"SANTA ANA COLLEGE                                           ","2003-2004",15,"Soccer",17500,22572,-5072,9000,11393,-2393,8500,11179,-2679,"26","18",9697,9554
"12577",210571,"ALBRIGHT COLLEGE                                            ","2003-2004",25,"Track and Field, X-Country",11006,16081,-5075,4980,7555,-2575,6026,8526,-2500,"10","12",4980,6026
"2934",155812,"UNIVERSITY OF SAINT MARY                                    ","2003-2004",2,"Basketball",54672,59754,-5082,29082,29558,-476,25590,30196,-4606,"18","17",14910,16471
"12703",209825,"UNIVERSITY OF PORTLAND                                      ","2003-2004",25,"Track and Field, X-Country",529374,534456,-5082,250397,252938,-2541,278977,281518,-2541,"104","78",50288,50288
"14539",198154,"CAPE FEAR COMMUNITY COLLEGE                                 ","2003-2004",26,"Volleyball",15000,20082,-5082,0,0,0,15000,20082,-5082,".","15",0,16000
"16793",236887,"WALLA WALLA COMMUNITY COLLEGE                               ","2003-2004",39,"Total Participants",278751,283835,-5084,162173,159837,2336,116578,123998,-7420,"112","77",133799,91687
"15398",241100,"AMERICAN UNIVERSITY OF PUERTO RICO                          ","2003-2004",37,"Table Tennis",15699,20785,-5086,15412,15412,0,287,5373,-5086,"6","3",8708,463
"3871",215062,"UNIVERSITY OF PENNSYLVANIA                                  ","2003-2004",3,"All Track Combined",538976,544067,-5091,271519,270673,846,267457,273394,-5937,"138","119",118633,109441
"15994",155496,"MANHATTAN CHRISTIAN COLLEGE                                 ","2003-2004",39,"Total Participants",61969,67062,-5093,32478,35135,-2657,29491,31927,-2436,"35","41",56203,52386
"9039",146427,"KNOX COLLEGE                                                ","2003-2004",16,"Softball",25138,30237,-5099,0,0,0,25138,30237,-5099,".","12",0,5761
"11661",113193,"CUESTA COLLEGE                                              ","2003-2004",22,"Tennis",4339,9456,-5117,0,0,0,4339,9456,-5117,".","10",0,3554
"7541",163657,"PRINCE GEORGES COMMUNITY COLLEGE                            ","2003-2004",15,"Soccer",24696,29814,-5118,2299,17485,-15186,22397,12329,10068,"20","16",10444,1967
"4562",203128,"HIRAM COLLEGE                                               ","2003-2004",7,"Football",105315,110434,-5119,105315,110434,-5119,0,0,0,"52",".",40450,0
"5661",117052,"REEDLEY COLLEGE                                             ","2003-2004",8,"Golf",4800,9928,-5128,4800,9928,-5128,0,0,0,"6","0",1380,0
"12592",131450,"GALLAUDET UNIVERSITY                                        ","2003-2004",25,"Track and Field, X-Country",5750,10880,-5130,5171,5171,0,579,5709,-5130,"5","6",2421,2959
"13300",210571,"ALBRIGHT COLLEGE                                            ","2003-2004",26,"Volleyball",12733,17863,-5130,0,0,0,12733,17863,-5130,".","16",0,12733
"665",233611,"SOUTHERN VIRGINIA UNIVERSITY                                ","2003-2004",1,"Baseball",10125,15267,-5142,10125,15267,-5142,0,0,0,"19",".",8839,0
"2705",212133,"EASTERN UNIVERSITY                                          ","2003-2004",2,"Basketball",67054,72200,-5146,42414,45660,-3246,24640,26540,-1900,"14","14",21460,14880
"9581",206604,"WRIGHT STATE UNIVERSITY-MAIN CAMPUS                         ","2003-2004",16,"Softball",298267,303416,-5149,0,0,0,298267,303416,-5149,".","20",0,82817
"2775",180151,"DAWSON COMMUNITY COLLEGE                                    ","2003-2004",2,"Basketball",40926,46079,-5153,22072,24881,-2809,18854,21198,-2344,"17","16",21931,18725
"3794",142461,"NORTHWEST NAZARENE UNIVERSITY                               ","2003-2004",3,"All Track Combined",289251,294408,-5157,147402,149454,-2052,141849,144954,-3105,"76","57",23007,23007
"10096",232423,"JAMES MADISON UNIVERSITY                                    ","2003-2004",18,"Swimming and Diving",247621,252797,-5176,128696,133549,-4853,118925,119248,-323,"24","39",37965,39280
"12415",240417,"UNIVERSITY OF WISCONSIN-STOUT                               ","2003-2004",25,"Track and Field, X-Country",52138,57326,-5188,30767,32442,-1675,21371,24884,-3513,"20","24",19200,13176
"3342",187897,"NEW MEXICO HIGHLANDS UNIVERSITY                             ","2003-2004",2,"Basketball",231214,236404,-5190,114883,123281,-8398,116331,113123,3208,"16","15",22525,25504
"1980",235750,"LOWER COLUMBIA COLLEGE                                      ","2003-2004",2,"Basketball",44006,49197,-5191,20619,26513,-5894,23387,22684,703,"12","12",17246,14918
"14030",207290,"NORTHEASTERN OKLAHOMA AGRICULTURAL AND MECH COLL            ","2003-2004",26,"Volleyball",47792,52983,-5191,0,0,0,47792,52983,-5191,".","11",0,12200
"2571",146667,"LINCOLN CHRISTIAN COLLEGE AND SEMINARY                      ","2003-2004",2,"Basketball",36720,41920,-5200,18360,20960,-2600,18360,20960,-2600,"18","13",18360,18360
"3547",229780,"WAYLAND BAPTIST UNIVERSITY                                  ","2003-2004",3,"All Track Combined",259900,265100,-5200,131700,140000,-8300,128200,125100,3100,"28","22",35500,33900
"8490",146667,"LINCOLN CHRISTIAN COLLEGE AND SEMINARY                      ","2003-2004",15,"Soccer",24480,29680,-5200,12240,14840,-2600,12240,14840,-2600,"15","22",12240,12240
"9232",214698,"PENNSYLVANIA STATE UNIVERSITY-PENN STATE BEAVER             ","2003-2004",16,"Softball",1,5201,-5200,0,0,0,1,5201,-5200,".","16",0,5200
"13098",150066,"ANDERSON UNIVERSITY                                         ","2003-2004",26,"Volleyball",37598,42805,-5207,0,0,0,37598,42805,-5207,".","15",0,23730
"14082",218645,"UNIVERSITY OF SOUTH CAROLINA-AIKEN                          ","2003-2004",26,"Volleyball",134130,139345,-5215,0,0,0,134130,139345,-5215,"0","14",0,25035
"932",186399,"RUTGERS UNIVERSITY-NEWARK                                   ","2003-2004",1,"Baseball",153616,158840,-5224,153616,158840,-5224,0,0,0,"37",".",69403,0
"5334",183859,"BROOKDALE COMMUNITY COLLEGE                                 ","2003-2004",8,"Golf",4000,9225,-5225,2000,7025,-5025,2000,2200,-200,"7",".",3208,450
"3954",148256,"REND LAKE COLLEGE                                           ","2003-2004",3,"All Track Combined",100966,106204,-5238,100966,106204,-5238,0,0,0,"85",".",78965,0
"7856",137564,"SOUTHEASTERN COLLEGE ASSEMBLIES OF GOD                      ","2003-2004",15,"Soccer",24750,30000,-5250,13250,16000,-2750,11500,14000,-2500,"20","17",13250,11500
"5986",191630,"HOBART WILLIAM SMITH COLLEGES                               ","2003-2004",8,"Golf",11884,17136,-5252,8299,13551,-5252,3585,3585,0,"11","5",4877,3000
"13516",151379,"INDIANA UNIVERSITY-SOUTHEAST                                ","2003-2004",26,"Volleyball",43627,48880,-5253,0,0,0,43627,48880,-5253,".","11",0,35166
"630",210571,"ALBRIGHT COLLEGE                                            ","2003-2004",1,"Baseball",19217,24472,-5255,19217,24472,-5255,0,0,0,"33",".",19217,0
"15022",193946,"NIAGARA COUNTY COMMUNITY COLLEGE                            ","2003-2004",28,"Wrestling",12410,17665,-5255,12410,17665,-5255,0,0,0,"13",".",9680,0
"9333",110413,"CALIFORNIA LUTHERAN UNIVERSITY                              ","2003-2004",16,"Softball",47642,52901,-5259,0,0,0,47642,52901,-5259,".","14",0,25700
"12006",210571,"ALBRIGHT COLLEGE                                            ","2003-2004",24,"Track and Field, Outdoor",12537,17799,-5262,6391,9074,-2683,6146,8725,-2579,"26","25",6391,6146
"5802",195562,"SAINT JOSEPHS COLLEGE-SUFFOLK CAMPUS                        ","2003-2004",8,"Golf",3414,8682,-5268,3414,8682,-5268,0,0,0,"5",".",2380,0
"14839",150145,"BETHEL COLLEGE                                              ","2003-2004",28,"Wrestling",11600,16880,-5280,11600,16880,-5280,0,0,0,"15",".",11500,0
"5182",235343,"GREEN RIVER COMMUNITY COLLEGE                               ","2003-2004",8,"Golf",12004,17292,-5288,6002,8646,-2644,6002,8646,-2644,"4","3",5402,5402
"13061",193946,"NIAGARA COUNTY COMMUNITY COLLEGE                            ","2003-2004",26,"Volleyball",4756,10056,-5300,0,0,0,4756,10056,-5300,".","12",0,4756
"5909",145619,"BENEDICTINE UNIVERSITY                                      ","2003-2004",8,"Golf",23700,29002,-5302,23700,29002,-5302,0,0,0,"6","0",2932,0
"13997",133951,"FLORIDA INTERNATIONAL UNIVERSITY                            ","2003-2004",26,"Volleyball",469668,474981,-5313,0,0,0,469668,474981,-5313,".","15",0,92378
"9876",230047,"BRIGHAM YOUNG UNIVERSITY-HAWAII CAMPUS                      ","2003-2004",16,"Softball",80500,85816,-5316,0,0,0,80500,85816,-5316,".","16",0,80500
"5585",146418,"KISHWAUKEE COLLEGE                                          ","2003-2004",8,"Golf",4029,9351,-5322,4029,9351,-5322,0,0,0,"6",".",4029,0
"1459",237181,"BETHANY COLLEGE                                             ","2003-2004",1,"Baseball",37139,42468,-5329,37139,42468,-5329,0,0,0,"30",".",12660,0
"11234",147660,"NORTH CENTRAL COLLEGE                                       ","2003-2004",22,"Tennis",13063,18395,-5332,7130,8895,-1765,5933,9500,-3567,"8","10",3895,4500
"11127",225548,"HOWARD PAYNE UNIVERSITY                                     ","2003-2004",22,"Tennis",55200,60534,-5334,31500,30267,1233,23700,30267,-6567,"8","9",8800,8800
"13685",162690,"HAGERSTOWN COMMUNITY COLLEGE                                ","2003-2004",26,"Volleyball",12395,17731,-5336,0,0,0,12395,17731,-5336,".","9",0,14367
"11056",168421,"WORCESTER POLYTECHNIC INSTITUTE                             ","2003-2004",22,"Tennis",7578,12923,-5345,3623,7158,-3535,3955,5765,-1810,"14","12",3824,2431
"9056",149727,"WAUBONSEE COMMUNITY COLLEGE                                 ","2003-2004",16,"Softball",14450,19806,-5356,0,0,0,14450,19806,-5356,".","11",0,9006
"13461",198561,"GARDNER-WEBB UNIVERSITY                                     ","2003-2004",26,"Volleyball",264065,269438,-5373,0,0,0,264065,269438,-5373,".","12",0,32920
"679",178059,"MARYVILLE UNIVERSITY OF SAINT LOUIS                         ","2003-2004",1,"Baseball",31277,36663,-5386,31277,36663,-5386,0,0,0,"25",".",28617,0
"3310",145831,"ILLINOIS VALLEY COMMUNITY COLLEGE                           ","2003-2004",2,"Basketball",50610,56008,-5398,30675,38042,-7367,19935,17966,1969,"15","9",19991,13862
"3802",153278,"UNIVERSITY OF DUBUQUE                                       ","2003-2004",3,"All Track Combined",74511,79909,-5398,43647,46400,-2753,30864,33509,-2645,"80","77",18306,17588
"506",209506,"OREGON INSTITUTE OF TECHNOLOGY                              ","2003-2004",1,"Baseball",99380,104779,-5399,99380,104779,-5399,0,0,0,"26",".",74670,0
"11185",243151,"UNIVERSITY OF PUERTO RICO-CAYEY UNIVERSITY COLLEGE          ","2003-2004",22,"Tennis",6000,11403,-5403,3000,6300,-3300,3000,5103,-2103,"7","6",2800,3475
"12945",237385,"GLENVILLE STATE COLLEGE                                     ","2003-2004",25,"Track and Field, X-Country",29169,34578,-5409,12427,14322,-1895,16742,20256,-3514,"21","17",5746,8407
"6079",181738,"UNION COLLEGE                                               ","2003-2004",8,"Golf",1641,7072,-5431,1641,7072,-5431,0,0,0,"10",".",5431,0
"12749",195988,"SULLIVAN COUNTY COMMUNITY COLLEGE                           ","2003-2004",25,"Track and Field, X-Country",5915,11346,-5431,5915,11346,-5431,0,0,0,"6",".",11345,0
"3667",207865,"SOUTHWESTERN OKLAHOMA STATE UNIVERSITY                      ","2003-2004",3,"All Track Combined",5000,10442,-5442,0,0,0,5000,10442,-5442,".","8",0,9600
"1078",213367,"LA SALLE UNIVERSITY                                         ","2003-2004",1,"Baseball",238606,244051,-5445,238606,244051,-5445,0,0,0,"29",".",68817,0
"9416",111948,"CHAPMAN UNIVERSITY                                          ","2003-2004",16,"Softball",32000,37450,-5450,0,0,0,32000,37450,-5450,".","18",0,13500
"13988",164207,"WASHINGTON BIBLE COLLEGE-CAPITAL BIBLE SEMINARY             ","2003-2004",26,"Volleyball",1,5462,-5461,0,0,0,1,5462,-5461,".","8",0,4192
"2573",130697,"WESLEYAN UNIVERSITY                                         ","2003-2004",2,"Basketball",170100,175562,-5462,90635,90612,23,79465,84950,-5485,"15","16",26148,30397
"1999",403478,"ILLINOIS EASTERN COMMUNITY COLLS-LINCOLN TR COLL            ","2003-2004",2,"Basketball",196222,201694,-5472,132967,134580,-1613,63255,67114,-3859,"13","13",17366,9815
"2242",198066,"BREVARD COLLEGE                                             ","2003-2004",2,"Basketball",107000,112477,-5477,58000,62293,-4293,49000,50184,-1184,"16","7",26293,20184
"14813",130697,"WESLEYAN UNIVERSITY                                         ","2003-2004",28,"Wrestling",58931,64411,-5480,58931,64411,-5480,0,0,0,"20",".",27136,0
"17326",117733,"LOS ANGELES VALLEY COLLEGE                                  ","2003-2004",39,"Total Participants",197212,202694,-5482,87177,90853,-3676,110035,111841,-1806,"189","95",80224,49442
"11766",197027,"UNITED STATES MERCHANT MARINE ACADEMY                       ","2003-2004",22,"Tennis",300,5798,-5498,300,5798,-5498,0,0,0,"11",".",898,0
"3360",214786,"PENNSYLVANIA STATE UNIVERSITY-PENN ST MCKEESPORT            ","2003-2004",2,"Basketball",13000,18500,-5500,13000,18500,-5500,0,0,0,"12","0",13000,0
"6255",173328,"CONCORDIA UNIVERSITY-ST PAUL                                ","2003-2004",8,"Golf",11932,17434,-5502,0,0,0,11932,17434,-5502,".","7",0,11434
"11294",199032,"MONTREAT COLLEGE                                            ","2003-2004",22,"Tennis",7900,13407,-5507,3950,6341,-2391,3950,7066,-3116,"6","7",3341,4066
"14115",125727,"WESTMONT COLLEGE                                            ","2003-2004",26,"Volleyball",90666,96181,-5515,0,0,0,90666,96181,-5515,".","13",0,22946
"4047",161554,"UNIVERSITY OF SOUTHERN MAINE                                ","2003-2004",6,"Field hocky",38761,44282,-5521,0,0,0,38761,44282,-5521,".","18",0,23704
"4907",165820,"FITCHBURG STATE COLLEGE                                     ","2003-2004",7,"Football",53332,58853,-5521,53332,58853,-5521,0,0,0,"69",".",35006,0
"1854",177676,"JEFFERSON COLLEGE                                           ","2003-2004",2,"Basketball",48463,53985,-5522,0,0,0,48463,53985,-5522,".","12",0,25006
"14205",121886,"RIO HONDO COLLEGE                                           ","2003-2004",26,"Volleyball",11510,17036,-5526,0,0,0,11510,17036,-5526,".","10",0,4942
"9584",141565,"UNIVERSITY OF HAWAII AT HILO                                ","2003-2004",16,"Softball",115174,120701,-5527,0,0,0,115174,120701,-5527,".","16",0,56129
"15266",228246,"SOUTHERN METHODIST UNIVERSITY                               ","2003-2004",34,"Equestrian",127494,133023,-5529,0,0,0,127494,133023,-5529,".","19",0,23514
"8614",170532,"KALAMAZOO COLLEGE                                           ","2003-2004",16,"Softball",13703,19247,-5544,0,0,0,13703,19247,-5544,".","16",0,11012
"4095",210571,"ALBRIGHT COLLEGE                                            ","2003-2004",6,"Field hocky",18305,23855,-5550,0,0,0,18305,23855,-5550,".","19",0,18305
"5624",172051,"SAGINAW VALLEY STATE UNIVERSITY                             ","2003-2004",8,"Golf",44376,49954,-5578,44376,49954,-5578,0,0,0,"12",".",30494,0
"8187",128744,"UNIVERSITY OF BRIDGEPORT                                    ","2003-2004",15,"Soccer",468581,474160,-5579,238907,237995,912,229674,236165,-6491,"26","21",16184,16854
"12829",164720,"BECKER COLLEGE                                              ","2003-2004",25,"Track and Field, X-Country",330,5917,-5587,220,3157,-2937,110,2760,-2650,"7","4",657,260
"4614",148131,"QUINCY UNIVERSITY                                           ","2003-2004",7,"Football",717313,722912,-5599,717313,722912,-5599,0,0,0,"98",".",74638,0
"15517",154721,"BETHANY COLLEGE                                             ","2003-2004",39,"Total Participants",659345,664948,-5603,385135,395885,-10750,274210,269063,5147,"238","79",146218,71013
"11529",195562,"SAINT JOSEPHS COLLEGE-SUFFOLK CAMPUS                        ","2003-2004",22,"Tennis",9770,15375,-5605,1128,4030,-2902,8642,11345,-2703,"7","7",1078,4683
"4050",190983,"ELMIRA COLLEGE                                              ","2003-2004",6,"Field hocky",89367,94978,-5611,0,0,0,89367,94978,-5611,".","24",0,30465
"11076",162928,"JOHNS HOPKINS UNIVERSITY                                    ","2003-2004",22,"Tennis",34896,40523,-5627,16947,19347,-2400,17949,21176,-3227,"10","11",9563,10424
"13213",176910,"CENTRAL CHRISTIAN COLLEGE OF THE BIBLE                      ","2003-2004",26,"Volleyball",2097,7737,-5640,0,0,0,2097,7737,-5640,".","9",0,5737
"7446",148131,"QUINCY UNIVERSITY                                           ","2003-2004",15,"Soccer",453407,459048,-5641,237201,241212,-4011,216206,217836,-1630,"28","23",25848,22912
"6755",231059,"SAINT MICHAELS COLLEGE                                      ","2003-2004",11,"Lacrosse",191875,197519,-5644,90585,93786,-3201,101290,103733,-2443,"25","23",22714,32468
"1290",161688,"ALLEGANY COLLEGE OF MARYLAND                                ","2003-2004",1,"Baseball",61626,67291,-5665,61626,67291,-5665,0,0,0,"25",".",9675,0
"11120",240480,"UNIVERSITY OF WISCONSIN-STEVENS POINT                       ","2003-2004",22,"Tennis",11915,17586,-5671,0,0,0,11915,17586,-5671,".","10",0,5411
"1446",201548,"CAPITAL UNIVERSITY                                          ","2003-2004",1,"Baseball",86950,92622,-5672,86950,92622,-5672,0,0,0,"23",".",29902,0
"12518",209038,"LANE COMMUNITY COLLEGE                                      ","2003-2004",25,"Track and Field, X-Country",26452,32134,-5682,13226,14177,-951,13226,17957,-4731,"2","3",10418,10418
"8785",191241,"FORDHAM UNIVERSITY                                          ","2003-2004",16,"Softball",517071,522755,-5684,0,0,0,517071,522755,-5684,".","20",0,90524
"10453",240365,"UNIVERSITY OF WISCONSIN-OSHKOSH                             ","2003-2004",18,"Swimming and Diving",67851,73541,-5690,33211,36091,-2880,34640,37450,-2810,"12","22",12108,13467
"6233",149231,"SOUTHERN ILLINOIS UNIVERSITY-EDWARDSVILLE                   ","2003-2004",8,"Golf",81534,87231,-5697,0,0,0,81534,87231,-5697,".","9",0,23874
"5609",164173,"VILLA JULIE COLLEGE                                         ","2003-2004",8,"Golf",9190,14889,-5699,4595,8587,-3992,4595,6302,-1707,"9","4",3038,752
"9267",190716,"D'YOUVILLE COLLEGE                                          ","2003-2004",16,"Softball",9000,14701,-5701,0,0,0,9000,14701,-5701,".","13",0,8951
"7526",214041,"MILLERSVILLE UNIVERSITY OF PENNSYLVANIA                     ","2003-2004",15,"Soccer",98685,104397,-5712,47812,52185,-4373,50873,52212,-1339,"30","24",15778,14190
"1906",195216,"ST LAWRENCE UNIVERSITY                                      ","2003-2004",2,"Basketball",129110,134824,-5714,67275,68497,-1222,61835,66327,-4492,"13","13",18804,24179
"11765",240453,"UNIVERSITY OF WISCONSIN-MILWAUKEE                           ","2003-2004",22,"Tennis",68973,74706,-5733,0,0,0,68973,74706,-5733,".","8",0,17924
"11740",190691,"CUNY YORK COLLEGE                                           ","2003-2004",22,"Tennis",4510,10247,-5737,4510,10247,-5737,0,0,0,"10",".",4510,0
"6611",211158,"BLOOMSBURG UNIVERSITY OF PENNSYLVANIA                       ","2003-2004",11,"Lacrosse",91246,96984,-5738,0,0,0,91246,96984,-5738,".","18",0,15496
"1355",236753,"TACOMA COMMUNITY COLLEGE                                    ","2003-2004",1,"Baseball",11770,17512,-5742,11770,17512,-5742,0,0,0,"26",".",11512,0
"5874",196149,"SUNY COLLEGE AT CORTLAND                                    ","2003-2004",8,"Golf",6925,12667,-5742,0,0,0,6925,12667,-5742,".","6",0,7484
"13243",191612,"HERKIMER COUNTY COMMUNITY COLLEGE                           ","2003-2004",26,"Volleyball",7995,13745,-5750,0,0,0,7995,13745,-5750,".","12",0,7995
"15315",229799,"WEATHERFORD COLLEGE                                         ","2003-2004",35,"Rodeo",13231,18986,-5755,8600,12341,-3741,4631,6645,-2014,"27","0",6500,3500
"11331",164720,"BECKER COLLEGE                                              ","2003-2004",22,"Tennis",1859,7616,-5757,1203,4351,-3148,656,3265,-2609,"6","7",1851,1065
"7875",210429,"WESTERN OREGON UNIVERSITY                                   ","2003-2004",15,"Soccer",71065,76838,-5773,0,0,0,71065,76838,-5773,".","20",0,31245
"15879",164492,"ANNA MARIA COLLEGE                                          ","2003-2004",39,"Total Participants",132355,138129,-5774,36705,39453,-2748,95650,98676,-3026,"62","68",81333,137815
"1225",216524,"URSINUS COLLEGE                                             ","2003-2004",1,"Baseball",38900,44676,-5776,38900,44676,-5776,0,0,0,"24",".",20600,0
"13992",172440,"FINLANDIA UNIVERSITY                                        ","2003-2004",26,"Volleyball",13754,19542,-5788,0,0,0,13754,19542,-5788,".","8",0,12012
"10822",154527,"WARTBURG COLLEGE                                            ","2003-2004",22,"Tennis",8504,14294,-5790,4009,6899,-2890,4495,7395,-2900,"11","13",3649,4145
"11594",176169,"NORTHEAST MISSISSIPPI COMMUNITY COLLEGE                     ","2003-2004",22,"Tennis",4662,10456,-5794,2331,5228,-2897,2331,5228,-2897,"6","4",2076,2076
"10138",196194,"SUNY COLLEGE AT OSWEGO                                      ","2003-2004",18,"Swimming and Diving",84712,90510,-5798,40813,43466,-2653,43899,47044,-3145,"17","25",21108,24685
"3047",204194,"MOUNT VERNON NAZARENE UNIVERSITY                            ","2003-2004",2,"Basketball",63138,68940,-5802,35096,39463,-4367,28042,29477,-1435,"22","14",32504,25450
"15162",241377,"CARIBBEAN UNIVERSITY-BAYAMON                                ","2003-2004",32,"Beach Volleyball",1500,7316,-5816,750,4560,-3810,750,2756,-2006,"5","3",830,630
"6170",207689,"SAINT GREGORYS UNIVERSITY                                   ","2003-2004",8,"Golf",129690,135509,-5819,70740,68725,2015,58950,66784,-7834,"6","5",7208,5000
"7284",146418,"KISHWAUKEE COLLEGE                                          ","2003-2004",15,"Soccer",9414,15238,-5824,9414,15238,-5824,0,0,0,"20",".",9970,0
"12866",232089,"FERRUM COLLEGE                                              ","2003-2004",25,"Track and Field, X-Country",7490,13314,-5824,3745,6657,-2912,3745,6657,-2912,"6","5",2937,2937
"10248",113980,"EL CAMINO COLLEGE                                           ","2003-2004",18,"Swimming and Diving",48476,54308,-5832,24238,27154,-2916,24238,27154,-2916,"16","14",16898,16898
"9597",212133,"EASTERN UNIVERSITY                                          ","2003-2004",16,"Softball",16413,22250,-5837,0,0,0,16413,22250,-5837,".","15",0,14970
"14885",119137,"MOORPARK COLLEGE                                            ","2003-2004",28,"Wrestling",8991,14830,-5839,8991,14830,-5839,0,0,0,"17",".",8991,0
"11946",104346,"CENTRAL ARIZONA COLLEGE                                     ","2003-2004",24,"Track and Field, Outdoor",190764,196614,-5850,93030,91802,1228,97734,104812,-7078,"44","21",31546,29387
"3274",175421,"BELHAVEN COLLEGE                                            ","2003-2004",2,"Basketball",329567,335422,-5855,164143,164109,34,165424,171313,-5889,"15","15",30170,29774
"12860",233897,"THE UNIVERSITY OF VIRGINIA'S COLLEGE AT WISE                ","2003-2004",25,"Track and Field, X-Country",6850,12714,-5864,3425,6223,-2798,3425,6491,-3066,"5","5",2478,2428
"10665",110671,"UNIVERSITY OF CALIFORNIA-RIVERSIDE                          ","2003-2004",22,"Tennis",277197,283067,-5870,118176,122770,-4594,159021,160297,-1276,"9","10",6617,6552
"16057",127732,"NORTHEASTERN JUNIOR COLLEGE                                 ","2003-2004",39,"Total Participants",41620,47500,-5880,21000,29000,-8000,20620,18500,2120,"38","25",37000,27000
"4232",186131,"PRINCETON UNIVERSITY                                        ","2003-2004",6,"Field hocky",213759,219658,-5899,0,0,0,213759,219658,-5899,".","16",0,59310
"12688",214652,"PENNSYLVANIA STATE UNIV-PENN ST WORTHINGTON SCRNTN          ","2003-2004",25,"Track and Field, X-Country",3500,9400,-5900,2000,4700,-2700,1500,4700,-3200,"6","3",300,300
"2164",175643,"EAST CENTRAL COMMUNITY COLLEGE                              ","2003-2004",2,"Basketball",234608,240514,-5906,118283,119079,-796,116325,121435,-5110,"15","14",23412,28001
"9885",167394,"COLLEGE OF OUR LADY OF THE ELMS                             ","2003-2004",16,"Softball",38571,44486,-5915,0,0,0,38571,44486,-5915,".","18",0,10973
"11662",154688,"BAKER UNIVERSITY COLLEGE OF ARTS AND SCIENCES               ","2003-2004",22,"Tennis",107151,113066,-5915,57941,58503,-562,49210,54563,-5353,"6","9",11937,12036
"10180",171599,"OLIVET COLLEGE                                              ","2003-2004",18,"Swimming and Diving",80700,86619,-5919,40350,43243,-2893,40350,43376,-3026,"19","19",14981,14981
"677",109907,"BARSTOW COLLEGE                                             ","2003-2004",1,"Baseball",15960,21890,-5930,15960,21890,-5930,0,0,0,"13",".",12756,0
"1158",194091,"NEW YORK INSTITUTE OF TECHNOLOGY-OLD WESTBURY               ","2003-2004",1,"Baseball",312593,318552,-5959,312593,318552,-5959,0,0,0,"33",".",62278,0
"13572",113193,"CUESTA COLLEGE                                              ","2003-2004",26,"Volleyball",8176,14136,-5960,0,0,0,8176,14136,-5960,".","10",0,5779
"9504",219082,"DAKOTA STATE UNIVERSITY                                     ","2003-2004",16,"Softball",45813,51793,-5980,0,0,0,45813,51793,-5980,".","13",0,19237
"755",170532,"KALAMAZOO COLLEGE                                           ","2003-2004",1,"Baseball",17662,23643,-5981,17662,23643,-5981,0,0,0,"19",".",15408,0
"9365",181446,"NEBRASKA WESLEYAN UNIVERSITY                                ","2003-2004",16,"Softball",27882,33865,-5983,0,0,0,27882,33865,-5983,".","22",0,24247
"6309",202222,"COLUMBUS STATE COMMUNITY COLLEGE                            ","2003-2004",9,"Gymnastics",5750,11735,-5985,0,0,0,5750,11735,-5985,".","9",0,3535
"87",113333,"DE ANZA COLLEGE                                             ","2003-2004",1,"Baseball",14855,20845,-5990,14855,20845,-5990,0,0,0,"29",".",15459,0
"8778",178411,"UNIVERSITY OF MISSOURI-ROLLA                                ","2003-2004",16,"Softball",100634,106626,-5992,0,0,0,100634,106626,-5992,".","18",0,33042
"88",191612,"HERKIMER COUNTY COMMUNITY COLLEGE                           ","2003-2004",1,"Baseball",10000,16000,-6000,10000,16000,-6000,0,0,0,"22",".",10000,0
"325",220604,"LE MOYNE-OWEN COLLEGE                                       ","2003-2004",1,"Baseball",90000,96000,-6000,90000,96000,-6000,0,0,0,"18",".",90000,0
"5924",170587,"KIRTLAND COMMUNITY COLLEGE                                  ","2003-2004",8,"Golf",11226,17226,-6000,11226,17226,-6000,0,0,0,"5",".",4348,0
"5945",164580,"BABSON COLLEGE                                              ","2003-2004",8,"Golf",3806,9806,-6000,3806,9806,-6000,0,0,0,"7","0",3806,0
"6540",182661,"DANIEL WEBSTER COLLEGE                                      ","2003-2004",11,"Lacrosse",7669,13669,-6000,7669,13669,-6000,0,0,0,"19",".",7669,0
"7254",182661,"DANIEL WEBSTER COLLEGE                                      ","2003-2004",15,"Soccer",7046,13046,-6000,7046,13046,-6000,0,0,0,"18",".",7046,0
"9285",191612,"HERKIMER COUNTY COMMUNITY COLLEGE                           ","2003-2004",16,"Softball",10000,16000,-6000,0,0,0,10000,16000,-6000,".","20",0,10000
"12739",190512,"CUNY BERNARD M BARUCH COLLEGE                               ","2003-2004",25,"Track and Field, X-Country",6500,12500,-6000,0,0,0,6500,12500,-6000,".","10",0,2500
"14988",210146,"SOUTHERN OREGON UNIVERSITY                                  ","2003-2004",28,"Wrestling",48526,54526,-6000,48526,54526,-6000,0,0,0,"43",".",29815,0
"15600",190673,"CUNY QUEENSBOROUGH COMMUNITY COLLEGE                        ","2003-2004",39,"Total Participants",36000,42000,-6000,18500,21500,-3000,17500,20500,-3000,"122","99",25000,23500
"16809",170587,"KIRTLAND COMMUNITY COLLEGE                                  ","2003-2004",39,"Total Participants",20300,26300,-6000,11226,17226,-6000,9074,9074,0,"20","17",48047,47946
"4228",164720,"BECKER COLLEGE                                              ","2003-2004",6,"Field hocky",5208,11226,-6018,0,0,0,5208,11226,-6018,".","15",0,7126
"708",173300,"CONCORDIA COLLEGE AT MOORHEAD                               ","2003-2004",1,"Baseball",53623,59646,-6023,53623,59646,-6023,0,0,0,"43",".",2385,0
"6885",232681,"MARY WASHINGTON COLLEGE                                     ","2003-2004",13,"Rowing",62910,68949,-6039,31455,34155,-2700,31455,34794,-3339,"25","54",14901,15564
"14948",120971,"PALOMAR COLLEGE                                             ","2003-2004",28,"Wrestling",9979,16027,-6048,9979,16027,-6048,0,0,0,"18",".",5464,0
"13160",201654,"CEDARVILLE UNIVERSITY                                       ","2003-2004",26,"Volleyball",86686,92738,-6052,0,0,0,86686,92738,-6052,".","12",0,23895
"7963",173300,"CONCORDIA COLLEGE AT MOORHEAD                               ","2003-2004",15,"Soccer",76637,82691,-6054,43768,52581,-8813,32869,30110,2759,"28","22",1800,1800
"5792",198899,"MARS HILL COLLEGE                                           ","2003-2004",8,"Golf",22211,28270,-6059,22211,28270,-6059,0,0,0,"9",".",11547,0
"8758",166513,"UNIVERSITY OF MASSACHUSETTS-LOWELL                          ","2003-2004",16,"Softball",127402,133467,-6065,0,0,0,127402,133467,-6065,".","20",0,16160
"5245",168546,"ALBION COLLEGE                                              ","2003-2004",8,"Golf",20337,26405,-6068,6388,12456,-6068,13949,13949,0,"9","7",4503,6103
"11422",109819,"BAKERSFIELD COLLEGE                                         ","2003-2004",22,"Tennis",22684,28754,-6070,11342,14377,-3035,11342,14377,-3035,"10","8",4572,4572
"6521",168005,"SUFFOLK UNIVERSITY                                          ","2003-2004",10,"Ice Hockey",29200,35277,-6077,29200,35277,-6077,0,0,0,"27",".",29200,0
"6830",216010,"SHIPPENSBURG UNIVERSITY OF PENNSYLVANIA                     ","2003-2004",11,"Lacrosse",70975,77057,-6082,0,0,0,70975,77057,-6082,".","25",0,17125
"14250",231165,"VERMONT TECHNICAL COLLEGE                                   ","2003-2004",26,"Volleyball",7651,13736,-6085,3611,7496,-3885,4040,6240,-2200,"11","12",3611,4040
"11382",166683,"MASSACHUSETTS INSTITUTE OF TECHNOLOGY                       ","2003-2004",22,"Tennis",84533,90628,-6095,35337,36548,-1211,49196,54080,-4884,"14","14",15589,25335
"8210",162104,"CECIL COMMUNITY COLLEGE                                     ","2003-2004",15,"Soccer",1106,7202,-6096,553,4522,-3969,553,2680,-2127,"13","11",1195,1195
"1969",229780,"WAYLAND BAPTIST UNIVERSITY                                  ","2003-2004",2,"Basketball",446300,452400,-6100,225400,229400,-4000,220900,223000,-2100,"13","14",63400,59900
"10595",167394,"COLLEGE OF OUR LADY OF THE ELMS                             ","2003-2004",19,"Swimming",22451,28556,-6105,10832,14022,-3190,11619,14534,-2915,"3","3",1797,2309
"10563",213321,"KINGS COLLEGE                                               ","2003-2004",19,"Swimming",13814,19932,-6118,6907,9966,-3059,6907,9966,-3059,"10","8",6907,6907
"1520",177135,"CROWDER COLLEGE                                             ","2003-2004",1,"Baseball",130143,136268,-6125,130143,136268,-6125,0,0,0,"30",".",32092,0
"16495",177135,"CROWDER COLLEGE                                             ","2003-2004",39,"Total Participants",130143,136268,-6125,130143,136268,-6125,0,0,0,"30","15",32092,21342
"13383",239071,"MARANATHA BAPTIST BIBLE COLLEGE INC                         ","2003-2004",26,"Volleyball",44669,50796,-6127,0,0,0,44669,50796,-6127,".","13",0,11372
"11789",199999,"WINSTON-SALEM STATE UNIVERSITY                              ","2003-2004",22,"Tennis",13700,19835,-6135,6850,10960,-4110,6850,8875,-2025,"8","6",6105,5108
"5670",214041,"MILLERSVILLE UNIVERSITY OF PENNSYLVANIA                     ","2003-2004",8,"Golf",33474,39613,-6139,33474,39613,-6139,0,0,0,"10",".",13851,0
"10735",121150,"PEPPERDINE UNIVERSITY                                       ","2003-2004",22,"Tennis",832420,838561,-6141,369933,394948,-25015,462487,443613,18874,"7","7",54803,26898
"4230",165820,"FITCHBURG STATE COLLEGE                                     ","2003-2004",6,"Field hocky",15268,21421,-6153,0,0,0,15268,21421,-6153,".","17",0,11587
"7899",199962,"WINGATE UNIVERSITY                                          ","2003-2004",15,"Soccer",51724,57877,-6153,31751,34984,-3233,19973,22893,-2920,"27","23",22664,19973
"12694",113980,"EL CAMINO COLLEGE                                           ","2003-2004",25,"Track and Field, X-Country",61308,67464,-6156,30654,33732,-3078,30654,33732,-3078,"45","38",8778,8778
"8713",165820,"FITCHBURG STATE COLLEGE                                     ","2003-2004",16,"Softball",24713,30870,-6157,0,0,0,24713,30870,-6157,".","14",0,23116
"10076",190415,"CORNELL UNIVERSITY-ENDOWED COLLEGES                         ","2003-2004",17,"Squash",147354,153520,-6166,73677,76760,-3083,73677,76760,-3083,"12","11",30164,30164
"1323",220701,"MARTIN METHODIST COLLEGE                                    ","2003-2004",1,"Baseball",224253,230421,-6168,224253,230421,-6168,0,0,0,"24",".",23572,0
"13940",191986,"JAMESTOWN COMMUNITY COLLEGE                                 ","2003-2004",26,"Volleyball",7553,13764,-6211,0,0,0,7553,13764,-6211,"0","8",0,3726
"14200",181738,"UNION COLLEGE                                               ","2003-2004",26,"Volleyball",1434,7649,-6215,0,0,0,1434,7649,-6215,".","11",0,6215
"6057",173142,"BETHANY LUTHERAN COLLEGE                                    ","2003-2004",8,"Golf",17196,23412,-6216,8598,11706,-3108,8598,11706,-3108,"5","6",3078,3078
"15830",239080,"MARIAN COLLEGE OF FOND DU LAC                               ","2003-2004",39,"Total Participants",383428,389645,-6217,217954,222497,-4543,165474,167148,-1674,"101","74",92156,64805
"1351",196158,"SUNY COLLEGE AT FREDONIA                                    ","2003-2004",1,"Baseball",63157,69379,-6222,63157,69379,-6222,0,0,0,"30",".",44010,0
"7612",236638,"SKAGIT VALLEY COLLEGE                                       ","2003-2004",15,"Soccer",32000,38223,-6223,16000,19400,-3400,16000,18823,-2823,"17","17",16000,16000
"7236",154350,"SIMPSON COLLEGE                                             ","2003-2004",15,"Soccer",66364,72590,-6226,33182,36295,-3113,33182,36295,-3113,"40","24",23025,21726
"11317",194222,"ONONDAGA COMMUNITY COLLEGE                                  ","2003-2004",22,"Tennis",32185,38427,-6242,17855,24617,-6762,14330,13810,520,"14","7",14488,3740
"1941",194569,"PRACTICAL BIBLE COLLEGE                                     ","2003-2004",2,"Basketball",14010,20260,-6250,7005,10005,-3000,7005,10255,-3250,"13","10",7005,7005
"12390",109208,"AMERICAN RIVER COLLEGE                                      ","2003-2004",25,"Track and Field, X-Country",5016,11273,-6257,2508,5877,-3369,2508,5396,-2888,"21","10",3485,3004
"10482",168254,"WESTERN NEW ENGLAND COLLEGE                                 ","2003-2004",19,"Swimming",5525,11795,-6270,0,0,0,5525,11795,-6270,".","12",0,5170
"8695",142461,"NORTHWEST NAZARENE UNIVERSITY                               ","2003-2004",16,"Softball",89124,95413,-6289,0,0,0,89124,95413,-6289,".","13",0,22139
"12523",110246,"BUTTE COLLEGE                                               ","2003-2004",25,"Track and Field, X-Country",31370,37664,-6294,15682,22300,-6618,15688,15364,324,"37","13",22299,10944
"372",167631,"ROXBURY COMMUNITY COLLEGE                                   ","2003-2004",1,"Baseball",5000,11295,-6295,5000,11295,-6295,0,0,0,"24",".",7095,0
"17016",167631,"ROXBURY COMMUNITY COLLEGE                                   ","2003-2004",39,"Total Participants",5000,11295,-6295,5000,11295,-6295,0,0,0,"38","9",26825,6316
"12710",169275,"MOTT COMMUNITY COLLEGE                                      ","2003-2004",25,"Track and Field, X-Country",400,6706,-6306,100,3253,-3153,300,3453,-3153,"6","4",3152,3152
"6192",176169,"NORTHEAST MISSISSIPPI COMMUNITY COLLEGE                     ","2003-2004",8,"Golf",3961,10273,-6312,3961,10273,-6312,0,0,0,"10",".",5868,0
"16050",173559,"MINNESOTA STATE COMM AND TECH COLLEGE-FERGUS FALLS          ","2003-2004",39,"Total Participants",122730,129042,-6312,55896,60428,-4532,66834,68614,-1780,"83","47",55534,44265
"467",198303,"CHOWAN COLLEGE                                              ","2003-2004",1,"Baseball",94401,100729,-6328,94401,100729,-6328,0,0,0,"47",".",49046,0
"6114",238661,"EDGEWOOD COLLEGE                                            ","2003-2004",8,"Golf",19627,25955,-6328,12240,9615,2625,7387,16340,-8953,"12","7",6615,6615
"6144",193326,"MONROE COMMUNITY COLLEGE                                    ","2003-2004",8,"Golf",14911,21240,-6329,14911,21240,-6329,0,0,0,"6",".",9639,0
"5766",224004,"CONCORDIA UNIVERSITY AT AUSTIN                              ","2003-2004",8,"Golf",8450,14782,-6332,8450,14782,-6332,0,0,0,"8",".",5962,0
"6032",191241,"FORDHAM UNIVERSITY                                          ","2003-2004",8,"Golf",32975,39310,-6335,32975,39310,-6335,0,0,0,"9","0",27821,0
"15630",153296,"ELLSWORTH COMMUNITY COLLEGE                                 ","2003-2004",39,"Total Participants",111775,118140,-6365,75972,79445,-3473,35803,38695,-2892,"150","44",124777,44076
"1390",228149,"ST MARYS UNIVERSITY                                         ","2003-2004",1,"Baseball",59097,65466,-6369,59097,65466,-6369,0,0,0,"33",".",43227,0
"11674",177214,"DRURY UNIVERSITY                                            ","2003-2004",22,"Tennis",54726,61113,-6387,32184,36853,-4669,22542,24260,-1718,"7","7",34076,19953
"2960",201964,"CIRCLEVILLE BIBLE COLLEGE                                   ","2003-2004",2,"Basketball",19151,25551,-6400,12767,15967,-3200,6384,9584,-3200,"14","7",12767,6384
"320",146418,"KISHWAUKEE COLLEGE                                          ","2003-2004",1,"Baseball",27675,34079,-6404,27675,34079,-6404,0,0,0,"23",".",25731,0
"3191",195526,"SKIDMORE COLLEGE                                            ","2003-2004",2,"Basketball",103522,109930,-6408,60675,66291,-5616,42847,43639,-792,"15","10",26157,15944
"9245",121619,"SANTA ANA COLLEGE                                           ","2003-2004",16,"Softball",9000,15427,-6427,0,0,0,9000,15427,-6427,".","13",0,12706
"14867",233611,"SOUTHERN VIRGINIA UNIVERSITY                                ","2003-2004",28,"Wrestling",2945,9373,-6428,2945,9373,-6428,0,0,0,"11",".",2945,0
"10477",231059,"SAINT MICHAELS COLLEGE                                      ","2003-2004",19,"Swimming",67474,73903,-6429,21592,23648,-2056,45882,50255,-4373,"11","23",12890,27392
"925",148131,"QUINCY UNIVERSITY                                           ","2003-2004",1,"Baseball",254248,260682,-6434,254248,260682,-6434,0,0,0,"40",".",50896,0
"7465",190558,"CUNY COLLEGE OF STATEN ISLAND                               ","2003-2004",15,"Soccer",8210,14652,-6442,8210,14652,-6442,0,0,0,"22",".",8210,0
"16428",190248,"CONCORDIA COLLEGE                                           ","2003-2004",39,"Total Participants",105577,112027,-6450,68709,75159,-6450,36868,36868,0,"85","65",48803,34086
"14617",142559,"COLLEGE OF SOUTHERN IDAHO                                   ","2003-2004",26,"Volleyball",105246,111700,-6454,0,0,0,105246,111700,-6454,".","12",0,105700
"14093",174817,"SAINT MARY'S UNIVERSITY OF MINNESOTA                        ","2003-2004",26,"Volleyball",55082,61545,-6463,0,0,0,55082,61545,-6463,".","24",0,23285
"2162",155520,"MIDAMERICA NAZARENE UNIVERSITY                              ","2003-2004",2,"Basketball",321540,328004,-6464,165541,168885,-3344,155999,159119,-3120,"25","13",34104,35170
"11919",155511,"MCPHERSON COLLEGE                                           ","2003-2004",23,"Track and Field, Indoor",6531,13000,-6469,3320,6500,-3180,3211,6500,-3289,"16","11",3000,3000
"12285",153296,"ELLSWORTH COMMUNITY COLLEGE                                 ","2003-2004",25,"Track and Field, X-Country",726,7200,-6474,200,3600,-3400,526,3600,-3074,"3","1",3500,3500
"9947",233611,"SOUTHERN VIRGINIA UNIVERSITY                                ","2003-2004",16,"Softball",8892,15384,-6492,0,0,0,8892,15384,-6492,".","15",0,8956
"10844",191612,"HERKIMER COUNTY COMMUNITY COLLEGE                           ","2003-2004",22,"Tennis",2100,8600,-6500,1050,4050,-3000,1050,4550,-3500,"5","6",1050,1050
"14672",109208,"AMERICAN RIVER COLLEGE                                      ","2003-2004",27,"Water Polo",6190,12690,-6500,0,0,0,6190,12690,-6500,".","12",0,10198
"2153",243188,"UNIVERSITY OF PUERTO RICO-UTUADO                            ","2003-2004",2,"Basketball",1000,7505,-6505,1000,7505,-6505,0,0,0,"13","0",1190,0
"9033",157951,"WESTERN KENTUCKY UNIVERSITY                                 ","2003-2004",16,"Softball",309272,315793,-6521,0,0,0,309272,315793,-6521,".","18",0,66425
"10999",134495,"HILLSBOROUGH COMMUNITY COLLEGE                              ","2003-2004",22,"Tennis",7019,13541,-6522,0,0,0,7019,13541,-6522,".","8",0,7019
"1640",240620,"LARAMIE COUNTY COMMUNITY COLLEGE                            ","2003-2004",2,"Basketball",61857,68380,-6523,61857,68380,-6523,0,0,0,"14",".",30205,0
"7616",150561,"TAYLOR UNIVERSITY-FT WAYNE                                  ","2003-2004",15,"Soccer",4350,10876,-6526,4350,10876,-6526,0,0,0,"13",".",6526,0
"13621",240417,"UNIVERSITY OF WISCONSIN-STOUT                               ","2003-2004",26,"Volleyball",43133,49667,-6534,0,0,0,43133,49667,-6534,".","15",0,22395
"3309",204024,"MIAMI UNIVERSITY-OXFORD                                     ","2003-2004",2,"Basketball",1784447,1790990,-6543,942351,942547,-196,842096,848443,-6347,"15","14",130316,140915
"8200",180106,"CARROLL COLLEGE                                             ","2003-2004",15,"Soccer",174010,180564,-6554,0,0,0,174010,180564,-6554,".","24",0,45479
"10319",190558,"CUNY COLLEGE OF STATEN ISLAND                               ","2003-2004",18,"Swimming and Diving",13000,19598,-6598,6500,9799,-3299,6500,9799,-3299,"17","18",6500,6500
"11184",239318,"MILWAUKEE SCHOOL OF ENGINEERING                             ","2003-2004",22,"Tennis",10376,16987,-6611,5870,10587,-4717,4506,6400,-1894,"11","6",6383,2196
"14674",113980,"EL CAMINO COLLEGE                                           ","2003-2004",27,"Water Polo",38954,45576,-6622,19477,22788,-3311,19477,22788,-3311,"19","12",14293,14293
"8089",190248,"CONCORDIA COLLEGE                                           ","2003-2004",15,"Soccer",11926,18556,-6630,5296,11926,-6630,6630,6630,0,"15","15",5296,3227
"9913",210571,"ALBRIGHT COLLEGE                                            ","2003-2004",16,"Softball",9785,16417,-6632,0,0,0,9785,16417,-6632,".","17",0,9785
"9828",173300,"CONCORDIA COLLEGE AT MOORHEAD                               ","2003-2004",16,"Softball",32635,39285,-6650,0,0,0,32635,39285,-6650,".","24",0,1540
"13732",133711,"FLAGLER COLLEGE                                             ","2003-2004",26,"Volleyball",58604,65276,-6672,0,0,0,58604,65276,-6672,"0","14",0,17922
"4203",195216,"ST LAWRENCE UNIVERSITY                                      ","2003-2004",6,"Field hocky",73490,80173,-6683,0,0,0,73490,80173,-6683,".","22",0,32609
"10831",168005,"SUFFOLK UNIVERSITY                                          ","2003-2004",22,"Tennis",9000,15708,-6708,4500,7854,-3354,4500,7854,-3354,"10","11",4500,4500
"9632",243151,"UNIVERSITY OF PUERTO RICO-CAYEY UNIVERSITY COLLEGE          ","2003-2004",16,"Softball",11950,18660,-6710,0,0,0,11950,18660,-6710,".","13",0,6760
"14304",233611,"SOUTHERN VIRGINIA UNIVERSITY                                ","2003-2004",26,"Volleyball",9766,16477,-6711,0,0,0,9766,16477,-6711,".","15",0,10049
"5412",236887,"WALLA WALLA COMMUNITY COLLEGE                               ","2003-2004",8,"Golf",25730,32445,-6715,17153,21145,-3992,8577,11300,-2723,"12","6",13645,5880
"13777",234164,"VIRGINIA UNION UNIVERSITY                                   ","2003-2004",26,"Volleyball",55945,62661,-6716,0,0,0,55945,62661,-6716,".","10",0,7121
"10449",213367,"LA SALLE UNIVERSITY                                         ","2003-2004",18,"Swimming and Diving",516553,523287,-6734,301597,304977,-3380,214956,218310,-3354,"23","25",32637,33799
"12814",118693,"MENLO COLLEGE                                               ","2003-2004",25,"Track and Field, X-Country",300,7038,-6738,150,3519,-3369,150,3519,-3369,"13",".",1475,1475
"17289",195526,"SKIDMORE COLLEGE                                            ","2003-2004",39,"Total Participants",773777,780527,-6750,450624,457075,-6451,323153,323452,-299,"180","171",224217,203936
"1961",169080,"CALVIN COLLEGE                                              ","2003-2004",2,"Basketball",127514,134266,-6752,70840,75799,-4959,56674,58467,-1793,"12","12",25895,15565
"12244",209250,"MT HOOD COMMUNITY COLLEGE                                   ","2003-2004",25,"Track and Field, X-Country",40,6800,-6760,20,3400,-3380,20,3400,-3380,"8","10",3380,3380
"1480",203128,"HIRAM COLLEGE                                               ","2003-2004",1,"Baseball",54560,61323,-6763,54560,61323,-6763,0,0,0,"29",".",28742,0
"9037",194240,"ORANGE COUNTY COMMUNITY COLLEGE                             ","2003-2004",16,"Softball",14708,21474,-6766,0,0,0,14708,21474,-6766,".","13",0,16174
"8787",109208,"AMERICAN RIVER COLLEGE                                      ","2003-2004",16,"Softball",9165,15932,-6767,0,0,0,9165,15932,-6767,".","12",0,10067
"12164",133881,"FLORIDA INSTITUTE OF TECHNOLOGY-MELBOURNE                   ","2003-2004",25,"Track and Field, X-Country",73953,80720,-6767,30252,32385,-2133,43701,48335,-4634,"13","10",7780,7781
"5349",212601,"GANNON UNIVERSITY                                           ","2003-2004",8,"Golf",120814,127583,-6769,58714,63764,-5050,62100,63819,-1719,"9","6",17067,11748
"3389",236638,"SKAGIT VALLEY COLLEGE                                       ","2003-2004",2,"Basketball",24000,30800,-6800,12000,15400,-3400,12000,15400,-3400,"14","14",12000,12000
"15437",206817,"BACONE COLLEGE                                              ","2003-2004",39,"Total Participants",1373200,1380000,-6800,875200,880000,-4800,498000,5e+05,-2000,"187","81",257067,117183
"16919",239071,"MARANATHA BAPTIST BIBLE COLLEGE INC                         ","2003-2004",39,"Total Participants",105066,111866,-6800,40040,43091,-3051,65026,68775,-3749,"153","67",42669,31734
"688",121886,"RIO HONDO COLLEGE                                           ","2003-2004",1,"Baseball",43271,50072,-6801,43271,50072,-6801,0,0,0,"29",".",29921,0
"8214",220701,"MARTIN METHODIST COLLEGE                                    ","2003-2004",15,"Soccer",450918,457737,-6819,228156,224345,3811,222762,233392,-10630,"24","16",15034,16333
"9169",178341,"MISSOURI SOUTHERN STATE UNIVERSITY                          ","2003-2004",16,"Softball",155540,162360,-6820,0,0,0,155540,162360,-6820,".","18",0,26985
"11053",173142,"BETHANY LUTHERAN COLLEGE                                    ","2003-2004",22,"Tennis",21362,28184,-6822,8206,10643,-2437,13156,17541,-4385,"6","8",1948,1948
"11340",148380,"ROCK VALLEY COLLEGE                                         ","2003-2004",22,"Tennis",8500,15361,-6861,5500,7320,-1820,3000,8041,-5041,"9","6",3660,4020
"15241",174075,"UNIVERSITY OF MINNESOTA-CROOKSTON                           ","2003-2004",34,"Equestrian",28120,34981,-6861,0,0,0,28120,34981,-6861,".","32",0,13861
"16720",198154,"CAPE FEAR COMMUNITY COLLEGE                                 ","2003-2004",39,"Total Participants",30000,36861,-6861,15000,16779,-1779,15000,20082,-5082,"32","15",35798,16000
"11316",167251,"NEWBURY COLLEGE-BROOKLINE                                   ","2003-2004",22,"Tennis",111,6982,-6871,57,3645,-3588,54,3337,-3283,"11","10",1285,1285
"11351",214591,"PENNSYLVANIA STATE UNIV-PENN ST ERIE-BEHREND COLL           ","2003-2004",22,"Tennis",11614,18486,-6872,7756,9889,-2133,3858,8597,-4739,"10","10",2645,3807
"10352",195562,"SAINT JOSEPHS COLLEGE-SUFFOLK CAMPUS                        ","2003-2004",18,"Swimming and Diving",11394,18267,-6873,0,0,0,11394,18267,-6873,".","11",0,10615
"15224",233499,"SAINT PAULS COLLEGE                                         ","2003-2004",33,"Bowling",4800,11677,-6877,0,0,0,4800,11677,-6877,".","9",0,5263
"6924",137546,"STETSON UNIVERSITY                                          ","2003-2004",13,"Rowing",105617,112495,-6878,34853,37123,-2270,70764,75372,-4608,"10","20",9910,20121
"9",155715,"PRATT COMMUNITY COLLEGE                                     ","2003-2004",1,"Baseball",133443,140323,-6880,133443,140323,-6880,0,0,0,"35",".",12500,0
"3651",133979,"FLORIDA MEMORIAL COLLEGE                                    ","2003-2004",3,"All Track Combined",94800,101700,-6900,34400,37850,-3450,60400,63850,-3450,"7","6",13850,13850
"14853",196194,"SUNY COLLEGE AT OSWEGO                                      ","2003-2004",28,"Wrestling",45742,52658,-6916,45742,52658,-6916,0,0,0,"25","0",27361,0
"11868",167996,"STONEHILL COLLEGE                                           ","2003-2004",23,"Track and Field, Indoor",31958,38883,-6925,15979,19445,-3466,15979,19438,-3459,"27","26",6931,6931
"12009",167996,"STONEHILL COLLEGE                                           ","2003-2004",24,"Track and Field, Outdoor",31958,38883,-6925,15979,19445,-3466,15979,19438,-3459,"28","23",6931,6931
"7618",236656,"SOUTH PUGET SOUND COMMUNITY COLLEGE                         ","2003-2004",15,"Soccer",22340,29273,-6933,22340,29273,-6933,0,0,0,"16",".",17221,0
"5282",154749,"BETHEL COLLEGE                                              ","2003-2004",8,"Golf",1000,7955,-6955,1000,7955,-6955,0,0,0,"5",".",5455,0
"9544",120971,"PALOMAR COLLEGE                                             ","2003-2004",16,"Softball",15851,22809,-6958,0,0,0,15851,22809,-6958,".","16",0,15113
"5523",175829,"ITAWAMBA COMMUNITY COLLEGE                                  ","2003-2004",8,"Golf",1,6968,-6967,1,6968,-6967,0,0,0,"8",".",3368,0
"1105",134079,"FLORIDA SOUTHERN COLLEGE                                    ","2003-2004",1,"Baseball",235131,242100,-6969,235131,242100,-6969,0,0,0,"35",".",81006,0
"12375",202222,"COLUMBUS STATE COMMUNITY COLLEGE                            ","2003-2004",25,"Track and Field, X-Country",12750,19730,-6980,6250,8492,-2242,6500,11238,-4738,"2","5",3317,5537
"14593",140988,"SHORTER COLLEGE                                             ","2003-2004",26,"Volleyball",82220,89208,-6988,0,0,0,82220,89208,-6988,".","11",0,17794
"6286",185873,"OCEAN COUNTY COLLEGE                                        ","2003-2004",8,"Golf",500,7500,-7000,500,7500,-7000,0,0,0,"9",".",3500,0
"8913",210146,"SOUTHERN OREGON UNIVERSITY                                  ","2003-2004",16,"Softball",48347,55347,-7000,0,0,0,48347,55347,-7000,".","16",0,46300
"12193",140669,"NORTH GEORGIA COLLEGE AND STATE UNIVERSITY                  ","2003-2004",25,"Track and Field, X-Country",22156,29156,-7000,11078,14578,-3500,11078,14578,-3500,"11","12",11098,11098
"14439",144175,"CITY COLLEGES OF CHICAGO-OLIVE-HARVEY COLLEGE               ","2003-2004",26,"Volleyball",1000,8000,-7000,0,0,0,1000,8000,-7000,".","10",0,5000
"16636",231077,"COLLEGE OF ST JOSEPH                                        ","2003-2004",39,"Total Participants",182968,189968,-7000,95807,95807,0,87161,94161,-7000,"27","34",171137,148359
"14472",154396,"SOUTHWESTERN COMMUNITY COLLEGE                              ","2003-2004",26,"Volleyball",13580,20590,-7010,0,0,0,13580,20590,-7010,".","13",0,16090
"6625",167899,"SPRINGFIELD COLLEGE                                         ","2003-2004",11,"Lacrosse",26322,33342,-7020,23944,20994,2950,2378,12348,-9970,"42","24",15056,10477
"8833",237181,"BETHANY COLLEGE                                             ","2003-2004",16,"Softball",29197,36237,-7040,0,0,0,29197,36237,-7040,".","21",0,19929
"1729",142559,"COLLEGE OF SOUTHERN IDAHO                                   ","2003-2004",2,"Basketball",346192,353250,-7058,173446,211250,-37804,172746,142000,30746,"16","14",205250,136000
"11099",196024,"SUNY COLLEGE OF TECHNOLOGY AT DELHI                         ","2003-2004",22,"Tennis",7610,14688,-7078,5510,10588,-5078,2100,4100,-2000,"7","9",7088,3000
"12299",150066,"ANDERSON UNIVERSITY                                         ","2003-2004",25,"Track and Field, X-Country",41714,48798,-7084,22856,25435,-2579,18858,23363,-4505,"11","8",9585,7513
"12615",126678,"COLORADO COLLEGE                                            ","2003-2004",25,"Track and Field, X-Country",46838,53928,-7090,23279,27783,-4504,23559,26145,-2586,"21","13",10694,8455
"2758",128744,"UNIVERSITY OF BRIDGEPORT                                    ","2003-2004",2,"Basketball",498712,505810,-7098,284496,291594,-7098,214216,214216,0,"15","16",21656,14885
"13210",131283,"CATHOLIC UNIVERSITY OF AMERICA                              ","2003-2004",26,"Volleyball",4000,11100,-7100,0,0,0,4000,11100,-7100,".","12",0,8500
"1368",203580,"LAKE ERIE COLLEGE                                           ","2003-2004",1,"Baseball",27922,35079,-7157,27922,35079,-7157,0,0,0,"15",".",19557,0
"7713",240374,"UNIVERSITY OF WISCONSIN-PARKSIDE                            ","2003-2004",15,"Soccer",365783,372941,-7158,202727,213357,-10630,163056,159584,3472,"21","18",20519,21822
"11906",240365,"UNIVERSITY OF WISCONSIN-OSHKOSH                             ","2003-2004",23,"Track and Field, Indoor",32865,40023,-7158,17516,20466,-2950,15349,19557,-4208,"46","37",19255,18343
"12096",240365,"UNIVERSITY OF WISCONSIN-OSHKOSH                             ","2003-2004",24,"Track and Field, Outdoor",32865,40023,-7158,17516,20466,-2950,15349,19557,-4208,"52","43",19255,18343
"14236",194541,"POLYTECHNIC UNIVERSITY                                      ","2003-2004",26,"Volleyball",16440,23598,-7158,8595,14065,-5470,7845,9533,-1688,"10","8",6315,2533
"9395",224642,"EL PASO COMMUNITY COLLEGE                                   ","2003-2004",16,"Softball",1e+05,107169,-7169,0,0,0,1e+05,107169,-7169,".","19",0,54097
"2919",191649,"HOFSTRA UNIVERSITY                                          ","2003-2004",2,"Basketball",2193623,2200793,-7170,1209915,1212814,-2899,983708,987979,-4271,"13","13",246449,153354
"11122",216010,"SHIPPENSBURG UNIVERSITY OF PENNSYLVANIA                     ","2003-2004",22,"Tennis",34688,41864,-7176,0,0,0,34688,41864,-7176,".","9",0,15398
"9758",178059,"MARYVILLE UNIVERSITY OF SAINT LOUIS                         ","2003-2004",16,"Softball",35182,42370,-7188,0,0,0,35182,42370,-7188,".","13",0,3311
"2057",172440,"FINLANDIA UNIVERSITY                                        ","2003-2004",2,"Basketball",56510,63703,-7193,29255,33973,-4718,27255,29730,-2475,"11","14",26773,22200
"11041",204936,"OTTERBEIN COLLEGE                                           ","2003-2004",22,"Tennis",14793,21993,-7200,7012,10012,-3000,7781,11981,-4200,"9","12",6808,6851
"8915",140988,"SHORTER COLLEGE                                             ","2003-2004",16,"Softball",98237,105438,-7201,0,0,0,98237,105438,-7201,".","18",0,23281
"12354",204936,"OTTERBEIN COLLEGE                                           ","2003-2004",25,"Track and Field, X-Country",27489,34690,-7201,17043,20644,-3601,10446,14046,-3600,"26","16",17044,10446
"5973",171304,"MUSKEGON COMMUNITY COLLEGE                                  ","2003-2004",8,"Golf",16335,23541,-7206,16335,23541,-7206,0,0,0,"10",".",7468,0
"7019",236328,"UNIVERSITY OF PUGET SOUND                                   ","2003-2004",13,"Rowing",50075,57286,-7211,25523,27497,-1974,24552,29789,-5237,"32","34",21551,23835
"13403",188438,"ADIRONDACK COMMUNITY COLLEGE                                ","2003-2004",26,"Volleyball",1243,8467,-7224,0,0,0,1243,8467,-7224,".","9",0,5680
"14460",172291,"ST CLAIR COUNTY COMMUNITY COLLEGE                           ","2003-2004",26,"Volleyball",42541,49770,-7229,0,0,0,42541,49770,-7229,"0","12",0,19030
"9389",167251,"NEWBURY COLLEGE-BROOKLINE                                   ","2003-2004",16,"Softball",42,7278,-7236,0,0,0,42,7278,-7236,".","15",0,3738
"5117",194161,"NYACK COLLEGE                                               ","2003-2004",8,"Golf",13100,20360,-7260,13100,20360,-7260,0,0,0,"5",".",10500,0
"9621",196194,"SUNY COLLEGE AT OSWEGO                                      ","2003-2004",16,"Softball",32998,40266,-7268,0,0,0,32998,40266,-7268,".","17",0,25663
"181",191986,"JAMESTOWN COMMUNITY COLLEGE                                 ","2003-2004",1,"Baseball",13279,20549,-7270,13279,20549,-7270,0,0,0,"18",".",9485,0
"12754",115728,"HOLY NAMES UNIVERSITY                                       ","2003-2004",25,"Track and Field, X-Country",200,7488,-7288,100,2304,-2204,100,5184,-5084,"4","9",1074,2389
"12705",230047,"BRIGHAM YOUNG UNIVERSITY-HAWAII CAMPUS                      ","2003-2004",25,"Track and Field, X-Country",23600,30890,-7290,11800,15445,-3645,11800,15445,-3645,"9","8",11800,11800
"14707",113193,"CUESTA COLLEGE                                              ","2003-2004",27,"Water Polo",20569,27862,-7293,7995,13941,-5946,12574,13921,-1347,"14","14",5314,7830
"8740",172440,"FINLANDIA UNIVERSITY                                        ","2003-2004",16,"Softball",34667,41962,-7295,0,0,0,34667,41962,-7295,".","13",0,34762
"2770",121901,"RIVERSIDE COMMUNITY COLLEGE                                 ","2003-2004",2,"Basketball",11000,18300,-7300,8000,9400,-1400,3000,8900,-5900,"14","12",8000,8000
"11608",185873,"OCEAN COUNTY COLLEGE                                        ","2003-2004",22,"Tennis",200,7500,-7300,100,3000,-2900,100,4500,-4400,"3","6",100,1500
"11166",138558,"ABRAHAM BALDWIN AGRICULTURAL COLLEGE                        ","2003-2004",22,"Tennis",76468,83769,-7301,49682,45079,4603,26786,38690,-11904,"11","9",24682,26786
"9635",114938,"GAVILAN COLLEGE                                             ","2003-2004",16,"Softball",19104,26428,-7324,0,0,0,19104,26428,-7324,".","15",0,10394
"7343",237783,"SALEM INTERNATIONAL UNIVERSITY                              ","2003-2004",15,"Soccer",69052,76384,-7332,29755,37587,-7832,39297,38797,500,"25","19",12437,13647
"13165",240453,"UNIVERSITY OF WISCONSIN-MILWAUKEE                           ","2003-2004",26,"Volleyball",516685,524025,-7340,0,0,0,516685,524025,-7340,".","15",0,58113
"8782",240471,"UNIVERSITY OF WISCONSIN-RIVER FALLS                         ","2003-2004",16,"Softball",76665,84031,-7366,0,0,0,76665,84031,-7366,".","20",0,27088
"13379",236610,"SHORELINE COMMUNITY COLLEGE                                 ","2003-2004",26,"Volleyball",28709,36080,-7371,0,0,0,28709,36080,-7371,".","10",0,22719
"6349",191968,"ITHACA COLLEGE                                              ","2003-2004",9,"Gymnastics",77761,85136,-7375,0,0,0,77761,85136,-7375,".","17",0,35567
"557",145619,"BENEDICTINE UNIVERSITY                                      ","2003-2004",1,"Baseball",155347,162728,-7381,155347,162728,-7381,0,0,0,"53",".",44342,0
"2527",164173,"VILLA JULIE COLLEGE                                         ","2003-2004",2,"Basketball",58852,66242,-7390,34792,38032,-3240,24060,28210,-4150,"13","12",22059,15621
"990",218919,"VOORHEES COLLEGE                                            ","2003-2004",1,"Baseball",26000,33400,-7400,26000,33400,-7400,0,0,0,"14",".",26000,0
"10540",190512,"CUNY BERNARD M BARUCH COLLEGE                               ","2003-2004",19,"Swimming",9000,16400,-7400,4500,7850,-3350,4500,8550,-4050,"10","12",3100,3800
"6143",156295,"BEREA COLLEGE                                               ","2003-2004",8,"Golf",5000,12402,-7402,5000,12402,-7402,0,0,0,"5",".",4626,0
"5829",231712,"CHRISTOPHER NEWPORT UNIVERSITY                              ","2003-2004",8,"Golf",11500,18913,-7413,11500,18913,-7413,0,0,0,"9",".",6053,0
"14342",211088,"ARCADIA UNIVERSITY                                          ","2003-2004",26,"Volleyball",4270,11695,-7425,0,0,0,4270,11695,-7425,".","10",0,6695
"7430",113193,"CUESTA COLLEGE                                              ","2003-2004",15,"Soccer",4528,11958,-7430,0,0,0,4528,11958,-7430,".","23",0,5535
"16323",181446,"NEBRASKA WESLEYAN UNIVERSITY                                ","2003-2004",39,"Total Participants",294756,302188,-7432,144920,140627,4293,149836,161561,-11725,"267","144",156922,113212
"15661",162609,"GARRETT COLLEGE                                             ","2003-2004",39,"Total Participants",66039,73485,-7446,48051,52147,-4096,17988,21338,-3350,"32","20",30547,32974
"14083",228529,"TARLETON STATE UNIVERSITY                                   ","2003-2004",26,"Volleyball",107445,114901,-7456,0,0,0,107445,114901,-7456,".","20",0,24449
"9427",122180,"SACRAMENTO CITY COLLEGE                                     ","2003-2004",16,"Softball",431,7890,-7459,0,0,0,431,7890,-7459,".","18",0,4846
"10949",211361,"CALIFORNIA UNIVERSITY OF PENNSYLVANIA                       ","2003-2004",22,"Tennis",78418,85885,-7467,0,0,0,78418,85885,-7467,".","8",0,10657
"12098",191612,"HERKIMER COUNTY COMMUNITY COLLEGE                           ","2003-2004",24,"Track and Field, Outdoor",9000,16490,-7490,4500,8245,-3745,4500,8245,-3745,"8","14",4500,4500
"2330",182634,"COLBY-SAWYER COLLEGE                                        ","2003-2004",2,"Basketball",165366,172860,-7494,82554,85349,-2795,82812,87511,-4699,"17","16",18604,21117
"7257",191676,"HOUGHTON COLLEGE                                            ","2003-2004",15,"Soccer",296655,304154,-7499,140261,143710,-3449,156394,160444,-4050,"21","24",32996,50223
"15206",199582,"SAINT AUGUSTINES COLLEGE                                    ","2003-2004",33,"Bowling",31727,39226,-7499,0,0,0,31727,39226,-7499,".","9",0,12346
"12247",194392,"PAUL SMITHS COLLEGE OF ARTS AND SCIENCE                     ","2003-2004",25,"Track and Field, X-Country",3000,10500,-7500,1500,5250,-3750,1500,5250,-3750,"11","4",1500,1500
"13433",127778,"OTERO JUNIOR COLLEGE                                        ","2003-2004",26,"Volleyball",21383,28883,-7500,0,0,0,21383,28883,-7500,".","20",0,12500
"13471",213321,"KINGS COLLEGE                                               ","2003-2004",26,"Volleyball",15909,23410,-7501,0,0,0,15909,23410,-7501,".","12",0,14989
"11285",181446,"NEBRASKA WESLEYAN UNIVERSITY                                ","2003-2004",22,"Tennis",19033,26537,-7504,9759,13755,-3996,9274,12782,-3508,"9","9",11209,10295
"5696",129941,"UNIVERSITY OF NEW HAVEN                                     ","2003-2004",8,"Golf",99120,106626,-7506,63249,63311,-62,35871,43315,-7444,"10","1",10768,11689
"11501",231174,"UNIVERSITY OF VERMONT AND STATE AGRICULTURAL COLL           ","2003-2004",22,"Tennis",85593,93118,-7525,24035,50028,-25993,61558,43090,18468,"8","11",27803,18942
"14888",109819,"BAKERSFIELD COLLEGE                                         ","2003-2004",28,"Wrestling",9355,16882,-7527,9355,16882,-7527,0,0,0,"19",".",5413,0
"6028",195526,"SKIDMORE COLLEGE                                            ","2003-2004",8,"Golf",64093,71634,-7541,64093,71634,-7541,0,0,0,"12",".",34563,0
"5454",202222,"COLUMBUS STATE COMMUNITY COLLEGE                            ","2003-2004",8,"Golf",12750,20300,-7550,12750,20300,-7550,0,0,0,"7",".",10400,0
"10189",191083,"ERIE COMMUNITY COLLEGE                                      ","2003-2004",18,"Swimming and Diving",13059,20610,-7551,6221,9467,-3246,6838,11143,-4305,"11","13",9332,11008
"13910",120184,"NOTRE DAME DE NAMUR UNIVERSITY                              ","2003-2004",26,"Volleyball",75211,82769,-7558,0,0,0,75211,82769,-7558,".","17",0,47548
"9744",199306,"PFEIFFER UNIVERSITY                                         ","2003-2004",16,"Softball",1472,9035,-7563,0,0,0,1472,9035,-7563,".","16",0,8173
"12968",239318,"MILWAUKEE SCHOOL OF ENGINEERING                             ","2003-2004",25,"Track and Field, X-Country",5700,13264,-7564,3800,7870,-4070,1900,5394,-3494,"13","5",4886,2410
"13672",169275,"MOTT COMMUNITY COLLEGE                                      ","2003-2004",26,"Volleyball",5000,12575,-7575,0,0,0,5000,12575,-7575,".","9",0,7574
"14185",219082,"DAKOTA STATE UNIVERSITY                                     ","2003-2004",26,"Volleyball",58529,66115,-7586,0,0,0,58529,66115,-7586,"0","12",0,14719
"6152",114938,"GAVILAN COLLEGE                                             ","2003-2004",8,"Golf",6401,13989,-7588,6401,13989,-7588,0,0,0,"12","0",3138,0
"8623",146418,"KISHWAUKEE COLLEGE                                          ","2003-2004",16,"Softball",15190,22781,-7591,0,0,0,15190,22781,-7591,".","17",0,15190
"9554",119137,"MOORPARK COLLEGE                                            ","2003-2004",16,"Softball",6843,14438,-7595,0,0,0,6843,14438,-7595,".","13",0,6843
"12032",225548,"HOWARD PAYNE UNIVERSITY                                     ","2003-2004",24,"Track and Field, Outdoor",32897,40497,-7600,18049,20249,-2200,14848,20248,-5400,"27","4",9200,9200
"14005",133979,"FLORIDA MEMORIAL COLLEGE                                    ","2003-2004",26,"Volleyball",59500,67100,-7600,0,0,0,59500,67100,-7600,".","9",0,14400
"14123",240125,"WAUKESHA COUNTY TECHNICAL COLLEGE                           ","2003-2004",26,"Volleyball",250,7854,-7604,0,0,0,250,7854,-7604,"0","10",0,3354
"12858",144351,"CONCORDIA UNIVERSITY                                        ","2003-2004",25,"Track and Field, X-Country",14759,22368,-7609,7582,11741,-4159,7177,10627,-3450,"27","34",5477,3054
"8864",173647,"GUSTAVUS ADOLPHUS COLLEGE                                   ","2003-2004",16,"Softball",59172,66795,-7623,0,0,0,59172,66795,-7623,".","17",0,33232
"5941",110510,"CALIFORNIA STATE UNIVERSITY-SAN BERNARDINO                  ","2003-2004",8,"Golf",31512,39138,-7626,31512,39138,-7626,0,0,0,"8",".",9933,0
"12135",165820,"FITCHBURG STATE COLLEGE                                     ","2003-2004",24,"Track and Field, Outdoor",12594,20223,-7629,6297,10450,-4153,6297,9773,-3476,"27","12",7345,5878
"12105",101675,"MILES COLLEGE                                               ","2003-2004",24,"Track and Field, Outdoor",8073,15710,-7637,5486,10109,-4623,2587,5601,-3014,"23","15",440,373
"1444",154396,"SOUTHWESTERN COMMUNITY COLLEGE                              ","2003-2004",1,"Baseball",13160,20798,-7638,13160,20798,-7638,0,0,0,"30",".",16298,0
"10678",108807,"ALLAN HANCOCK COLLEGE                                       ","2003-2004",22,"Tennis",18509,26147,-7638,9254,12197,-2943,9255,13950,-4695,"7","6",4378,4616
"5190",174251,"UNIVERSITY OF MINNESOTA-MORRIS                              ","2003-2004",8,"Golf",8000,15640,-7640,4000,12354,-8354,4000,3286,714,"7","7",6015,1298
"9739",190691,"CUNY YORK COLLEGE                                           ","2003-2004",16,"Softball",11177,18827,-7650,0,0,0,11177,18827,-7650,".","15",0,11177
"10479",213507,"LEBANON VALLEY COLLEGE                                      ","2003-2004",19,"Swimming",15723,23389,-7666,7295,11062,-3767,8428,12327,-3899,"18","39",5645,6778
"3681",211644,"CLARION UNIVERSITY OF PENNSYLVANIA                          ","2003-2004",3,"All Track Combined",98741,106408,-7667,45298,41737,3561,53443,64671,-11228,"53","77",8792,16753
"3517",237011,"WESTERN WASHINGTON UNIVERSITY                               ","2003-2004",3,"All Track Combined",149088,156762,-7674,69766,73848,-4082,79322,82914,-3592,"122","161",23159,23159
"8891",199069,"MOUNT OLIVE COLLEGE                                         ","2003-2004",16,"Softball",86193,93880,-7687,0,0,0,86193,93880,-7687,".","20",0,22416
"10523",122180,"SACRAMENTO CITY COLLEGE                                     ","2003-2004",19,"Swimming",2,7690,-7688,1,3845,-3844,1,3845,-3844,"10","19",1605,1605
"5574",168421,"WORCESTER POLYTECHNIC INSTITUTE                             ","2003-2004",8,"Golf",6599,14289,-7690,6599,14289,-7690,0,0,0,"23","0",8289,0
"7410",212133,"EASTERN UNIVERSITY                                          ","2003-2004",15,"Soccer",49432,57130,-7698,29918,32830,-2912,19514,24300,-4786,"26","20",12320,13550
"5320",197027,"UNITED STATES MERCHANT MARINE ACADEMY                       ","2003-2004",8,"Golf",1,7721,-7720,1,7721,-7720,0,0,0,"10",".",5621,0
"10613",145619,"BENEDICTINE UNIVERSITY                                      ","2003-2004",19,"Swimming",26228,33956,-7728,13249,17598,-4349,12979,16358,-3379,"2","5",6443,6024
"13564",214731,"PENNSYLVANIA STATE UNIVERSITY-DELAWARE COUNTY               ","2003-2004",26,"Volleyball",417,8149,-7732,0,0,0,417,8149,-7732,".","11",0,3349
"13721",176053,"MISSISSIPPI COLLEGE                                         ","2003-2004",26,"Volleyball",41035,48776,-7741,0,0,0,41035,48776,-7741,"0","12",0,34606
"1353",117894,"LOS MEDANOS COLLEGE                                         ","2003-2004",1,"Baseball",7672,15417,-7745,7672,15417,-7745,0,0,0,"26",".",7672,0
"8487",117894,"LOS MEDANOS COLLEGE                                         ","2003-2004",15,"Soccer",3624,11369,-7745,0,0,0,3624,11369,-7745,".","16",0,3624
"14383",117894,"LOS MEDANOS COLLEGE                                         ","2003-2004",26,"Volleyball",1584,9329,-7745,0,0,0,1584,9329,-7745,".","7",0,1984
"4801",117894,"LOS MEDANOS COLLEGE                                         ","2003-2004",7,"Football",18828,26574,-7746,18828,26574,-7746,0,0,0,"50",".",18829,0
"5306",233499,"SAINT PAULS COLLEGE                                         ","2003-2004",8,"Golf",2900,10651,-7751,2900,10651,-7751,0,0,0,"8",".",6137,0
"10770",149781,"WHEATON COLLEGE                                             ","2003-2004",22,"Tennis",47921,55678,-7757,17074,22649,-5575,30847,33029,-2182,"10","12",11507,18186
"14721",110413,"CALIFORNIA LUTHERAN UNIVERSITY                              ","2003-2004",27,"Water Polo",71102,78860,-7758,40079,43938,-3859,31023,34922,-3899,"8","7",27167,16447
"737",262031,"ST CHARLES COMMUNITY COLLEGE                                ","2003-2004",1,"Baseball",123917,131685,-7768,123917,131685,-7768,0,0,0,"30",".",27944,0
"7685",209825,"UNIVERSITY OF PORTLAND                                      ","2003-2004",15,"Soccer",1045947,1053730,-7783,477685,478090,-405,568262,575640,-7378,"29","23",122812,118663
"7017",157401,"MURRAY STATE UNIVERSITY                                     ","2003-2004",13,"Rowing",138076,145869,-7793,0,0,0,138076,145869,-7793,".","21",0,39914
"10935",105525,"PIMA COMMUNITY COLLEGE                                      ","2003-2004",22,"Tennis",21204,28998,-7794,10686,15133,-4447,10518,13865,-3347,"10","5",5020,4792
"11442",194240,"ORANGE COUNTY COMMUNITY COLLEGE                             ","2003-2004",22,"Tennis",13749,21550,-7801,6110,12832,-6722,7639,8718,-1079,"6","7",9610,5495
"8340",114938,"GAVILAN COLLEGE                                             ","2003-2004",15,"Soccer",12326,20136,-7810,0,0,0,12326,20136,-7810,"0","16",0,6191
"8550",170790,"MACOMB COMMUNITY COLLEGE                                    ","2003-2004",16,"Softball",35400,43213,-7813,0,0,0,35400,43213,-7813,".","20",0,36730
"15690",209506,"OREGON INSTITUTE OF TECHNOLOGY                              ","2003-2004",39,"Total Participants",364849,372665,-7816,133354,140673,-7319,231495,231992,-497,"76","90",161479,146996
"3332",202356,"CUYAHOGA COMMUNITY COLLEGE DISTRICT                         ","2003-2004",2,"Basketball",84912,92751,-7839,43392,52948,-9556,41520,39803,1717,"14","7",42392,28902
"4399",122180,"SACRAMENTO CITY COLLEGE                                     ","2003-2004",7,"Football",9974,17815,-7841,9974,17815,-7841,0,0,0,"71",".",14964,0
"11648",196866,"UNION COLLEGE                                               ","2003-2004",22,"Tennis",28551,36392,-7841,12535,13979,-1444,16016,22413,-6397,"11","9",3716,7679
"14784",105525,"PIMA COMMUNITY COLLEGE                                      ","2003-2004",28,"Wrestling",23157,31000,-7843,23157,31000,-7843,0,0,0,"19",".",21880,0
"955",149727,"WAUBONSEE COMMUNITY COLLEGE                                 ","2003-2004",1,"Baseball",14450,22302,-7852,14450,22302,-7852,0,0,0,"21",".",15052,0
"9322",236656,"SOUTH PUGET SOUND COMMUNITY COLLEGE                         ","2003-2004",16,"Softball",30065,37926,-7861,0,0,0,30065,37926,-7861,".","11",0,14270
"106",139968,"GORDON COLLEGE                                              ","2003-2004",1,"Baseball",43255,51122,-7867,43255,51122,-7867,0,0,0,"36",".",26400,0
"9889",155511,"MCPHERSON COLLEGE                                           ","2003-2004",16,"Softball",12148,20023,-7875,0,0,0,12148,20023,-7875,".","21",0,12148
"5568",195720,"SAINT JOHN FISHER COLLEGE                                   ","2003-2004",8,"Golf",4950,12830,-7880,4950,12830,-7880,0,0,0,"11",".",5311,0
"8966",161341,"UNIVERSITY OF MAINE AT PRESQUE ISLE                         ","2003-2004",16,"Softball",2030,9919,-7889,0,0,0,2030,9919,-7889,".","14",0,7800
"12764",192323,"LE MOYNE COLLEGE                                            ","2003-2004",25,"Track and Field, X-Country",11000,18889,-7889,5500,9444,-3944,5500,9445,-3945,"12","14",5500,5500
"14937",202763,"THE UNIVERSITY OF FINDLAY                                   ","2003-2004",28,"Wrestling",138174,146071,-7897,138174,146071,-7897,0,0,0,"37",".",32032,0
"13933",195058,"ROCKLAND COMMUNITY COLLEGE                                  ","2003-2004",26,"Volleyball",100,8000,-7900,0,0,0,100,8000,-7900,".","10",0,250
"864",235334,"GRAYS HARBOR COLLEGE                                        ","2003-2004",1,"Baseball",39538,47448,-7910,39538,47448,-7910,0,0,0,"30",".",28397,0
"11952",210401,"WILLAMETTE UNIVERSITY                                       ","2003-2004",24,"Track and Field, Outdoor",62532,70442,-7910,31266,35221,-3955,31266,35221,-3955,"70","63",18895,16180
"12273",210401,"WILLAMETTE UNIVERSITY                                       ","2003-2004",25,"Track and Field, X-Country",62531,70442,-7911,31265,35221,-3956,31266,35221,-3955,"25","36",7157,9872
"1232",169080,"CALVIN COLLEGE                                              ","2003-2004",1,"Baseball",50881,58799,-7918,50881,58799,-7918,0,0,0,"24",".",35667,0
"8385",204194,"MOUNT VERNON NAZARENE UNIVERSITY                            ","2003-2004",15,"Soccer",39025,46950,-7925,19517,26815,-7298,19508,20135,-627,"23","21",19517,19508
"2506",187912,"NEW MEXICO MILITARY INSTITUTE                               ","2003-2004",2,"Basketball",211685,219614,-7929,211685,219614,-7929,0,0,0,"15",".",43515,0
"10476",190594,"CUNY HUNTER COLLEGE                                         ","2003-2004",19,"Swimming",1,7939,-7938,0,0,0,1,7939,-7938,".","18",0,3439
"8028",196866,"UNION COLLEGE                                               ","2003-2004",15,"Soccer",263907,271858,-7951,109279,107092,2187,154628,164766,-10138,"30","23",16322,16892
"6709",196158,"SUNY COLLEGE AT FREDONIA                                    ","2003-2004",11,"Lacrosse",66528,74483,-7955,0,0,0,66528,74483,-7955,".","22",0,34765
"11469",139968,"GORDON COLLEGE                                              ","2003-2004",22,"Tennis",17600,25559,-7959,8800,11409,-2609,8800,14150,-5350,"7","9",8800,8800
"9329",236708,"SPOKANE FALLS COMMUNITY COLLEGE                             ","2003-2004",16,"Softball",45200,53175,-7975,0,0,0,45200,53175,-7975,".","17",0,42233
"9227",214041,"MILLERSVILLE UNIVERSITY OF PENNSYLVANIA                     ","2003-2004",16,"Softball",74430,82418,-7988,0,0,0,74430,82418,-7988,".","18",0,18252
"15203",184603,"FAIRLEIGH DICKINSON UNIVERSITY-METROPOLITAN CAMPUS          ","2003-2004",33,"Bowling",115817,123805,-7988,0,0,0,115817,123805,-7988,".","14",0,31059
"3825",239248,"MILWAUKEE AREA TECHNICAL COLLEGE                            ","2003-2004",3,"All Track Combined",2,8000,-7998,1,4000,-3999,1,4000,-3999,"4","5",3250,3250
"145",127732,"NORTHEASTERN JUNIOR COLLEGE                                 ","2003-2004",1,"Baseball",21000,29000,-8000,21000,29000,-8000,0,0,0,"23",".",21000,0
"2813",214652,"PENNSYLVANIA STATE UNIV-PENN ST WORTHINGTON SCRNTN          ","2003-2004",2,"Basketball",19000,27000,-8000,12000,15000,-3000,7000,12000,-5000,"14","9",700,500
"3003",215442,"POINT PARK UNIVERSITY                                       ","2003-2004",2,"Basketball",411151,419151,-8000,261394,265394,-4000,149757,153757,-4000,"13","10",32130,23864
"6021",109819,"BAKERSFIELD COLLEGE                                         ","2003-2004",8,"Golf",16800,24800,-8000,8400,12400,-4000,8400,12400,-4000,"9","6",2200,2200
"6732",230834,"CASTLETON STATE COLLEGE                                     ","2003-2004",11,"Lacrosse",21575,29575,-8000,12073,16073,-4000,9502,13502,-4000,"24","14",12073,9502
"8375",214166,"MOUNT ALOYSIUS COLLEGE                                      ","2003-2004",15,"Soccer",23400,31400,-8000,11700,15700,-4000,11700,15700,-4000,"17","18",11700,11700
"14647",132471,"BARRY UNIVERSITY                                            ","2003-2004",26,"Volleyball",94218,102218,-8000,0,0,0,94218,102218,-8000,".","14",0,46518
"15264",211307,"BUCKS COUNTY COMMUNITY COLLEGE                              ","2003-2004",34,"Equestrian",12523,20523,-8000,0,0,0,12523,20523,-8000,".","10",0,12523
"6787",211088,"ARCADIA UNIVERSITY                                          ","2003-2004",11,"Lacrosse",3532,11551,-8019,0,0,0,3532,11551,-8019,".","15",0,6501
"954",439288,"JOHNSON &amp; WALES UNIVERSITY-DENVER                           ","2003-2004",1,"Baseball",17212,25244,-8032,17212,25244,-8032,0,0,0,"21",".",20244,0
"13049",240620,"LARAMIE COUNTY COMMUNITY COLLEGE                            ","2003-2004",26,"Volleyball",49280,57315,-8035,0,0,0,49280,57315,-8035,".","13",0,21008
"12500",145619,"BENEDICTINE UNIVERSITY                                      ","2003-2004",25,"Track and Field, X-Country",53693,61733,-8040,27006,30716,-3710,26687,31017,-4330,"32","23",2922,3441
"14193",203580,"LAKE ERIE COLLEGE                                           ","2003-2004",26,"Volleyball",15610,23675,-8065,0,0,0,15610,23675,-8065,".","8",0,13259
"2907",104425,"COCHISE COLLEGE                                             ","2003-2004",2,"Basketball",97100,105180,-8080,48550,52590,-4040,48550,52590,-4040,"13","11",13946,13946
"15346",104425,"COCHISE COLLEGE                                             ","2003-2004",35,"Rodeo",38250,46330,-8080,19125,23165,-4040,19125,23165,-4040,"18","7",22725,22725
"16269",104425,"COCHISE COLLEGE                                             ","2003-2004",39,"Total Participants",146200,154280,-8080,77275,81315,-4040,68925,72965,-4040,"55","38",66274,53617
"3002",199458,"ROANOKE BIBLE COLLEGE                                       ","2003-2004",2,"Basketball",2,8087,-8085,1,4727,-4726,1,3360,-3359,"14","9",3927,2560
"730",173416,"DAKOTA COUNTY TECHNICAL COLLEGE                             ","2003-2004",1,"Baseball",15000,23100,-8100,15000,23100,-8100,0,0,0,"25",".",15000,0
"7617",173416,"DAKOTA COUNTY TECHNICAL COLLEGE                             ","2003-2004",15,"Soccer",15000,23100,-8100,0,0,0,15000,23100,-8100,".","23",0,15000
"14933",173416,"DAKOTA COUNTY TECHNICAL COLLEGE                             ","2003-2004",28,"Wrestling",15000,23100,-8100,15000,23100,-8100,0,0,0,"9",".",15000,0
"12948",184348,"DREW UNIVERSITY                                             ","2003-2004",25,"Track and Field, X-Country",14166,22280,-8114,6192,10858,-4666,7974,11422,-3448,"5","9",1424,1988
"797",170790,"MACOMB COMMUNITY COLLEGE                                    ","2003-2004",1,"Baseball",35098,43213,-8115,35098,43213,-8115,0,0,0,"30",".",36730,0
"15006",240365,"UNIVERSITY OF WISCONSIN-OSHKOSH                             ","2003-2004",28,"Wrestling",26325,34450,-8125,26325,34450,-8125,0,0,0,"17",".",21802,0
"6891",191515,"HAMILTON COLLEGE                                            ","2003-2004",13,"Rowing",107488,115620,-8132,55549,59615,-4066,51939,56005,-4066,"22","21",16353,15143
"9161",243188,"UNIVERSITY OF PUERTO RICO-UTUADO                            ","2003-2004",16,"Softball",2000,10138,-8138,0,0,0,2000,10138,-8138,".","17",0,4888
"17109",236753,"TACOMA COMMUNITY COLLEGE                                    ","2003-2004",39,"Total Participants",54976,63114,-8138,31763,38593,-6830,23213,24521,-1308,"68","32",32459,20409
"1150",113193,"CUESTA COLLEGE                                              ","2003-2004",1,"Baseball",17756,25901,-8145,17756,25901,-8145,0,0,0,"39",".",18243,0
"3",191083,"ERIE COMMUNITY COLLEGE                                      ","2003-2004",1,"Baseball",32514,40660,-8146,32514,40660,-8146,0,0,0,"30",".",29580,0
"9806",207157,"HILLSDALE FREE WILL BAPTIST COLLEGE                         ","2003-2004",16,"Softball",3800,11950,-8150,0,0,0,3800,11950,-8150,".","16",0,8300
"8281",133711,"FLAGLER COLLEGE                                             ","2003-2004",15,"Soccer",94680,102837,-8157,46330,52031,-5701,48350,50806,-2456,"23","24",16451,15456
"14340",190558,"CUNY COLLEGE OF STATEN ISLAND                               ","2003-2004",26,"Volleyball",7320,15501,-8181,0,0,0,7320,15501,-8181,".","15",0,7320
"1451",207290,"NORTHEASTERN OKLAHOMA AGRICULTURAL AND MECH COLL            ","2003-2004",1,"Baseball",61505,69693,-8188,61505,69693,-8188,0,0,0,"30",".",22100,0
"2599",162690,"HAGERSTOWN COMMUNITY COLLEGE                                ","2003-2004",2,"Basketball",29734,37930,-8196,14387,19947,-5560,15347,17983,-2636,"14","10",12398,11219
"12607",113193,"CUESTA COLLEGE                                              ","2003-2004",25,"Track and Field, X-Country",8294,16492,-8198,4147,8246,-4099,4147,8246,-4099,"11","9",1406,1406
"5381",214698,"PENNSYLVANIA STATE UNIVERSITY-PENN STATE BEAVER             ","2003-2004",8,"Golf",2,8201,-8199,1,8199,-8198,1,2,-1,"8","0",8099,1
"10460",194824,"RENSSELAER POLYTECHNIC INSTITUTE                            ","2003-2004",18,"Swimming and Diving",76052,84252,-8200,38026,42126,-4100,38026,42126,-4100,"26","20",14581,14581
"12514",117140,"UNIVERSITY OF LA VERNE                                      ","2003-2004",25,"Track and Field, X-Country",52476,60687,-8211,26238,29343,-3105,26238,31344,-5106,"46","45",10789,10789
"1646",101143,"ENTERPRISE-OZARK COMMUNITY COLLEGE                          ","2003-2004",2,"Basketball",49652,57866,-8214,25165,33795,-8630,24487,24071,416,"15","11",25165,22812
"4178",156286,"BELLARMINE UNIVERSITY                                       ","2003-2004",6,"Field hocky",84737,92961,-8224,0,0,0,84737,92961,-8224,".","19",0,13525
"16367",144351,"CONCORDIA UNIVERSITY                                        ","2003-2004",39,"Total Participants",99723,107957,-8234,55559,60533,-4974,44164,47424,-3260,"161","102",71659,36353
"8835",172644,"WAYNE STATE UNIVERSITY                                      ","2003-2004",16,"Softball",205413,213655,-8242,0,0,0,205413,213655,-8242,".","17",0,44983
"12207",179894,"WEBSTER UNIVERSITY                                          ","2003-2004",25,"Track and Field, X-Country",210,8470,-8260,0,0,0,210,8470,-8260,".","10",0,540
"7325",192192,"KEUKA COLLEGE                                               ","2003-2004",15,"Soccer",62816,71088,-8272,31408,35408,-4000,31408,35680,-4272,"28","25",13408,14560
"15296",207050,"EASTERN OKLAHOMA STATE COLLEGE                              ","2003-2004",35,"Rodeo",27420,35700,-8280,19420,22200,-2780,8000,13500,-5500,"11","5",20200,12000
"5356",155715,"PRATT COMMUNITY COLLEGE                                     ","2003-2004",8,"Golf",43761,52044,-8283,21880,26022,-4142,21881,26022,-4141,"12","5",4000,4000
"82",173993,"MESABI RANGE COMMUNITY AND TECHNICAL COLLEGE                ","2003-2004",1,"Baseball",10177,18461,-8284,10177,18461,-8284,0,0,0,"22",".",10177,0
"12952",212601,"GANNON UNIVERSITY                                           ","2003-2004",25,"Track and Field, X-Country",76165,84449,-8284,36940,40927,-3987,39225,43522,-4297,"12","12",8633,8858
"6701",193326,"MONROE COMMUNITY COLLEGE                                    ","2003-2004",11,"Lacrosse",40359,48655,-8296,40359,48655,-8296,0,0,0,"24",".",26131,0
"3418",153302,"EMMAUS BIBLE COLLEGE                                        ","2003-2004",2,"Basketball",200,8500,-8300,100,4500,-4400,100,4000,-3900,"10","10",4500,4000
"11328",192323,"LE MOYNE COLLEGE                                            ","2003-2004",22,"Tennis",13000,21300,-8300,6500,10650,-4150,6500,10650,-4150,"8","11",6500,6500
"12583",174437,"NORTH CENTRAL UNIVERSITY                                    ","2003-2004",25,"Track and Field, X-Country",7600,15910,-8310,3800,7970,-4170,3800,7940,-4140,"15","18",5375,5345
"8667",164465,"AMHERST COLLEGE                                             ","2003-2004",16,"Softball",66933,75245,-8312,0,0,0,66933,75245,-8312,".","13",0,10498
"12427",206525,"WITTENBERG UNIVERSITY                                       ","2003-2004",25,"Track and Field, X-Country",74467,82785,-8318,36406,42452,-6046,38061,40333,-2272,"69","71",15782,14930
"7402",247603,"SUSSEX COUNTY COMMUNITY COLLEGE                             ","2003-2004",15,"Soccer",24227,32567,-8340,11552,14681,-3129,12675,17886,-5211,"15","15",6011,6011
"5850",178341,"MISSOURI SOUTHERN STATE UNIVERSITY                          ","2003-2004",8,"Golf",42864,51205,-8341,42864,51205,-8341,0,0,0,"12",".",20059,0
"15570",245953,"MID-AMERICA CHRISTIAN UNIVERSITY                            ","2003-2004",39,"Total Participants",85000,93354,-8354,51346,55362,-4016,33654,37992,-4338,"64","35",37075,28086
"11654",110653,"UNIVERSITY OF CALIFORNIA-IRVINE                             ","2003-2004",22,"Tennis",498672,507038,-8366,225020,230287,-5267,273652,276751,-3099,"14","10",25817,30838
"7525",190594,"CUNY HUNTER COLLEGE                                         ","2003-2004",15,"Soccer",1,8374,-8373,1,8374,-8373,0,0,0,"22",".",6874,0
"5274",238263,"MADISON AREA TECHNICAL COLLEGE                              ","2003-2004",8,"Golf",15562,23936,-8374,7781,19601,-11820,7781,4335,3446,"15","2",16316,1050
"15559",169974,"GLEN OAKS COMMUNITY COLLEGE                                 ","2003-2004",39,"Total Participants",137895,146273,-8378,75173,86033,-10860,62722,60240,2482,"51","36",42667,27554
"10806",215275,"UNIVERSITY OF PITTSBURGH-GREENSBURG                         ","2003-2004",22,"Tennis",1,8393,-8392,1,8393,-8392,0,0,0,"12",".",924,0
"10445",121886,"RIO HONDO COLLEGE                                           ","2003-2004",18,"Swimming and Diving",21404,29798,-8394,10702,14787,-4085,10702,15011,-4309,"9","9",2711,2935
"4151",161226,"UNIVERSITY OF MAINE AT FARMINGTON                           ","2003-2004",6,"Field hocky",1079,9479,-8400,0,0,0,1079,9479,-8400,".","20",0,8030
"12940",237367,"FAIRMONT STATE COLLEGE                                      ","2003-2004",25,"Track and Field, X-Country",9850,18250,-8400,4500,8978,-4478,5350,9272,-3922,"8","7",3395,2839
"16862",219879,"CLEVELAND STATE COMMUNITY COLLEGE                           ","2003-2004",39,"Total Participants",107849,116260,-8411,75479,84572,-9093,32370,31688,682,"51","28",93319,60042
"12091",122597,"SAN FRANCISCO STATE UNIVERSITY                              ","2003-2004",24,"Track and Field, Outdoor",216644,225063,-8419,105999,106240,-241,110645,118823,-8178,"25","32",21565,27298
"15572",146676,"LINCOLN COLLEGE                                             ","2003-2004",39,"Total Participants",495711,504133,-8422,337642,350273,-12631,158069,153860,4209,"129","86",141177,83891
"10743",237215,"BLUEFIELD STATE COLLEGE                                     ","2003-2004",22,"Tennis",18975,27399,-8424,8075,18566,-10491,10900,8833,2067,"8","8",8075,8075
"10565",199306,"PFEIFFER UNIVERSITY                                         ","2003-2004",19,"Swimming",1,8431,-8430,0,0,0,1,8431,-8430,".","9",0,6231
"11222",156295,"BEREA COLLEGE                                               ","2003-2004",22,"Tennis",8240,16675,-8435,4120,8383,-4263,4120,8292,-4172,"10","18",4363,4272
"2248",213598,"LINCOLN UNIVERSITY                                          ","2003-2004",2,"Basketball",77100,85540,-8440,51800,60240,-8440,25300,25300,0,"15","15",15000,10600
"8893",198561,"GARDNER-WEBB UNIVERSITY                                     ","2003-2004",16,"Softball",276064,284508,-8444,0,0,0,276064,284508,-8444,".","14",0,48390
"14972",213321,"KINGS COLLEGE                                               ","2003-2004",28,"Wrestling",24205,32653,-8448,24205,32653,-8448,0,0,0,"22",".",23680,0
"448",194240,"ORANGE COUNTY COMMUNITY COLLEGE                             ","2003-2004",1,"Baseball",15500,23958,-8458,15500,23958,-8458,0,0,0,"24",".",18658,0
"11143",184694,"FAIRLEIGH DICKINSON UNIVERSITY-COLLEGE AT FLORHAM           ","2003-2004",22,"Tennis",12009,20471,-8462,6604,6963,-359,5405,13508,-8103,"8","9",3603,3926
"9698",171304,"MUSKEGON COMMUNITY COLLEGE                                  ","2003-2004",16,"Softball",22802,31277,-8475,0,0,0,22802,31277,-8475,".","12",0,9904
"12763",195562,"SAINT JOSEPHS COLLEGE-SUFFOLK CAMPUS                        ","2003-2004",25,"Track and Field, X-Country",21433,29909,-8476,9860,14198,-4338,11573,15711,-4138,"8","10",9440,10860
"2896",196024,"SUNY COLLEGE OF TECHNOLOGY AT DELHI                         ","2003-2004",2,"Basketball",36014,44496,-8482,18454,21910,-3456,17560,22586,-5026,"13","13",12360,14086
"3816",159717,"MCNEESE STATE UNIVERSITY                                    ","2003-2004",3,"All Track Combined",337871,346358,-8487,163268,171860,-8592,174603,174498,105,"61","52",44288,31640
"8203",142443,"NORTH IDAHO COLLEGE                                         ","2003-2004",15,"Soccer",58329,66829,-8500,23947,28047,-4100,34382,38782,-4400,"22","19",22662,15852
"16977",243221,"UNIVERSITY OF PUERTO RICO-RIO PIEDRAS CAMPUS                ","2003-2004",39,"Total Participants",225390,233890,-8500,110790,116790,-6000,114600,117100,-2500,"164","118",133090,134200
"8769",126678,"COLORADO COLLEGE                                            ","2003-2004",16,"Softball",58340,66845,-8505,0,0,0,58340,66845,-8505,".","11",0,16264
"1190",219879,"CLEVELAND STATE COMMUNITY COLLEGE                           ","2003-2004",1,"Baseball",60064,68572,-8508,60064,68572,-8508,0,0,0,"27",".",44398,0
"6061",110334,"CABRILLO COLLEGE                                            ","2003-2004",8,"Golf",4470,12980,-8510,4470,12980,-8510,0,0,0,"9",".",3650,0
"12044",243188,"UNIVERSITY OF PUERTO RICO-UTUADO                            ","2003-2004",24,"Track and Field, Outdoor",5100,13618,-8518,3000,9066,-6066,2100,4552,-2452,"8","6",3156,2332
"2075",170240,"HENRY FORD COMMUNITY COLLEGE                                ","2003-2004",2,"Basketball",45870,54390,-8520,23135,27545,-4410,22735,26845,-4110,"13","8",13400,12700
"373",104708,"GLENDALE COMMUNITY COLLEGE                                  ","2003-2004",1,"Baseball",22384,30907,-8523,22384,30907,-8523,0,0,0,"25",".",9500,0
"17319",166513,"UNIVERSITY OF MASSACHUSETTS-LOWELL                          ","2003-2004",39,"Total Participants",1899142,1907665,-8523,1296397,1297660,-1263,602745,610005,-7260,"152","127",244294,145153
"4807",130697,"WESLEYAN UNIVERSITY                                         ","2003-2004",7,"Football",203622,212146,-8524,203622,212146,-8524,0,0,0,"74",".",45527,0
"8703",213321,"KINGS COLLEGE                                               ","2003-2004",16,"Softball",26853,35378,-8525,0,0,0,26853,35378,-8525,".","18",0,25531
"8701",126580,"UNIVERSITY OF COLORADO AT COLORADO SPRINGS                  ","2003-2004",16,"Softball",118305,126852,-8547,0,0,0,118305,126852,-8547,".","14",0,76389
"13517",136215,"NOVA SOUTHEASTERN UNIVERSITY                                ","2003-2004",26,"Volleyball",231009,239559,-8550,0,0,0,231009,239559,-8550,".","12",0,46525
"1024",197027,"UNITED STATES MERCHANT MARINE ACADEMY                       ","2003-2004",1,"Baseball",5395,13990,-8595,5395,13990,-8595,0,0,0,"20",".",8942,0
"9425",156295,"BEREA COLLEGE                                               ","2003-2004",16,"Softball",9300,17905,-8605,0,0,0,9300,17905,-8605,".","14",0,9373
"15484",137847,"THE UNIVERSITY OF TAMPA                                     ","2003-2004",39,"Total Participants",1739229,1747838,-8609,812950,782954,29996,926279,964884,-38605,"152","155",258037,267186
"14583",217776,"SOUTHERN WESLEYAN UNIVERSITY                                ","2003-2004",26,"Volleyball",94434,103104,-8670,0,0,0,94434,103104,-8670,".","11",0,19934
"17029",217776,"SOUTHERN WESLEYAN UNIVERSITY                                ","2003-2004",39,"Total Participants",732070,740740,-8670,359510,359510,0,372560,381230,-8670,"76","61",128063,103834
"8082",245953,"MID-AMERICA CHRISTIAN UNIVERSITY                            ","2003-2004",15,"Soccer",5500,14175,-8675,5500,14175,-8675,0,0,0,"15",".",9175,0
"5889",231174,"UNIVERSITY OF VERMONT AND STATE AGRICULTURAL COLL           ","2003-2004",8,"Golf",7850,16530,-8680,7850,16530,-8680,0,0,0,"8",".",7203,0
"11264",203128,"HIRAM COLLEGE                                               ","2003-2004",22,"Tennis",35520,44200,-8680,17760,22100,-4340,17760,22100,-4340,"7","9",3450,3450
"14977",216667,"WASHINGTON &amp; JEFFERSON COLLEGE                              ","2003-2004",28,"Wrestling",30899,39604,-8705,30899,39604,-8705,0,0,0,"12","0",9435,0
"11191",213321,"KINGS COLLEGE                                               ","2003-2004",22,"Tennis",12905,21622,-8717,6913,13339,-6426,5992,8283,-2291,"9","10",6913,5992
"9256",150145,"BETHEL COLLEGE                                              ","2003-2004",16,"Softball",25570,34300,-8730,0,0,0,25570,34300,-8730,".","16",0,28570
"16027",207050,"EASTERN OKLAHOMA STATE COLLEGE                              ","2003-2004",39,"Total Participants",202420,211150,-8730,103420,107700,-4280,99000,103450,-4450,"58","34",185450,188890
"971",180373,"MILES COMMUNITY COLLEGE                                     ","2003-2004",1,"Baseball",77199,85937,-8738,77199,85937,-8738,0,0,0,"28",".",53702,0
"7312",231059,"SAINT MICHAELS COLLEGE                                      ","2003-2004",15,"Soccer",175815,184556,-8741,85692,88916,-3224,90123,95640,-5517,"22","25",20413,24866
"398",146685,"LINCOLN LAND COMMUNITY COLLEGE                              ","2003-2004",1,"Baseball",47532,56285,-8753,47532,56285,-8753,0,0,0,"26",".",18700,0
"1747",217536,"SALVE REGINA UNIVERSITY                                     ","2003-2004",2,"Basketball",76736,85497,-8761,38092,41530,-3438,38644,43967,-5323,"14","11",20372,22257
"4519",174075,"UNIVERSITY OF MINNESOTA-CROOKSTON                           ","2003-2004",7,"Football",273652,282430,-8778,273652,282430,-8778,0,0,0,"83",".",88075,0
"14157",225885,"JARVIS CHRISTIAN COLLEGE                                    ","2003-2004",26,"Volleyball",998,9783,-8785,0,0,0,998,9783,-8785,".","13",0,8785
"150",214041,"MILLERSVILLE UNIVERSITY OF PENNSYLVANIA                     ","2003-2004",1,"Baseball",58216,67002,-8786,58216,67002,-8786,0,0,0,"28",".",27781,0
"10506",210571,"ALBRIGHT COLLEGE                                            ","2003-2004",19,"Swimming",22840,31638,-8798,10418,14431,-4013,12422,17207,-4785,"26","31",10418,12422
"792",190512,"CUNY BERNARD M BARUCH COLLEGE                               ","2003-2004",1,"Baseball",12500,21300,-8800,12500,21300,-8800,0,0,0,"20",".",15300,0
"10204",110334,"CABRILLO COLLEGE                                            ","2003-2004",18,"Swimming and Diving",5000,13800,-8800,2500,6900,-4400,2500,6900,-4400,"9","8",3150,3150
"11668",155061,"FORT HAYS STATE UNIVERSITY                                  ","2003-2004",22,"Tennis",32526,41326,-8800,0,0,0,32526,41326,-8800,".","12",0,7309
"13790",213507,"LEBANON VALLEY COLLEGE                                      ","2003-2004",26,"Volleyball",10375,19177,-8802,0,0,0,10375,19177,-8802,".","13",0,9575
"5442",149019,"SPRINGFIELD COLLEGE IN ILLINOIS                             ","2003-2004",8,"Golf",9015,17825,-8810,9015,17825,-8810,0,0,0,"10",".",10704,0
"6609",217518,"ROGER WILLIAMS UNIVERSITY                                   ","2003-2004",11,"Lacrosse",121113,129940,-8827,76974,85673,-8699,44139,44267,-128,"30","21",66781,22764
"10515",211352,"CABRINI COLLEGE                                             ","2003-2004",19,"Swimming",1000,9829,-8829,0,0,0,1000,9829,-8829,".","7",0,8230
"10954",174783,"SAINT CLOUD STATE UNIVERSITY                                ","2003-2004",22,"Tennis",29940,38790,-8850,18336,20336,-2000,11604,18454,-6850,"9","10",6541,6629
"15407",243151,"UNIVERSITY OF PUERTO RICO-CAYEY UNIVERSITY COLLEGE          ","2003-2004",38,"Weight Lifting",8100,16952,-8852,4050,8476,-4426,4050,8476,-4426,"10","8",1575,1575
"1621",247603,"SUSSEX COUNTY COMMUNITY COLLEGE                             ","2003-2004",2,"Basketball",14482,23339,-8857,14482,23339,-8857,0,0,0,"12",".",9123,0
"504",221892,"TREVECCA NAZARENE UNIVERSITY                                ","2003-2004",1,"Baseball",204504,213363,-8859,204504,213363,-8859,0,0,0,"25",".",37319,0
"9492",195562,"SAINT JOSEPHS COLLEGE-SUFFOLK CAMPUS                        ","2003-2004",16,"Softball",27429,36295,-8866,0,0,0,27429,36295,-8866,".","16",0,23248
"740",110413,"CALIFORNIA LUTHERAN UNIVERSITY                              ","2003-2004",1,"Baseball",78513,87381,-8868,78513,87381,-8868,0,0,0,"34",".",56925,0
"210",166513,"UNIVERSITY OF MASSACHUSETTS-LOWELL                          ","2003-2004",1,"Baseball",104393,113270,-8877,104393,113270,-8877,0,0,0,"33",".",28295,0
"10518",178411,"UNIVERSITY OF MISSOURI-ROLLA                                ","2003-2004",19,"Swimming",95984,104870,-8886,95984,104870,-8886,0,0,0,"15",".",28628,0
"8049",190053,"CLINTON COMMUNITY COLLEGE                                   ","2003-2004",15,"Soccer",13700,22603,-8903,6850,11204,-4354,6850,11399,-4549,"21","19",6850,6850
"2903",190053,"CLINTON COMMUNITY COLLEGE                                   ","2003-2004",2,"Basketball",21200,30118,-8918,10600,15133,-4533,10600,14985,-4385,"15","9",10600,10600
"12561",161341,"UNIVERSITY OF MAINE AT PRESQUE ISLE                         ","2003-2004",25,"Track and Field, X-Country",660,9580,-8920,330,4830,-4500,330,4750,-4420,"9","5",4176,3426
"9410",164720,"BECKER COLLEGE                                              ","2003-2004",16,"Softball",4025,12964,-8939,0,0,0,4025,12964,-8939,".","16",0,7864
"12848",185129,"NEW JERSEY CITY UNIVERSITY                                  ","2003-2004",25,"Track and Field, X-Country",4300,13240,-8940,2150,6620,-4470,2150,6620,-4470,"9","7",850,1850
"11450",198613,"GUILFORD COLLEGE                                            ","2003-2004",22,"Tennis",9046,17994,-8948,0,0,0,9046,17994,-8948,".","6",0,5058
"14172",149019,"SPRINGFIELD COLLEGE IN ILLINOIS                             ","2003-2004",26,"Volleyball",9459,18413,-8954,0,0,0,9459,18413,-8954,".","9",0,6762
"9589",235431,"HIGHLINE COMMUNITY COLLEGE                                  ","2003-2004",16,"Softball",30786,39755,-8969,0,0,0,30786,39755,-8969,".","13",0,9938
"10882",171571,"OAKLAND UNIVERSITY                                          ","2003-2004",22,"Tennis",43671,52671,-9000,0,0,0,43671,52671,-9000,".","11",0,11237
"12667",117751,"THE MASTER'S COLLEGE AND SEMINARY                           ","2003-2004",25,"Track and Field, X-Country",45269,54269,-9000,22635,27135,-4500,22634,27134,-4500,"10","6",4389,4390
"15362",166692,"MASSACHUSETTS MARITIME ACADEMY                              ","2003-2004",36,"Sailing",6000,15000,-9000,4000,9500,-5500,2000,5500,-3500,"39","11",4000,3000
"16972",214786,"PENNSYLVANIA STATE UNIVERSITY-PENN ST MCKEESPORT            ","2003-2004",39,"Total Participants",21000,30000,-9000,7000,10000,-3000,14000,20000,-6000,"28","24",20000,14000
"8416",190716,"D'YOUVILLE COLLEGE                                          ","2003-2004",15,"Soccer",18000,27001,-9001,9000,13771,-4771,9000,13230,-4230,"19","13",9021,8480
"8259",162168,"CHESAPEAKE COLLEGE                                          ","2003-2004",15,"Soccer",7475,16481,-9006,7475,16481,-9006,0,0,0,"15",".",6239,0
"16647",155681,"PITTSBURG STATE UNIVERSITY                                  ","2003-2004",39,"Total Participants",737723,746758,-9035,298040,296196,1844,439683,450562,-10879,"199","83",206574,108398
"8140",109208,"AMERICAN RIVER COLLEGE                                      ","2003-2004",15,"Soccer",9059,18114,-9055,3848,8106,-4258,5211,10008,-4797,"29","22",4591,6493
"8165",169716,"UNIVERSITY OF DETROIT MERCY                                 ","2003-2004",15,"Soccer",571250,580310,-9060,246410,254607,-8197,324840,325703,-863,"20","19",30894,41462
"11866",150066,"ANDERSON UNIVERSITY                                         ","2003-2004",23,"Track and Field, Indoor",53368,62431,-9063,29241,32541,-3300,24127,29890,-5763,"37","29",12262,9612
"12097",150066,"ANDERSON UNIVERSITY                                         ","2003-2004",24,"Track and Field, Outdoor",53368,62431,-9063,29241,32541,-3300,24127,29890,-5763,"29","23",12262,9612
"16558",213020,"INDIANA UNIVERSITY OF PENNSYLVANIA-MAIN CAMPUS              ","2003-2004",39,"Total Participants",966415,975485,-9070,249738,267227,-17489,716677,708258,8419,"212","193",241474,198678
"697",169974,"GLEN OAKS COMMUNITY COLLEGE                                 ","2003-2004",1,"Baseball",58550,67629,-9079,58550,67629,-9079,0,0,0,"33",".",26170,0
"344",110334,"CABRILLO COLLEGE                                            ","2003-2004",1,"Baseball",6370,15460,-9090,6370,15460,-9090,0,0,0,"24",".",6100,0
"15422",211158,"BLOOMSBURG UNIVERSITY OF PENNSYLVANIA                       ","2003-2004",39,"Total Participants",1602110,1611203,-9093,670987,655708,15279,931123,955495,-24372,"293","200",163655,129543
"7788",214731,"PENNSYLVANIA STATE UNIVERSITY-DELAWARE COUNTY               ","2003-2004",15,"Soccer",1108,10206,-9098,1108,10206,-9098,0,0,0,"13",".",6306,0
"10127",156295,"BEREA COLLEGE                                               ","2003-2004",18,"Swimming and Diving",6200,15299,-9099,3245,7815,-4570,2955,7484,-4529,"11","10",3645,3314
"8118",194824,"RENSSELAER POLYTECHNIC INSTITUTE                            ","2003-2004",15,"Soccer",96698,105798,-9100,57272,61372,-4100,39426,44426,-5000,"28","29",17573,17434
"11717",175421,"BELHAVEN COLLEGE                                            ","2003-2004",22,"Tennis",68062,77162,-9100,33693,38243,-4550,34369,38919,-4550,"6","7",6555,6555
"14339",170000,"GRACE BIBLE COLLEGE                                         ","2003-2004",26,"Volleyball",5500,14601,-9101,0,0,0,5500,14601,-9101,".","10",0,5013
"11170",161554,"UNIVERSITY OF SOUTHERN MAINE                                ","2003-2004",22,"Tennis",16813,25923,-9110,5000,7667,-2667,11813,18256,-6443,"9","9",4667,15256
"5933",198695,"HIGH POINT UNIVERSITY                                       ","2003-2004",8,"Golf",208555,217688,-9133,110406,110802,-396,98149,106886,-8737,"15","9",24751,26125
"7954",155520,"MIDAMERICA NAZARENE UNIVERSITY                              ","2003-2004",15,"Soccer",228480,237621,-9141,114215,114215,0,114265,123406,-9141,"24","26",26100,27450
"25",213507,"LEBANON VALLEY COLLEGE                                      ","2003-2004",1,"Baseball",16363,25526,-9163,16363,25526,-9163,0,0,0,"26",".",16022,0
"12327",151111,"INDIANA UNIVERSITY-PURDUE UNIVERSITY-INDIANAPOLIS           ","2003-2004",25,"Track and Field, X-Country",3900,13069,-9169,1950,7395,-5445,1950,5674,-3724,"10","10",1534,820
"14481",168591,"ALMA COLLEGE                                                ","2003-2004",26,"Volleyball",30379,39556,-9177,0,0,0,30379,39556,-9177,".","15",0,27177
"9906",117894,"LOS MEDANOS COLLEGE                                         ","2003-2004",16,"Softball",4716,13895,-9179,0,0,0,4716,13895,-9179,".","13",0,6150
"11107",117052,"REEDLEY COLLEGE                                             ","2003-2004",22,"Tennis",2000,11192,-9192,2000,11192,-9192,0,0,0,"8","0",2500,0
"9886",173993,"MESABI RANGE COMMUNITY AND TECHNICAL COLLEGE                ","2003-2004",16,"Softball",7892,17089,-9197,0,0,0,7892,17089,-9197,".","16",0,7892
"11925",217873,"CLAFLIN UNIVERSITY                                          ","2003-2004",23,"Track and Field, Indoor",800,10000,-9200,400,6000,-5600,400,4000,-3600,"8","9",3000,3500
"7428",238263,"MADISON AREA TECHNICAL COLLEGE                              ","2003-2004",15,"Soccer",18946,28149,-9203,18946,28149,-9203,0,0,0,"24",".",20225,0
"9440",154396,"SOUTHWESTERN COMMUNITY COLLEGE                              ","2003-2004",16,"Softball",11835,21050,-9215,0,0,0,11835,21050,-9215,".","18",0,16550
"572",196219,"SUNY COLLEGE AT PURCHASE                                    ","2003-2004",1,"Baseball",24500,33718,-9218,24500,33718,-9218,0,0,0,"21",".",24500,0
"643",123800,"SOUTHWESTERN COLLEGE                                        ","2003-2004",1,"Baseball",106008,115232,-9224,106008,115232,-9224,0,0,0,"30",".",12619,0
"11783",212106,"DUQUESNE UNIVERSITY                                         ","2003-2004",22,"Tennis",225585,234823,-9238,68080,72500,-4420,157505,162323,-4818,"8","10",18550,20980
"13965",216287,"SWARTHMORE COLLEGE                                          ","2003-2004",26,"Volleyball",10440,19678,-9238,0,0,0,10440,19678,-9238,".","14",0,18946
"3775",157401,"MURRAY STATE UNIVERSITY                                     ","2003-2004",3,"All Track Combined",319658,328898,-9240,175936,181022,-5086,143722,147876,-4154,"71","58",16505,22006
"8483",154998,"DODGE CITY COMMUNITY COLLEGE                                ","2003-2004",15,"Soccer",56570,65816,-9246,28762,32908,-4146,27808,32908,-5100,"22","16",14500,14500
"13724",164720,"BECKER COLLEGE                                              ","2003-2004",26,"Volleyball",5162,14408,-9246,0,0,0,5162,14408,-9246,".","13",0,9620
"8547",155186,"HIGHLAND COMMUNITY COLLEGE                                  ","2003-2004",16,"Softball",59747,68994,-9247,0,0,0,59747,68994,-9247,".","12",0,27585
"13990",155186,"HIGHLAND COMMUNITY COLLEGE                                  ","2003-2004",26,"Volleyball",39807,49055,-9248,0,0,0,39807,49055,-9248,".","12",0,19450
"7760",190169,"COLUMBIA-GREENE COMMUNITY COLLEGE                           ","2003-2004",15,"Soccer",500,9750,-9250,0,0,0,500,9750,-9250,".","15",0,9250
"695",243188,"UNIVERSITY OF PUERTO RICO-UTUADO                            ","2003-2004",1,"Baseball",3000,12256,-9256,3000,12256,-9256,0,0,0,"19",".",6538,0
"12474",112172,"CITRUS COLLEGE                                              ","2003-2004",25,"Track and Field, X-Country",47652,56919,-9267,23826,27755,-3929,23826,29164,-5338,"19","11",8451,8451
"10447",110413,"CALIFORNIA LUTHERAN UNIVERSITY                              ","2003-2004",18,"Swimming and Diving",147639,156918,-9279,73820,74459,-639,73819,82459,-8640,"1","4",41213,41213
"5611",148380,"ROCK VALLEY COLLEGE                                         ","2003-2004",8,"Golf",5500,14780,-9280,5500,14780,-9280,0,0,0,"9",".",7390,0
"11624",164173,"VILLA JULIE COLLEGE                                         ","2003-2004",22,"Tennis",8153,17441,-9288,4012,8230,-4218,4141,9211,-5070,"5","7",3113,3935
"11261",235343,"GREEN RIVER COMMUNITY COLLEGE                               ","2003-2004",22,"Tennis",11000,20289,-9289,5500,9921,-4421,5500,10368,-4868,"6","6",4600,4600
"16826",106713,"CENTRAL BAPTIST COLLEGE                                     ","2003-2004",39,"Total Participants",96667,105967,-9300,46924,50024,-3100,49743,55943,-6200,"37","33",34500,34325
"12528",219718,"BETHEL COLLEGE                                              ","2003-2004",25,"Track and Field, X-Country",25663,34966,-9303,12831,17483,-4652,12832,17483,-4651,"9","7",3393,2639
"3411",159717,"MCNEESE STATE UNIVERSITY                                    ","2003-2004",2,"Basketball",810399,819731,-9332,441989,457149,-15160,368410,362582,5828,"16","14",127860,94474
"6562",213020,"INDIANA UNIVERSITY OF PENNSYLVANIA-MAIN CAMPUS              ","2003-2004",11,"Lacrosse",44401,53734,-9333,0,0,0,44401,53734,-9333,".","17",0,18384
"2614",153126,"CLARKE COLLEGE                                              ","2003-2004",2,"Basketball",90512,99848,-9336,52089,58479,-6390,38423,41369,-2946,"18","16",23849,17919
"2405",168546,"ALBION COLLEGE                                              ","2003-2004",2,"Basketball",177240,186578,-9338,91800,107932,-16132,85440,78646,6794,"25","26",33589,34057
"6473",192749,"MANHATTANVILLE COLLEGE                                      ","2003-2004",10,"Ice Hockey",168819,178174,-9355,86318,91916,-5598,82501,86258,-3757,"29","24",39235,33150
"9773",193326,"MONROE COMMUNITY COLLEGE                                    ","2003-2004",16,"Softball",32475,41831,-9356,0,0,0,32475,41831,-9356,".","20",0,19612
"4678",181330,"MIDLAND LUTHERAN COLLEGE                                    ","2003-2004",7,"Football",52804,62167,-9363,52804,62167,-9363,0,0,0,"101",".",45698,0
"9401",212601,"GANNON UNIVERSITY                                           ","2003-2004",16,"Softball",145727,155094,-9367,0,0,0,145727,155094,-9367,".","22",0,51594
"533",163657,"PRINCE GEORGES COMMUNITY COLLEGE                            ","2003-2004",1,"Baseball",4020,13392,-9372,4020,13392,-9372,0,0,0,"16",".",6181,0
"5466",199412,"QUEENS UNIVERSITY OF CHARLOTTE                              ","2003-2004",8,"Golf",100171,109556,-9385,49563,55211,-5648,50608,54345,-3737,"11","5",9721,5621
"6518",127060,"UNIVERSITY OF DENVER                                        ","2003-2004",10,"Ice Hockey",2064457,2073842,-9385,2064457,2073842,-9385,0,0,0,"26",".",401221,0
"14697",162928,"JOHNS HOPKINS UNIVERSITY                                    ","2003-2004",27,"Water Polo",30418,39810,-9392,30418,39810,-9392,0,0,0,"13",".",20050,0
"2731",209746,"PORTLAND COMMUNITY COLLEGE                                  ","2003-2004",2,"Basketball",92853,102256,-9403,47968,52310,-4342,44885,49946,-5061,"9","10",15865,16222
"3560",118347,"COLLEGE OF MARIN                                            ","2003-2004",3,"All Track Combined",200,9604,-9404,100,6693,-6593,100,2911,-2811,"8",".",5813,2906
"7364",110468,"ALLIANT INTERNATIONAL UNIVERSITY-SAN DIEGO                  ","2003-2004",15,"Soccer",104000,113414,-9414,52000,60285,-8285,52000,53129,-1129,"24","17",32186,29456
"14577",179867,"WASHINGTON UNIVERSITY IN ST LOUIS                           ","2003-2004",26,"Volleyball",127965,137381,-9416,0,0,0,127965,137381,-9416,".","15",0,50367
"4824",117140,"UNIVERSITY OF LA VERNE                                      ","2003-2004",7,"Football",201860,211279,-9419,201860,211279,-9419,0,0,0,"71",".",39767,0
"15423",108807,"ALLAN HANCOCK COLLEGE                                       ","2003-2004",39,"Total Participants",180853,190278,-9425,95116,100466,-5350,85737,89812,-4075,"180","83",117956,57341
"499",171304,"MUSKEGON COMMUNITY COLLEGE                                  ","2003-2004",1,"Baseball",24072,33527,-9455,24072,33527,-9455,0,0,0,"23",".",11351,0
"13709",164580,"BABSON COLLEGE                                              ","2003-2004",26,"Volleyball",6960,16460,-9500,0,0,0,6960,16460,-9500,"0","10",0,6960
"12496",110510,"CALIFORNIA STATE UNIVERSITY-SAN BERNARDINO                  ","2003-2004",25,"Track and Field, X-Country",21480,30995,-9515,0,0,0,21480,30995,-9515,".","12",0,8464
"1598",152266,"PURDUE UNIVERSITY-NORTH CENTRAL CAMPUS                      ","2003-2004",2,"Basketball",54121,63642,-9521,54121,63642,-9521,0,0,0,"9",".",46873,0
"5279",201654,"CEDARVILLE UNIVERSITY                                       ","2003-2004",8,"Golf",48630,58156,-9526,48630,58156,-9526,0,0,0,"6",".",8644,0
"5461",240426,"UNIVERSITY OF WISCONSIN-SUPERIOR                            ","2003-2004",8,"Golf",4538,14064,-9526,0,0,0,4538,14064,-9526,".","6",0,5564
"1296",212601,"GANNON UNIVERSITY                                           ","2003-2004",1,"Baseball",142175,151709,-9534,142175,151709,-9534,0,0,0,"36",".",44957,0
"11541",138716,"ALBANY STATE UNIVERSITY                                     ","2003-2004",22,"Tennis",8730,18264,-9534,0,0,0,8730,18264,-9534,".","6",0,8730
"14840",173805,"ITASCA COMMUNITY COLLEGE                                    ","2003-2004",28,"Wrestling",11326,20884,-9558,11326,20884,-9558,0,0,0,"12",".",5955,0
"5112",234979,"COLUMBIA BASIN COLLEGE                                      ","2003-2004",8,"Golf",26995,36568,-9573,15335,20463,-5128,11660,16105,-4445,"11","4",13115,8215
"13892",191676,"HOUGHTON COLLEGE                                            ","2003-2004",26,"Volleyball",84070,93644,-9574,0,0,0,84070,93644,-9574,".","13",0,26049
"12363",154350,"SIMPSON COLLEGE                                             ","2003-2004",25,"Track and Field, X-Country",87668,97250,-9582,43834,48625,-4791,43834,48625,-4791,"26","22",21008,21008
"14373",112172,"CITRUS COLLEGE                                              ","2003-2004",26,"Volleyball",7796,17379,-9583,0,0,0,7796,17379,-9583,".","7",0,6203
"6246",228529,"TARLETON STATE UNIVERSITY                                   ","2003-2004",8,"Golf",60814,70399,-9585,0,0,0,60814,70399,-9585,".","10",0,23708
"13127",149727,"WAUBONSEE COMMUNITY COLLEGE                                 ","2003-2004",26,"Volleyball",10100,19687,-9587,0,0,0,10100,19687,-9587,".","11",0,9687
"9249",179867,"WASHINGTON UNIVERSITY IN ST LOUIS                           ","2003-2004",16,"Softball",104716,114316,-9600,0,0,0,104716,114316,-9600,".","20",0,50600
"17307",216825,"WESTMORELAND COUNTY COMMUNITY COLLEGE                       ","2003-2004",39,"Total Participants",12000,21600,-9600,6000,13100,-7100,6000,8500,-2500,"24","25",3170,3420
"14950",208406,"CLACKAMAS COMMUNITY COLLEGE                                 ","2003-2004",28,"Wrestling",3511,13120,-9609,3511,13120,-9609,0,0,0,"17",".",8296,0
"13698",187897,"NEW MEXICO HIGHLANDS UNIVERSITY                             ","2003-2004",26,"Volleyball",96557,106168,-9611,0,0,0,96557,106168,-9611,".","14",0,18371
"16580",183822,"BLOOMFIELD COLLEGE                                          ","2003-2004",39,"Total Participants",54833,64444,-9611,28500,33224,-4724,26333,31220,-4887,"62","49",41942,40033
"4768",134945,"JACKSONVILLE UNIVERSITY                                     ","2003-2004",7,"Football",453062,462675,-9613,453062,462675,-9613,0,0,0,"129",".",171642,0
"16533",236708,"SPOKANE FALLS COMMUNITY COLLEGE                             ","2003-2004",39,"Total Participants",413016,422639,-9623,193531,195149,-1618,219485,227490,-8005,"112","102",192120,199419
"6294",154998,"DODGE CITY COMMUNITY COLLEGE                                ","2003-2004",8,"Golf",38240,47872,-9632,18216,19347,-1131,20024,28525,-8501,"8","8",10410,10310
"15159",117788,"LOS ANGELES CITY COLLEGE                                    ","2003-2004",31,"Badminton",3100,12742,-9642,0,0,0,3100,12742,-9642,".","11",0,1027
"3340",174604,"RAINY RIVER COMMUNITY COLLEGE                               ","2003-2004",2,"Basketball",30948,40606,-9658,14124,13966,158,16824,26640,-9816,"15","9",12967,15668
"8733",235343,"GREEN RIVER COMMUNITY COLLEGE                               ","2003-2004",16,"Softball",12972,22636,-9664,0,0,0,12972,22636,-9664,".","15",0,11772
"16424",199865,"WARREN WILSON COLLEGE                                       ","2003-2004",39,"Total Participants",54550,64218,-9668,27750,31156,-3406,26800,33062,-6262,"55","65",36500,34019
"6042",219000,"AUGUSTANA COLLEGE                                           ","2003-2004",8,"Golf",23580,33250,-9670,13990,14450,-460,9590,18800,-9210,"9","8",7784,7784
"9473",207290,"NORTHEASTERN OKLAHOMA AGRICULTURAL AND MECH COLL            ","2003-2004",16,"Softball",55967,65652,-9685,0,0,0,55967,65652,-9685,".","21",0,17250
"1188",209038,"LANE COMMUNITY COLLEGE                                      ","2003-2004",1,"Baseball",49056,58745,-9689,49056,58745,-9689,0,0,0,"20",".",29301,0
"460",122746,"SAN JOSE CITY COLLEGE                                       ","2003-2004",1,"Baseball",76550,86248,-9698,76550,86248,-9698,0,0,0,"29",".",12098,0
"11231",194541,"POLYTECHNIC UNIVERSITY                                      ","2003-2004",22,"Tennis",11500,21254,-9754,5250,11475,-6225,6250,9779,-3529,"13","9",6225,3529
"8904",195988,"SULLIVAN COUNTY COMMUNITY COLLEGE                           ","2003-2004",16,"Softball",5915,15681,-9766,0,0,0,5915,15681,-9766,".","12",0,15680
"10599",118347,"COLLEGE OF MARIN                                            ","2003-2004",19,"Swimming",100,9885,-9785,50,6880,-6830,50,3005,-2955,"15",".",6000,3000
"4142",213321,"KINGS COLLEGE                                               ","2003-2004",6,"Field hocky",23814,33606,-9792,0,0,0,23814,33606,-9792,".","28",0,23106
"9796",232681,"MARY WASHINGTON COLLEGE                                     ","2003-2004",16,"Softball",27762,37556,-9794,0,0,0,27762,37556,-9794,".","15",0,12925
"2411",241225,"BAYAMON CENTRAL UNIVERSITY                                  ","2003-2004",2,"Basketball",3900,13700,-9800,3900,13700,-9800,0,0,0,"15",".",4200,0
"11768",195058,"ROCKLAND COMMUNITY COLLEGE                                  ","2003-2004",22,"Tennis",200,10000,-9800,100,4000,-3900,100,6000,-5900,"6","8",50,50
"11889",155973,"TABOR COLLEGE                                               ","2003-2004",23,"Track and Field, Indoor",200,10000,-9800,100,5000,-4900,100,5000,-4900,"9","3",747,249
"13824",236300,"PUGET SOUND CHRISTIAN COLLEGE                               ","2003-2004",26,"Volleyball",200,10000,-9800,0,0,0,200,10000,-9800,".","11",0,9066
"16996",236300,"PUGET SOUND CHRISTIAN COLLEGE                               ","2003-2004",39,"Total Participants",200,10000,-9800,0,0,0,200,10000,-9800,"9","11",18133,9066
"5682",161554,"UNIVERSITY OF SOUTHERN MAINE                                ","2003-2004",8,"Golf",7000,16819,-9819,7000,16819,-9819,0,0,0,"10","0",13820,0
"6009",204194,"MOUNT VERNON NAZARENE UNIVERSITY                            ","2003-2004",8,"Golf",8800,18627,-9827,8800,18627,-9827,0,0,0,"8",".",8800,0
"7943",182980,"NEW ENGLAND COLLEGE                                         ","2003-2004",15,"Soccer",56368,66205,-9837,27874,27405,469,28494,38800,-10306,"21","18",13376,10972
"6242",181446,"NEBRASKA WESLEYAN UNIVERSITY                                ","2003-2004",8,"Golf",25783,35627,-9844,16074,22956,-6882,9709,12671,-2962,"15","7",16385,7915
"14607",155104,"GARDEN CITY COMMUNITY COLLEGE                               ","2003-2004",26,"Volleyball",19429,29280,-9851,0,0,0,19429,29280,-9851,".","16",0,16380
"5833",123341,"SIERRA COLLEGE                                              ","2003-2004",8,"Golf",6213,16070,-9857,2130,8094,-5964,4083,7976,-3893,"14","6",6202,5142
"7939",211024,"BAPTIST BIBLE COLLEGE AND SEMINARY                          ","2003-2004",15,"Soccer",22442,32312,-9870,12441,19123,-6682,10001,13189,-3188,"20","20",16823,11489
"5742",212009,"DICKINSON COLLEGE                                           ","2003-2004",8,"Golf",7821,17714,-9893,5310,13301,-7991,2511,4413,-1902,"15","8",5310,2511
"8854",209506,"OREGON INSTITUTE OF TECHNOLOGY                              ","2003-2004",16,"Softball",76339,86235,-9896,0,0,0,76339,86235,-9896,".","20",0,41750
"2828",214698,"PENNSYLVANIA STATE UNIVERSITY-PENN STATE BEAVER             ","2003-2004",2,"Basketball",1100,11001,-9901,1100,11001,-9901,0,0,0,"16","0",10500,0
"13867",179292,"SAINT LOUIS COMMUNITY COLLEGE-FLORISSANT VALLEY             ","2003-2004",26,"Volleyball",10981,20882,-9901,0,0,0,10981,20882,-9901,".","10",0,13620
"13835",173993,"MESABI RANGE COMMUNITY AND TECHNICAL COLLEGE                ","2003-2004",26,"Volleyball",9204,19109,-9905,0,0,0,9204,19109,-9905,".","9",0,9204
"1821",180373,"MILES COMMUNITY COLLEGE                                     ","2003-2004",2,"Basketball",189212,199133,-9921,103009,110102,-7093,86203,89031,-2828,"14","13",51505,46735
"12760",243188,"UNIVERSITY OF PUERTO RICO-UTUADO                            ","2003-2004",25,"Track and Field, X-Country",600,10521,-9921,400,6408,-6008,200,4113,-3913,"10","5",288,423
"13966",434672,"THE COMMUNITY COLLEGE OF BALTIMORE COUNTY                   ","2003-2004",26,"Volleyball",21872,31797,-9925,0,0,0,21872,31797,-9925,".","16",0,26375
"10260",213020,"INDIANA UNIVERSITY OF PENNSYLVANIA-MAIN CAMPUS              ","2003-2004",18,"Swimming and Diving",123723,133663,-9940,49861,57331,-7470,73862,76332,-2470,"17","22",19202,19203
"4979",145619,"BENEDICTINE UNIVERSITY                                      ","2003-2004",7,"Football",210199,220143,-9944,210199,220143,-9944,0,0,0,"66",".",40247,0
"13539",171456,"NORTHERN MICHIGAN UNIVERSITY                                ","2003-2004",26,"Volleyball",410692,420637,-9945,0,0,0,410692,420637,-9945,"0","15",0,66722
"13629",180258,"UNIVERSITY OF GREAT FALLS                                   ","2003-2004",26,"Volleyball",74588,84543,-9955,0,0,0,74588,84543,-9955,".","12",0,76548
"16516",180258,"UNIVERSITY OF GREAT FALLS                                   ","2003-2004",39,"Total Participants",74588,84543,-9955,0,0,0,74588,84543,-9955,"12","24",87931,150198
"16673",211352,"CABRINI COLLEGE                                             ","2003-2004",39,"Total Participants",195452,205415,-9963,82345,81607,738,113107,123808,-10701,"121","148",120012,121455
"11424",162584,"FROSTBURG STATE UNIVERSITY                                  ","2003-2004",22,"Tennis",19954,29920,-9966,12091,14068,-1977,7863,15852,-7989,"6","8",4738,6704
"9449",201654,"CEDARVILLE UNIVERSITY                                       ","2003-2004",16,"Softball",78946,88918,-9972,0,0,0,78946,88918,-9972,".","12",0,28019
"10153",112172,"CITRUS COLLEGE                                              ","2003-2004",18,"Swimming and Diving",12958,22956,-9998,6329,11414,-5085,6629,11542,-4913,"16","14",6107,6235
"11601",220710,"MARYVILLE COLLEGE                                           ","2003-2004",22,"Tennis",11312,21310,-9998,8849,13260,-4411,2463,8050,-5587,"14","13",7762,2552
"1448",179946,"WESTMINSTER COLLEGE                                         ","2003-2004",1,"Baseball",30000,40000,-10000,30000,40000,-10000,0,0,0,"18",".",20000,0
"5125",147013,"MCKENDREE COLLEGE                                           ","2003-2004",8,"Golf",67701,77701,-10000,30577,35577,-5000,37124,42124,-5000,"10","6",8817,4263
"7038",182458,"SIERRA NEVADA COLLEGE                                       ","2003-2004",14,"Skiing",40000,50000,-10000,20000,25000,-5000,20000,25000,-5000,"5","5",19000,19000
"7170",230834,"CASTLETON STATE COLLEGE                                     ","2003-2004",15,"Soccer",31703,41703,-10000,16695,21695,-5000,15008,20008,-5000,"19","20",16695,15008
"10662",151801,"INDIANA WESLEYAN UNIVERSITY                                 ","2003-2004",22,"Tennis",41093,51093,-10000,12111,22507,-10396,28982,28586,396,"17","15",18513,20145
"10741",140669,"NORTH GEORGIA COLLEGE AND STATE UNIVERSITY                  ","2003-2004",22,"Tennis",40957,50957,-10000,24008,29008,-5000,16949,21949,-5000,"7","6",11808,6299
"11030",176406,"TOUGALOO COLLEGE                                            ","2003-2004",22,"Tennis",54920,64920,-10000,27460,32460,-5000,27460,32460,-5000,"8","8",5000,5000
"11549",220181,"FISK UNIVERSITY                                             ","2003-2004",22,"Tennis",8000,18000,-10000,4000,9000,-5000,4000,9000,-5000,"7","7",4000,4000
"13977",238476,"CARTHAGE COLLEGE                                            ","2003-2004",26,"Volleyball",94670,104670,-10000,0,0,0,94670,104670,-10000,"0","23",0,15500
"15326",181765,"NEBRASKA COLLEGE OF TECHNICAL AGRICULTURE                   ","2003-2004",35,"Rodeo",5600,15600,-10000,2800,7800,-5000,2800,7800,-5000,"19","10",5600,5600
"15802",168786,"AQUINAS COLLEGE                                             ","2003-2004",39,"Total Participants",240000,250000,-10000,112000,119000,-7000,128000,131000,-3000,"224","202",157492,170522
"16049",182458,"SIERRA NEVADA COLLEGE                                       ","2003-2004",39,"Total Participants",40000,50000,-10000,20000,25000,-5000,20000,25000,-5000,"5","5",19000,19000
"16456",153472,"INDIAN HILLS COMMUNITY COLLEGE                              ","2003-2004",39,"Total Participants",400894,410897,-10003,194598,208405,-13807,206296,202492,3804,"57","25",119702,78622
"14690",118347,"COLLEGE OF MARIN                                            ","2003-2004",27,"Water Polo",100,10105,-10005,50,7027,-6977,50,3078,-3028,"10",".",6147,3073
"5949",174136,"MINNEAPOLIS COMMUNITY AND TECHNICAL COLLEGE                 ","2003-2004",8,"Golf",5200,15212,-10012,5200,15212,-10012,0,0,0,"12",".",5200,0
"17079",174136,"MINNEAPOLIS COMMUNITY AND TECHNICAL COLLEGE                 ","2003-2004",39,"Total Participants",5200,15212,-10012,5200,15212,-10012,0,0,0,"27","10",29741,24541
"12765",239628,"RIPON COLLEGE                                               ","2003-2004",25,"Track and Field, X-Country",13000,23014,-10014,6500,11507,-5007,6500,11507,-5007,"16","9",6500,6500
"15391",243151,"UNIVERSITY OF PUERTO RICO-CAYEY UNIVERSITY COLLEGE          ","2003-2004",37,"Table Tennis",7300,17325,-10025,3650,8600,-4950,3650,8725,-5075,"5","5",1750,1750
"1557",156295,"BEREA COLLEGE                                               ","2003-2004",1,"Baseball",10500,20529,-10029,10500,20529,-10029,0,0,0,"15",".",10689,0
"12021",113218,"CUYAMACA COLLEGE                                            ","2003-2004",24,"Track and Field, Outdoor",38928,48968,-10040,19464,24484,-5020,19464,24484,-5020,"16","20",19216,19216
"7418",191339,"GENESEE COMMUNITY COLLEGE                                   ","2003-2004",15,"Soccer",34544,44593,-10049,17272,23163,-5891,17272,21430,-4158,"23","23",15195,625
"4080",196194,"SUNY COLLEGE AT OSWEGO                                      ","2003-2004",6,"Field hocky",35603,45663,-10060,0,0,0,35603,45663,-10060,".","19",0,25729
"9902",202514,"DEFIANCE COLLEGE                                            ","2003-2004",16,"Softball",63657,73728,-10071,0,0,0,63657,73728,-10071,".","22",0,38624
"11636",165936,"GORDON COLLEGE                                              ","2003-2004",22,"Tennis",4400,14485,-10085,2200,7029,-4829,2200,7456,-5256,"9","17",3007,3456
"4251",191676,"HOUGHTON COLLEGE                                            ","2003-2004",6,"Field hocky",86851,96942,-10091,0,0,0,86851,96942,-10091,".","17",0,25632
"1692",174358,"MINNESOTA STATE UNIVERSITY-MOORHEAD                         ","2003-2004",2,"Basketball",374939,385031,-10092,185003,194137,-9134,189936,190894,-958,"16","19",41679,51964
"9263",239318,"MILWAUKEE SCHOOL OF ENGINEERING                             ","2003-2004",16,"Softball",14883,24982,-10099,0,0,0,14883,24982,-10099,".","15",0,18548
"2157",214795,"PENNSYLVANIA STATE UNIVERSITY-PENN STATE MONT ALTO          ","2003-2004",2,"Basketball",14600,24700,-10100,7400,13200,-5800,7200,11500,-4300,"12","11",7400,7200
"12872",217873,"CLAFLIN UNIVERSITY                                          ","2003-2004",25,"Track and Field, X-Country",400,10500,-10100,200,6000,-5800,200,4500,-4300,"9","6",3000,2500
"391",215114,"PHILADELPHIA BIBLICAL UNIVERSITY-LANGHORNE                  ","2003-2004",1,"Baseball",12461,22564,-10103,12461,22564,-10103,0,0,0,"18",".",18689,0
"16309",215114,"PHILADELPHIA BIBLICAL UNIVERSITY-LANGHORNE                  ","2003-2004",39,"Total Participants",124507,134610,-10103,64596,74699,-10103,59911,59911,0,"81","82",75406,62399
"2312",165820,"FITCHBURG STATE COLLEGE                                     ","2003-2004",2,"Basketball",35043,45147,-10104,19625,24016,-4391,15418,21131,-5713,"15","12",13875,11282
"2596",231581,"BRIDGEWATER COLLEGE                                         ","2003-2004",2,"Basketball",203903,214007,-10104,116784,116176,608,87119,97831,-10712,"25","14",33859,41912
"1584",228529,"TARLETON STATE UNIVERSITY                                   ","2003-2004",1,"Baseball",107464,117577,-10113,107464,117577,-10113,0,0,0,"36",".",41183,0
"16398",153278,"UNIVERSITY OF DUBUQUE                                       ","2003-2004",39,"Total Participants",461677,471794,-10117,240097,246929,-6832,221580,224865,-3285,"394","173",213794,119000
"9961",211644,"CLARION UNIVERSITY OF PENNSYLVANIA                          ","2003-2004",16,"Softball",58221,68339,-10118,0,0,0,58221,68339,-10118,".","18",0,11299
"15181",218733,"SOUTH CAROLINA STATE UNIVERSITY                             ","2003-2004",33,"Bowling",80972,91110,-10138,0,0,0,80972,91110,-10138,".","8",0,21803
"11409",214731,"PENNSYLVANIA STATE UNIVERSITY-DELAWARE COUNTY               ","2003-2004",22,"Tennis",236,10376,-10140,118,5188,-5070,118,5188,-5070,"10",".",2288,1400
"10007",121707,"COLLEGE OF THE REDWOODS                                     ","2003-2004",16,"Softball",29183,39327,-10144,0,0,0,29183,39327,-10144,".","13",0,20644
"13216",105525,"PIMA COMMUNITY COLLEGE                                      ","2003-2004",26,"Volleyball",25243,35394,-10151,0,0,0,25243,35394,-10151,".","10",0,16467
"10832",236328,"UNIVERSITY OF PUGET SOUND                                   ","2003-2004",22,"Tennis",2126,12279,-10153,978,5648,-4670,1148,6631,-5483,"11","13",5284,6204
"10723",233499,"SAINT PAULS COLLEGE                                         ","2003-2004",22,"Tennis",3494,13649,-10155,1394,6422,-5028,2100,7227,-5127,"6","5",2875,2974
"12447",199306,"PFEIFFER UNIVERSITY                                         ","2003-2004",25,"Track and Field, X-Country",2796,12960,-10164,2795,7824,-5029,1,5136,-5135,"14","5",7642,4599
"6554",161554,"UNIVERSITY OF SOUTHERN MAINE                                ","2003-2004",11,"Lacrosse",37525,47723,-10198,14800,19149,-4349,22725,28574,-5849,"23","18",13149,11009
"10537",190691,"CUNY YORK COLLEGE                                           ","2003-2004",19,"Swimming",12170,22370,-10200,6085,11185,-5100,6085,11185,-5100,"10","13",6085,6085
"8760",191339,"GENESEE COMMUNITY COLLEGE                                   ","2003-2004",16,"Softball",17272,27482,-10210,0,0,0,17272,27482,-10210,".","16",0,1069
"1361",235343,"GREEN RIVER COMMUNITY COLLEGE                               ","2003-2004",1,"Baseball",17978,28194,-10216,17978,28194,-10216,0,0,0,"30",".",16778,0
"15742",199333,"PITT COMMUNITY COLLEGE                                      ","2003-2004",39,"Total Participants",108843,119065,-10222,98682,76599,22083,10161,42466,-32305,"37","26",27516,21590
"3989",213385,"LAFAYETTE COLLEGE                                           ","2003-2004",5,"Fencing",4005,14246,-10241,2844,10115,-7271,1161,4131,-2970,"10","4",6173,2521
"8837",127918,"REGIS UNIVERSITY                                            ","2003-2004",16,"Softball",220370,230623,-10253,0,0,0,220370,230623,-10253,".","13",0,30057
"15871",174783,"SAINT CLOUD STATE UNIVERSITY                                ","2003-2004",39,"Total Participants",2276551,2286810,-10259,1535521,1121145,414376,741030,1165665,-424635,"314","217",532862,396284
"8670",210401,"WILLAMETTE UNIVERSITY                                       ","2003-2004",16,"Softball",54093,64364,-10271,0,0,0,54093,64364,-10271,".","15",0,31928
"2168",439288,"JOHNSON &amp; WALES UNIVERSITY-DENVER                           ","2003-2004",2,"Basketball",42670,52943,-10273,26190,33841,-7651,16480,19102,-2622,"13","8",28841,14102
"6436",130697,"WESLEYAN UNIVERSITY                                         ","2003-2004",10,"Ice Hockey",134333,144610,-10277,66873,75603,-8730,67460,69007,-1547,"31","14",49149,26389
"3162",228042,"SCHREINER UNIVERSITY                                        ","2003-2004",2,"Basketball",124364,134646,-10282,63842,62207,1635,60522,72439,-11917,"23","10",21814,21814
"13589",232681,"MARY WASHINGTON COLLEGE                                     ","2003-2004",26,"Volleyball",28320,38611,-10291,0,0,0,28320,38611,-10291,".","12",0,14927
"1106",225548,"HOWARD PAYNE UNIVERSITY                                     ","2003-2004",1,"Baseball",109196,119514,-10318,109196,119514,-10318,0,0,0,"33",".",34650,0
"9248",224323,"UNIVERSITY OF DALLAS                                        ","2003-2004",16,"Softball",32485,42808,-10323,0,0,0,32485,42808,-10323,".","14",0,25160
"13107",131520,"HOWARD UNIVERSITY                                           ","2003-2004",26,"Volleyball",329712,340048,-10336,0,0,0,329712,340048,-10336,".","14",0,45545
"5774",215099,"PHILADELPHIA UNIVERSITY                                     ","2003-2004",8,"Golf",20203,30544,-10341,20203,30544,-10341,0,0,0,"11",".",2400,0
"6282",204635,"OHIO NORTHERN UNIVERSITY                                    ","2003-2004",8,"Golf",47529,57874,-10345,22926,26333,-3407,24603,31541,-6938,"8","8",13663,15340
"12306",229832,"WESTERN TEXAS COLLEGE                                       ","2003-2004",25,"Track and Field, X-Country",13486,23855,-10369,4050,6998,-2948,9436,16857,-7421,"2","5",5114,13312
"6495",196200,"SUNY-POTSDAM                                                ","2003-2004",10,"Ice Hockey",148424,158804,-10380,148424,158804,-10380,0,0,0,"30",".",88096,0
"13545",174437,"NORTH CENTRAL UNIVERSITY                                    ","2003-2004",26,"Volleyball",4635,15025,-10390,0,0,0,4635,15025,-10390,".","12",0,10250
"14240",167394,"COLLEGE OF OUR LADY OF THE ELMS                             ","2003-2004",26,"Volleyball",42474,52868,-10394,20532,26317,-5785,21942,26551,-4609,"9","7",3478,3712
"15848",146667,"LINCOLN CHRISTIAN COLLEGE AND SEMINARY                      ","2003-2004",39,"Total Participants",48960,59360,-10400,24480,29680,-5200,24480,29680,-5200,"54","50",42840,42840
"14398",204635,"OHIO NORTHERN UNIVERSITY                                    ","2003-2004",26,"Volleyball",46141,56549,-10408,0,0,0,46141,56549,-10408,".","19",0,27249
"10167",196079,"SUNY AT BINGHAMTON                                          ","2003-2004",18,"Swimming and Diving",435913,446324,-10411,218587,223910,-5323,217326,222414,-5088,"22","29",33529,34328
"14062",199306,"PFEIFFER UNIVERSITY                                         ","2003-2004",26,"Volleyball",648,11073,-10425,0,0,0,648,11073,-10425,".","11",0,9166
"14682",110510,"CALIFORNIA STATE UNIVERSITY-SAN BERNARDINO                  ","2003-2004",27,"Water Polo",37907,48339,-10432,0,0,0,37907,48339,-10432,".","19",0,13641
"11713",212009,"DICKINSON COLLEGE                                           ","2003-2004",22,"Tennis",6158,16600,-10442,2805,7800,-4995,3353,8800,-5447,"14","13",2805,3353
"8770",203128,"HIRAM COLLEGE                                               ","2003-2004",16,"Softball",49230,59677,-10447,0,0,0,49230,59677,-10447,".","19",0,24356
"12309",198543,"FAYETTEVILLE STATE UNIVERSITY                               ","2003-2004",25,"Track and Field, X-Country",2,10452,-10450,1,5226,-5225,1,5226,-5225,"10","12",2803,2803
"14887",127741,"UNIVERSITY OF NORTHERN COLORADO                             ","2003-2004",28,"Wrestling",233108,243561,-10453,233108,243561,-10453,0,0,0,"28",".",47587,0
"1567",240107,"VITERBO UNIVERSITY                                          ","2003-2004",1,"Baseball",60712,71172,-10460,60712,71172,-10460,0,0,0,"29",".",48460,0
"14847",191986,"JAMESTOWN COMMUNITY COLLEGE                                 ","2003-2004",28,"Wrestling",8360,18820,-10460,8360,18820,-10460,0,0,0,"11","0",6800,0
"14242",206525,"WITTENBERG UNIVERSITY                                       ","2003-2004",26,"Volleyball",55331,65796,-10465,0,0,0,55331,65796,-10465,"0","15",0,17525
"13480",156286,"BELLARMINE UNIVERSITY                                       ","2003-2004",26,"Volleyball",82667,93149,-10482,0,0,0,82667,93149,-10482,".","12",0,19499
"9569",204194,"MOUNT VERNON NAZARENE UNIVERSITY                            ","2003-2004",16,"Softball",25783,36283,-10500,0,0,0,25783,36283,-10500,".","17",0,25783
"14118",185828,"NEW JERSEY INSTITUTE OF TECHNOLOGY                          ","2003-2004",26,"Volleyball",18945,29445,-10500,9020,13020,-4000,9925,16425,-6500,"11","11",9020,9925
"655",121619,"SANTA ANA COLLEGE                                           ","2003-2004",1,"Baseball",15800,26303,-10503,15800,26303,-10503,0,0,0,"31",".",20193,0
"1073",162104,"CECIL COMMUNITY COLLEGE                                     ","2003-2004",1,"Baseball",553,11060,-10507,553,11060,-10507,0,0,0,"20",".",2730,0
"5333",239318,"MILWAUKEE SCHOOL OF ENGINEERING                             ","2003-2004",8,"Golf",23278,33807,-10529,19158,31206,-12048,4120,2601,1519,"12","8",25618,1520
"4003",184348,"DREW UNIVERSITY                                             ","2003-2004",5,"Fencing",24138,34668,-10530,12069,18200,-6131,12069,16468,-4399,"15","15",8109,6715
"12189",137847,"THE UNIVERSITY OF TAMPA                                     ","2003-2004",25,"Track and Field, X-Country",94320,104872,-10552,36660,50909,-14249,57660,53963,3697,"10","17",9468,9468
"13336",168421,"WORCESTER POLYTECHNIC INSTITUTE                             ","2003-2004",26,"Volleyball",8274,18826,-10552,0,0,0,8274,18826,-10552,"0","12",0,8826
"8895",134945,"JACKSONVILLE UNIVERSITY                                     ","2003-2004",16,"Softball",251482,262051,-10569,0,0,0,251482,262051,-10569,".","17",0,74548
"7966",156295,"BEREA COLLEGE                                               ","2003-2004",15,"Soccer",19700,30288,-10588,9850,15452,-5602,9850,14836,-4986,"24","15",9848,9838
"5309",127918,"REGIS UNIVERSITY                                            ","2003-2004",8,"Golf",56625,67222,-10597,56625,67222,-10597,0,0,0,"11",".",17255,0
"8795",163657,"PRINCE GEORGES COMMUNITY COLLEGE                            ","2003-2004",16,"Softball",3929,14526,-10597,0,0,0,3929,14526,-10597,".","13",0,4549
"3506",179867,"WASHINGTON UNIVERSITY IN ST LOUIS                           ","2003-2004",3,"All Track Combined",198671,209277,-10606,97709,103890,-6181,100962,105387,-4425,"32","36",57263,58750
"9490",204501,"OBERLIN COLLEGE                                             ","2003-2004",16,"Softball",27485,38102,-10617,0,0,0,27485,38102,-10617,".","12",0,19744
"13290",151111,"INDIANA UNIVERSITY-PURDUE UNIVERSITY-INDIANAPOLIS           ","2003-2004",26,"Volleyball",5496,16120,-10624,0,0,0,5496,16120,-10624,".","12",0,9782
"3264",158802,"DILLARD UNIVERSITY                                          ","2003-2004",2,"Basketball",643943,654569,-10626,348251,353511,-5260,295692,301058,-5366,"15","15",23634,20070
"2148",220604,"LE MOYNE-OWEN COLLEGE                                       ","2003-2004",2,"Basketball",239000,249650,-10650,119500,124825,-5325,119500,124825,-5325,"20","16",118000,118000
"1428",214731,"PENNSYLVANIA STATE UNIVERSITY-DELAWARE COUNTY               ","2003-2004",1,"Baseball",1396,12057,-10661,1396,12057,-10661,0,0,0,"12",".",6757,0
"10657",130697,"WESLEYAN UNIVERSITY                                         ","2003-2004",22,"Tennis",99155,109820,-10665,50265,54725,-4460,48890,55095,-6205,"13","11",8789,8984
"13550",171492,"NORTHWOOD UNIVERSITY                                        ","2003-2004",26,"Volleyball",276398,287077,-10679,0,0,0,276398,287077,-10679,".","15",0,57361
"1593",173647,"GUSTAVUS ADOLPHUS COLLEGE                                   ","2003-2004",2,"Basketball",227112,237807,-10695,136151,142862,-6711,90961,94945,-3984,"24","24",44734,38230
"9533",155520,"MIDAMERICA NAZARENE UNIVERSITY                              ","2003-2004",16,"Softball",118879,129578,-10699,0,0,0,118879,129578,-10699,".","13",0,32405
"5859",127060,"UNIVERSITY OF DENVER                                        ","2003-2004",8,"Golf",748623,759351,-10728,343893,349795,-5902,404730,409556,-4826,"6","9",74761,83907
"9354",123800,"SOUTHWESTERN COLLEGE                                        ","2003-2004",16,"Softball",16596,27332,-10736,0,0,0,16596,27332,-10736,".","16",0,8272
"9532",190558,"CUNY COLLEGE OF STATEN ISLAND                               ","2003-2004",16,"Softball",18940,29680,-10740,0,0,0,18940,29680,-10740,".","16",0,18940
"10002",211079,"COMMUNITY COLLEGE OF BEAVER COUNTY                          ","2003-2004",16,"Softball",6300,17040,-10740,0,0,0,6300,17040,-10740,".","11",0,12637
"15719",173452,"MARTIN LUTHER COLLEGE                                       ","2003-2004",39,"Total Participants",52750,63500,-10750,23000,30200,-7200,29750,33300,-3550,"151","102",36900,31500
"16099",216038,"SLIPPERY ROCK UNIVERSITY OF PENNSYLVANIA                    ","2003-2004",39,"Total Participants",1557618,1568371,-10753,712010,726446,-14436,845608,841925,3683,"295","260",339764,279278
"11370",157401,"MURRAY STATE UNIVERSITY                                     ","2003-2004",22,"Tennis",267997,278755,-10758,128962,120554,8408,139035,158201,-19166,"5","9",16214,19834
"13901",235343,"GREEN RIVER COMMUNITY COLLEGE                               ","2003-2004",26,"Volleyball",11262,22025,-10763,0,0,0,11262,22025,-10763,".","12",0,9562
"6338",169798,"EASTERN MICHIGAN UNIVERSITY                                 ","2003-2004",9,"Gymnastics",310903,321674,-10771,0,0,0,310903,321674,-10771,".","19",0,29610
"14488",123341,"SIERRA COLLEGE                                              ","2003-2004",26,"Volleyball",2592,13379,-10787,0,0,0,2592,13379,-10787,".","14",0,10682
"2505",121707,"COLLEGE OF THE REDWOODS                                     ","2003-2004",2,"Basketball",47817,58609,-10792,21505,28873,-7368,26312,29736,-3424,"15","9",17580,12636
"2457",196699,"SUNY ULSTER COUNTY COMMUNITY COLLEGE                        ","2003-2004",2,"Basketball",4800,15600,-10800,4800,15600,-10800,0,0,0,"12",".",5150,0
"7234",194392,"PAUL SMITHS COLLEGE OF ARTS AND SCIENCE                     ","2003-2004",15,"Soccer",10200,21000,-10800,5100,10500,-5400,5100,10500,-5400,"24","17",3000,3000
"15164",235149,"EVERETT COMMUNITY COLLEGE                                   ","2003-2004",32,"Beach Volleyball",600,11400,-10800,0,0,0,600,11400,-10800,".","10",0,1200
"162",127778,"OTERO JUNIOR COLLEGE                                        ","2003-2004",1,"Baseball",44667,55473,-10806,44667,55473,-10806,0,0,0,"38",".",14206,0
"6758",196194,"SUNY COLLEGE AT OSWEGO                                      ","2003-2004",11,"Lacrosse",109564,120402,-10838,72772,72223,549,36792,48179,-11387,"28","26",35912,27702
"5171",110413,"CALIFORNIA LUTHERAN UNIVERSITY                              ","2003-2004",8,"Golf",30353,41203,-10850,30353,41203,-10850,0,0,0,"11",".",28028,0
"1492",121707,"COLLEGE OF THE REDWOODS                                     ","2003-2004",1,"Baseball",29996,40870,-10874,29996,40870,-10874,0,0,0,"21",".",22974,0
"12376",125028,"VENTURA COLLEGE                                             ","2003-2004",25,"Track and Field, X-Country",30732,41624,-10892,15366,20812,-5446,15366,20812,-5446,"13","13",4252,4252
"5467",236328,"UNIVERSITY OF PUGET SOUND                                   ","2003-2004",8,"Golf",5194,16092,-10898,2597,8046,-5449,2597,8046,-5449,"9","9",7129,7129
"16422",190169,"COLUMBIA-GREENE COMMUNITY COLLEGE                           ","2003-2004",39,"Total Participants",36600,47550,-10950,24050,27400,-3350,12550,20150,-7600,"31","47",40900,31150
"9470",165936,"GORDON COLLEGE                                              ","2003-2004",16,"Softball",6870,17821,-10951,0,0,0,6870,17821,-10951,".","13",0,14821
"12051",166683,"MASSACHUSETTS INSTITUTE OF TECHNOLOGY                       ","2003-2004",24,"Track and Field, Outdoor",73773,84733,-10960,48675,58283,-9608,25098,26450,-1352,"39","47",37961,11751
"13137",133881,"FLORIDA INSTITUTE OF TECHNOLOGY-MELBOURNE                   ","2003-2004",26,"Volleyball",175875,186862,-10987,0,0,0,175875,186862,-10987,".","12",0,19156
"14501",224004,"CONCORDIA UNIVERSITY AT AUSTIN                              ","2003-2004",26,"Volleyball",23200,34188,-10988,0,0,0,23200,34188,-10988,".","8",0,15440
"14884",239318,"MILWAUKEE SCHOOL OF ENGINEERING                             ","2003-2004",28,"Wrestling",14500,25489,-10989,14500,25489,-10989,0,0,0,"26",".",16519,0
"2135",214166,"MOUNT ALOYSIUS COLLEGE                                      ","2003-2004",2,"Basketball",54890,65890,-11000,27370,32870,-5500,27520,33020,-5500,"13","8",27370,27520
"11709",230047,"BRIGHAM YOUNG UNIVERSITY-HAWAII CAMPUS                      ","2003-2004",22,"Tennis",79800,90802,-11002,39900,45401,-5501,39900,45401,-5501,"7","9",39900,39900
"1947",150604,"FRANKLIN COLLEGE                                            ","2003-2004",2,"Basketball",155671,166679,-11008,90625,94193,-3568,65046,72486,-7440,"21","16",52788,53448
"16394",150561,"TAYLOR UNIVERSITY-FT WAYNE                                  ","2003-2004",39,"Total Participants",10497,21507,-11010,4350,10876,-6526,6147,10631,-4484,"20","22",16253,20022
"12078",234164,"VIRGINIA UNION UNIVERSITY                                   ","2003-2004",24,"Track and Field, Outdoor",33486,44522,-11036,16743,22261,-5518,16743,22261,-5518,"11","1",776,776
"12222",234164,"VIRGINIA UNION UNIVERSITY                                   ","2003-2004",25,"Track and Field, X-Country",33486,44522,-11036,16743,22261,-5518,16743,22261,-5518,"2","5",776,776
"17343",235334,"GRAYS HARBOR COLLEGE                                        ","2003-2004",39,"Total Participants",96224,107281,-11057,52393,58142,-5749,43831,49139,-5308,"50","37",52580,43149
"3195",239080,"MARIAN COLLEGE OF FOND DU LAC                               ","2003-2004",2,"Basketball",105284,116355,-11071,46875,50259,-3384,58409,66096,-7687,"15","16",19858,16238
"13223",146418,"KISHWAUKEE COLLEGE                                          ","2003-2004",26,"Volleyball",11548,22628,-11080,0,0,0,11548,22628,-11080,".","9",0,17655
"5141",215655,"ROBERT MORRIS UNIVERSITY                                    ","2003-2004",8,"Golf",45768,56849,-11081,40775,46930,-6155,4993,9919,-4926,"10","6",10851,3457
"5507",153737,"KIRKWOOD COMMUNITY COLLEGE                                  ","2003-2004",8,"Golf",6100,17225,-11125,6100,17225,-11125,0,0,0,"8",".",5900,0
"11748",228802,"THE UNIVERSITY OF TEXAS AT TYLER                            ","2003-2004",22,"Tennis",37058,48200,-11142,18529,24100,-5571,18529,24100,-5571,"8","10",8100,8100
"11665",199306,"PFEIFFER UNIVERSITY                                         ","2003-2004",22,"Tennis",5365,16531,-11166,4025,10957,-6932,1340,5574,-4234,"10","8",9151,5015
"11908",177940,"LINCOLN UNIVERSITY                                          ","2003-2004",23,"Track and Field, Indoor",127828,138998,-11170,59131,62183,-3052,68697,76815,-8118,"17","23",17620,33113
"12099",177940,"LINCOLN UNIVERSITY                                          ","2003-2004",24,"Track and Field, Outdoor",127828,138998,-11170,59131,62183,-3052,68697,76815,-8118,"17","23",17620,33113
"1183",156286,"BELLARMINE UNIVERSITY                                       ","2003-2004",1,"Baseball",247435,258631,-11196,247435,258631,-11196,0,0,0,"33",".",56898,0
"10168",174358,"MINNESOTA STATE UNIVERSITY-MOORHEAD                         ","2003-2004",18,"Swimming and Diving",62432,73628,-11196,0,0,0,62432,73628,-11196,".","35",0,29630
"3331",207157,"HILLSDALE FREE WILL BAPTIST COLLEGE                         ","2003-2004",2,"Basketball",26700,37900,-11200,16500,19000,-2500,10200,18900,-8700,"15","15",18500,14900
"6931",236230,"PACIFIC LUTHERAN UNIVERSITY                                 ","2003-2004",13,"Rowing",18000,29200,-11200,9000,14600,-5600,9000,14600,-5600,"30","42",9000,9000
"3644",154998,"DODGE CITY COMMUNITY COLLEGE                                ","2003-2004",3,"All Track Combined",17900,29106,-11206,12888,14553,-1665,5012,14553,-9541,"18","7",5330,5330
"11492",165644,"EASTERN NAZARENE COLLEGE                                    ","2003-2004",22,"Tennis",10834,22043,-11209,8074,6766,1308,2760,15277,-12517,"10","8",3321,2048
"2936",206604,"WRIGHT STATE UNIVERSITY-MAIN CAMPUS                         ","2003-2004",2,"Basketball",2342161,2353374,-11213,1651562,1662597,-11035,690599,690777,-178,"14","12",280010,147289
"1777",230834,"CASTLETON STATE COLLEGE                                     ","2003-2004",2,"Basketball",58476,69701,-11225,28070,33670,-5600,30406,36031,-5625,"15","12",27670,30031
"5793",109208,"AMERICAN RIVER COLLEGE                                      ","2003-2004",8,"Golf",4044,15270,-11226,2200,8435,-6235,1844,6835,-4991,"10","7",6083,4483
"32",150066,"ANDERSON UNIVERSITY                                         ","2003-2004",1,"Baseball",87662,98894,-11232,87662,98894,-11232,0,0,0,"36",".",57760,0
"6463",240417,"UNIVERSITY OF WISCONSIN-STOUT                               ","2003-2004",10,"Ice Hockey",57157,68389,-11232,57157,68389,-11232,0,0,0,"30",".",50610,0
"9638",130183,"TEIKYO POST UNIVERSITY                                      ","2003-2004",16,"Softball",12202,23443,-11241,0,0,0,12202,23443,-11241,".","18",0,23254
"8505",167251,"NEWBURY COLLEGE-BROOKLINE                                   ","2003-2004",15,"Soccer",1059,12301,-11242,1059,12301,-11242,0,0,0,"20","0",5591,0
"7044",236328,"UNIVERSITY OF PUGET SOUND                                   ","2003-2004",14,"Skiing",2100,13363,-11263,903,5746,-4843,1197,7617,-6420,"3","4",5195,6887
"8939",110334,"CABRILLO COLLEGE                                            ","2003-2004",16,"Softball",4170,15445,-11275,0,0,0,4170,15445,-11275,".","16",0,5251
"9745",208406,"CLACKAMAS COMMUNITY COLLEGE                                 ","2003-2004",16,"Softball",12151,23427,-11276,0,0,0,12151,23427,-11276,".","17",0,11481
"13863",236595,"SEATTLE UNIVERSITY                                          ","2003-2004",26,"Volleyball",115304,126582,-11278,0,0,0,115304,126582,-11278,".","14",0,42797
"9432",155627,"OTTAWA UNIVERSITY                                           ","2003-2004",16,"Softball",13523,24805,-11282,0,0,0,13523,24805,-11282,".","11",0,12352
"1379",187444,"WILLIAM PATERSON UNIVERSITY OF NEW JERSEY                   ","2003-2004",1,"Baseball",117244,128532,-11288,117244,128532,-11288,0,0,0,"27",".",53080,0
"17133",240268,"UNIVERSITY OF WISCONSIN-EAU CLAIRE                          ","2003-2004",39,"Total Participants",667853,679144,-11291,254815,259341,-4526,413038,419803,-6765,"322","274",195013,194066
"11758",123341,"SIERRA COLLEGE                                              ","2003-2004",22,"Tennis",6074,17380,-11306,3037,5719,-2682,3037,11661,-8624,"5","11",2350,8316
"4021",130697,"WESLEYAN UNIVERSITY                                         ","2003-2004",6,"Field hocky",92332,103640,-11308,0,0,0,92332,103640,-11308,".","23",0,30744
"1615",176910,"CENTRAL CHRISTIAN COLLEGE OF THE BIBLE                      ","2003-2004",2,"Basketball",6322,17656,-11334,3962,10829,-6867,2360,6827,-4467,"12","10",7829,3827
"3297",235334,"GRAYS HARBOR COLLEGE                                        ","2003-2004",2,"Basketball",60226,71567,-11341,30921,33988,-3067,29305,37579,-8274,"14","12",17608,18513
"1373",159656,"LOYOLA UNIVERSITY NEW ORLEANS                               ","2003-2004",1,"Baseball",109680,121046,-11366,109680,121046,-11366,0,0,0,"31",".",67455,0
"14650",110680,"UNIVERSITY OF CALIFORNIA-SAN DIEGO                          ","2003-2004",27,"Water Polo",208322,219696,-11374,98448,105749,-7301,109874,113947,-4073,"21","25",39864,48322
"4467",233541,"SHENANDOAH UNIVERSITY                                       ","2003-2004",7,"Football",189476,200860,-11384,189476,200860,-11384,0,0,0,"104",".",65829,0
"1148",198066,"BREVARD COLLEGE                                             ","2003-2004",1,"Baseball",97900,109290,-11390,97900,109290,-11390,0,0,0,"26",".",45290,0
"12441",224004,"CONCORDIA UNIVERSITY AT AUSTIN                              ","2003-2004",25,"Track and Field, X-Country",7600,19000,-11400,3800,9500,-5700,3800,9500,-5700,"6","8",3736,3736
"13416",174358,"MINNESOTA STATE UNIVERSITY-MOORHEAD                         ","2003-2004",26,"Volleyball",123780,135187,-11407,0,0,0,123780,135187,-11407,".","14",0,32546
"6716",196024,"SUNY COLLEGE OF TECHNOLOGY AT DELHI                         ","2003-2004",11,"Lacrosse",23422,34845,-11423,23422,34845,-11423,0,0,0,"20",".",17345,0
"8498",216287,"SWARTHMORE COLLEGE                                          ","2003-2004",15,"Soccer",28530,39968,-11438,14635,22425,-7790,13895,17543,-3648,"24","23",20546,16256
"10122",188641,"ALFRED UNIVERSITY                                           ","2003-2004",18,"Swimming and Diving",72642,84080,-11438,36321,44095,-7774,36321,39985,-3664,"30","19",14100,13600
"4237",190099,"COLGATE UNIVERSITY                                          ","2003-2004",6,"Field hocky",324638,336086,-11448,0,0,0,324638,336086,-11448,".","21",0,36788
"13407",181330,"MIDLAND LUTHERAN COLLEGE                                    ","2003-2004",26,"Volleyball",24943,36392,-11449,0,0,0,24943,36392,-11449,".","27",0,23299
"9257",153126,"CLARKE COLLEGE                                              ","2003-2004",16,"Softball",31947,43399,-11452,0,0,0,31947,43399,-11452,".","22",0,23206
"10141",131469,"GEORGE WASHINGTON UNIVERSITY                                ","2003-2004",18,"Swimming and Diving",584780,596246,-11466,274814,281439,-6625,309966,314807,-4841,"16","18",36195,36798
"12979",215275,"UNIVERSITY OF PITTSBURGH-GREENSBURG                         ","2003-2004",25,"Track and Field, X-Country",100,11568,-11468,50,5644,-5594,50,5924,-5874,"7","6",2961,3246
"11224",120971,"PALOMAR COLLEGE                                             ","2003-2004",22,"Tennis",1838,13320,-11482,968,6891,-5923,870,6429,-5559,"8","6",3043,2581
"5047",216694,"WAYNESBURG COLLEGE                                          ","2003-2004",7,"Football",132377,143875,-11498,132377,143875,-11498,0,0,0,"95",".",130243,0
"17097",220604,"LE MOYNE-OWEN COLLEGE                                       ","2003-2004",39,"Total Participants",264000,275500,-11500,118000,124000,-6000,146000,151500,-5500,"53","55",221000,229000
"1762",105525,"PIMA COMMUNITY COLLEGE                                      ","2003-2004",2,"Basketball",58955,70477,-11522,29926,37941,-8015,29029,32536,-3507,"12","13",16323,16097
"11133",152637,"VINCENNES UNIVERSITY                                        ","2003-2004",22,"Tennis",17107,28640,-11533,17107,28640,-11533,0,0,0,"6",".",17107,0
"454",185572,"MONMOUTH UNIVERSITY                                         ","2003-2004",1,"Baseball",382113,393683,-11570,382113,393683,-11570,0,0,0,"29",".",83795,0
"9123",199999,"WINSTON-SALEM STATE UNIVERSITY                              ","2003-2004",16,"Softball",42754,54336,-11582,0,0,0,42754,54336,-11582,".","12",0,16110
"11837",131283,"CATHOLIC UNIVERSITY OF AMERICA                              ","2003-2004",23,"Track and Field, Indoor",2,11600,-11598,1,5500,-5499,1,6100,-6099,"10","20",5335,5335
"11970",131283,"CATHOLIC UNIVERSITY OF AMERICA                              ","2003-2004",24,"Track and Field, Outdoor",2,11600,-11598,1,5500,-5499,1,6100,-6099,"10","20",5335,5335
"1325",236610,"SHORELINE COMMUNITY COLLEGE                                 ","2003-2004",1,"Baseball",31749,43349,-11600,31749,43349,-11600,0,0,0,"21",".",23228,0
"9633",145619,"BENEDICTINE UNIVERSITY                                      ","2003-2004",16,"Softball",57540,69145,-11605,0,0,0,57540,69145,-11605,".","19",0,26071
"7483",164207,"WASHINGTON BIBLE COLLEGE-CAPITAL BIBLE SEMINARY             ","2003-2004",15,"Soccer",2,11614,-11612,1,6358,-6357,1,5256,-5255,"12","11",4788,4091
"16828",170000,"GRACE BIBLE COLLEGE                                         ","2003-2004",39,"Total Participants",8598,20234,-11636,3098,5633,-2535,5500,14601,-9101,"26","20",13679,19614
"17088",181738,"UNION COLLEGE                                               ","2003-2004",39,"Total Participants",3075,14721,-11646,1641,7072,-5431,1434,7649,-6215,"22","23",22637,19758
"10696",175272,"WINONA STATE UNIVERSITY                                     ","2003-2004",22,"Tennis",27424,39093,-11669,12968,16973,-4005,14456,22120,-7664,"10","9",13005,13664
"15855",200022,"BISMARCK STATE COLLEGE                                      ","2003-2004",39,"Total Participants",30836,42517,-11681,17490,25638,-8148,13346,16879,-3533,"33","18",46503,35030
"6252",209825,"UNIVERSITY OF PORTLAND                                      ","2003-2004",8,"Golf",223806,235493,-11687,120026,139462,-19436,103780,96031,7749,"9","7",45879,23618
"1786",211079,"COMMUNITY COLLEGE OF BEAVER COUNTY                          ","2003-2004",2,"Basketball",36641,48337,-11696,36641,48337,-11696,0,0,0,"12",".",35381,0
"9649",434672,"THE COMMUNITY COLLEGE OF BALTIMORE COUNTY                   ","2003-2004",16,"Softball",29697,41397,-11700,0,0,0,29697,41397,-11700,".","21",0,29000
"10725",211088,"ARCADIA UNIVERSITY                                          ","2003-2004",22,"Tennis",3036,14736,-11700,1016,6866,-5850,2020,7870,-5850,"13","10",2516,3520
"15953",166692,"MASSACHUSETTS MARITIME ACADEMY                              ","2003-2004",39,"Total Participants",83500,95200,-11700,46500,60000,-13500,37000,35200,1800,"250","75",50500,17500
"6651",188641,"ALFRED UNIVERSITY                                           ","2003-2004",11,"Lacrosse",142505,154208,-11703,84850,88172,-3322,57655,66036,-8381,"27","16",26000,21900
"1345",175272,"WINONA STATE UNIVERSITY                                     ","2003-2004",1,"Baseball",98041,109758,-11717,98041,109758,-11717,0,0,0,"35",".",32729,0
"14130",209250,"MT HOOD COMMUNITY COLLEGE                                   ","2003-2004",26,"Volleyball",13375,25095,-11720,0,0,0,13375,25095,-11720,".","10",0,24616
"16154",137564,"SOUTHEASTERN COLLEGE ASSEMBLIES OF GOD                      ","2003-2004",39,"Total Participants",62250,74000,-11750,50750,60000,-9250,11500,14000,-2500,"73","29",69500,28000
"11181",183859,"BROOKDALE COMMUNITY COLLEGE                                 ","2003-2004",22,"Tennis",8000,19764,-11764,4000,10500,-6500,4000,9264,-5264,"7","7",7566,4606
"14712",110334,"CABRILLO COLLEGE                                            ","2003-2004",27,"Water Polo",775,12540,-11765,775,12540,-11765,0,0,0,"10",".",2471,0
"2629",168005,"SUFFOLK UNIVERSITY                                          ","2003-2004",2,"Basketball",30000,41800,-11800,15000,20900,-5900,15000,20900,-5900,"13","16",15000,15000
"10059",189088,"BARD COLLEGE                                                ","2003-2004",17,"Squash",1,11810,-11809,1,11810,-11809,0,0,0,"12",".",2981,0
"5718",229063,"TEXAS SOUTHERN UNIVERSITY                                   ","2003-2004",8,"Golf",210702,222527,-11825,79230,91055,-11825,131472,131472,0,"6","8",18500,50000
"10199",169080,"CALVIN COLLEGE                                              ","2003-2004",18,"Swimming and Diving",64702,76527,-11825,30913,36696,-5783,33789,39831,-6042,"14","24",19125,21097
"8157",195216,"ST LAWRENCE UNIVERSITY                                      ","2003-2004",15,"Soccer",130548,142375,-11827,76404,83499,-7095,54144,58876,-4732,"26","25",21268,15810
"1008",229814,"WEST TEXAS A &amp; M UNIVERSITY                                 ","2003-2004",1,"Baseball",61317,73168,-11851,61317,73168,-11851,0,0,0,"43",".",48218,0
"8041",187897,"NEW MEXICO HIGHLANDS UNIVERSITY                             ","2003-2004",15,"Soccer",102072,113927,-11855,0,0,0,102072,113927,-11855,".","19",0,21182
"14063",190691,"CUNY YORK COLLEGE                                           ","2003-2004",26,"Volleyball",20320,32177,-11857,10530,16522,-5992,9790,15655,-5865,"15","13",10530,9790
"7059",171456,"NORTHERN MICHIGAN UNIVERSITY                                ","2003-2004",14,"Skiing",253719,265582,-11863,77784,82120,-4336,175935,183462,-7527,"9","14",32493,50585
"6692",196866,"UNION COLLEGE                                               ","2003-2004",11,"Lacrosse",125431,137299,-11868,56302,62882,-6580,69129,74417,-5288,"36","28",16671,18356
"12487",169080,"CALVIN COLLEGE                                              ","2003-2004",25,"Track and Field, X-Country",136063,147932,-11869,68014,74550,-6536,68049,73382,-5333,"44","40",37872,33018
"3657",110413,"CALIFORNIA LUTHERAN UNIVERSITY                              ","2003-2004",3,"All Track Combined",100872,112743,-11871,50436,56371,-5935,50436,56372,-5936,"26","14",25075,25076
"1807",122180,"SACRAMENTO CITY COLLEGE                                     ","2003-2004",2,"Basketball",5472,17354,-11882,3862,8567,-4705,1610,8787,-7177,"16","17",3775,3604
"13205",173805,"ITASCA COMMUNITY COLLEGE                                    ","2003-2004",26,"Volleyball",7360,19242,-11882,0,0,0,7360,19242,-11882,".","11",0,3015
"945",172291,"ST CLAIR COUNTY COMMUNITY COLLEGE                           ","2003-2004",1,"Baseball",50466,62351,-11885,50466,62351,-11885,0,0,0,"28",".",31092,0
"9940",220710,"MARYVILLE COLLEGE                                           ","2003-2004",16,"Softball",26565,38459,-11894,0,0,0,26565,38459,-11894,".","14",0,25919
"4201",131283,"CATHOLIC UNIVERSITY OF AMERICA                              ","2003-2004",6,"Field hocky",400,12300,-11900,0,0,0,400,12300,-11900,".","24",0,10000
"10559",179867,"WASHINGTON UNIVERSITY IN ST LOUIS                           ","2003-2004",19,"Swimming",121355,133278,-11923,60046,66283,-6237,61309,66995,-5686,"13","21",29578,30290
"13464",146685,"LINCOLN LAND COMMUNITY COLLEGE                              ","2003-2004",26,"Volleyball",6216,18147,-11931,0,0,0,6216,18147,-11931,".","14",0,5144
"5817",231624,"COLLEGE OF WILLIAM AND MARY                                 ","2003-2004",8,"Golf",153070,165008,-11938,82953,86660,-3707,70117,78348,-8231,"11","13",35947,29533
"13310",233499,"SAINT PAULS COLLEGE                                         ","2003-2004",26,"Volleyball",1000,12945,-11945,0,0,0,1000,12945,-11945,".","9",0,4185
"1741",171535,"OAKLAND COMMUNITY COLLEGE                                   ","2003-2004",2,"Basketball",71737,83685,-11948,33621,38459,-4838,38116,45226,-7110,"16","13",24306,31073
"13626",112084,"CHRISTIAN HERITAGE COLLEGE                                  ","2003-2004",26,"Volleyball",17919,29867,-11948,0,0,0,17919,29867,-11948,".","10",0,12795
"11546",195720,"SAINT JOHN FISHER COLLEGE                                   ","2003-2004",22,"Tennis",4450,16422,-11972,2474,8658,-6184,1976,7764,-5788,"11","14",2291,1809
"3751",211158,"BLOOMSBURG UNIVERSITY OF PENNSYLVANIA                       ","2003-2004",3,"All Track Combined",87466,99442,-11976,44220,46114,-1894,43246,53328,-10082,"69","62",12782,13553
"9497",173142,"BETHANY LUTHERAN COLLEGE                                    ","2003-2004",16,"Softball",40524,52503,-11979,0,0,0,40524,52503,-11979,".","16",0,11769
"14771",149727,"WAUBONSEE COMMUNITY COLLEGE                                 ","2003-2004",28,"Wrestling",5100,17084,-11984,5100,17084,-11984,0,0,0,"15",".",8684,0
"10602",216287,"SWARTHMORE COLLEGE                                          ","2003-2004",19,"Swimming",24585,36580,-11995,12000,16200,-4200,12585,20380,-7795,"20","25",15069,18869
"5325",239248,"MILWAUKEE AREA TECHNICAL COLLEGE                            ","2003-2004",8,"Golf",2,12000,-11998,1,6000,-5999,1,6000,-5999,"5","1",3000,3000
"78",144175,"CITY COLLEGES OF CHICAGO-OLIVE-HARVEY COLLEGE               ","2003-2004",1,"Baseball",3000,15000,-12000,3000,15000,-12000,0,0,0,"26",".",10000,0
"2558",231165,"VERMONT TECHNICAL COLLEGE                                   ","2003-2004",2,"Basketball",16988,28988,-12000,12260,18260,-6000,4728,10728,-6000,"13","9",12260,4728
"2633",156213,"ASBURY COLLEGE                                              ","2003-2004",2,"Basketball",49007,61007,-12000,29763,38763,-9000,19244,22244,-3000,"16","7",29265,18701
"6513",230834,"CASTLETON STATE COLLEGE                                     ","2003-2004",10,"Ice Hockey",33858,45858,-12000,33858,45858,-12000,0,0,0,"21",".",33858,0
"8560",155104,"GARDEN CITY COMMUNITY COLLEGE                               ","2003-2004",16,"Softball",20734,32734,-12000,0,0,0,20734,32734,-12000,".","21",0,20734
"14324",192192,"KEUKA COLLEGE                                               ","2003-2004",26,"Volleyball",27459,39459,-12000,0,0,0,27459,39459,-12000,".","14",0,17008
"5984",216597,"VILLANOVA UNIVERSITY                                        ","2003-2004",8,"Golf",41090,53103,-12013,41090,53103,-12013,0,0,0,"8",".",31554,0
"16315",159656,"LOYOLA UNIVERSITY NEW ORLEANS                               ","2003-2004",39,"Total Participants",257162,269207,-12045,126664,133046,-6382,130498,136161,-5663,"50","56",116835,57349
"5790",102368,"TROY STATE UNIVERSITY-MAIN CAMPUS                           ","2003-2004",8,"Golf",215353,227402,-12049,107675,99974,7701,107678,127428,-19750,"12","7",22423,22423
"6736",125763,"WHITTIER COLLEGE                                            ","2003-2004",11,"Lacrosse",111340,123392,-12052,66450,90121,-23671,44890,33271,11619,"29","20",60126,20890
"2550",154396,"SOUTHWESTERN COMMUNITY COLLEGE                              ","2003-2004",2,"Basketball",26055,38110,-12055,13065,18584,-5519,12990,19526,-6536,"15","10",14084,15026
"14247",131113,"WILMINGTON COLLEGE                                          ","2003-2004",26,"Volleyball",71650,83711,-12061,0,0,0,71650,83711,-12061,".","11",0,25276
"12791",189088,"BARD COLLEGE                                                ","2003-2004",25,"Track and Field, X-Country",50,12126,-12076,25,6062,-6037,25,6064,-6039,"13","12",1075,1075
"7934",213321,"KINGS COLLEGE                                               ","2003-2004",15,"Soccer",39091,51171,-12080,21479,27444,-5965,17612,23727,-6115,"25","19",20825,17370
"15230",176044,"MISSISSIPPI VALLEY STATE UNIVERSITY                         ","2003-2004",33,"Bowling",9400,21487,-12087,0,0,0,9400,21487,-12087,"0","10",0,13757
"4078",204501,"OBERLIN COLLEGE                                             ","2003-2004",6,"Field hocky",32296,44394,-12098,0,0,0,32296,44394,-12098,".","18",0,16024
"1104",188438,"ADIRONDACK COMMUNITY COLLEGE                                ","2003-2004",1,"Baseball",1389,13488,-12099,1389,13488,-12099,0,0,0,"16",".",9497,0
"6256",171535,"OAKLAND COMMUNITY COLLEGE                                   ","2003-2004",8,"Golf",9651,21800,-12149,9651,21800,-12149,0,0,0,"6",".",17600,0
"15095",174251,"UNIVERSITY OF MINNESOTA-MORRIS                              ","2003-2004",29,"Other Sports",5000,17152,-12152,0,0,0,5000,17152,-12152,".","8",0,13257
"8469",210571,"ALBRIGHT COLLEGE                                            ","2003-2004",15,"Soccer",29640,41793,-12153,12255,20735,-8480,17385,21058,-3673,"28","20",12255,17385
"6151",119137,"MOORPARK COLLEGE                                            ","2003-2004",8,"Golf",9012,21170,-12158,6083,12783,-6700,2929,8387,-5458,"14","7",6083,2929
"11151",213507,"LEBANON VALLEY COLLEGE                                      ","2003-2004",22,"Tennis",9443,21604,-12161,4580,10615,-6035,4863,10989,-6126,"9","15",4580,4863
"12522",236577,"SEATTLE PACIFIC UNIVERSITY                                  ","2003-2004",25,"Track and Field, X-Country",425579,437768,-12189,91307,97170,-5863,334272,340598,-6326,"52","99",24355,45230
"9085",188438,"ADIRONDACK COMMUNITY COLLEGE                                ","2003-2004",16,"Softball",4217,16412,-12195,0,0,0,4217,16412,-12195,".","12",0,9608
"277",157632,"SAINT CATHARINE COLLEGE                                     ","2003-2004",1,"Baseball",154493,166693,-12200,154493,166693,-12200,0,0,0,"44",".",21000,0
"15599",170240,"HENRY FORD COMMUNITY COLLEGE                                ","2003-2004",39,"Total Participants",61835,74040,-12205,27105,33170,-6065,34730,40870,-6140,"33","27",27850,29700
"14468",195720,"SAINT JOHN FISHER COLLEGE                                   ","2003-2004",26,"Volleyball",9220,21431,-12211,0,0,0,9220,21431,-12211,".","11",0,10363
"11771",151111,"INDIANA UNIVERSITY-PURDUE UNIVERSITY-INDIANAPOLIS           ","2003-2004",22,"Tennis",5520,17733,-12213,3520,8342,-4822,2000,9391,-7391,"8","10",2890,5474
"542",153472,"INDIAN HILLS COMMUNITY COLLEGE                              ","2003-2004",1,"Baseball",130457,142686,-12229,130457,142686,-12229,0,0,0,"36",".",41235,0
"6370",240329,"UNIVERSITY OF WISCONSIN-LA CROSSE                           ","2003-2004",9,"Gymnastics",102779,115016,-12237,0,0,0,102779,115016,-12237,".","19",0,40406
"17204",161688,"ALLEGANY COLLEGE OF MARYLAND                                ","2003-2004",39,"Total Participants",133157,145399,-12242,76976,84052,-7076,56181,61347,-5166,"53","53",24945,18215
"13455",153126,"CLARKE COLLEGE                                              ","2003-2004",26,"Volleyball",44354,56610,-12256,22507,30003,-7496,21847,26607,-4760,"12","11",17802,14366
"2212",100706,"UNIVERSITY OF ALABAMA IN HUNTSVILLE                         ","2003-2004",2,"Basketball",586064,598330,-12266,357508,350706,6802,228556,247624,-19068,"13","11",43666,38489
"9481",127778,"OTERO JUNIOR COLLEGE                                        ","2003-2004",16,"Softball",42317,54593,-12276,0,0,0,42317,54593,-12276,".","28",0,17276
"8650",213613,"LOCK HAVEN UNIVERSITY OF PENNSYLVANIA                       ","2003-2004",16,"Softball",184138,196444,-12306,0,0,0,184138,196444,-12306,".","19",0,47250
"12753",216357,"THIEL COLLEGE                                               ","2003-2004",25,"Track and Field, X-Country",2664,14972,-12308,1476,7630,-6154,1188,7342,-6154,"14","27",1100,858
"12531",156295,"BEREA COLLEGE                                               ","2003-2004",25,"Track and Field, X-Country",8000,20322,-12322,5333,11484,-6151,2667,8838,-6171,"14","7",5292,2646
"15205",199157,"NORTH CAROLINA CENTRAL UNIVERSITY                           ","2003-2004",33,"Bowling",200,12528,-12328,0,0,0,200,12528,-12328,".","10",0,8336
"3551",110671,"UNIVERSITY OF CALIFORNIA-RIVERSIDE                          ","2003-2004",3,"All Track Combined",455341,467686,-12345,221517,228233,-6716,233824,239453,-5629,"70","84",3069,3069
"13795",191241,"FORDHAM UNIVERSITY                                          ","2003-2004",26,"Volleyball",616727,629072,-12345,0,0,0,616727,629072,-12345,"0","14",0,65533
"13322",161554,"UNIVERSITY OF SOUTHERN MAINE                                ","2003-2004",26,"Volleyball",14545,26898,-12353,0,0,0,14545,26898,-12353,".","10",0,17823
"11251",136330,"PALM BEACH ATLANTIC UNIVERSITY-WEST PALM BEACH              ","2003-2004",22,"Tennis",6305,18666,-12361,1979,9634,-7655,4326,9032,-4706,"7","8",5914,5422
"14550",224961,"GALVESTON COLLEGE                                           ","2003-2004",26,"Volleyball",2000,14366,-12366,0,0,0,2000,14366,-12366,".","11",0,7117
"5352",240480,"UNIVERSITY OF WISCONSIN-STEVENS POINT                       ","2003-2004",8,"Golf",57,12425,-12368,0,0,0,57,12425,-12368,".","7",0,7266
"7285",193946,"NIAGARA COUNTY COMMUNITY COLLEGE                            ","2003-2004",15,"Soccer",10404,22774,-12370,4986,10426,-5440,5418,12348,-6930,"20","16",4157,4356
"2282",105899,"SOUTHWESTERN CONSERVATIVE BAPTIST BIBLE COLLEGE             ","2003-2004",2,"Basketball",56633,69010,-12377,26733,51069,-24336,29900,17941,11959,"17","10",40887,6950
"13126",241377,"CARIBBEAN UNIVERSITY-BAYAMON                                ","2003-2004",26,"Volleyball",3000,15390,-12390,3000,15390,-12390,0,0,0,"11",".",3200,0
"9217",131283,"CATHOLIC UNIVERSITY OF AMERICA                              ","2003-2004",16,"Softball",1,12400,-12399,0,0,0,1,12400,-12399,".","15",0,11000
"1010",225885,"JARVIS CHRISTIAN COLLEGE                                    ","2003-2004",1,"Baseball",3142,15556,-12414,3142,15556,-12414,0,0,0,"18",".",12414,0
"13969",243188,"UNIVERSITY OF PUERTO RICO-UTUADO                            ","2003-2004",26,"Volleyball",2000,14424,-12424,1000,7377,-6377,1000,7047,-6047,"14","14",1227,1227
"10858",207041,"EAST CENTRAL UNIVERSITY                                     ","2003-2004",22,"Tennis",14871,27296,-12425,7065,13648,-6583,7806,13648,-5842,"12","9",9100,7907
"14416",237701,"POTOMAC STATE COLLEGE OF WEST VIRGINIA UNIVERSITY           ","2003-2004",26,"Volleyball",5000,17436,-12436,0,0,0,5000,17436,-12436,".","9",0,4539
"580",190558,"CUNY COLLEGE OF STATEN ISLAND                               ","2003-2004",1,"Baseball",32408,44851,-12443,32408,44851,-12443,0,0,0,"26",".",32408,0
"9881",199333,"PITT COMMUNITY COLLEGE                                      ","2003-2004",16,"Softball",7390,19834,-12444,0,0,0,7390,19834,-12444,".","12",0,8859
"13773",152637,"VINCENNES UNIVERSITY                                        ","2003-2004",26,"Volleyball",19880,32326,-12446,0,0,0,19880,32326,-12446,".","9",0,19880
"13775",224110,"NORTH CENTRAL TEXAS COLLEGE                                 ","2003-2004",26,"Volleyball",87200,99650,-12450,0,0,0,87200,99650,-12450,".","13",0,11862
"11177",196194,"SUNY COLLEGE AT OSWEGO                                      ","2003-2004",22,"Tennis",6932,19403,-12471,3466,7027,-3561,3466,12376,-8910,"14","11",2855,8204
"14584",234979,"COLUMBIA BASIN COLLEGE                                      ","2003-2004",26,"Volleyball",25030,37569,-12539,0,0,0,25030,37569,-12539,".","14",0,22137
"12756",155937,"STERLING COLLEGE                                            ","2003-2004",25,"Track and Field, X-Country",2,12546,-12544,1,6273,-6272,1,6273,-6272,"6","5",6272,6272
"10561",211088,"ARCADIA UNIVERSITY                                          ","2003-2004",19,"Swimming",7094,19644,-12550,3547,9822,-6275,3547,9822,-6275,"6","15",6597,6597
"1349",163338,"UNIVERSITY OF MARYLAND-EASTERN SHORE                        ","2003-2004",1,"Baseball",91248,103803,-12555,91248,103803,-12555,0,0,0,"18",".",34051,0
"841",247603,"SUSSEX COUNTY COMMUNITY COLLEGE                             ","2003-2004",1,"Baseball",24629,37185,-12556,24629,37185,-12556,0,0,0,"27",".",13570,0
"7204",142461,"NORTHWEST NAZARENE UNIVERSITY                               ","2003-2004",15,"Soccer",126250,138809,-12559,0,0,0,126250,138809,-12559,".","17",0,29004
"8264",123341,"SIERRA COLLEGE                                              ","2003-2004",15,"Soccer",75,12645,-12570,0,0,0,75,12645,-12570,".","20",0,12300
"8297",175421,"BELHAVEN COLLEGE                                            ","2003-2004",15,"Soccer",244202,256777,-12575,128542,133917,-5375,115660,122860,-7200,"24","18",19048,21106
"3430",112172,"CITRUS COLLEGE                                              ","2003-2004",2,"Basketball",46338,58915,-12577,23588,32961,-9373,22750,25954,-3204,"18","17",8803,9525
"13900",206604,"WRIGHT STATE UNIVERSITY-MAIN CAMPUS                         ","2003-2004",26,"Volleyball",412255,424854,-12599,0,0,0,412255,424854,-12599,".","13",0,60824
"647",161545,"SOUTHERN MAINE COMMUNITY COLLEGE                            ","2003-2004",1,"Baseball",1200,13800,-12600,1200,13800,-12600,0,0,0,"15",".",13500,0
"10031",236230,"PACIFIC LUTHERAN UNIVERSITY                                 ","2003-2004",16,"Softball",17000,29600,-12600,0,0,0,17000,29600,-12600,".","18",0,17000
"6390",239318,"MILWAUKEE SCHOOL OF ENGINEERING                             ","2003-2004",10,"Ice Hockey",82400,95011,-12611,82400,95011,-12611,0,0,0,"27",".",84478,0
"14588",130183,"TEIKYO POST UNIVERSITY                                      ","2003-2004",26,"Volleyball",2256,14869,-12613,0,0,0,2256,14869,-12613,".","13",0,14353
"8612",139968,"GORDON COLLEGE                                              ","2003-2004",16,"Softball",34189,46809,-12620,0,0,0,34189,46809,-12620,".","16",0,26400
"10306",109208,"AMERICAN RIVER COLLEGE                                      ","2003-2004",18,"Swimming and Diving",7800,20421,-12621,3900,10152,-6252,3900,10269,-6369,"7","11",7700,7817
"12926",174251,"UNIVERSITY OF MINNESOTA-MORRIS                              ","2003-2004",25,"Track and Field, X-Country",19091,31714,-12623,7045,10664,-3619,12046,21050,-9004,"37","44",3950,7617
"2494",233611,"SOUTHERN VIRGINIA UNIVERSITY                                ","2003-2004",2,"Basketball",33876,46503,-12627,14707,21713,-7006,19169,24790,-5621,"16","13",15285,18362
"370",117788,"LOS ANGELES CITY COLLEGE                                    ","2003-2004",1,"Baseball",33881,46512,-12631,33881,46512,-12631,0,0,0,"24",".",21450,0
"13112",120290,"OHLONE COLLEGE                                              ","2003-2004",26,"Volleyball",6146,18782,-12636,0,0,0,6146,18782,-12636,".","11",0,6376
"1652",240666,"SHERIDAN COLLEGE                                            ","2003-2004",2,"Basketball",266747,279412,-12665,139198,141323,-2125,127549,138089,-10540,"12","14",35770,30440
"7279",170532,"KALAMAZOO COLLEGE                                           ","2003-2004",15,"Soccer",41328,54005,-12677,23131,28059,-4928,18197,25946,-7749,"20","19",21598,19218
"10581",131283,"CATHOLIC UNIVERSITY OF AMERICA                              ","2003-2004",19,"Swimming",800,13500,-12700,400,6750,-6350,400,6750,-6350,"13","14",6250,6250
"5755",112172,"CITRUS COLLEGE                                              ","2003-2004",8,"Golf",12226,24973,-12747,8042,17825,-9783,4184,7148,-2964,"8","4",5581,1841
"8985",141574,"UNIVERSITY OF HAWAII AT MANOA                               ","2003-2004",16,"Softball",513844,526596,-12752,0,0,0,513844,526596,-12752,".","23",0,234981
"3769",155681,"PITTSBURG STATE UNIVERSITY                                  ","2003-2004",3,"All Track Combined",265943,278697,-12754,127909,134011,-6102,138034,144686,-6652,"31","37",27770,27770
"9625",174604,"RAINY RIVER COMMUNITY COLLEGE                               ","2003-2004",16,"Softball",13529,26300,-12771,0,0,0,13529,26300,-12771,".","12",0,13529
"7259",162690,"HAGERSTOWN COMMUNITY COLLEGE                                ","2003-2004",15,"Soccer",1358,14132,-12774,238,9737,-9499,1120,4395,-3275,"16","2",6738,2378
"15083",216357,"THIEL COLLEGE                                               ","2003-2004",29,"Other Sports",16285,29061,-12776,2961,3585,-624,13324,25476,-12152,"6","27",2784,12529
"713",122180,"SACRAMENTO CITY COLLEGE                                     ","2003-2004",1,"Baseball",1798,14577,-12779,1798,14577,-12779,0,0,0,"37",".",9092,0
"13590",120421,"OXNARD COLLEGE                                              ","2003-2004",26,"Volleyball",4698,17500,-12802,0,0,0,4698,17500,-12802,".","11",0,4698
"11255",110413,"CALIFORNIA LUTHERAN UNIVERSITY                              ","2003-2004",22,"Tennis",47205,60008,-12803,23270,26915,-3645,23935,33093,-9158,"10","11",13191,9117
"9766",196006,"SUNY COLLEGE OF TECHNOLOGY AT ALFRED                        ","2003-2004",16,"Softball",17568,30382,-12814,0,0,0,17568,30382,-12814,".","11",0,10636
"1199",207041,"EAST CENTRAL UNIVERSITY                                     ","2003-2004",1,"Baseball",22197,35026,-12829,22197,35026,-12829,0,0,0,"33",".",18997,0
"8822",146685,"LINCOLN LAND COMMUNITY COLLEGE                              ","2003-2004",16,"Softball",7458,20299,-12841,0,0,0,7458,20299,-12841,".","17",0,9775
"8474",229267,"TRINITY UNIVERSITY                                          ","2003-2004",15,"Soccer",188992,201835,-12843,104241,118700,-14459,84751,83135,1616,"30","27",63337,43875
"9682",122205,"SADDLEBACK COLLEGE                                          ","2003-2004",16,"Softball",12154,25000,-12846,0,0,0,12154,25000,-12846,".","15",0,11895
"3666",206507,"WILMINGTON COLLEGE                                          ","2003-2004",3,"All Track Combined",106942,119794,-12852,53471,65106,-11635,53471,54688,-1217,"28","22",26040,20372
"16276",133951,"FLORIDA INTERNATIONAL UNIVERSITY                            ","2003-2004",39,"Total Participants",3465264,3478116,-12852,1283926,1288632,-4706,2181338,2189484,-8146,"264","177",1105765,582174
"16649",231165,"VERMONT TECHNICAL COLLEGE                                   ","2003-2004",39,"Total Participants",22193,35045,-12852,18153,28805,-10652,4040,6240,-2200,"52","21",30413,8768
"489",209074,"LINN-BENTON COMMUNITY COLLEGE                               ","2003-2004",1,"Baseball",12857,25712,-12855,12857,25712,-12855,0,0,0,"28",".",17095,0
"5866",140164,"KENNESAW STATE UNIVERSITY                                   ","2003-2004",8,"Golf",115334,128193,-12859,115334,128193,-12859,0,0,0,"13",".",32479,0
"14108",154350,"SIMPSON COLLEGE                                             ","2003-2004",26,"Volleyball",65942,78801,-12859,0,0,0,65942,78801,-12859,".","27",0,52607
"6262",233897,"THE UNIVERSITY OF VIRGINIA'S COLLEGE AT WISE                ","2003-2004",8,"Golf",3600,16463,-12863,3600,16463,-12863,0,0,0,"15",".",9674,0
"4258",211088,"ARCADIA UNIVERSITY                                          ","2003-2004",6,"Field hocky",6784,19652,-12868,0,0,0,6784,19652,-12868,".","20",0,12352
"5137",215132,"UNIVERSITY OF THE SCIENCES IN PHILADELPHIA                  ","2003-2004",8,"Golf",1,12888,-12887,1,12888,-12887,0,0,0,"14",".",3400,0
"1693",199962,"WINGATE UNIVERSITY                                          ","2003-2004",2,"Basketball",118417,131318,-12901,38371,39080,-709,80046,92238,-12192,"18","16",34361,38894
"10688",109208,"AMERICAN RIVER COLLEGE                                      ","2003-2004",22,"Tennis",4884,17826,-12942,2459,9548,-7089,2425,8278,-5853,"9","8",6946,5676
"951",148380,"ROCK VALLEY COLLEGE                                         ","2003-2004",1,"Baseball",9000,21974,-12974,9000,21974,-12974,0,0,0,"19",".",10987,0
"6088",117788,"LOS ANGELES CITY COLLEGE                                    ","2003-2004",8,"Golf",5200,18188,-12988,2500,10164,-7664,2700,8024,-5324,"6","4",3799,2849
"8394",191612,"HERKIMER COUNTY COMMUNITY COLLEGE                           ","2003-2004",15,"Soccer",22500,35500,-13000,12000,18750,-6750,10500,16750,-6250,"24","24",12000,10500
"8805",225247,"HARDIN-SIMMONS UNIVERSITY                                   ","2003-2004",16,"Softball",6000,19000,-13000,0,0,0,6000,19000,-13000,".","16",0,13011
"14445",219134,"SI TANKA UNIVERSITY-HURON CAMPUS                            ","2003-2004",26,"Volleyball",35902,48902,-13000,0,0,0,35902,48902,-13000,".","16",0,35902
"3710",233611,"SOUTHERN VIRGINIA UNIVERSITY                                ","2003-2004",3,"All Track Combined",7854,20856,-13002,3927,10428,-6501,3927,10428,-6501,"48","50",3097,3097
"13008",113218,"CUYAMACA COLLEGE                                            ","2003-2004",26,"Volleyball",7657,20690,-13033,0,0,0,7657,20690,-13033,".","10",0,12334
"10401",110486,"CALIFORNIA STATE UNIVERSITY-BAKERSFIELD                     ","2003-2004",18,"Swimming and Diving",300273,313308,-13035,97807,112213,-14406,202466,201095,1371,"20","43",29160,51071
"14844",122180,"SACRAMENTO CITY COLLEGE                                     ","2003-2004",28,"Wrestling",1065,14103,-13038,1065,14103,-13038,0,0,0,"33",".",3670,0
"6411",196194,"SUNY COLLEGE AT OSWEGO                                      ","2003-2004",10,"Ice Hockey",229839,242883,-13044,229839,242883,-13044,0,0,0,"25","0",65598,0
"15053",123341,"SIERRA COLLEGE                                              ","2003-2004",28,"Wrestling",2125,15174,-13049,2125,15174,-13049,0,0,0,"24",".",12624,0
"8124",186131,"PRINCETON UNIVERSITY                                        ","2003-2004",15,"Soccer",446406,459468,-13062,199847,205444,-5597,246559,254024,-7465,"28","27",84956,86264
"16734",196219,"SUNY COLLEGE AT PURCHASE                                    ","2003-2004",39,"Total Participants",135093,148167,-13074,68580,78410,-9830,66513,69757,-3244,"72","72",89100,84871
"1017",204501,"OBERLIN COLLEGE                                             ","2003-2004",1,"Baseball",37599,50678,-13079,37599,50678,-13079,0,0,0,"26",".",23914,0
"8525",181330,"MIDLAND LUTHERAN COLLEGE                                    ","2003-2004",16,"Softball",23073,36166,-13093,0,0,0,23073,36166,-13093,".","19",0,23073
"9510",203580,"LAKE ERIE COLLEGE                                           ","2003-2004",16,"Softball",15610,28713,-13103,0,0,0,15610,28713,-13103,".","11",0,11048
"7811",145619,"BENEDICTINE UNIVERSITY                                      ","2003-2004",15,"Soccer",87852,100961,-13109,43854,51540,-7686,43998,49421,-5423,"25","18",11264,9642
"12579",165936,"GORDON COLLEGE                                              ","2003-2004",25,"Track and Field, X-Country",3000,16112,-13112,1500,8056,-6556,1500,8056,-6556,"13","18",5056,5056
"7099",184348,"DREW UNIVERSITY                                             ","2003-2004",15,"Soccer",157124,170240,-13116,68208,95840,-27632,88916,74400,14516,"32","26",12384,12799
"4181",216010,"SHIPPENSBURG UNIVERSITY OF PENNSYLVANIA                     ","2003-2004",6,"Field hocky",84467,97588,-13121,0,0,0,84467,97588,-13121,".","22",0,21540
"4655",175421,"BELHAVEN COLLEGE                                            ","2003-2004",7,"Football",565137,578261,-13124,565137,578261,-13124,0,0,0,"103",".",76910,0
"2223",122409,"SAN DIEGO STATE UNIVERSITY                                  ","2003-2004",2,"Basketball",3432949,3446075,-13126,2935227,2279833,655394,497722,1166242,-668520,"14","13",464813,258806
"10219",186131,"PRINCETON UNIVERSITY                                        ","2003-2004",18,"Swimming and Diving",552422,565597,-13175,270230,277759,-7529,282192,287838,-5646,"55","42",87363,112560
"68",173920,"MINNESOTA STATE UNVERSITY-MANKATO                           ","2003-2004",1,"Baseball",162611,175799,-13188,162611,175799,-13188,0,0,0,"43",".",71596,0
"1118",146676,"LINCOLN COLLEGE                                             ","2003-2004",1,"Baseball",75727,88922,-13195,75727,88922,-13195,0,0,0,"31",".",37880,0
"6804",194824,"RENSSELAER POLYTECHNIC INSTITUTE                            ","2003-2004",11,"Lacrosse",109316,122516,-13200,72746,80946,-8200,36570,41570,-5000,"33","20",21698,15164
"1744",141574,"UNIVERSITY OF HAWAII AT MANOA                               ","2003-2004",2,"Basketball",2126542,2139744,-13202,1395229,1355738,39491,731313,784006,-52693,"13","15",471176,285224
"2874",211024,"BAPTIST BIBLE COLLEGE AND SEMINARY                          ","2003-2004",2,"Basketball",27594,40814,-13220,14956,26025,-11069,12638,14789,-2151,"24","23",22025,10789
"941",155104,"GARDEN CITY COMMUNITY COLLEGE                               ","2003-2004",1,"Baseball",29508,42785,-13277,29508,42785,-13277,0,0,0,"36",".",28312,0
"5579",113218,"CUYAMACA COLLEGE                                            ","2003-2004",8,"Golf",7230,20508,-13278,7230,20508,-13278,0,0,0,"8",".",12388,0
"1510",134495,"HILLSBOROUGH COMMUNITY COLLEGE                              ","2003-2004",1,"Baseball",15500,28787,-13287,15500,28787,-13287,0,0,0,"25",".",15500,0
"1006",214698,"PENNSYLVANIA STATE UNIVERSITY-PENN STATE BEAVER             ","2003-2004",1,"Baseball",1,13301,-13300,1,13301,-13300,0,0,0,"22",".",11200,0
"11606",200280,"UNIVERSITY OF NORTH DAKOTA-MAIN CAMPUS                      ","2003-2004",22,"Tennis",34407,47742,-13335,0,0,0,34407,47742,-13335,".","11",0,12099
"1287",175421,"BELHAVEN COLLEGE                                            ","2003-2004",1,"Baseball",228386,241722,-13336,228386,241722,-13336,0,0,0,"31",".",56339,0
"6284",186371,"RUTGERS UNIVERSITY-CAMDEN                                   ","2003-2004",8,"Golf",0,13336,-13336,0,13336,-13336,0,0,0,"9",".",6541,0
"62",219082,"DAKOTA STATE UNIVERSITY                                     ","2003-2004",1,"Baseball",73274,86614,-13340,73274,86614,-13340,0,0,0,"27",".",24672,0
"12515",168254,"WESTERN NEW ENGLAND COLLEGE                                 ","2003-2004",25,"Track and Field, X-Country",2650,15996,-13346,925,7898,-6973,1725,8098,-6373,"15","10",3600,3800
"424",153126,"CLARKE COLLEGE                                              ","2003-2004",1,"Baseball",34923,48271,-13348,34923,48271,-13348,0,0,0,"20",".",27850,0
"8486",153320,"FAITH BAPTIST BIBLE COLLEGE AND THEOLOGICAL SEM             ","2003-2004",15,"Soccer",8875,22230,-13355,6250,9945,-3695,2625,12285,-9660,"17","21",9945,12285
"4969",218441,"NORTH GREENVILLE COLLEGE                                    ","2003-2004",7,"Football",63779,77135,-13356,63779,77135,-13356,0,0,0,"85",".",73507,0
"9118",176479,"WILLIAM CAREY COLLEGE                                       ","2003-2004",16,"Softball",142210,155571,-13361,0,0,0,142210,155571,-13361,".","16",0,19974
"9778",153621,"IOWA WESLEYAN COLLEGE                                       ","2003-2004",16,"Softball",12629,26002,-13373,0,0,0,12629,26002,-13373,".","18",0,21879
"7558",233611,"SOUTHERN VIRGINIA UNIVERSITY                                ","2003-2004",15,"Soccer",18462,31845,-13383,8451,14417,-5966,10011,17428,-7417,"31","17",7990,11000
"11031",204468,"NOTRE DAME COLLEGE                                          ","2003-2004",22,"Tennis",11146,24532,-13386,11146,24532,-13386,0,0,0,"10",".",11146,0
"10123",177214,"DRURY UNIVERSITY                                            ","2003-2004",18,"Swimming and Diving",116862,130265,-13403,58431,68149,-9718,58431,62116,-3685,"22","21",66309,60276
"14235",232089,"FERRUM COLLEGE                                              ","2003-2004",26,"Volleyball",18000,31411,-13411,0,0,0,18000,31411,-13411,".","11",0,13411
"126",165820,"FITCHBURG STATE COLLEGE                                     ","2003-2004",1,"Baseball",29409,42863,-13454,29409,42863,-13454,0,0,0,"25",".",37168,0
"7538",240480,"UNIVERSITY OF WISCONSIN-STEVENS POINT                       ","2003-2004",15,"Soccer",47439,60898,-13459,0,0,0,47439,60898,-13459,".","23",0,26015
"12852",111948,"CHAPMAN UNIVERSITY                                          ","2003-2004",25,"Track and Field, X-Country",35940,49400,-13460,6000,14400,-8400,29940,35000,-5060,"2","21",1000,10000
"10650",231420,"AVERETT UNIVERSITY                                          ","2003-2004",22,"Tennis",31000,44461,-13461,16000,20993,-4993,15000,23468,-8468,"7","7",17000,16000
"6791",231420,"AVERETT UNIVERSITY                                          ","2003-2004",11,"Lacrosse",21000,34478,-13478,0,0,0,21000,34478,-13478,"0","12",0,23000
"8601",224004,"CONCORDIA UNIVERSITY AT AUSTIN                              ","2003-2004",16,"Softball",25700,39199,-13499,0,0,0,25700,39199,-13499,".","11",0,25699
"11257",131283,"CATHOLIC UNIVERSITY OF AMERICA                              ","2003-2004",22,"Tennis",2,13501,-13499,1,9000,-8999,1,4501,-4500,"10","11",4500,4500
"3916",179955,"WILLIAM JEWELL COLLEGE                                      ","2003-2004",3,"All Track Combined",34574,48076,-13502,17287,24038,-6751,17287,24038,-6751,"52","24",13116,13116
"1326",119137,"MOORPARK COLLEGE                                            ","2003-2004",1,"Baseball",13295,26802,-13507,13295,26802,-13507,0,0,0,"24",".",13295,0
"7237",207041,"EAST CENTRAL UNIVERSITY                                     ","2003-2004",15,"Soccer",30780,44292,-13512,0,0,0,30780,44292,-13512,".","25",0,29299
"8828",216764,"WEST CHESTER UNIVERSITY OF PENNSYLVANIA                     ","2003-2004",16,"Softball",31474,45012,-13538,0,0,0,31474,45012,-13538,".","17",0,25783
"5717",237701,"POTOMAC STATE COLLEGE OF WEST VIRGINIA UNIVERSITY           ","2003-2004",8,"Golf",5000,18549,-13549,5000,18549,-13549,0,0,0,"7","0",5652,0
"8531",247603,"SUSSEX COUNTY COMMUNITY COLLEGE                             ","2003-2004",16,"Softball",12995,26576,-13581,0,0,0,12995,26576,-13581,".","16",0,7180
"8095",119137,"MOORPARK COLLEGE                                            ","2003-2004",15,"Soccer",9213,22795,-13582,4058,11053,-6995,5155,11742,-6587,"24","25",4058,5155
"8657",231420,"AVERETT UNIVERSITY                                          ","2003-2004",16,"Softball",15500,29116,-13616,0,0,0,15500,29116,-13616,".","18",0,18500
"15897",142461,"NORTHWEST NAZARENE UNIVERSITY                               ","2003-2004",39,"Total Participants",961644,975288,-13644,443117,432075,11042,518527,543213,-24686,"119","111",174613,169307
"16256",155520,"MIDAMERICA NAZARENE UNIVERSITY                              ","2003-2004",39,"Total Participants",803106,816750,-13644,351235,352470,-1235,451871,464280,-12409,"281","132",230395,147595
"13542",203128,"HIRAM COLLEGE                                               ","2003-2004",26,"Volleyball",30670,44333,-13663,0,0,0,30670,44333,-13663,"0","12",0,14850
"11979",240417,"UNIVERSITY OF WISCONSIN-STOUT                               ","2003-2004",24,"Track and Field, Outdoor",52421,66092,-13671,25394,33066,-7672,27027,33026,-5999,"47","44",19176,16808
"691",216807,"WESTMINSTER COLLEGE                                         ","2003-2004",1,"Baseball",27884,41580,-13696,27884,41580,-13696,0,0,0,"41",".",17012,0
"3167",149781,"WHEATON COLLEGE                                             ","2003-2004",2,"Basketball",342626,356323,-13697,191906,190983,923,150720,165340,-14620,"17","13",46091,36566
"12786",168591,"ALMA COLLEGE                                                ","2003-2004",25,"Track and Field, X-Country",51715,65447,-13732,26151,31904,-5753,25564,33543,-7979,"25","33",19958,20556
"14857",168254,"WESTERN NEW ENGLAND COLLEGE                                 ","2003-2004",28,"Wrestling",19775,33510,-13735,19775,33510,-13735,0,0,0,"17",".",21825,0
"660",224527,"EAST TEXAS BAPTIST UNIVERSITY                               ","2003-2004",1,"Baseball",78673,92412,-13739,78673,92412,-13739,0,0,0,"36",".",34773,0
"15761",219833,"CHRISTIAN BROTHERS UNIVERSITY                               ","2003-2004",39,"Total Participants",138126,151895,-13769,73401,74536,-1135,64725,77359,-12634,"100","74",85951,89404
"13745",112075,"CONCORDIA UNIVERSITY                                        ","2003-2004",26,"Volleyball",61985,75756,-13771,0,0,0,61985,75756,-13771,".","12",0,33998
"3662",174358,"MINNESOTA STATE UNIVERSITY-MOORHEAD                         ","2003-2004",3,"All Track Combined",157699,171473,-13774,78065,84726,-6661,79634,86747,-7113,"33","30",33863,35784
"9883",231712,"CHRISTOPHER NEWPORT UNIVERSITY                              ","2003-2004",16,"Softball",12455,26230,-13775,0,0,0,12455,26230,-13775,".","17",0,8475
"1090",178387,"MISSOURI WESTERN STATE COLLEGE                              ","2003-2004",1,"Baseball",157633,171431,-13798,157633,171431,-13798,0,0,0,"36",".",32739,0
"2050",217891,"CLINTON JUNIOR COLLEGE                                      ","2003-2004",2,"Basketball",200,14000,-13800,100,7000,-6900,100,7000,-6900,"17","11",5000,5000
"2380",114938,"GAVILAN COLLEGE                                             ","2003-2004",2,"Basketball",27938,41739,-13801,15762,22262,-6500,12176,19477,-7301,"10","9",8733,6058
"6039",238078,"WHEELING JESUIT UNIVERSITY                                  ","2003-2004",8,"Golf",500,14306,-13806,500,14306,-13806,0,0,0,"10",".",9936,0
"7007",136950,"ROLLINS COLLEGE                                             ","2003-2004",13,"Rowing",122832,136646,-13814,61416,68323,-6907,61416,68323,-6907,"24","35",28483,28483
"17277",136950,"ROLLINS COLLEGE                                             ","2003-2004",39,"Total Participants",2924749,2938563,-13814,1403006,1409913,-6907,1521743,1528650,-6907,"172","149",324345,270063
"13460",147013,"MCKENDREE COLLEGE                                           ","2003-2004",26,"Volleyball",156942,170757,-13815,0,0,0,156942,170757,-13815,".","22",0,33937
"8225",122205,"SADDLEBACK COLLEGE                                          ","2003-2004",15,"Soccer",9181,23000,-13819,0,0,0,9181,23000,-13819,".","19",0,8854
"815",154721,"BETHANY COLLEGE                                             ","2003-2004",1,"Baseball",104088,117926,-13838,104088,117926,-13838,0,0,0,"26",".",17874,0
"13565",204501,"OBERLIN COLLEGE                                             ","2003-2004",26,"Volleyball",25193,39051,-13858,0,0,0,25193,39051,-13858,".","12",0,16307
"6460",165820,"FITCHBURG STATE COLLEGE                                     ","2003-2004",10,"Ice Hockey",52800,66660,-13860,52800,66660,-13860,0,0,0,"25",".",43162,0
"10362",166683,"MASSACHUSETTS INSTITUTE OF TECHNOLOGY                       ","2003-2004",18,"Swimming and Diving",60244,74110,-13866,33395,37285,-3890,26849,36825,-9976,"25","26",16104,15644
"860",204194,"MOUNT VERNON NAZARENE UNIVERSITY                            ","2003-2004",1,"Baseball",36236,50106,-13870,36236,50106,-13870,0,0,0,"25",".",33236,0
"599",155186,"HIGHLAND COMMUNITY COLLEGE                                  ","2003-2004",1,"Baseball",122541,136412,-13871,122541,136412,-13871,0,0,0,"28",".",60154,0
"8593",174251,"UNIVERSITY OF MINNESOTA-MORRIS                              ","2003-2004",16,"Softball",18349,32222,-13873,0,0,0,18349,32222,-13873,".","17",0,16408
"16235",148131,"QUINCY UNIVERSITY                                           ","2003-2004",39,"Total Participants",1394329,1408222,-13893,746834,762484,-15650,647495,645738,1757,"216","86",254720,152475
"2254",170790,"MACOMB COMMUNITY COLLEGE                                    ","2003-2004",2,"Basketball",72525,86426,-13901,36544,43213,-6669,35981,43213,-7232,"20","15",36730,36730
"10714",110510,"CALIFORNIA STATE UNIVERSITY-SAN BERNARDINO                  ","2003-2004",22,"Tennis",20944,34864,-13920,0,0,0,20944,34864,-13920,".","9",0,6730
"14969",212601,"GANNON UNIVERSITY                                           ","2003-2004",28,"Wrestling",118932,132875,-13943,118932,132875,-13943,0,0,0,"32",".",27502,0
"17322",229027,"THE UNIVERSITY OF TEXAS AT SAN ANTONIO                      ","2003-2004",39,"Total Participants",2433575,2447550,-13975,1157482,1139815,17667,1276093,1307735,-31642,"130","139",372399,297361
"8288",215284,"UNIVERSITY OF PITTSBURGH-JOHNSTOWN                          ","2003-2004",15,"Soccer",17600,31577,-13977,17600,31577,-13977,0,0,0,"26",".",12918,0
"1080",112075,"CONCORDIA UNIVERSITY                                        ","2003-2004",1,"Baseball",85812,99792,-13980,85812,99792,-13980,0,0,0,"21",".",44085,0
"2621",236300,"PUGET SOUND CHRISTIAN COLLEGE                               ","2003-2004",2,"Basketball",6000,20000,-14000,6000,20000,-14000,0,0,0,"9",".",18133,0
"5415",150048,"ANCILLA COLLEGE                                             ","2003-2004",8,"Golf",1000,15000,-14000,1000,15000,-14000,0,0,0,"5",".",10000,0
"11574",217873,"CLAFLIN UNIVERSITY                                          ","2003-2004",22,"Tennis",1000,15000,-14000,500,8000,-7500,500,7000,-6500,"7","8",3000,3500
"11820",240417,"UNIVERSITY OF WISCONSIN-STOUT                               ","2003-2004",23,"Track and Field, Indoor",53440,67441,-14001,26413,34415,-8002,27027,33026,-5999,"50","44",19950,16808
"1427",161341,"UNIVERSITY OF MAINE AT PRESQUE ISLE                         ","2003-2004",1,"Baseball",6634,20654,-14020,6634,20654,-14020,0,0,0,"17",".",11000,0
"16584",190691,"CUNY YORK COLLEGE                                           ","2003-2004",39,"Total Participants",110665,124686,-14021,56723,64209,-7486,53942,60477,-6535,"97","80",53658,50779
"16296",211343,"BUTLER COUNTY COMMUNITY COLLEGE                             ","2003-2004",39,"Total Participants",23346,37389,-14043,12964,21256,-8292,10382,16133,-5751,"39","30",24510,15160
"10653",113218,"CUYAMACA COLLEGE                                            ","2003-2004",22,"Tennis",7060,21107,-14047,0,0,0,7060,21107,-14047,".","9",0,13997
"10699",122597,"SAN FRANCISCO STATE UNIVERSITY                              ","2003-2004",22,"Tennis",93227,107277,-14050,0,0,0,93227,107277,-14050,".","12",0,13123
"15429",240620,"LARAMIE COUNTY COMMUNITY COLLEGE                            ","2003-2004",39,"Total Participants",164244,178300,-14056,72670,81311,-8641,91574,96989,-5415,"47","29",75316,39828
"7928",165529,"CURRY COLLEGE                                               ","2003-2004",15,"Soccer",34719,48779,-14060,16481,24402,-7921,18238,24377,-6139,"15","16",13196,13171
"13263",123800,"SOUTHWESTERN COLLEGE                                        ","2003-2004",26,"Volleyball",11619,25683,-14064,0,0,0,11619,25683,-14064,".","15",0,7663
"12711",199412,"QUEENS UNIVERSITY OF CHARLOTTE                              ","2003-2004",25,"Track and Field, X-Country",114455,128562,-14107,56884,64036,-7152,57571,64526,-6955,"9","8",5926,6126
"5559",237367,"FAIRMONT STATE COLLEGE                                      ","2003-2004",8,"Golf",14150,28267,-14117,6400,15814,-9414,7750,12453,-4703,"9","6",6537,1995
"5126",199333,"PITT COMMUNITY COLLEGE                                      ","2003-2004",8,"Golf",3665,17799,-14134,3665,17799,-14134,0,0,0,"11","0",4643,0
"16943",224527,"EAST TEXAS BAPTIST UNIVERSITY                               ","2003-2004",39,"Total Participants",391169,405307,-14138,130985,168157,-37172,260184,237150,23034,"192","82",228779,142598
"17197",243142,"UNIVERSITY OF PUERTO RICO IN CAROLINA                       ","2003-2004",39,"Total Participants",40861,55016,-14155,21017,28666,-7649,19844,26350,-6506,"91","82",20861,19260
"10052",163462,"MOUNT SAINT MARYS COLLEGE                                   ","2003-2004",16,"Softball",122340,136501,-14161,0,0,0,122340,136501,-14161,".","18",0,33711
"15393",241739,"UNIVERSIDAD METROPOLITANA                                   ","2003-2004",37,"Table Tennis",2,14200,-14198,1,7100,-7099,1,7100,-7099,"3","3",1100,1100
"7168",200156,"JAMESTOWN COLLEGE                                           ","2003-2004",15,"Soccer",23598,37798,-14200,0,0,0,23598,37798,-14200,".","17",0,10864
"7556",183859,"BROOKDALE COMMUNITY COLLEGE                                 ","2003-2004",15,"Soccer",26000,40200,-14200,13000,16850,-3850,13000,23350,-10350,"19","19",15113,20125
"17305",211024,"BAPTIST BIBLE COLLEGE AND SEMINARY                          ","2003-2004",39,"Total Participants",70382,84622,-14240,33972,41540,-7568,36410,43082,-6672,"88","103",55925,46531
"15464",190053,"CLINTON COMMUNITY COLLEGE                                   ","2003-2004",39,"Total Participants",26100,40359,-14259,13050,20446,-7396,13050,19913,-6863,"52","40",23650,23650
"2543",238661,"EDGEWOOD COLLEGE                                            ","2003-2004",2,"Basketball",80591,94852,-14261,37272,49001,-11729,43319,45851,-2532,"15","15",24451,24451
"13627",110671,"UNIVERSITY OF CALIFORNIA-RIVERSIDE                          ","2003-2004",26,"Volleyball",378758,393026,-14268,0,0,0,378758,393026,-14268,".","14",0,30861
"11102",190594,"CUNY HUNTER COLLEGE                                         ","2003-2004",22,"Tennis",2,14271,-14269,1,6910,-6909,1,7361,-7360,"12","15",2410,2861
"16251",214795,"PENNSYLVANIA STATE UNIVERSITY-PENN STATE MONT ALTO          ","2003-2004",39,"Total Participants",24000,38297,-14297,12500,19524,-7024,11500,18773,-7273,"62","45",19900,18700
"1987",176479,"WILLIAM CAREY COLLEGE                                       ","2003-2004",2,"Basketball",335220,349520,-14300,179085,185503,-6418,156135,164017,-7882,"14","16",42276,29575
"2771",172291,"ST CLAIR COUNTY COMMUNITY COLLEGE                           ","2003-2004",2,"Basketball",72445,86746,-14301,37233,45711,-8478,35212,41035,-5823,"14","11",22308,21573
"10713",233426,"ROANOKE COLLEGE                                             ","2003-2004",22,"Tennis",70,14375,-14305,35,6171,-6136,35,8204,-8169,"10","13",2948,3248
"129",209250,"MT HOOD COMMUNITY COLLEGE                                   ","2003-2004",1,"Baseball",14683,28999,-14316,14683,28999,-14316,0,0,0,"24",".",27770,0
"11883",110495,"CALIFORNIA STATE UNIVERSITY-STANISLAUS                      ","2003-2004",23,"Track and Field, Indoor",13654,27972,-14318,4566,8689,-4123,9088,19283,-10195,"2","30",857,3900
"4172",162928,"JOHNS HOPKINS UNIVERSITY                                    ","2003-2004",6,"Field hocky",72992,87311,-14319,0,0,0,72992,87311,-14319,".","23",0,31930
"1159",183859,"BROOKDALE COMMUNITY COLLEGE                                 ","2003-2004",1,"Baseball",13000,27330,-14330,13000,27330,-14330,0,0,0,"24",".",19545,0
"2952",193946,"NIAGARA COUNTY COMMUNITY COLLEGE                            ","2003-2004",2,"Basketball",10854,25194,-14340,5275,12395,-7120,5579,12799,-7220,"14","9",4354,4085
"9668",183211,"RIVIER COLLEGE                                              ","2003-2004",16,"Softball",300,14640,-14340,0,0,0,300,14640,-14340,".","15",0,4755
"4303",109208,"AMERICAN RIVER COLLEGE                                      ","2003-2004",7,"Football",12435,26778,-14343,12435,26778,-14343,0,0,0,"77",".",23483,0
"9967",235149,"EVERETT COMMUNITY COLLEGE                                   ","2003-2004",16,"Softball",800,15200,-14400,0,0,0,800,15200,-14400,".","14",0,1600
"5652",177542,"HANNIBAL-LAGRANGE COLLEGE                                   ","2003-2004",8,"Golf",42335,56740,-14405,42335,56740,-14405,0,0,0,"6",".",6705,0
"7568",150066,"ANDERSON UNIVERSITY                                         ","2003-2004",15,"Soccer",65201,79621,-14420,35142,41746,-6604,30059,37875,-7816,"31","21",22596,19925
"13399",171137,"UNIVERSITY OF MICHIGAN-DEARBORN                             ","2003-2004",26,"Volleyball",74001,88422,-14421,0,0,0,74001,88422,-14421,".","15",0,59949
"16409",171137,"UNIVERSITY OF MICHIGAN-DEARBORN                             ","2003-2004",39,"Total Participants",74001,88422,-14421,0,0,0,74001,88422,-14421,"13","32",14635,68173
"15698",182634,"COLBY-SAWYER COLLEGE                                        ","2003-2004",39,"Total Participants",531684,546108,-14424,256379,263145,-6766,275305,282963,-7658,"97","150",120399,126162
"2221",146685,"LINCOLN LAND COMMUNITY COLLEGE                              ","2003-2004",2,"Basketball",14805,29230,-14425,11266,18195,-6929,3539,11035,-7496,"12","11",6919,6919
"16870",192749,"MANHATTANVILLE COLLEGE                                      ","2003-2004",39,"Total Participants",421994,436422,-14428,200881,206788,-5907,221113,229634,-8521,"130","106",92628,80026
"134",101301,"GEORGE C WALLACE STATE COMMUNITY COLLEGE-SELMA              ","2003-2004",1,"Baseball",1195,15633,-14438,1195,15633,-14438,0,0,0,"18",".",7252,0
"15554",101301,"GEORGE C WALLACE STATE COMMUNITY COLLEGE-SELMA              ","2003-2004",39,"Total Participants",1195,15633,-14438,1195,15633,-14438,0,0,0,"28","15",15814,10023
"9919",194541,"POLYTECHNIC UNIVERSITY                                      ","2003-2004",16,"Softball",7500,21950,-14450,0,0,0,7500,21950,-14450,".","14",0,5070
"5983",233426,"ROANOKE COLLEGE                                             ","2003-2004",8,"Golf",2350,16804,-14454,2350,16804,-14454,0,0,0,"8",".",13804,0
"10416",212054,"DREXEL UNIVERSITY                                           ","2003-2004",18,"Swimming and Diving",483460,497919,-14459,293336,299578,-6242,190124,198341,-8217,"21","12",29434,29434
"794",202222,"COLUMBUS STATE COMMUNITY COLLEGE                            ","2003-2004",1,"Baseball",22600,37075,-14475,22600,37075,-14475,0,0,0,"30",".",26425,0
"13110",170790,"MACOMB COMMUNITY COLLEGE                                    ","2003-2004",26,"Volleyball",28712,43213,-14501,0,0,0,28712,43213,-14501,".","10",0,23791
"5727",130943,"UNIVERSITY OF DELAWARE                                      ","2003-2004",8,"Golf",44176,58691,-14515,44176,58691,-14515,0,0,0,"10",".",30841,0
"5021",128391,"WESTERN STATE COLLEGE OF COLORADO                           ","2003-2004",7,"Football",502122,516642,-14520,502122,516642,-14520,0,0,0,"122",".",75586,0
"12717",228529,"TARLETON STATE UNIVERSITY                                   ","2003-2004",25,"Track and Field, X-Country",145599,160130,-14531,69936,77202,-7266,75663,82928,-7265,"29","27",21429,21429
"97",101143,"ENTERPRISE-OZARK COMMUNITY COLLEGE                          ","2003-2004",1,"Baseball",33729,48266,-14537,33729,48266,-14537,0,0,0,"24",".",33765,0
"13453",109819,"BAKERSFIELD COLLEGE                                         ","2003-2004",26,"Volleyball",9400,23941,-14541,0,0,0,9400,23941,-14541,"0","13",0,3896
"4139",196167,"SUNY COLLEGE AT GENESEO                                     ","2003-2004",6,"Field hocky",18164,32719,-14555,0,0,0,18164,32719,-14555,".","25",0,20610
"8407",171599,"OLIVET COLLEGE                                              ","2003-2004",15,"Soccer",65389,79951,-14562,33192,46092,-12900,32197,33859,-1662,"20","24",14448,12394
"8048",178679,"OZARK CHRISTIAN COLLEGE                                     ","2003-2004",15,"Soccer",1000,15600,-14600,1000,15600,-14600,0,0,0,"24","0",12950,0
"7061",127060,"UNIVERSITY OF DENVER                                        ","2003-2004",14,"Skiing",823564,838167,-14603,411782,426385,-14603,411782,411782,0,"14","12",42919,42919
"8059",211644,"CLARION UNIVERSITY OF PENNSYLVANIA                          ","2003-2004",15,"Soccer",73707,88314,-14607,0,0,0,73707,88314,-14607,".","23",0,16171
"14437",175421,"BELHAVEN COLLEGE                                            ","2003-2004",26,"Volleyball",74222,88837,-14615,0,0,0,74222,88837,-14615,".","12",0,18083
"5694",154059,"NORTH IOWA AREA COMMUNITY COLLEGE                           ","2003-2004",8,"Golf",175,14802,-14627,157,13322,-13165,18,1480,-1462,"8","1",8462,940
"11961",156295,"BEREA COLLEGE                                               ","2003-2004",24,"Track and Field, Outdoor",20800,35439,-14639,11500,19972,-8472,9300,15467,-6167,"20","23",12628,9527
"14824",198561,"GARDNER-WEBB UNIVERSITY                                     ","2003-2004",28,"Wrestling",254498,269139,-14641,254498,269139,-14641,0,0,0,"19",".",34300,0
"2016",145619,"BENEDICTINE UNIVERSITY                                      ","2003-2004",2,"Basketball",120242,134890,-14648,59985,65238,-5253,60257,69652,-9395,"24","16",26204,20578
"16633",178369,"MISSOURI VALLEY COLLEGE                                     ","2003-2004",39,"Total Participants",187600,202250,-14650,97200,105530,-8330,90400,96720,-6320,"438","229",155562,96526
"9141",147013,"MCKENDREE COLLEGE                                           ","2003-2004",16,"Softball",181201,195863,-14662,0,0,0,181201,195863,-14662,".","31",0,42676
"9185",179292,"SAINT LOUIS COMMUNITY COLLEGE-FLORISSANT VALLEY             ","2003-2004",16,"Softball",6968,21634,-14666,0,0,0,6968,21634,-14666,".","12",0,17991
"12081",113193,"CUESTA COLLEGE                                              ","2003-2004",24,"Track and Field, Outdoor",14848,29514,-14666,7424,14757,-7333,7424,14757,-7333,"35","14",8996,8996
"12846",121619,"SANTA ANA COLLEGE                                           ","2003-2004",25,"Track and Field, X-Country",24000,38667,-14667,12000,20662,-8662,12000,18005,-6005,"31","33",15769,14320
"938",434672,"THE COMMUNITY COLLEGE OF BALTIMORE COUNTY                   ","2003-2004",1,"Baseball",57965,72636,-14671,57965,72636,-14671,0,0,0,"59",".",44880,0
"3480",187444,"WILLIAM PATERSON UNIVERSITY OF NEW JERSEY                   ","2003-2004",2,"Basketball",195101,209792,-14691,109293,116728,-7435,85808,93064,-7256,"16","15",20030,20744
"8817",154776,"THE BROWN MACKIE COLLEGE                                    ","2003-2004",16,"Softball",300,15000,-14700,0,0,0,300,15000,-14700,".","19",0,1235
"15007",171304,"MUSKEGON COMMUNITY COLLEGE                                  ","2003-2004",28,"Wrestling",26652,41356,-14704,26652,41356,-14704,0,0,0,"35",".",18249,0
"5128",148405,"ROCKFORD COLLEGE                                            ","2003-2004",8,"Golf",23012,37730,-14718,23012,37730,-14718,0,0,0,"7",".",5016,0
"5809",215275,"UNIVERSITY OF PITTSBURGH-GREENSBURG                         ","2003-2004",8,"Golf",236,14954,-14718,118,10381,-10263,118,4573,-4455,"11","4",7161,2652
"16238",161165,"HUSSON COLLEGE                                              ","2003-2004",39,"Total Participants",257823,272551,-14728,128323,123122,5201,129500,149429,-19929,"156","95",174543,78060
"6277",152336,"UNIVERSITY OF SAINT FRANCIS-FT WAYNE                        ","2003-2004",8,"Golf",5000,19742,-14742,5000,19742,-14742,0,0,0,"10",".",3478,0
"10607",233295,"RANDOLPH-MACON COLLEGE                                      ","2003-2004",19,"Swimming",2275,17050,-14775,1100,8525,-7425,1175,8525,-7350,"8","12",5000,6000
"13818",178679,"OZARK CHRISTIAN COLLEGE                                     ","2003-2004",26,"Volleyball",1000,15780,-14780,0,0,0,1000,15780,-14780,"0","14",0,12600
"16768",236656,"SOUTH PUGET SOUND COMMUNITY COLLEGE                         ","2003-2004",39,"Total Participants",52405,67199,-14794,22340,29273,-6933,30065,37926,-7861,"25","23",39007,37118
"13730",225247,"HARDIN-SIMMONS UNIVERSITY                                   ","2003-2004",26,"Volleyball",1200,16000,-14800,0,0,0,1200,16000,-14800,".","14",0,14215
"15604",214652,"PENNSYLVANIA STATE UNIV-PENN ST WORTHINGTON SCRNTN          ","2003-2004",39,"Total Participants",30500,45300,-14800,17000,24900,-7900,13500,20400,-6900,"58","30",2450,1700
"1551",169275,"MOTT COMMUNITY COLLEGE                                      ","2003-2004",1,"Baseball",8000,22804,-14804,8000,22804,-14804,0,0,0,"26",".",12803,0
"5948",140960,"SAVANNAH STATE UNIVERSITY                                   ","2003-2004",8,"Golf",0,14807,-14807,0,7691,-7691,0,7116,-7116,"3","3",2794,2330
"14852",190594,"CUNY HUNTER COLLEGE                                         ","2003-2004",28,"Wrestling",3205,18014,-14809,3205,18014,-14809,0,0,0,"19","0",8534,0
"13132",110334,"CABRILLO COLLEGE                                            ","2003-2004",26,"Volleyball",1142,15963,-14821,0,0,0,1142,15963,-14821,".","10",0,4785
"10850",224110,"NORTH CENTRAL TEXAS COLLEGE                                 ","2003-2004",22,"Tennis",68900,83750,-14850,0,0,0,68900,83750,-14850,".","6",0,11455
"16232",178059,"MARYVILLE UNIVERSITY OF SAINT LOUIS                         ","2003-2004",39,"Total Participants",127224,142080,-14856,60653,66507,-5854,66571,75573,-9002,"80","79",86004,60261
"13105",157757,"SPALDING UNIVERSITY                                         ","2003-2004",26,"Volleyball",100,14973,-14873,0,0,0,100,14973,-14873,".","15",0,14970
"15216",199999,"WINSTON-SALEM STATE UNIVERSITY                              ","2003-2004",33,"Bowling",1000,15889,-14889,0,0,0,1000,15889,-14889,".","7",0,9120
"535",131469,"GEORGE WASHINGTON UNIVERSITY                                ","2003-2004",1,"Baseball",646675,661571,-14896,646675,661571,-14896,0,0,0,"27",".",164228,0
"10535",236230,"PACIFIC LUTHERAN UNIVERSITY                                 ","2003-2004",19,"Swimming",13800,28702,-14902,6900,14351,-7451,6900,14351,-7451,"12","19",6900,6900
"8166",214157,"MORAVIAN COLLEGE AND THEOLOGICAL SEMINARY                   ","2003-2004",15,"Soccer",82804,97712,-14908,36857,42984,-6127,45947,54728,-8781,"21","22",18300,19732
"12655",161244,"UNIVERSITY OF MAINE AT MACHIAS                              ","2003-2004",25,"Track and Field, X-Country",8169,23086,-14917,3431,10924,-7493,4738,12162,-7424,"5","7",3249,4487
"2858",208406,"CLACKAMAS COMMUNITY COLLEGE                                 ","2003-2004",2,"Basketball",4824,19766,-14942,3319,11600,-8281,1505,8166,-6661,"12","9",8989,7868
"9995",192448,"LONG ISLAND UNIVERSITY-C W POST CAMPUS                      ","2003-2004",16,"Softball",223968,238935,-14967,0,0,0,223968,238935,-14967,".","20",0,56453
"808",219134,"SI TANKA UNIVERSITY-HURON CAMPUS                            ","2003-2004",1,"Baseball",41125,56125,-15000,41125,56125,-15000,0,0,0,"24",".",41125,0
"4922",194824,"RENSSELAER POLYTECHNIC INSTITUTE                            ","2003-2004",7,"Football",184560,199560,-15000,184560,199560,-15000,0,0,0,"88",".",33545,0
"7027",164580,"BABSON COLLEGE                                              ","2003-2004",14,"Skiing",10868,25868,-15000,5434,12934,-7500,5434,12934,-7500,"8","5",5434,5434
"9657",238476,"CARTHAGE COLLEGE                                            ","2003-2004",16,"Softball",64909,79909,-15000,0,0,0,64909,79909,-15000,".","20",0,17000
"10705",147013,"MCKENDREE COLLEGE                                           ","2003-2004",22,"Tennis",84895,99895,-15000,45008,52508,-7500,39887,47387,-7500,"8","9",6473,6344
"11298",213303,"KEYSTONE COLLEGE                                            ","2003-2004",22,"Tennis",7269,22269,-15000,3634,11134,-7500,3635,11135,-7500,"7","5",3634,3635
"13925",198039,"BLUE RIDGE COMMUNITY COLLEGE                                ","2003-2004",26,"Volleyball",5000,20000,-15000,0,0,0,5000,20000,-15000,".","12",0,15000
"15107",150048,"ANCILLA COLLEGE                                             ","2003-2004",29,"Other Sports",1000,16000,-15000,0,0,0,1000,16000,-15000,".","5",0,11000
"15348",219134,"SI TANKA UNIVERSITY-HURON CAMPUS                            ","2003-2004",35,"Rodeo",49514,64514,-15000,24757,32257,-7500,24757,32257,-7500,"23","13",24757,24757
"16362",181765,"NEBRASKA COLLEGE OF TECHNICAL AGRICULTURE                   ","2003-2004",39,"Total Participants",9700,24700,-15000,3800,10500,-6700,5900,14200,-8300,"39","20",13400,8700
"2499",109907,"BARSTOW COLLEGE                                             ","2003-2004",2,"Basketball",31920,46928,-15008,15960,23859,-7899,15960,23069,-7109,"13","13",16226,14956
"14963",174783,"SAINT CLOUD STATE UNIVERSITY                                ","2003-2004",28,"Wrestling",51457,66467,-15010,51457,66467,-15010,0,0,0,"21",".",16506,0
"1337",210401,"WILLAMETTE UNIVERSITY                                       ","2003-2004",1,"Baseball",95244,110278,-15034,95244,110278,-15034,0,0,0,"26",".",66453,0
"13868",155627,"OTTAWA UNIVERSITY                                           ","2003-2004",26,"Volleyball",16618,31657,-15039,0,0,0,16618,31657,-15039,".","13",0,14238
"310",152266,"PURDUE UNIVERSITY-NORTH CENTRAL CAMPUS                      ","2003-2004",1,"Baseball",45691,60736,-15045,45691,60736,-15045,0,0,0,"25",".",42846,0
"11278",164465,"AMHERST COLLEGE                                             ","2003-2004",22,"Tennis",96510,111560,-15050,52422,59779,-7357,44088,51781,-7693,"13","11",7594,7076
"5576",151111,"INDIANA UNIVERSITY-PURDUE UNIVERSITY-INDIANAPOLIS           ","2003-2004",8,"Golf",2444,17497,-15053,1222,13350,-12128,1222,4147,-2925,"14","14",850,1306
"14574",236328,"UNIVERSITY OF PUGET SOUND                                   ","2003-2004",26,"Volleyball",9722,24800,-15078,0,0,0,9722,24800,-15078,".","15",0,23527
"15307",155104,"GARDEN CITY COMMUNITY COLLEGE                               ","2003-2004",35,"Rodeo",31780,46866,-15086,15890,28685,-12795,15890,18181,-2291,"24","12",19368,9540
"11786",154749,"BETHEL COLLEGE                                              ","2003-2004",22,"Tennis",10400,25490,-15090,5505,11553,-6048,4895,13937,-9042,"6","6",3657,2397
"12332",203128,"HIRAM COLLEGE                                               ","2003-2004",25,"Track and Field, X-Country",67800,82900,-15100,33900,41450,-7550,33900,41450,-7550,"20","25",12980,12980
"3122",110653,"UNIVERSITY OF CALIFORNIA-IRVINE                             ","2003-2004",2,"Basketball",1969823,1984930,-15107,1256364,1272136,-15772,713459,712794,665,"14","12",223881,116783
"2889",133711,"FLAGLER COLLEGE                                             ","2003-2004",2,"Basketball",138425,153550,-15125,78360,86977,-8617,60065,66573,-6508,"14","11",28667,19508
"2737",191986,"JAMESTOWN COMMUNITY COLLEGE                                 ","2003-2004",2,"Basketball",59264,74390,-15126,24551,33786,-9235,34713,40604,-5891,"19","20",17228,23270
"348",231059,"SAINT MICHAELS COLLEGE                                      ","2003-2004",1,"Baseball",63999,79151,-15152,63999,79151,-15152,0,0,0,"24",".",35755,0
"10627",213613,"LOCK HAVEN UNIVERSITY OF PENNSYLVANIA                       ","2003-2004",19,"Swimming",115707,130887,-15180,0,0,0,115707,130887,-15180,".","10",0,23041
"8699",207670,"ROSE STATE COLLEGE                                          ","2003-2004",16,"Softball",11867,27167,-15300,0,0,0,11867,27167,-15300,".","24",0,15970
"16732",229063,"TEXAS SOUTHERN UNIVERSITY                                   ","2003-2004",39,"Total Participants",1857147,1872484,-15337,501835,513950,-12115,1355312,1358534,-3222,"177","111",1096614,709635
"3642",131520,"HOWARD UNIVERSITY                                           ","2003-2004",3,"All Track Combined",720980,736324,-15344,310601,313659,-3058,410379,422665,-12286,"73","76",51195,51195
"11235",122205,"SADDLEBACK COLLEGE                                          ","2003-2004",22,"Tennis",12629,28000,-15371,5653,13000,-7347,6976,15000,-8024,"7","7",4228,3997
"4851",212577,"FRANKLIN AND MARSHALL COLLEGE                               ","2003-2004",7,"Football",296560,311936,-15376,296560,311936,-15376,0,0,0,"96",".",85182,0
"13649",228149,"ST MARYS UNIVERSITY                                         ","2003-2004",26,"Volleyball",42450,57838,-15388,0,0,0,42450,57838,-15388,".","13",0,42253
"14804",144962,"ELMHURST COLLEGE                                            ","2003-2004",28,"Wrestling",25335,40739,-15404,25335,40739,-15404,0,0,0,"26",".",10739,0
"3368",144351,"CONCORDIA UNIVERSITY                                        ","2003-2004",2,"Basketball",24404,39830,-15426,13253,21540,-8287,11151,18290,-7139,"10","14",6790,6679
"12825",212577,"FRANKLIN AND MARSHALL COLLEGE                               ","2003-2004",25,"Track and Field, X-Country",105736,121169,-15433,52903,60574,-7671,52833,60595,-7762,"79","64",29530,29350
"118",168254,"WESTERN NEW ENGLAND COLLEGE                                 ","2003-2004",1,"Baseball",27097,42538,-15441,27097,42538,-15441,0,0,0,"26",".",16120,0
"33",100724,"ALABAMA STATE UNIVERSITY                                    ","2003-2004",1,"Baseball",136998,152444,-15446,136998,152444,-15446,0,0,0,"27",".",108271,0
"6724",232089,"FERRUM COLLEGE                                              ","2003-2004",11,"Lacrosse",15300,30757,-15457,0,0,0,15300,30757,-15457,".","13",0,11957
"7171",202763,"THE UNIVERSITY OF FINDLAY                                   ","2003-2004",15,"Soccer",148825,164283,-15458,50432,87170,-36738,98393,77113,21280,"38","18",12179,13238
"8236",224323,"UNIVERSITY OF DALLAS                                        ","2003-2004",15,"Soccer",106645,122107,-15462,29784,57728,-27944,76861,64379,12482,"17","24",22393,26374
"8925",176071,"MISSISSIPPI GULF COAST COMMUNITY COLLEGE                    ","2003-2004",16,"Softball",1,15481,-15480,0,0,0,1,15481,-15480,".","17",0,8338
"2814",117894,"LOS MEDANOS COLLEGE                                         ","2003-2004",2,"Basketball",13408,28899,-15491,7823,15569,-7746,5585,13330,-7745,"15","7",7824,5585
"1271",195058,"ROCKLAND COMMUNITY COLLEGE                                  ","2003-2004",1,"Baseball",500,16000,-15500,500,16000,-15500,0,0,0,"25",".",250,0
"7707",156286,"BELLARMINE UNIVERSITY                                       ","2003-2004",15,"Soccer",263892,279420,-15528,129961,131469,-1508,133931,147951,-14020,"28","26",15082,16224
"14214",123457,"SIMPSON COLLEGE                                             ","2003-2004",26,"Volleyball",6163,21693,-15530,0,0,0,6163,21693,-15530,"0","9",0,15667
"9831",143279,"BLACK HAWK COLLEGE                                          ","2003-2004",16,"Softball",22034,37580,-15546,0,0,0,22034,37580,-15546,".","13",0,15546
"14561",119137,"MOORPARK COLLEGE                                            ","2003-2004",26,"Volleyball",10982,26535,-15553,4389,8750,-4361,6593,17785,-11192,"12","14",4389,6593
"11043",216667,"WASHINGTON &amp; JEFFERSON COLLEGE                              ","2003-2004",22,"Tennis",11000,26556,-15556,5500,13038,-7538,5500,13518,-8018,"8","10",3338,3818
"5287",172334,"SPRING ARBOR UNIVERSITY                                     ","2003-2004",8,"Golf",10325,25882,-15557,10325,25882,-15557,0,0,0,"8","0",10325,0
"2416",164207,"WASHINGTON BIBLE COLLEGE-CAPITAL BIBLE SEMINARY             ","2003-2004",2,"Basketball",630,16196,-15566,315,8520,-8205,315,7676,-7361,"8","8",6060,5216
"10926",237367,"FAIRMONT STATE COLLEGE                                      ","2003-2004",22,"Tennis",7500,23080,-15580,4000,12585,-8585,3500,10495,-6995,"7","10",5592,4287
"7246",118347,"COLLEGE OF MARIN                                            ","2003-2004",15,"Soccer",200,15793,-15593,100,8766,-8666,100,7027,-6927,"17","18",7886,6147
"10114",120290,"OHLONE COLLEGE                                              ","2003-2004",18,"Swimming and Diving",7086,22682,-15596,3543,11341,-7798,3543,11341,-7798,"8","8",3212,3212
"13579",190512,"CUNY BERNARD M BARUCH COLLEGE                               ","2003-2004",26,"Volleyball",27000,42600,-15600,8500,17500,-9000,18500,25100,-6600,"10","12",12500,18100
"5387",129020,"UNIVERSITY OF CONNECTICUT                                   ","2003-2004",8,"Golf",126057,141658,-15601,126057,141658,-15601,0,0,0,"10",".",74890,0
"2714",127778,"OTERO JUNIOR COLLEGE                                        ","2003-2004",2,"Basketball",86884,102492,-15608,44002,50966,-6964,42882,51526,-8644,"22","19",13324,13884
"7961",164173,"VILLA JULIE COLLEGE                                         ","2003-2004",15,"Soccer",33350,48961,-15611,16698,23794,-7096,16652,25167,-8515,"23","20",13787,13995
"7546",161554,"UNIVERSITY OF SOUTHERN MAINE                                ","2003-2004",15,"Soccer",68656,84291,-15635,19961,33992,-14031,48695,50299,-1604,"24","22",20781,18651
"13986",120971,"PALOMAR COLLEGE                                             ","2003-2004",26,"Volleyball",5342,20982,-15640,1263,10632,-9369,4079,10350,-6271,"10","13",5601,5128
"9415",211088,"ARCADIA UNIVERSITY                                          ","2003-2004",16,"Softball",6215,21863,-15648,0,0,0,6215,21863,-15648,".","21",0,6215
"2585",150066,"ANDERSON UNIVERSITY                                         ","2003-2004",2,"Basketball",158970,174621,-15651,112165,117228,-5063,46805,57393,-10588,"23","14",47463,30123
"12909",127741,"UNIVERSITY OF NORTHERN COLORADO                             ","2003-2004",25,"Track and Field, X-Country",11298,26959,-15661,0,0,0,11298,26959,-15661,".","16",0,5828
"8320",177065,"COLUMBIA COLLEGE                                            ","2003-2004",15,"Soccer",1519,17190,-15671,1519,17190,-15671,0,0,0,"21",".",13865,0
"6824",191612,"HERKIMER COUNTY COMMUNITY COLLEGE                           ","2003-2004",11,"Lacrosse",25890,41565,-15675,17750,24135,-6385,8140,17430,-9290,"33","26",17750,8140
"9870",219718,"BETHEL COLLEGE                                              ","2003-2004",16,"Softball",47539,63226,-15687,0,0,0,47539,63226,-15687,".","21",0,37556
"14742",230047,"BRIGHAM YOUNG UNIVERSITY-HAWAII CAMPUS                      ","2003-2004",27,"Water Polo",46600,62292,-15692,46600,62292,-15692,0,0,0,"17",".",46600,0
"11663",179894,"WEBSTER UNIVERSITY                                          ","2003-2004",22,"Tennis",675,16382,-15707,250,5525,-5275,425,10857,-10432,"8","9",1350,5334
"5108",237385,"GLENVILLE STATE COLLEGE                                     ","2003-2004",8,"Golf",22434,38143,-15709,18276,31759,-13483,4158,6384,-2226,"7","2",12932,2142
"3554",237330,"CONCORD COLLEGE                                             ","2003-2004",3,"All Track Combined",66452,82192,-15740,32162,44784,-12622,34290,37408,-3118,"27","17",8056,8056
"12453",218229,"LANDER UNIVERSITY                                           ","2003-2004",25,"Track and Field, X-Country",10393,26142,-15749,0,0,0,10393,26142,-15749,".","8",0,2943
"11089",225247,"HARDIN-SIMMONS UNIVERSITY                                   ","2003-2004",22,"Tennis",8234,24000,-15766,4000,12000,-8000,4234,12000,-7766,"8","7",10555,10155
"12286",131283,"CATHOLIC UNIVERSITY OF AMERICA                              ","2003-2004",25,"Track and Field, X-Country",2,15800,-15798,1,6200,-6199,1,9600,-9599,"8","15",4500,4500
"16419",153320,"FAITH BAPTIST BIBLE COLLEGE AND THEOLOGICAL SEM             ","2003-2004",39,"Total Participants",12325,28130,-15805,6250,9945,-3695,6075,18185,-12110,"29","41",18645,25435
"8044",191986,"JAMESTOWN COMMUNITY COLLEGE                                 ","2003-2004",15,"Soccer",14311,30136,-15825,8360,17398,-9038,5951,12738,-6787,"20","19",10327,3657
"765",118347,"COLLEGE OF MARIN                                            ","2003-2004",1,"Baseball",100,15943,-15843,100,15943,-15843,0,0,0,"23",".",15063,0
"1062",149514,"TRINITY INTERNATIONAL UNIVERSITY                            ","2003-2004",1,"Baseball",299533,315377,-15844,299533,315377,-15844,0,0,0,"26",".",45399,0
"16284",133979,"FLORIDA MEMORIAL COLLEGE                                    ","2003-2004",39,"Total Participants",218770,234620,-15850,98870,103670,-4800,119900,130950,-11050,"42","27",58550,49950
"10098",196051,"MORRISVILLE STATE COLLEGE                                   ","2003-2004",18,"Swimming and Diving",6968,22830,-15862,3484,11415,-7931,3484,11415,-7931,"5","7",7931,7931
"14314",167251,"NEWBURY COLLEGE-BROOKLINE                                   ","2003-2004",26,"Volleyball",5520,21393,-15873,2340,9459,-7119,3180,11934,-8754,"10","11",5503,4179
"10030",123484,"COLLEGE OF THE SISKIYOUS                                    ","2003-2004",16,"Softball",19837,35747,-15910,0,0,0,19837,35747,-15910,".","10",0,19380
"7540",118684,"MENDOCINO COLLEGE                                           ","2003-2004",15,"Soccer",2465,18398,-15933,0,0,0,2465,18398,-15933,".","20",0,16640
"8543",239628,"RIPON COLLEGE                                               ","2003-2004",16,"Softball",24952,40887,-15935,0,0,0,24952,40887,-15935,".","19",0,24952
"5445",199306,"PFEIFFER UNIVERSITY                                         ","2003-2004",8,"Golf",59560,75499,-15939,58285,67275,-8990,1275,8224,-6949,"19","7",67091,7950
"10235",204501,"OBERLIN COLLEGE                                             ","2003-2004",18,"Swimming and Diving",103090,119044,-15954,54651,57788,-3137,48439,61256,-12817,"12","18",10745,15462
"14219",194310,"PACE UNIVERSITY-NEW YORK                                    ","2003-2004",26,"Volleyball",113911,129906,-15995,0,0,0,113911,129906,-15995,".","11",0,23000
"575",132471,"BARRY UNIVERSITY                                            ","2003-2004",1,"Baseball",108021,124021,-16000,108021,124021,-16000,0,0,0,"31",".",66921,0
"2518",132471,"BARRY UNIVERSITY                                            ","2003-2004",2,"Basketball",187863,203863,-16000,95298,105665,-10367,92565,98198,-5633,"13","13",51565,49198
"7009",132471,"BARRY UNIVERSITY                                            ","2003-2004",13,"Rowing",82408,98408,-16000,0,0,0,82408,98408,-16000,".","45",0,43908
"17273",210146,"SOUTHERN OREGON UNIVERSITY                                  ","2003-2004",39,"Total Participants",266456,282456,-16000,84596,89596,-5000,181860,192860,-11000,"193","96",264560,183956
"16077",199962,"WINGATE UNIVERSITY                                          ","2003-2004",39,"Total Participants",286320,302321,-16001,158741,167285,-8544,127579,135036,-7457,"249","116",264821,136200
"1206",207670,"ROSE STATE COLLEGE                                          ","2003-2004",1,"Baseball",12647,28649,-16002,12647,28649,-16002,0,0,0,"24",".",16672,0
"14475",153366,"GRACELAND UNIVERSITY-LAMONI                                 ","2003-2004",26,"Volleyball",248609,264618,-16009,101639,109124,-7485,146970,155494,-8524,"27","37",33305,31546
"8924",132471,"BARRY UNIVERSITY                                            ","2003-2004",16,"Softball",108903,124930,-16027,0,0,0,108903,124930,-16027,".","17",0,70930
"1547",208406,"CLACKAMAS COMMUNITY COLLEGE                                 ","2003-2004",1,"Baseball",5441,21488,-16047,5441,21488,-16047,0,0,0,"25",".",9659,0
"14692",123341,"SIERRA COLLEGE                                              ","2003-2004",27,"Water Polo",4404,20451,-16047,0,0,0,4404,20451,-16047,".","18",0,14490
"5122",118693,"MENLO COLLEGE                                               ","2003-2004",8,"Golf",1000,17061,-16061,1000,17061,-16061,0,0,0,"10",".",6350,0
"13228",216764,"WEST CHESTER UNIVERSITY OF PENNSYLVANIA                     ","2003-2004",26,"Volleyball",23450,39511,-16061,0,0,0,23450,39511,-16061,".","11",0,18023
"6066",200059,"DICKINSON STATE UNIVERSITY                                  ","2003-2004",8,"Golf",9244,25307,-16063,4622,11373,-6751,4622,13934,-9312,"11","8",3733,3733
"5857",196024,"SUNY COLLEGE OF TECHNOLOGY AT DELHI                         ","2003-2004",8,"Golf",11600,27698,-16098,6600,19862,-13262,5000,7836,-2836,"7","6",16862,2836
"16128",201371,"BLUFFTON COLLEGE                                            ","2003-2004",39,"Total Participants",314317,330425,-16108,135894,145168,-9274,178423,185257,-6834,"223","122",105304,78501
"16742",202514,"DEFIANCE COLLEGE                                            ","2003-2004",39,"Total Participants",363730,379849,-16119,154540,163658,-9118,209190,216191,-7001,"210","95",168182,124953
"8017",196699,"SUNY ULSTER COUNTY COMMUNITY COLLEGE                        ","2003-2004",15,"Soccer",4000,20150,-16150,4000,20150,-16150,0,0,0,"22",".",9150,0
"11650",196149,"SUNY COLLEGE AT CORTLAND                                    ","2003-2004",22,"Tennis",6308,22487,-16179,0,0,0,6308,22487,-16179,".","16",0,11892
"1599",190567,"CUNY CITY COLLEGE                                           ","2003-2004",2,"Basketball",27235,43425,-16190,13620,21022,-7402,13615,22403,-8788,"15","10",15022,16386
"2669",235149,"EVERETT COMMUNITY COLLEGE                                   ","2003-2004",2,"Basketball",8400,24600,-16200,4600,12400,-7800,3800,12200,-8400,"14","11",1200,2000
"6527",194824,"RENSSELAER POLYTECHNIC INSTITUTE                            ","2003-2004",10,"Ice Hockey",406373,422573,-16200,311122,323222,-12100,95251,99351,-4100,"27","27",107989,37651
"11689",152336,"UNIVERSITY OF SAINT FRANCIS-FT WAYNE                        ","2003-2004",22,"Tennis",7900,24110,-16210,0,0,0,7900,24110,-16210,".","10",0,7387
"5714",206330,"URBANA UNIVERSITY                                           ","2003-2004",8,"Golf",9392,25603,-16211,9392,25603,-16211,0,0,0,"8",".",23433,0
"7633",100663,"UNIVERSITY OF ALABAMA AT BIRMINGHAM                         ","2003-2004",15,"Soccer",926345,942579,-16234,521652,521662,-10,404693,420917,-16224,"25","22",96417,71620
"1154",173805,"ITASCA COMMUNITY COLLEGE                                    ","2003-2004",1,"Baseball",10763,27000,-16237,10763,27000,-16237,0,0,0,"23",".",4101,0
"6173",102094,"UNIVERSITY OF SOUTH ALABAMA                                 ","2003-2004",8,"Golf",304427,320687,-16260,151877,168281,-16404,152550,152406,144,"9","8",24321,20265
"14395",196167,"SUNY COLLEGE AT GENESEO                                     ","2003-2004",26,"Volleyball",25641,41911,-16270,0,0,0,25641,41911,-16270,".","13",0,22833
"6394",196167,"SUNY COLLEGE AT GENESEO                                     ","2003-2004",10,"Ice Hockey",72033,88313,-16280,72033,88313,-16280,0,0,0,"26",".",47185,0
"10962",201654,"CEDARVILLE UNIVERSITY                                       ","2003-2004",22,"Tennis",108734,125018,-16284,43243,49201,-5958,65491,75817,-10326,"9","11",13394,19346
"2844",233541,"SHENANDOAH UNIVERSITY                                       ","2003-2004",2,"Basketball",152318,168612,-16294,69651,75385,-5734,82667,93227,-10560,"16","11",41869,49549
"7972",238661,"EDGEWOOD COLLEGE                                            ","2003-2004",15,"Soccer",69576,85876,-16300,34785,42938,-8153,34791,42938,-8147,"21","20",17412,17412
"14396",225627,"UNIVERSITY OF THE INCARNATE WORD                            ","2003-2004",26,"Volleyball",222048,238363,-16315,0,0,0,222048,238363,-16315,".","11",0,20689
"6221",206835,"OKLAHOMA WESLEYAN UNIVERSITY                                ","2003-2004",8,"Golf",13705,30038,-16333,13705,30038,-16333,0,0,0,"8",".",7288,0
"5660",207865,"SOUTHWESTERN OKLAHOMA STATE UNIVERSITY                      ","2003-2004",8,"Golf",21000,37334,-16334,10500,20721,-10221,10500,16613,-6113,"17","8",10500,10500
"4089",213613,"LOCK HAVEN UNIVERSITY OF PENNSYLVANIA                       ","2003-2004",6,"Field hocky",314674,331030,-16356,0,0,0,314674,331030,-16356,".","30",0,36024
"5776",194958,"ROBERTS WESLEYAN COLLEGE                                    ","2003-2004",8,"Golf",23708,40089,-16381,23708,40089,-16381,0,0,0,"9",".",12062,0
"7869",157401,"MURRAY STATE UNIVERSITY                                     ","2003-2004",15,"Soccer",256335,272724,-16389,0,0,0,256335,272724,-16389,".","30",0,40588
"10957",153108,"CENTRAL COLLEGE                                             ","2003-2004",22,"Tennis",17897,34307,-16410,7507,16062,-8555,10390,18245,-7855,"10","16",7175,9358
"5416",154527,"WARTBURG COLLEGE                                            ","2003-2004",8,"Golf",25097,41531,-16434,13477,21832,-8355,11620,19699,-8079,"16","17",12555,10422
"4816",144865,"COLLEGE OF DUPAGE                                           ","2003-2004",7,"Football",66263,82700,-16437,66263,82700,-16437,0,0,0,"59",".",53000,0
"3109",190716,"D'YOUVILLE COLLEGE                                          ","2003-2004",2,"Basketball",30250,46696,-16446,16125,24636,-8511,14125,22060,-7935,"13","11",16136,13560
"1107",181330,"MIDLAND LUTHERAN COLLEGE                                    ","2003-2004",1,"Baseball",26693,43162,-16469,26693,43162,-16469,0,0,0,"31",".",26693,0
"13691",186371,"RUTGERS UNIVERSITY-CAMDEN                                   ","2003-2004",26,"Volleyball",0,16469,-16469,0,0,0,0,16469,-16469,".","10",0,8469
"2123",183822,"BLOOMFIELD COLLEGE                                          ","2003-2004",2,"Basketball",27400,43881,-16481,13700,24771,-11071,13700,19110,-5410,"13","12",13700,13700
"12936",172200,"SCHOOLCRAFT COLLEGE                                         ","2003-2004",25,"Track and Field, X-Country",26843,43336,-16493,0,0,0,26843,43336,-16493,".","7",0,13012
"8081",139968,"GORDON COLLEGE                                              ","2003-2004",15,"Soccer",57586,74081,-16495,29404,44817,-15413,28182,29264,-1082,"28","27",19800,19800
"8772",183859,"BROOKDALE COMMUNITY COLLEGE                                 ","2003-2004",16,"Softball",13000,29500,-16500,0,0,0,13000,29500,-16500,".","18",0,22070
"14070",233897,"THE UNIVERSITY OF VIRGINIA'S COLLEGE AT WISE                ","2003-2004",26,"Volleyball",29226,45735,-16509,0,0,0,29226,45735,-16509,".","9",0,20608
"529",240480,"UNIVERSITY OF WISCONSIN-STEVENS POINT                       ","2003-2004",1,"Baseball",26638,43149,-16511,26638,43149,-16511,0,0,0,"30",".",18342,0
"6269",232089,"FERRUM COLLEGE                                              ","2003-2004",8,"Golf",4250,20832,-16582,4250,20832,-16582,0,0,0,"13",".",17832,0
"7189",112075,"CONCORDIA UNIVERSITY                                        ","2003-2004",15,"Soccer",73906,90492,-16586,36953,45246,-8293,36953,45246,-8293,"20","19",15061,15061
"8398",236230,"PACIFIC LUTHERAN UNIVERSITY                                 ","2003-2004",15,"Soccer",26400,43000,-16600,13200,19000,-5800,13200,24000,-10800,"26","18",13200,13200
"12204",160612,"SOUTHEASTERN LOUISIANA UNIVERSITY                           ","2003-2004",25,"Track and Field, X-Country",1936,18570,-16634,1062,7493,-6431,874,11077,-10203,"5","5",1705,1705
"8192",219833,"CHRISTIAN BROTHERS UNIVERSITY                               ","2003-2004",15,"Soccer",68576,85222,-16646,33551,39736,-6185,35025,45486,-10461,"22","20",31480,37230
"7157",211158,"BLOOMSBURG UNIVERSITY OF PENNSYLVANIA                       ","2003-2004",15,"Soccer",182381,199028,-16647,85563,88259,-2696,96818,110769,-13951,"25","29",17593,15412
"12882",155627,"OTTAWA UNIVERSITY                                           ","2003-2004",25,"Track and Field, X-Country",38002,54650,-16648,19001,27325,-8324,19001,27325,-8324,"26","24",18060,18060
"14726",214591,"PENNSYLVANIA STATE UNIV-PENN ST ERIE-BEHREND COLL           ","2003-2004",27,"Water Polo",32717,49368,-16651,18033,24684,-6651,14684,24684,-10000,"14","14",13732,13732
"10253",173920,"MINNESOTA STATE UNVERSITY-MANKATO                           ","2003-2004",18,"Swimming and Diving",119007,135677,-16670,62115,54583,7532,56892,81094,-24202,"14","26",27798,31901
"2548",162168,"CHESAPEAKE COLLEGE                                          ","2003-2004",2,"Basketball",8869,25540,-16671,8869,25540,-16671,0,0,0,"9",".",13749,0
"6833",216287,"SWARTHMORE COLLEGE                                          ","2003-2004",11,"Lacrosse",26690,43380,-16690,14185,25942,-11757,12505,17438,-4933,"29","24",24530,16536
"5350",190761,"DOMINICAN COLLEGE OF BLAUVELT                               ","2003-2004",8,"Golf",3100,19806,-16706,3100,19806,-16706,0,0,0,"6",".",6806,0
"13719",162928,"JOHNS HOPKINS UNIVERSITY                                    ","2003-2004",26,"Volleyball",33091,49822,-16731,0,0,0,33091,49822,-16731,".","12",0,25357
"9208",163338,"UNIVERSITY OF MARYLAND-EASTERN SHORE                        ","2003-2004",16,"Softball",98689,115422,-16733,0,0,0,98689,115422,-16733,".","14",0,30986
"14178",215275,"UNIVERSITY OF PITTSBURGH-GREENSBURG                         ","2003-2004",26,"Volleyball",214,16948,-16734,0,0,0,214,16948,-16734,".","8",0,7832
"1372",190415,"CORNELL UNIVERSITY-ENDOWED COLLEGES                         ","2003-2004",1,"Baseball",182519,199259,-16740,182519,199259,-16740,0,0,0,"27",".",76579,0
"11349",196246,"SUNY COLLEGE AT PLATTSBURGH                                 ","2003-2004",22,"Tennis",3498,20240,-16742,0,0,0,3498,20240,-16742,".","9",0,11856
"962",164216,"WASHINGTON COLLEGE                                          ","2003-2004",1,"Baseball",25040,41797,-16757,25040,41797,-16757,0,0,0,"26",".",20213,0
"5191",206589,"COLLEGE OF WOOSTER                                          ","2003-2004",8,"Golf",180,16944,-16764,180,16944,-16764,0,0,0,"9",".",10359,0
"12497",196194,"SUNY COLLEGE AT OSWEGO                                      ","2003-2004",25,"Track and Field, X-Country",73354,90118,-16764,36627,43498,-6871,36727,46620,-9893,"54","29",26744,29866
"11578",162007,"BOWIE STATE UNIVERSITY                                      ","2003-2004",22,"Tennis",4979,21760,-16781,0,0,0,4979,21760,-16781,"0","7",0,7834
"14198",155450,"LABETTE COMMUNITY COLLEGE                                   ","2003-2004",26,"Volleyball",1253,18068,-16815,0,0,0,1253,18068,-16815,"0","10",0,6830
"5599",156286,"BELLARMINE UNIVERSITY                                       ","2003-2004",8,"Golf",98986,115808,-16822,61722,69470,-7748,37264,46338,-9074,"14","7",13348,11791
"5310",171571,"OAKLAND UNIVERSITY                                          ","2003-2004",8,"Golf",112266,129139,-16873,59016,67638,-8622,53250,61501,-8251,"11","11",23783,16030
"3444",195562,"SAINT JOSEPHS COLLEGE-SUFFOLK CAMPUS                        ","2003-2004",2,"Basketball",67716,84594,-16878,31290,39908,-8618,36426,44686,-8260,"13","13",25337,25948
"12803",207351,"OKLAHOMA PANHANDLE STATE UNIVERSITY                         ","2003-2004",25,"Track and Field, X-Country",8060,24954,-16894,4030,6111,-2081,4030,18843,-14813,"8","9",4366,4366
"8551",133881,"FLORIDA INSTITUTE OF TECHNOLOGY-MELBOURNE                   ","2003-2004",16,"Softball",218334,235235,-16901,0,0,0,218334,235235,-16901,".","20",0,20664
"1496",236708,"SPOKANE FALLS COMMUNITY COLLEGE                             ","2003-2004",1,"Baseball",58655,75558,-16903,58655,75558,-16903,0,0,0,"24",".",65118,0
"10302",240480,"UNIVERSITY OF WISCONSIN-STEVENS POINT                       ","2003-2004",18,"Swimming and Diving",47748,64663,-16915,24186,32576,-8390,23562,32087,-8525,"30","47",15032,14879
"8764",185129,"NEW JERSEY CITY UNIVERSITY                                  ","2003-2004",16,"Softball",15000,31946,-16946,0,0,0,15000,31946,-16946,".","12",0,3375
"8172",176938,"CENTRAL BIBLE COLLEGE                                       ","2003-2004",15,"Soccer",50,17000,-16950,50,17000,-16950,0,0,0,"16",".",14000,0
"15645",133711,"FLAGLER COLLEGE                                             ","2003-2004",39,"Total Participants",378074,395029,-16955,196820,209414,-12594,181254,185615,-4361,"102","70",104261,71619
"3727",219134,"SI TANKA UNIVERSITY-HURON CAMPUS                            ","2003-2004",3,"All Track Combined",21798,38756,-16958,10899,19378,-8479,10899,19378,-8479,"7","4",10899,10899
"12479",198969,"METHODIST COLLEGE                                           ","2003-2004",25,"Track and Field, X-Country",20,16984,-16964,10,9128,-9118,10,7856,-7846,"12","8",3818,2546
"11113",216357,"THIEL COLLEGE                                               ","2003-2004",22,"Tennis",3371,20336,-16965,1644,10945,-9301,1727,9391,-7664,"13","9",1581,1608
"4341",118347,"COLLEGE OF MARIN                                            ","2003-2004",7,"Football",1170,18137,-16967,1170,18137,-16967,0,0,0,"53",".",17257,0
"5937",409698,"CALIFORNIA STATE UNIVERSITY-MONTEREY BAY                    ","2003-2004",8,"Golf",69706,86701,-16995,37986,46447,-8461,31720,40254,-8534,"15","13",21409,17447
"1761",194392,"PAUL SMITHS COLLEGE OF ARTS AND SCIENCE                     ","2003-2004",2,"Basketball",25000,42000,-17000,12500,21000,-8500,12500,21000,-8500,"13","10",18000,18000
"9099",150048,"ANCILLA COLLEGE                                             ","2003-2004",16,"Softball",15000,32000,-17000,0,0,0,15000,32000,-17000,".","20",0,24000
"12798",196006,"SUNY COLLEGE OF TECHNOLOGY AT ALFRED                        ","2003-2004",25,"Track and Field, X-Country",8396,25410,-17014,4198,15246,-11048,4198,10164,-5966,"9","6",3240,2160
"8186",212601,"GANNON UNIVERSITY                                           ","2003-2004",15,"Soccer",368291,385311,-17020,205480,215749,-10269,162811,169562,-6751,"24","18",22311,19336
"10893",110334,"CABRILLO COLLEGE                                            ","2003-2004",22,"Tennis",5380,22406,-17026,2135,11422,-9287,3245,10984,-7739,"8","8",2490,2570
"2983",165529,"CURRY COLLEGE                                               ","2003-2004",2,"Basketball",38834,55867,-17033,22690,29789,-7099,16144,26078,-9934,"15","10",17776,14065
"12506",164580,"BABSON COLLEGE                                              ","2003-2004",25,"Track and Field, X-Country",11492,28532,-17040,5766,14266,-8500,5726,14266,-8540,"28","20",5766,5726
"1664",182661,"DANIEL WEBSTER COLLEGE                                      ","2003-2004",2,"Basketball",20709,37755,-17046,14955,14001,954,5754,23754,-18000,"9","7",13791,5754
"11117",110680,"UNIVERSITY OF CALIFORNIA-SAN DIEGO                          ","2003-2004",22,"Tennis",186517,203565,-17048,134362,124458,9904,52155,79107,-26952,"12","17",27566,29903
"14729",123800,"SOUTHWESTERN COLLEGE                                        ","2003-2004",27,"Water Polo",21388,38454,-17066,5553,16966,-11413,15835,21488,-5653,"13","15",5500,8322
"8589",209250,"MT HOOD COMMUNITY COLLEGE                                   ","2003-2004",16,"Softball",4864,21934,-17070,0,0,0,4864,21934,-17070,".","16",0,20764
"16508",164207,"WASHINGTON BIBLE COLLEGE-CAPITAL BIBLE SEMINARY             ","2003-2004",39,"Total Participants",3,17076,-17073,1,6358,-6357,2,10718,-10716,"20","27",10848,13499
"9136",187897,"NEW MEXICO HIGHLANDS UNIVERSITY                             ","2003-2004",16,"Softball",98232,115310,-17078,0,0,0,98232,115310,-17078,".","22",0,25965
"14393",196194,"SUNY COLLEGE AT OSWEGO                                      ","2003-2004",26,"Volleyball",33459,50549,-17090,0,0,0,33459,50549,-17090,"0","14",0,20839
"17135",141574,"UNIVERSITY OF HAWAII AT MANOA                               ","2003-2004",39,"Total Participants",5764145,5781239,-17094,2199600,2204328,-4728,3564545,3576911,-12366,"249","304",2784868,2131244
"14877",161554,"UNIVERSITY OF SOUTHERN MAINE                                ","2003-2004",28,"Wrestling",11800,28905,-17105,11800,28905,-17105,0,0,0,"20",".",20605,0
"12546",238661,"EDGEWOOD COLLEGE                                            ","2003-2004",25,"Track and Field, X-Country",11850,28978,-17128,5925,14489,-8564,5925,14489,-8564,"5","11",5409,5409
"9809",185873,"OCEAN COUNTY COLLEGE                                        ","2003-2004",16,"Softball",3500,20650,-17150,0,0,0,3500,20650,-17150,".","18",0,12000
"7527",202356,"CUYAHOGA COMMUNITY COLLEGE DISTRICT                         ","2003-2004",15,"Soccer",42681,59868,-17187,42681,59868,-17187,0,0,0,"20",".",38992,0
"3062",235343,"GREEN RIVER COMMUNITY COLLEGE                               ","2003-2004",2,"Basketball",27898,45095,-17197,14299,21711,-7412,13599,23384,-9785,"13","13",11399,11399
"1208",235149,"EVERETT COMMUNITY COLLEGE                                   ","2003-2004",1,"Baseball",1000,18200,-17200,1000,18200,-17200,0,0,0,"26",".",1800,0
"1425",207157,"HILLSDALE FREE WILL BAPTIST COLLEGE                         ","2003-2004",1,"Baseball",6800,24000,-17200,6800,24000,-17200,0,0,0,"19",".",21200,0
"13705",190716,"D'YOUVILLE COLLEGE                                          ","2003-2004",26,"Volleyball",27375,44598,-17223,17975,25567,-7592,9400,19031,-9631,"10","14",20067,13531
"12158",120421,"OXNARD COLLEGE                                              ","2003-2004",24,"Track and Field, Outdoor",5772,23000,-17228,3695,11500,-7805,2077,11500,-9423,"9","5",3695,2077
"9254",237385,"GLENVILLE STATE COLLEGE                                     ","2003-2004",16,"Softball",36264,53493,-17229,0,0,0,36264,53493,-17229,".","16",0,16623
"14258",171304,"MUSKEGON COMMUNITY COLLEGE                                  ","2003-2004",26,"Volleyball",19421,36657,-17236,0,0,0,19421,36657,-17236,".","10",0,10337
"14026",212115,"EAST STROUDSBURG UNIVERSITY OF PENNSYLVANIA                 ","2003-2004",26,"Volleyball",75758,93034,-17276,33355,44011,-10656,42403,49023,-6620,"14","14",15730,14225
"5782",143279,"BLACK HAWK COLLEGE                                          ","2003-2004",8,"Golf",28039,45330,-17291,28039,45330,-17291,0,0,0,"10",".",17291,0
"7923",105525,"PIMA COMMUNITY COLLEGE                                      ","2003-2004",15,"Soccer",39865,57168,-17303,19912,21943,-2031,19953,35225,-15272,"17","16",11056,11067
"8154",195562,"SAINT JOSEPHS COLLEGE-SUFFOLK CAMPUS                        ","2003-2004",15,"Soccer",54090,71397,-17307,32387,42924,-10537,21703,28473,-6770,"24","23",24912,19389
"5773",154518,"WALDORF COLLEGE                                             ","2003-2004",8,"Golf",6500,23814,-17314,3250,12750,-9500,3250,11064,-7814,"4","5",3250,3250
"13979",164173,"VILLA JULIE COLLEGE                                         ","2003-2004",26,"Volleyball",19075,36410,-17335,7918,18337,-10419,11157,18073,-6916,"8","17",11982,9522
"8566",112075,"CONCORDIA UNIVERSITY                                        ","2003-2004",16,"Softball",56837,74223,-17386,0,0,0,56837,74223,-17386,".","17",0,39762
"2953",118347,"COLLEGE OF MARIN                                            ","2003-2004",2,"Basketball",1400,18816,-17416,415,8862,-8447,985,9954,-8969,"10","12",7802,9074
"11207",150400,"DEPAUW UNIVERSITY                                           ","2003-2004",22,"Tennis",58350,75773,-17423,22179,34716,-12537,36171,41057,-4886,"14","13",16297,19139
"10062",195030,"UNIVERSITY OF ROCHESTER                                     ","2003-2004",17,"Squash",11819,29253,-17434,11819,29253,-17434,0,0,0,"18",".",9698,0
"5502",126580,"UNIVERSITY OF COLORADO AT COLORADO SPRINGS                  ","2003-2004",8,"Golf",46582,64022,-17440,46582,64022,-17440,0,0,0,"9",".",33974,0
"1195",217484,"UNIVERSITY OF RHODE ISLAND                                  ","2003-2004",1,"Baseball",249716,267164,-17448,249716,267164,-17448,0,0,0,"32",".",123354,0
"9762",168005,"SUFFOLK UNIVERSITY                                          ","2003-2004",16,"Softball",9000,26471,-17471,0,0,0,9000,26471,-17471,".","12",0,9000
"14487",209074,"LINN-BENTON COMMUNITY COLLEGE                               ","2003-2004",26,"Volleyball",2354,19833,-17479,0,0,0,2354,19833,-17479,".","12",0,11216
"14698",121886,"RIO HONDO COLLEGE                                           ","2003-2004",27,"Water Polo",24000,41480,-17480,11000,15299,-4299,13000,26181,-13181,"10","11",3831,5029
"9522",219134,"SI TANKA UNIVERSITY-HURON CAMPUS                            ","2003-2004",16,"Softball",35852,53352,-17500,0,0,0,35852,53352,-17500,".","14",0,35852
"11265",102270,"STILLMAN COLLEGE                                            ","2003-2004",22,"Tennis",9000,26500,-17500,4500,6500,-2000,4500,20000,-15500,"7","9",4500,4500
"11073",199412,"QUEENS UNIVERSITY OF CHARLOTTE                              ","2003-2004",22,"Tennis",109407,126935,-17528,50146,58751,-8605,59261,68184,-8923,"10","9",6920,8251
"7964",149727,"WAUBONSEE COMMUNITY COLLEGE                                 ","2003-2004",15,"Soccer",17800,35340,-17540,8900,17699,-8799,8900,17641,-8741,"18","12",7696,7241
"9035",200156,"JAMESTOWN COLLEGE                                           ","2003-2004",16,"Softball",26263,43863,-17600,0,0,0,26263,43863,-17600,".","25",0,14249
"5385",110680,"UNIVERSITY OF CALIFORNIA-SAN DIEGO                          ","2003-2004",8,"Golf",57787,75390,-17603,57787,75390,-17603,0,0,0,"12",".",49159,0
"10958",241739,"UNIVERSIDAD METROPOLITANA                                   ","2003-2004",22,"Tennis",2,17608,-17606,1,6948,-6947,1,10660,-10659,"3","3",3250,3250
"12143",117788,"LOS ANGELES CITY COLLEGE                                    ","2003-2004",24,"Track and Field, Outdoor",4440,22053,-17613,0,0,0,4440,22053,-17613,".","9",0,7828
"6158",180461,"MONTANA STATE UNIVERSITY-BOZEMAN                            ","2003-2004",8,"Golf",135604,153227,-17623,0,0,0,135604,153227,-17623,".","8",0,42162
"3750",122180,"SACRAMENTO CITY COLLEGE                                     ","2003-2004",3,"All Track Combined",1054,18681,-17627,527,7428,-6901,527,11253,-10726,"27","33",5778,5941
"1369",164465,"AMHERST COLLEGE                                             ","2003-2004",1,"Baseball",185263,202893,-17630,185263,202893,-17630,0,0,0,"28",".",34577,0
"4754",185572,"MONMOUTH UNIVERSITY                                         ","2003-2004",7,"Football",663659,681294,-17635,663659,681294,-17635,0,0,0,"81",".",191908,0
"11289",224323,"UNIVERSITY OF DALLAS                                        ","2003-2004",22,"Tennis",16944,34580,-17636,7902,16706,-8804,9042,17874,-8832,"12","11",7196,8432
"11632",201104,"ASHLAND UNIVERSITY                                          ","2003-2004",22,"Tennis",108080,125718,-17638,0,0,0,108080,125718,-17638,".","11",0,6000
"14870",197027,"UNITED STATES MERCHANT MARINE ACADEMY                       ","2003-2004",28,"Wrestling",12183,29824,-17641,12183,29824,-17641,0,0,0,"20",".",11150,0
"7116",133881,"FLORIDA INSTITUTE OF TECHNOLOGY-MELBOURNE                   ","2003-2004",15,"Soccer",467375,485022,-17647,238980,246714,-7734,228395,238308,-9913,"24","25",18716,26231
"8161",239248,"MILWAUKEE AREA TECHNICAL COLLEGE                            ","2003-2004",15,"Soccer",1,17650,-17649,1,17650,-17649,0,0,0,"18","0",9650,0
"487",185873,"OCEAN COUNTY COLLEGE                                        ","2003-2004",1,"Baseball",3000,20650,-17650,3000,20650,-17650,0,0,0,"16",".",12000,0
"1309",164720,"BECKER COLLEGE                                              ","2003-2004",1,"Baseball",24982,42634,-17652,24982,42634,-17652,0,0,0,"22",".",21007,0
"3373",180258,"UNIVERSITY OF GREAT FALLS                                   ","2003-2004",2,"Basketball",159200,176853,-17653,87931,95224,-7293,71269,81629,-10360,"12","12",87931,73650
"14432",199032,"MONTREAT COLLEGE                                            ","2003-2004",26,"Volleyball",19609,37281,-17672,0,0,0,19609,37281,-17672,"0","11",0,13281
"7971",201548,"CAPITAL UNIVERSITY                                          ","2003-2004",15,"Soccer",71376,89050,-17674,34753,42407,-7654,36623,46643,-10020,"42","32",15228,16214
"1308",224004,"CONCORDIA UNIVERSITY AT AUSTIN                              ","2003-2004",1,"Baseball",59000,76676,-17676,59000,76676,-17676,0,0,0,"49",".",58109,0
"11407",118541,"MARYMOUNT COLLEGE                                           ","2003-2004",22,"Tennis",34322,51999,-17677,17161,25543,-8382,17161,26456,-9295,"9","8",17161,17161
"7263",188438,"ADIRONDACK COMMUNITY COLLEGE                                ","2003-2004",15,"Soccer",252,17937,-17685,126,9746,-9620,126,8191,-8065,"16","15",5859,4375
"3620",186131,"PRINCETON UNIVERSITY                                        ","2003-2004",3,"All Track Combined",753830,771516,-17686,414101,423486,-9385,339729,348030,-8301,"93","64",171784,148564
"6564",162584,"FROSTBURG STATE UNIVERSITY                                  ","2003-2004",11,"Lacrosse",61983,79677,-17694,0,0,0,61983,79677,-17694,".","17",0,27457
"3216",195058,"ROCKLAND COMMUNITY COLLEGE                                  ","2003-2004",2,"Basketball",300,18000,-17700,300,18000,-17700,0,0,0,"12",".",250,0
"8999",240480,"UNIVERSITY OF WISCONSIN-STEVENS POINT                       ","2003-2004",16,"Softball",14269,31972,-17703,0,0,0,14269,31972,-17703,".","37",0,14861
"13502",212009,"DICKINSON COLLEGE                                           ","2003-2004",26,"Volleyball",8901,26620,-17719,0,0,0,8901,26620,-17719,".","18",0,11401
"545",196194,"SUNY COLLEGE AT OSWEGO                                      ","2003-2004",1,"Baseball",56865,74588,-17723,56865,74588,-17723,0,0,0,"27",".",39123,0
"8941",190594,"CUNY HUNTER COLLEGE                                         ","2003-2004",16,"Softball",2709,20451,-17742,0,0,0,2709,20451,-17742,".","17",0,12151
"1400",187897,"NEW MEXICO HIGHLANDS UNIVERSITY                             ","2003-2004",1,"Baseball",108022,125789,-17767,108022,125789,-17767,0,0,0,"45",".",38590,0
"7761",235343,"GREEN RIVER COMMUNITY COLLEGE                               ","2003-2004",15,"Soccer",23000,40771,-17771,11500,21559,-10059,11500,19212,-7712,"18","15",10300,10300
"11180",185262,"KEAN UNIVERSITY                                             ","2003-2004",22,"Tennis",1,17773,-17772,0,0,0,1,17773,-17772,".","8",0,8273
"13681",118684,"MENDOCINO COLLEGE                                           ","2003-2004",26,"Volleyball",1525,19305,-17780,0,0,0,1525,19305,-17780,".","9",0,13100
"6652",232423,"JAMES MADISON UNIVERSITY                                    ","2003-2004",11,"Lacrosse",474855,492644,-17789,0,0,0,474855,492644,-17789,".","31",0,100986
"8936",207041,"EAST CENTRAL UNIVERSITY                                     ","2003-2004",16,"Softball",19312,37112,-17800,0,0,0,19312,37112,-17800,".","18",0,14206
"8113",161341,"UNIVERSITY OF MAINE AT PRESQUE ISLE                         ","2003-2004",15,"Soccer",390,18202,-17812,155,9202,-9047,235,9000,-8765,"22","17",8724,8588
"7973",102049,"SAMFORD UNIVERSITY                                          ","2003-2004",15,"Soccer",438278,456115,-17837,0,0,0,438278,456115,-17837,".","25",0,40117
"14934",219134,"SI TANKA UNIVERSITY-HURON CAMPUS                            ","2003-2004",28,"Wrestling",26736,44586,-17850,26736,44586,-17850,0,0,0,"9",".",26736,0
"14048",224323,"UNIVERSITY OF DALLAS                                        ","2003-2004",26,"Volleyball",38056,55929,-17873,0,0,0,38056,55929,-17873,".","15",0,31414
"12106",198969,"METHODIST COLLEGE                                           ","2003-2004",24,"Track and Field, Outdoor",2233,20107,-17874,1653,10060,-8407,580,10047,-9467,"33","10",6760,2237
"12218",228705,"TEXAS A &amp; M UNIVERSITY-KINGSVILLE                           ","2003-2004",25,"Track and Field, X-Country",25162,43058,-17896,12581,23029,-10448,12581,20029,-7448,"6","9",14983,12986
"10617",232681,"MARY WASHINGTON COLLEGE                                     ","2003-2004",19,"Swimming",63100,80999,-17899,31550,39836,-8286,31550,41163,-9613,"21","21",14411,15945
"10551",184348,"DREW UNIVERSITY                                             ","2003-2004",19,"Swimming",49508,67409,-17901,24754,33194,-8440,24754,34215,-9461,"8","8",7947,7947
"8411",112084,"CHRISTIAN HERITAGE COLLEGE                                  ","2003-2004",15,"Soccer",44030,61943,-17913,22015,31869,-9854,22015,30074,-8059,"20","15",11968,10074
"13087",176938,"CENTRAL BIBLE COLLEGE                                       ","2003-2004",26,"Volleyball",50,18000,-17950,0,0,0,50,18000,-17950,"0","12",0,13000
"12178",196024,"SUNY COLLEGE OF TECHNOLOGY AT DELHI                         ","2003-2004",25,"Track and Field, X-Country",9562,27524,-17962,4781,16762,-11981,4781,10762,-5981,"20","8",5927,4032
"14181",237385,"GLENVILLE STATE COLLEGE                                     ","2003-2004",26,"Volleyball",28199,46177,-17978,0,0,0,28199,46177,-17978,"0","17",0,12713
"3318",109208,"AMERICAN RIVER COLLEGE                                      ","2003-2004",2,"Basketball",22481,40464,-17983,11523,24668,-13145,10958,15796,-4838,"13","16",21173,12341
"12939",202356,"CUYAHOGA COMMUNITY COLLEGE DISTRICT                         ","2003-2004",25,"Track and Field, X-Country",72853,90838,-17985,0,0,0,72853,90838,-17985,".","16",0,32560
"9229",182661,"DANIEL WEBSTER COLLEGE                                      ","2003-2004",16,"Softball",4730,22730,-18000,0,0,0,4730,22730,-18000,".","12",0,4730
"11342",226587,"MCMURRY UNIVERSITY                                          ","2003-2004",22,"Tennis",21912,39912,-18000,11788,19956,-8168,10124,19956,-9832,"9","11",10142,10142
"13092",173142,"BETHANY LUTHERAN COLLEGE                                    ","2003-2004",26,"Volleyball",36533,54535,-18002,0,0,0,36533,54535,-18002,".","13",0,18382
"15223",162007,"BOWIE STATE UNIVERSITY                                      ","2003-2004",33,"Bowling",9070,27079,-18009,0,0,0,9070,27079,-18009,"0","7",0,12849
"14117",220710,"MARYVILLE COLLEGE                                           ","2003-2004",26,"Volleyball",28879,46896,-18017,0,0,0,28879,46896,-18017,".","12",0,25971
"3594",240471,"UNIVERSITY OF WISCONSIN-RIVER FALLS                         ","2003-2004",3,"All Track Combined",102056,120089,-18033,51635,51086,549,50421,69003,-18582,"113","71",18055,16602
"16492",110653,"UNIVERSITY OF CALIFORNIA-IRVINE                             ","2003-2004",39,"Total Participants",4761641,4779676,-18035,2591791,2576516,15275,2169850,2203160,-33310,"312","254",735541,480759
"11454",215655,"ROBERT MORRIS UNIVERSITY                                    ","2003-2004",22,"Tennis",76941,94979,-18038,45401,49403,-4002,31540,45576,-14036,"8","8",6305,4445
"2783",236610,"SHORELINE COMMUNITY COLLEGE                                 ","2003-2004",2,"Basketball",65418,83472,-18054,36569,46887,-10318,28849,36585,-7736,"11","10",19112,20608
"12485",136330,"PALM BEACH ATLANTIC UNIVERSITY-WEST PALM BEACH              ","2003-2004",25,"Track and Field, X-Country",2350,20418,-18068,1024,11504,-10480,1326,8914,-7588,"7","8",9151,6645
"9259",105525,"PIMA COMMUNITY COLLEGE                                      ","2003-2004",16,"Softball",27715,45795,-18080,0,0,0,27715,45795,-18080,".","18",0,16041
"5436",127556,"MESA STATE COLLEGE                                          ","2003-2004",8,"Golf",15946,34037,-18091,0,0,0,15946,34037,-18091,".","7",0,24318
"8092",113634,"DIABLO VALLEY COLLEGE                                       ","2003-2004",15,"Soccer",902,19000,-18098,0,0,0,902,19000,-18098,".","19",0,3800
"13989",113634,"DIABLO VALLEY COLLEGE                                       ","2003-2004",26,"Volleyball",902,19000,-18098,0,0,0,902,19000,-18098,".","13",0,3783
"610",241739,"UNIVERSIDAD METROPOLITANA                                   ","2003-2004",1,"Baseball",1,18100,-18099,1,18100,-18099,0,0,0,"15",".",6936,0
"7102",161165,"HUSSON COLLEGE                                              ","2003-2004",15,"Soccer",89833,107950,-18117,20205,20204,1,69628,87746,-18118,"28","25",14571,21149
"3609",212106,"DUQUESNE UNIVERSITY                                         ","2003-2004",3,"All Track Combined",703785,721925,-18140,282130,288095,-5965,421655,433830,-12175,"44","96",47840,63800
"5617",207041,"EAST CENTRAL UNIVERSITY                                     ","2003-2004",8,"Golf",11142,29285,-18143,11142,29285,-18143,0,0,0,"10",".",20553,0
"4585",231581,"BRIDGEWATER COLLEGE                                         ","2003-2004",7,"Football",307200,325383,-18183,307200,325383,-18183,0,0,0,"163",".",130753,0
"2379",203580,"LAKE ERIE COLLEGE                                           ","2003-2004",2,"Basketball",41928,60124,-18196,26680,34352,-7672,15248,25772,-10524,"14","9",20890,15248
"12267",366401,"LAS POSITAS COLLEGE                                         ","2003-2004",25,"Track and Field, X-Country",21062,39276,-18214,10531,19638,-9107,10531,19638,-9107,"8","8",10188,10188
"3944",155061,"FORT HAYS STATE UNIVERSITY                                  ","2003-2004",3,"All Track Combined",167720,185941,-18221,96737,93281,3456,70983,92660,-21677,"154","98",15676,19333
"1178",176053,"MISSISSIPPI COLLEGE                                         ","2003-2004",1,"Baseball",149931,168158,-18227,149931,168158,-18227,0,0,0,"62",".",76260,0
"2531",162104,"CECIL COMMUNITY COLLEGE                                     ","2003-2004",2,"Basketball",1106,19336,-18230,553,11764,-11211,553,7572,-7019,"18","12",2285,2280
"8289",161244,"UNIVERSITY OF MAINE AT MACHIAS                              ","2003-2004",15,"Soccer",62637,80885,-18248,30216,39500,-9284,32421,41385,-8964,"18","15",29315,31200
"683",224642,"EL PASO COMMUNITY COLLEGE                                   ","2003-2004",1,"Baseball",1e+05,118249,-18249,1e+05,118249,-18249,0,0,0,"28",".",54097,0
"9275",123341,"SIERRA COLLEGE                                              ","2003-2004",16,"Softball",15252,33516,-18264,0,0,0,15252,33516,-18264,".","15",0,15690
"14648",240107,"VITERBO UNIVERSITY                                          ","2003-2004",26,"Volleyball",23187,41468,-18281,0,0,0,23187,41468,-18281,"0","15",0,19117
"15569",194392,"PAUL SMITHS COLLEGE OF ARTS AND SCIENCE                     ","2003-2004",39,"Total Participants",16450,34750,-18300,9850,19000,-9150,6600,15750,-9150,"68","31",25500,22500
"4491",206525,"WITTENBERG UNIVERSITY                                       ","2003-2004",7,"Football",195649,213950,-18301,195649,213950,-18301,0,0,0,"119",".",67359,0
"2355",199281,"UNIVERSITY OF NORTH CAROLINA AT PEMBROKE                    ","2003-2004",2,"Basketball",92450,110767,-18317,45459,61126,-15667,46991,49641,-2650,"11","17",31213,42085
"13599",196006,"SUNY COLLEGE OF TECHNOLOGY AT ALFRED                        ","2003-2004",26,"Volleyball",14687,33008,-18321,0,0,0,14687,33008,-18321,".","10",0,11519
"9933",237701,"POTOMAC STATE COLLEGE OF WEST VIRGINIA UNIVERSITY           ","2003-2004",16,"Softball",12000,30341,-18341,0,0,0,12000,30341,-18341,".","17",0,8846
"5326",180948,"CHADRON STATE COLLEGE                                       ","2003-2004",8,"Golf",9906,28254,-18348,0,0,0,9906,28254,-18348,"0","6",0,8654
"10643",189088,"BARD COLLEGE                                                ","2003-2004",22,"Tennis",266,18648,-18382,133,8539,-8406,133,10109,-9976,"12","15",1612,3332
"3097",403487,"ILLINOIS EASTERN COMMUNITY COLLS-WABASH VLY COLL            ","2003-2004",2,"Basketball",186904,205298,-18394,124083,140642,-16559,62821,64656,-1835,"14","11",18803,13232
"3199",169275,"MOTT COMMUNITY COLLEGE                                      ","2003-2004",2,"Basketball",8000,26399,-18399,6000,16691,-10691,2000,9708,-7708,"13","12",12690,7707
"14879",174251,"UNIVERSITY OF MINNESOTA-MORRIS                              ","2003-2004",28,"Wrestling",26000,44414,-18414,26000,44414,-18414,0,0,0,"13",".",20768,0
"10805",204501,"OBERLIN COLLEGE                                             ","2003-2004",22,"Tennis",77256,95682,-18426,38319,47096,-8777,38937,48586,-9649,"10","8",4737,5849
"7496",110680,"UNIVERSITY OF CALIFORNIA-SAN DIEGO                          ","2003-2004",15,"Soccer",199052,217511,-18459,96723,103881,-7158,102329,113630,-11301,"24","28",41793,58500
"13961",179955,"WILLIAM JEWELL COLLEGE                                      ","2003-2004",26,"Volleyball",17379,35845,-18466,0,0,0,17379,35845,-18466,".","14",0,16224
"8313",434672,"THE COMMUNITY COLLEGE OF BALTIMORE COUNTY                   ","2003-2004",15,"Soccer",62018,80495,-18477,36060,45867,-9807,25958,34628,-8670,"51","34",42275,27595
"14055",207351,"OKLAHOMA PANHANDLE STATE UNIVERSITY                         ","2003-2004",26,"Volleyball",1125,19684,-18559,0,0,0,1125,19684,-18559,".","12",0,10184
"1327",176169,"NORTHEAST MISSISSIPPI COMMUNITY COLLEGE                     ","2003-2004",1,"Baseball",69430,88005,-18575,69430,88005,-18575,0,0,0,"26",".",19442,0
"13791",154527,"WARTBURG COLLEGE                                            ","2003-2004",26,"Volleyball",29519,48098,-18579,0,0,0,29519,48098,-18579,".","26",0,19216
"804",202356,"CUYAHOGA COMMUNITY COLLEGE DISTRICT                         ","2003-2004",1,"Baseball",54376,72962,-18586,54376,72962,-18586,0,0,0,"32",".",42691,0
"11193",138789,"ARMSTRONG ATLANTIC STATE UNIVERSITY                         ","2003-2004",22,"Tennis",187331,205931,-18600,75750,82399,-6649,111581,123532,-11951,"8","8",36746,71544
"6879",234085,"VIRGINIA MILITARY INSTITUTE                                 ","2003-2004",12,"Rifle",3270,21885,-18615,3270,21885,-18615,0,0,0,"20",".",11409,0
"6126",199157,"NORTH CAROLINA CENTRAL UNIVERSITY                           ","2003-2004",8,"Golf",700,19321,-18621,700,19321,-18621,0,0,0,"7",".",11396,0
"15342",105297,"DINE COLLEGE                                                ","2003-2004",35,"Rodeo",9770,28392,-18622,4885,14196,-9311,4885,14196,-9311,"4","4",4326,4326
"3786",240453,"UNIVERSITY OF WISCONSIN-MILWAUKEE                           ","2003-2004",3,"All Track Combined",460665,479288,-18623,215040,225299,-10259,245625,253989,-8364,"35","35",36580,32217
"10536",179894,"WEBSTER UNIVERSITY                                          ","2003-2004",19,"Swimming",2707,21333,-18626,682,9985,-9303,2025,11348,-9323,"5","8",650,2012
"5427",229814,"WEST TEXAS A &amp; M UNIVERSITY                                 ","2003-2004",8,"Golf",33752,52380,-18628,16876,26190,-9314,16876,26190,-9314,"5","5",17507,17507
"16376",122746,"SAN JOSE CITY COLLEGE                                       ","2003-2004",39,"Total Participants",493983,512638,-18655,315009,329818,-14809,178974,182820,-3846,"149","47",49940,22536
"12680",144892,"EASTERN ILLINOIS UNIVERSITY                                 ","2003-2004",25,"Track and Field, X-Country",31106,49777,-18671,15553,25241,-9688,15553,24536,-8983,"21","21",11587,10702
"14983",212054,"DREXEL UNIVERSITY                                           ","2003-2004",28,"Wrestling",337045,355758,-18713,337045,355758,-18713,0,0,0,"38",".",49370,0
"15001",153108,"CENTRAL COLLEGE                                             ","2003-2004",28,"Wrestling",41135,59870,-18735,41135,59870,-18735,0,0,0,"47",".",22000,0
"12664",119137,"MOORPARK COLLEGE                                            ","2003-2004",25,"Track and Field, X-Country",5954,24714,-18760,2977,12357,-9380,2977,12357,-9380,"13","8",2977,2977
"904",227401,"PARIS JUNIOR COLLEGE                                        ","2003-2004",1,"Baseball",1,18805,-18804,1,18805,-18804,0,0,0,"28",".",11185,0
"540",216038,"SLIPPERY ROCK UNIVERSITY OF PENNSYLVANIA                    ","2003-2004",1,"Baseball",185290,204110,-18820,185290,204110,-18820,0,0,0,"33",".",71981,0
"7969",207865,"SOUTHWESTERN OKLAHOMA STATE UNIVERSITY                      ","2003-2004",15,"Soccer",20486,39307,-18821,0,0,0,20486,39307,-18821,".","23",0,20486
"2761",191612,"HERKIMER COUNTY COMMUNITY COLLEGE                           ","2003-2004",2,"Basketball",29000,47830,-18830,15000,22915,-7915,14000,24915,-10915,"16","14",15000,14000
"3686",235167,"EVERGREEN STATE COLLEGE                                     ","2003-2004",3,"All Track Combined",970,19840,-18870,485,9920,-9435,485,9920,-9435,"5","5",6575,6575
"12616",236595,"SEATTLE UNIVERSITY                                          ","2003-2004",25,"Track and Field, X-Country",87910,106810,-18900,39905,49355,-9450,48005,57455,-9450,"17","22",19374,19374
"15931",218919,"VOORHEES COLLEGE                                            ","2003-2004",39,"Total Participants",71000,89900,-18900,44000,53900,-9900,27000,36000,-9000,"44","54",77000,57000
"10548",211361,"CALIFORNIA UNIVERSITY OF PENNSYLVANIA                       ","2003-2004",19,"Swimming",116163,135086,-18923,0,0,0,116163,135086,-18923,".","8",0,17300
"1685",219949,"CUMBERLAND UNIVERSITY                                       ","2003-2004",2,"Basketball",584214,603142,-18928,220639,259226,-38587,363575,343916,19659,"14","16",28195,26904
"10080",164465,"AMHERST COLLEGE                                             ","2003-2004",17,"Squash",110509,129437,-18928,66735,78383,-11648,43774,51054,-7280,"20","15",6812,8001
"10776",175078,"SOUTHWEST MINNESOTA STATE UNIVERSITY                        ","2003-2004",22,"Tennis",1016,19969,-18953,0,0,0,1016,19969,-18953,".","9",0,6385
"1387",211088,"ARCADIA UNIVERSITY                                          ","2003-2004",1,"Baseball",11706,30670,-18964,11706,30670,-18964,0,0,0,"22",".",17970,0
"12439",127556,"MESA STATE COLLEGE                                          ","2003-2004",25,"Track and Field, X-Country",8778,27743,-18965,0,0,0,8778,27743,-18965,".","10",0,18024
"8485",237011,"WESTERN WASHINGTON UNIVERSITY                               ","2003-2004",15,"Soccer",201904,220884,-18980,96131,103469,-7338,105773,117415,-11642,"23","28",41029,44590
"461",244437,"GEORGIA PERIMETER COLLEGE                                   ","2003-2004",1,"Baseball",113553,132542,-18989,113553,132542,-18989,0,0,0,"25",".",59097,0
"4894",119137,"MOORPARK COLLEGE                                            ","2003-2004",7,"Football",39994,58985,-18991,39994,58985,-18991,0,0,0,"75",".",21127,0
"15828",176406,"TOUGALOO COLLEGE                                            ","2003-2004",39,"Total Participants",118927,137926,-18999,65187,77813,-12626,53740,60113,-6373,"36","29",36600,33600
"2370",190512,"CUNY BERNARD M BARUCH COLLEGE                               ","2003-2004",2,"Basketball",25000,44000,-19000,12500,23600,-11100,12500,20400,-7900,"14","13",14600,12400
"17306",144175,"CITY COLLEGES OF CHICAGO-OLIVE-HARVEY COLLEGE               ","2003-2004",39,"Total Participants",4000,23000,-19000,3000,15000,-12000,1000,8000,-7000,"46","30",20000,20000
"7927",239318,"MILWAUKEE SCHOOL OF ENGINEERING                             ","2003-2004",15,"Soccer",24951,43964,-19013,15965,30330,-14365,8986,13634,-4648,"26","16",26086,7404
"15762",209038,"LANE COMMUNITY COLLEGE                                      ","2003-2004",39,"Total Participants",159851,178870,-19019,89881,100836,-10955,69970,78034,-8064,"52","39",67234,50331
"7791",149019,"SPRINGFIELD COLLEGE IN ILLINOIS                             ","2003-2004",15,"Soccer",32213,51245,-19032,19713,38463,-18750,12500,12782,-282,"20","14",28987,7427
"8538",192925,"MEDAILLE COLLEGE                                            ","2003-2004",16,"Softball",3123,22160,-19037,0,0,0,3123,22160,-19037,".","14",0,16110
"8481",221856,"TENNESSEE TEMPLE UNIVERSITY                                 ","2003-2004",15,"Soccer",13730,32797,-19067,13730,32797,-19067,0,0,0,"18",".",10667,0
"9009",199032,"MONTREAT COLLEGE                                            ","2003-2004",16,"Softball",19301,38382,-19081,0,0,0,19301,38382,-19081,".","10",0,16989
"11592",101240,"GADSDEN STATE COMMUNITY COLLEGE                             ","2003-2004",22,"Tennis",15907,34995,-19088,15907,34995,-19088,0,0,0,"6",".",7041,0
"14458",228608,"TEMPLE COLLEGE                                              ","2003-2004",26,"Volleyball",29792,48885,-19093,0,0,0,29792,48885,-19093,".","12",0,11160
"6644",121345,"POMONA COLLEGE                                              ","2003-2004",11,"Lacrosse",13000,32107,-19107,0,0,0,13000,32107,-19107,".","22",0,19521
"1919",122746,"SAN JOSE CITY COLLEGE                                       ","2003-2004",2,"Basketball",164286,183399,-19113,89507,102529,-13022,74779,80870,-6091,"15","12",13020,8892
"15087",130697,"WESLEYAN UNIVERSITY                                         ","2003-2004",29,"Other Sports",159058,178173,-19115,159058,178173,-19115,0,0,0,"34",".",48952,0
"8916",153108,"CENTRAL COLLEGE                                             ","2003-2004",16,"Softball",95683,114815,-19132,0,0,0,95683,114815,-19132,".","30",0,23192
"389",143279,"BLACK HAWK COLLEGE                                          ","2003-2004",1,"Baseball",32041,51185,-19144,32041,51185,-19144,0,0,0,"19",".",19144,0
"3850",110653,"UNIVERSITY OF CALIFORNIA-IRVINE                             ","2003-2004",3,"All Track Combined",553278,572424,-19146,276639,272598,4041,276639,299826,-23187,"72","82",41221,64717
"16200",118541,"MARYMOUNT COLLEGE                                           ","2003-2004",39,"Total Participants",35822,54999,-19177,18661,28543,-9882,17161,26456,-9295,"19","8",18661,17161
"3432",177135,"CROWDER COLLEGE                                             ","2003-2004",2,"Basketball",79091,98282,-19191,0,0,0,79091,98282,-19191,".","15",0,21342
"5663",101240,"GADSDEN STATE COMMUNITY COLLEGE                             ","2003-2004",8,"Golf",22627,41824,-19197,22627,41824,-19197,0,0,0,"8",".",14239,0
"50",191339,"GENESEE COMMUNITY COLLEGE                                   ","2003-2004",1,"Baseball",18136,37343,-19207,18136,37343,-19207,0,0,0,"15",".",16293,0
"12208",171571,"OAKLAND UNIVERSITY                                          ","2003-2004",25,"Track and Field, X-Country",101144,120358,-19214,47718,57097,-9379,53426,63261,-9835,"12","16",16129,16263
"11593",185828,"NEW JERSEY INSTITUTE OF TECHNOLOGY                          ","2003-2004",22,"Tennis",6700,25936,-19236,3350,6034,-2684,3350,19902,-16552,"8","10",3350,3350
"9499",152266,"PURDUE UNIVERSITY-NORTH CENTRAL CAMPUS                      ","2003-2004",16,"Softball",25990,45233,-19243,0,0,0,25990,45233,-19243,".","17",0,28482
"7502",228149,"ST MARYS UNIVERSITY                                         ","2003-2004",15,"Soccer",40783,60034,-19251,19876,30895,-11019,20907,29139,-8232,"31","25",17997,18225
"7858",112172,"CITRUS COLLEGE                                              ","2003-2004",15,"Soccer",15514,34780,-19266,7764,14926,-7162,7750,19854,-12104,"22","20",5251,5762
"1264",236188,"OLYMPIC COLLEGE                                             ","2003-2004",1,"Baseball",43250,62565,-19315,43250,62565,-19315,0,0,0,"25",".",26904,0
"7587",164720,"BECKER COLLEGE                                              ","2003-2004",15,"Soccer",8290,27605,-19315,4383,13784,-9401,3907,13821,-9914,"14","17",9672,8789
"5147",200332,"NORTH DAKOTA STATE UNIVERSITY-MAIN CAMPUS                   ","2003-2004",8,"Golf",31794,51112,-19318,9926,30248,-20322,21868,20864,1004,"11","10",20138,10540
"5185",170541,"KALAMAZOO VALLEY COMMUNITY COLLEGE                          ","2003-2004",8,"Golf",1,19330,-19329,1,19330,-19329,0,0,0,"10",".",11837,0
"3992",164924,"BOSTON COLLEGE                                              ","2003-2004",5,"Fencing",3320,22668,-19348,1660,11334,-9674,1660,11334,-9674,"14","16",6326,6326
"9207",147679,"NORTH PARK UNIVERSITY                                       ","2003-2004",16,"Softball",19798,39146,-19348,0,0,0,19798,39146,-19348,".","15",0,24972
"1288",174783,"SAINT CLOUD STATE UNIVERSITY                                ","2003-2004",1,"Baseball",56276,75626,-19350,56276,75626,-19350,0,0,0,"36",".",26590,0
"12233",129941,"UNIVERSITY OF NEW HAVEN                                     ","2003-2004",25,"Track and Field, X-Country",167587,186950,-19363,84755,102144,-17389,82832,84806,-1974,"41","36",20916,19836
"1820",235167,"EVERGREEN STATE COLLEGE                                     ","2003-2004",2,"Basketball",32293,51661,-19368,17095,29138,-12043,15198,22523,-7325,"12","13",17595,18080
"7815",130183,"TEIKYO POST UNIVERSITY                                      ","2003-2004",15,"Soccer",4345,23715,-19370,2793,12349,-9556,1552,11366,-9814,"28","19",11674,10891
"5673",182670,"DARTMOUTH COLLEGE                                           ","2003-2004",8,"Golf",128544,147927,-19383,71968,82457,-10489,56576,65470,-8894,"10","7",39374,34252
"9525",216807,"WESTMINSTER COLLEGE                                         ","2003-2004",16,"Softball",20081,39490,-19409,0,0,0,20081,39490,-19409,".","22",0,13727
"3367",194240,"ORANGE COUNTY COMMUNITY COLLEGE                             ","2003-2004",2,"Basketball",30272,49708,-19436,15744,22199,-6455,14528,27509,-12981,"15","13",15909,21898
"6917",164216,"WASHINGTON COLLEGE                                          ","2003-2004",13,"Rowing",57939,77389,-19450,19313,25796,-6483,38626,51593,-12967,"18","45",15839,31679
"8691",168421,"WORCESTER POLYTECHNIC INSTITUTE                             ","2003-2004",16,"Softball",7947,27415,-19468,0,0,0,7947,27415,-19468,".","10",0,7915
"10410",196006,"SUNY COLLEGE OF TECHNOLOGY AT ALFRED                        ","2003-2004",18,"Swimming and Diving",13458,32927,-19469,6729,13864,-7135,6729,19063,-12334,"8","11",11024,15158
"14431",174604,"RAINY RIVER COMMUNITY COLLEGE                               ","2003-2004",26,"Volleyball",13077,32549,-19472,0,0,0,13077,32549,-19472,".","12",0,11920
"4726",105525,"PIMA COMMUNITY COLLEGE                                      ","2003-2004",7,"Football",130315,149797,-19482,130315,149797,-19482,0,0,0,"86",".",105949,0
"16440",136516,"POLK COMMUNITY COLLEGE                                      ","2003-2004",39,"Total Participants",359284,378770,-19486,135972,115972,20000,223312,262798,-39486,"38","45",130832,124515
"5027",210401,"WILLAMETTE UNIVERSITY                                       ","2003-2004",7,"Football",215969,235463,-19494,215969,235463,-19494,0,0,0,"106",".",105295,0
"1540",236230,"PACIFIC LUTHERAN UNIVERSITY                                 ","2003-2004",1,"Baseball",18100,37600,-19500,18100,37600,-19500,0,0,0,"23",".",18100,0
"10505",185873,"OCEAN COUNTY COLLEGE                                        ","2003-2004",19,"Swimming",500,20000,-19500,250,10000,-9750,250,10000,-9750,"7","8",8000,8000
"7112",137546,"STETSON UNIVERSITY                                          ","2003-2004",15,"Soccer",881882,901387,-19505,466581,476878,-10297,415301,424509,-9208,"26","27",40851,45792
"13671",228325,"SOUTHWESTERN ASSEMBLIES OF GOD UNIVERSITY                   ","2003-2004",26,"Volleyball",39965,59484,-19519,0,0,0,39965,59484,-19519,".","12",0,16029
"13239",151306,"UNIVERSITY OF SOUTHERN INDIANA                              ","2003-2004",26,"Volleyball",73513,93034,-19521,0,0,0,73513,93034,-19521,".","13",0,21461
"1830",167631,"ROXBURY COMMUNITY COLLEGE                                   ","2003-2004",2,"Basketball",19300,38846,-19546,15500,27330,-11830,3800,11516,-7716,"14","9",19730,6316
"9816",192323,"LE MOYNE COLLEGE                                            ","2003-2004",16,"Softball",33766,53329,-19563,0,0,0,33766,53329,-19563,".","18",0,33766
"13604",192323,"LE MOYNE COLLEGE                                            ","2003-2004",26,"Volleyball",19895,39458,-19563,0,0,0,19895,39458,-19563,".","12",0,19895
"5422",107071,"HENDERSON STATE UNIVERSITY                                  ","2003-2004",8,"Golf",14072,33649,-19577,14072,33649,-19577,0,0,0,"8",".",6383,0
"14350",185590,"MONTCLAIR STATE UNIVERSITY                                  ","2003-2004",26,"Volleyball",825,20416,-19591,0,0,0,825,20416,-19591,".","17",0,10864
"6600",198899,"MARS HILL COLLEGE                                           ","2003-2004",11,"Lacrosse",42949,62550,-19601,42949,62550,-19601,0,0,0,"13",".",17611,0
"8886",128106,"COLORADO STATE UNIVERSITY-PUEBLO                            ","2003-2004",16,"Softball",140654,160260,-19606,0,0,0,140654,160260,-19606,".","20",0,47269
"3261",161235,"UNIVERSITY OF MAINE AT FORT KENT                            ","2003-2004",2,"Basketball",85561,105196,-19635,44686,44713,-27,40875,60483,-19608,"12","10",41470,48595
"1147",208390,"CHEMEKETA COMMUNITY COLLEGE                                 ","2003-2004",1,"Baseball",300,19953,-19653,300,19953,-19653,0,0,0,"24",".",19952,0
"6240",169798,"EASTERN MICHIGAN UNIVERSITY                                 ","2003-2004",8,"Golf",317269,336951,-19682,147108,158151,-11043,170161,178800,-8639,"9","10",42917,30866
"5530",130989,"GOLDEY-BEACOM COLLEGE                                       ","2003-2004",8,"Golf",25000,44683,-19683,25000,44683,-19683,0,0,0,"11",".",16483,0
"4068",162654,"GOUCHER COLLEGE                                             ","2003-2004",6,"Field hocky",2852,22568,-19716,0,0,0,2852,22568,-19716,".","13",0,5296
"12468",220312,"HIWASSEE COLLEGE                                            ","2003-2004",25,"Track and Field, X-Country",1500,21225,-19725,750,10300,-9550,750,10925,-10175,"5","2",60,166
"13595",168005,"SUFFOLK UNIVERSITY                                          ","2003-2004",26,"Volleyball",7750,27500,-19750,0,0,0,7750,27500,-19750,".","13",0,7750
"12418",101240,"GADSDEN STATE COMMUNITY COLLEGE                             ","2003-2004",25,"Track and Field, X-Country",21593,41346,-19753,0,0,0,21593,41346,-19753,".","6",0,3197
"7287",159656,"LOYOLA UNIVERSITY NEW ORLEANS                               ","2003-2004",15,"Soccer",55766,75532,-19766,0,0,0,55766,75532,-19766,".","24",0,19070
"4465",149781,"WHEATON COLLEGE                                             ","2003-2004",7,"Football",322777,342558,-19781,322777,342558,-19781,0,0,0,"87",".",128960,0
"9363",173665,"HAMLINE UNIVERSITY                                          ","2003-2004",16,"Softball",48728,68525,-19797,0,0,0,48728,68525,-19797,".","18",0,12511
"9344",233426,"ROANOKE COLLEGE                                             ","2003-2004",16,"Softball",9408,29224,-19816,0,0,0,9408,29224,-19816,".","19",0,23224
"6657",196006,"SUNY COLLEGE OF TECHNOLOGY AT ALFRED                        ","2003-2004",11,"Lacrosse",20265,40100,-19835,20265,40100,-19835,0,0,0,"23",".",16962,0
"15611",178411,"UNIVERSITY OF MISSOURI-ROLLA                                ","2003-2004",39,"Total Participants",668054,687906,-19852,393873,404837,-10964,274181,283069,-8888,"235","83",241391,120530
"13463",199333,"PITT COMMUNITY COLLEGE                                      ","2003-2004",26,"Volleyball",2771,22632,-19861,0,0,0,2771,22632,-19861,"0","14",0,12731
"3998",185828,"NEW JERSEY INSTITUTE OF TECHNOLOGY                          ","2003-2004",5,"Fencing",9000,28868,-19868,4500,14368,-9868,4500,14500,-10000,"14","8",4500,4500
"1789",194824,"RENSSELAER POLYTECHNIC INSTITUTE                            ","2003-2004",2,"Basketball",167332,187203,-19871,95907,105778,-9871,71425,81425,-10000,"24","14",26769,20840
"180",168421,"WORCESTER POLYTECHNIC INSTITUTE                             ","2003-2004",1,"Baseball",9463,29351,-19888,9463,29351,-19888,0,0,0,"25",".",15500,0
"17271",235431,"HIGHLINE COMMUNITY COLLEGE                                  ","2003-2004",39,"Total Participants",205588,225540,-19952,88415,94017,-5602,117173,131523,-14350,"97","69",48310,56168
"5329",195164,"SAINT BONAVENTURE UNIVERSITY                                ","2003-2004",8,"Golf",22299,42262,-19963,22299,42262,-19963,0,0,0,"10",".",16152,0
"9546",240462,"UNIVERSITY OF WISCONSIN-PLATTEVILLE                         ","2003-2004",16,"Softball",39665,59628,-19963,0,0,0,39665,59628,-19963,".","26",0,38370
"3997",190594,"CUNY HUNTER COLLEGE                                         ","2003-2004",5,"Fencing",810,20776,-19966,809,11017,-10208,1,9759,-9758,"21","21",5842,4584
"26",150048,"ANCILLA COLLEGE                                             ","2003-2004",1,"Baseball",23000,43000,-20000,23000,43000,-20000,0,0,0,"35",".",30000,0
"52",198039,"BLUE RIDGE COMMUNITY COLLEGE                                ","2003-2004",1,"Baseball",5000,25000,-20000,5000,25000,-20000,0,0,0,"45",".",15000,0
"218",141097,"SOUTHERN POLYTECHNIC STATE UNIVERSITY                       ","2003-2004",1,"Baseball",162000,182000,-20000,162000,182000,-20000,0,0,0,"33",".",21500,0
"1882",198118,"CALDWELL COMMUNITY COLLEGE AND TECHNICAL INSTITUTE          ","2003-2004",2,"Basketball",4500,24500,-20000,4500,24500,-20000,0,0,0,"16",".",20000,0
"3388",189839,"CAYUGA COUNTY COMMUNITY COLLEGE                             ","2003-2004",2,"Basketball",39200,59200,-20000,21175,31175,-10000,18025,28025,-10000,"15","12",21175,18025
"6770",189839,"CAYUGA COUNTY COMMUNITY COLLEGE                             ","2003-2004",11,"Lacrosse",23520,43520,-20000,14470,24470,-10000,9050,19050,-10000,"25","20",14470,9050
"7929",189839,"CAYUGA COUNTY COMMUNITY COLLEGE                             ","2003-2004",15,"Soccer",26850,46850,-20000,13100,23100,-10000,13750,23750,-10000,"22","22",13100,13750
"3887",201371,"BLUFFTON COLLEGE                                            ","2003-2004",3,"All Track Combined",71880,91881,-20001,35808,46591,-10783,36072,45290,-9218,"66","53",12086,12399
"6001",147679,"NORTH PARK UNIVERSITY                                       ","2003-2004",8,"Golf",10254,30318,-20064,5127,16154,-11027,5127,14164,-9037,"7","2",6025,4035
"3059",203128,"HIRAM COLLEGE                                               ","2003-2004",2,"Basketball",95225,115311,-20086,45880,54987,-9107,49345,60324,-10979,"17","14",16790,16200
"14505",100663,"UNIVERSITY OF ALABAMA AT BIRMINGHAM                         ","2003-2004",26,"Volleyball",498305,518397,-20092,0,0,0,498305,518397,-20092,".","12",0,69023
"13047",206589,"COLLEGE OF WOOSTER                                          ","2003-2004",26,"Volleyball",200,20309,-20109,0,0,0,200,20309,-20109,".","10",0,18483
"15020",240480,"UNIVERSITY OF WISCONSIN-STEVENS POINT                       ","2003-2004",28,"Wrestling",29518,49631,-20113,29518,49631,-20113,0,0,0,"30",".",17690,0
"3914",199148,"UNIVERSITY OF NORTH CAROLINA AT GREENSBORO                  ","2003-2004",3,"All Track Combined",214463,234597,-20134,105256,107314,-2058,109207,127283,-18076,"14","15",15626,15627
"3237",146418,"KISHWAUKEE COLLEGE                                          ","2003-2004",2,"Basketball",27587,47725,-20138,14748,28995,-14247,12839,18730,-5891,"14","9",15891,10995
"10646",100724,"ALABAMA STATE UNIVERSITY                                    ","2003-2004",22,"Tennis",100389,120539,-20150,30548,35496,-4948,69841,85043,-15202,"7","6",15274,15932
"11211",199582,"SAINT AUGUSTINES COLLEGE                                    ","2003-2004",22,"Tennis",34954,55116,-20162,16255,26928,-10673,18699,28188,-9489,"5","6",3886,5158
"4135",168421,"WORCESTER POLYTECHNIC INSTITUTE                             ","2003-2004",6,"Field hocky",13231,33404,-20173,0,0,0,13231,33404,-20173,".","14",0,13904
"3359",167394,"COLLEGE OF OUR LADY OF THE ELMS                             ","2003-2004",2,"Basketball",66969,87146,-20177,36908,45056,-8148,30061,42090,-12029,"15","8",13149,8285
"5143",227526,"PRAIRIE VIEW A &amp; M UNIVERSITY                               ","2003-2004",8,"Golf",33674,53853,-20179,16837,28800,-11963,16837,25053,-8216,"7","7",16837,16837
"628",224110,"NORTH CENTRAL TEXAS COLLEGE                                 ","2003-2004",1,"Baseball",152300,172500,-20200,152300,172500,-20200,0,0,0,"28",".",24436,0
"9338",224110,"NORTH CENTRAL TEXAS COLLEGE                                 ","2003-2004",16,"Softball",103700,123900,-20200,0,0,0,103700,123900,-20200,".","20",0,14865
"1382",161554,"UNIVERSITY OF SOUTHERN MAINE                                ","2003-2004",1,"Baseball",114698,134907,-20209,114698,134907,-20209,0,0,0,"34",".",81023,0
"12929",182670,"DARTMOUTH COLLEGE                                           ","2003-2004",25,"Track and Field, X-Country",79255,99489,-20234,42923,55411,-12488,36332,44078,-7746,"27","20",18380,15731
"1745",154721,"BETHANY COLLEGE                                             ","2003-2004",2,"Basketball",242661,262904,-20243,136734,139912,-3178,105927,122992,-17065,"25","22",19195,30511
"11984",196024,"SUNY COLLEGE OF TECHNOLOGY AT DELHI                         ","2003-2004",24,"Track and Field, Outdoor",16220,36466,-20246,9110,21233,-12123,7110,15233,-8123,"22","8",11653,7249
"9487",221351,"RHODES COLLEGE                                              ","2003-2004",16,"Softball",24450,44721,-20271,0,0,0,24450,44721,-20271,".","11",0,22100
"308",239318,"MILWAUKEE SCHOOL OF ENGINEERING                             ","2003-2004",1,"Baseball",37131,57434,-20303,37131,57434,-20303,0,0,0,"40",".",48762,0
"13769",174251,"UNIVERSITY OF MINNESOTA-MORRIS                              ","2003-2004",26,"Volleyball",35066,55374,-20308,0,0,0,35066,55374,-20308,".","19",0,29477
"7933",233912,"VIRGINIA INTERMONT COLLEGE                                  ","2003-2004",15,"Soccer",48200,68530,-20330,29000,55067,-26067,19200,13463,5737,"22","17",10975,11650
"9103",207865,"SOUTHWESTERN OKLAHOMA STATE UNIVERSITY                      ","2003-2004",16,"Softball",20881,41228,-20347,0,0,0,20881,41228,-20347,".","19",0,18986
"12747",120421,"OXNARD COLLEGE                                              ","2003-2004",25,"Track and Field, X-Country",2645,23000,-20355,1137,11500,-10363,1508,11500,-9992,"8","6",1508,1137
"11729",174233,"UNIVERSITY OF MINNESOTA-DULUTH                              ","2003-2004",22,"Tennis",6625,26996,-20371,0,0,0,6625,26996,-20371,"0","12",0,11580
"4764",110334,"CABRILLO COLLEGE                                            ","2003-2004",7,"Football",20940,41344,-20404,20940,41344,-20404,0,0,0,"47",".",22740,0
"787",150145,"BETHEL COLLEGE                                              ","2003-2004",1,"Baseball",27500,47910,-20410,27500,47910,-20410,0,0,0,"21",".",25500,0
"8871",170541,"KALAMAZOO VALLEY COMMUNITY COLLEGE                          ","2003-2004",16,"Softball",1,20425,-20424,0,0,0,1,20425,-20424,".","13",0,8652
"12668",220710,"MARYVILLE COLLEGE                                           ","2003-2004",25,"Track and Field, X-Country",10167,30596,-20429,4799,15336,-10537,5368,15260,-9892,"7","6",4677,4601
"5417",231420,"AVERETT UNIVERSITY                                          ","2003-2004",8,"Golf",18000,38477,-20477,18000,38477,-20477,0,0,0,"7","0",19500,0
"4735",121707,"COLLEGE OF THE REDWOODS                                     ","2003-2004",7,"Football",94354,114874,-20520,94354,114874,-20520,0,0,0,"60",".",39840,0
"14662",112172,"CITRUS COLLEGE                                              ","2003-2004",27,"Water Polo",23527,44047,-20520,11760,19626,-7866,11767,24421,-12654,"9","9",8266,8527
"13120",110547,"CALIFORNIA STATE UNIVERSITY-DOMINGUEZ HILLS                 ","2003-2004",26,"Volleyball",12138,32665,-20527,0,0,0,12138,32665,-20527,".","15",0,29870
"3693",162690,"HAGERSTOWN COMMUNITY COLLEGE                                ","2003-2004",3,"All Track Combined",10121,30658,-20537,5002,15672,-10670,5119,14986,-9867,"46",".",11267,9987
"14068",237011,"WESTERN WASHINGTON UNIVERSITY                               ","2003-2004",26,"Volleyball",229888,250454,-20566,0,0,0,229888,250454,-20566,".","13",0,45651
"6045",205470,"SINCLAIR COMMUNITY COLLEGE                                  ","2003-2004",8,"Golf",7672,28255,-20583,80,20663,-20583,7592,7592,0,"7","1",15859,6865
"11324",142294,"ALBERTSON COLLEGE OF IDAHO                                  ","2003-2004",22,"Tennis",3000,23583,-20583,0,0,0,3000,23583,-20583,".","9",0,9100
"10032",206330,"URBANA UNIVERSITY                                           ","2003-2004",16,"Softball",7497,28081,-20584,0,0,0,7497,28081,-20584,".","17",0,20217
"8369",208406,"CLACKAMAS COMMUNITY COLLEGE                                 ","2003-2004",15,"Soccer",4564,25150,-20586,0,0,0,4564,25150,-20586,".","16",0,13055
"15951",100724,"ALABAMA STATE UNIVERSITY                                    ","2003-2004",39,"Total Participants",799116,819727,-20611,276140,302483,-26343,522976,517244,5732,"154","77",1846217,565435
"2537",184348,"DREW UNIVERSITY                                             ","2003-2004",2,"Basketball",126997,147619,-20622,70242,81332,-11090,56755,66287,-9532,"15","13",14253,14969
"4134",231712,"CHRISTOPHER NEWPORT UNIVERSITY                              ","2003-2004",6,"Field hocky",13021,33673,-20652,0,0,0,13021,33673,-20652,".","26",0,10401
"8876",237215,"BLUEFIELD STATE COLLEGE                                     ","2003-2004",16,"Softball",25124,45820,-20696,0,0,0,25124,45820,-20696,".","15",0,18040
"8680",232937,"NORFOLK STATE UNIVERSITY                                    ","2003-2004",16,"Softball",248479,269195,-20716,0,0,0,248479,269195,-20716,".","18",0,180275
"7361",179292,"SAINT LOUIS COMMUNITY COLLEGE-FLORISSANT VALLEY             ","2003-2004",15,"Soccer",11336,32061,-20725,4578,13175,-8597,6758,18886,-12128,"19","21",11007,10640
"8368",168421,"WORCESTER POLYTECHNIC INSTITUTE                             ","2003-2004",15,"Soccer",23680,44415,-20735,11840,24575,-12735,11840,19840,-8000,"30","19",12575,11840
"1493",155627,"OTTAWA UNIVERSITY                                           ","2003-2004",1,"Baseball",33610,54366,-20756,33610,54366,-20756,0,0,0,"24",".",25544,0
"9240",216010,"SHIPPENSBURG UNIVERSITY OF PENNSYLVANIA                     ","2003-2004",16,"Softball",149961,170720,-20759,0,0,0,149961,170720,-20759,".","18",0,39256
"13015",239628,"RIPON COLLEGE                                               ","2003-2004",26,"Volleyball",19920,40692,-20772,0,0,0,19920,40692,-20772,".","16",0,19020
"13557",199999,"WINSTON-SALEM STATE UNIVERSITY                              ","2003-2004",26,"Volleyball",45518,66296,-20778,0,0,0,45518,66296,-20778,".","12",0,17200
"11333",228608,"TEMPLE COLLEGE                                              ","2003-2004",22,"Tennis",45527,66308,-20781,22383,28542,-6159,23144,37766,-14622,"8","6",10888,10890
"8002",131283,"CATHOLIC UNIVERSITY OF AMERICA                              ","2003-2004",15,"Soccer",2,20800,-20798,1,10400,-10399,1,10400,-10399,"25","24",9200,9200
"13029",162654,"GOUCHER COLLEGE                                             ","2003-2004",26,"Volleyball",2098,22902,-20804,0,0,0,2098,22902,-20804,".","12",0,6315
"6298",133650,"FLORIDA AGRICULTURAL AND MECHANICAL UNIVERSITY              ","2003-2004",8,"Golf",1200,22008,-20808,1200,22008,-20808,0,0,0,"8",".",21519,0
"11610",151306,"UNIVERSITY OF SOUTHERN INDIANA                              ","2003-2004",22,"Tennis",84355,105168,-20813,52731,62408,-9677,31624,42760,-11136,"15","8",10937,11136
"14231",229160,"TEXAS WESLEYAN UNIVERSITY                                   ","2003-2004",26,"Volleyball",27237,48063,-20826,0,0,0,27237,48063,-20826,".","21",0,19935
"13173",100706,"UNIVERSITY OF ALABAMA IN HUNTSVILLE                         ","2003-2004",26,"Volleyball",180290,201118,-20828,0,0,0,180290,201118,-20828,".","14",0,47183
"17077",206507,"WILMINGTON COLLEGE                                          ","2003-2004",39,"Total Participants",414146,434984,-20838,206328,220245,-13917,207818,214739,-6921,"251","125",518313,251962
"2299",194541,"POLYTECHNIC UNIVERSITY                                      ","2003-2004",2,"Basketball",26750,47608,-20858,14250,26723,-12473,12500,20885,-8385,"9","11",12316,7924
"14041",164465,"AMHERST COLLEGE                                             ","2003-2004",26,"Volleyball",52576,73465,-20889,0,0,0,52576,73465,-20889,".","12",0,20651
"11822",218973,"WOFFORD COLLEGE                                             ","2003-2004",23,"Track and Field, Indoor",22656,43551,-20895,12081,19873,-7792,10575,23678,-13103,"22","23",4574,4574
"16196",161545,"SOUTHERN MAINE COMMUNITY COLLEGE                            ","2003-2004",39,"Total Participants",28700,49600,-20900,12700,29000,-16300,16000,20600,-4600,"52","30",52000,44100
"13905",141565,"UNIVERSITY OF HAWAII AT HILO                                ","2003-2004",26,"Volleyball",112342,133245,-20903,0,0,0,112342,133245,-20903,".","12",0,52089
"9397",236328,"UNIVERSITY OF PUGET SOUND                                   ","2003-2004",16,"Softball",7413,28317,-20904,0,0,0,7413,28317,-20904,".","21",0,27563
"14836",185590,"MONTCLAIR STATE UNIVERSITY                                  ","2003-2004",28,"Wrestling",2806,23712,-20906,2806,23712,-20906,0,0,0,"27",".",13775,0
"5391",178387,"MISSOURI WESTERN STATE COLLEGE                              ","2003-2004",8,"Golf",63476,84415,-20939,39614,47035,-7421,23862,37380,-13518,"16","8",15805,8478
"1354",131283,"CATHOLIC UNIVERSITY OF AMERICA                              ","2003-2004",1,"Baseball",4000,25000,-21000,4000,25000,-21000,0,0,0,"25",".",13610,0
"3150",119137,"MOORPARK COLLEGE                                            ","2003-2004",2,"Basketball",20104,41128,-21024,8961,20861,-11900,11143,20267,-9124,"13","15",6991,8407
"13017",191339,"GENESEE COMMUNITY COLLEGE                                   ","2003-2004",26,"Volleyball",29398,50492,-21094,11262,21379,-10117,18136,29113,-10977,"12","12",8574,1252
"3280",150561,"TAYLOR UNIVERSITY-FT WAYNE                                  ","2003-2004",2,"Basketball",11560,32662,-21102,6744,15537,-8793,4816,17125,-12309,"7","12",9727,13258
"8856",225627,"UNIVERSITY OF THE INCARNATE WORD                            ","2003-2004",16,"Softball",247360,268473,-21113,0,0,0,247360,268473,-21113,".","20",0,14836
"7050",174783,"SAINT CLOUD STATE UNIVERSITY                                ","2003-2004",14,"Skiing",36045,57170,-21125,0,0,0,36045,57170,-21125,".","6",0,24722
"7827",123457,"SIMPSON COLLEGE                                             ","2003-2004",15,"Soccer",7692,28818,-21126,120,11821,-11701,7572,16997,-9425,"16","13",11721,9977
"4875",195216,"ST LAWRENCE UNIVERSITY                                      ","2003-2004",7,"Football",285281,306435,-21154,285281,306435,-21154,0,0,0,"99",".",56320,0
"16496",172291,"ST CLAIR COUNTY COMMUNITY COLLEGE                           ","2003-2004",39,"Total Participants",135463,156628,-21165,69067,79341,-10274,66396,77287,-10891,"49","38",65488,56883
"7627",201654,"CEDARVILLE UNIVERSITY                                       ","2003-2004",15,"Soccer",191085,212264,-21179,99045,116907,-17862,92040,95357,-3317,"26","29",33750,21543
"8328",120971,"PALOMAR COLLEGE                                             ","2003-2004",15,"Soccer",10056,31238,-21182,4149,15880,-11731,5907,15358,-9451,"24","21",5987,4965
"9396",199412,"QUEENS UNIVERSITY OF CHARLOTTE                              ","2003-2004",16,"Softball",87253,108438,-21185,0,0,0,87253,108438,-21185,".","17",0,13558
"8815",240417,"UNIVERSITY OF WISCONSIN-STOUT                               ","2003-2004",16,"Softball",57750,78936,-21186,0,0,0,57750,78936,-21186,".","17",0,47107
"15542",225885,"JARVIS CHRISTIAN COLLEGE                                    ","2003-2004",39,"Total Participants",4140,25339,-21199,3142,15556,-12414,998,9783,-8785,"34","27",35148,28987
"12156",199582,"SAINT AUGUSTINES COLLEGE                                    ","2003-2004",24,"Track and Field, Outdoor",159541,180791,-21250,117742,109930,7812,41799,70861,-29062,"27","17",13023,10018
"9463",162584,"FROSTBURG STATE UNIVERSITY                                  ","2003-2004",16,"Softball",33358,54620,-21262,0,0,0,33358,54620,-21262,".","16",0,23989
"6271",179894,"WEBSTER UNIVERSITY                                          ","2003-2004",8,"Golf",3015,24312,-21297,3015,24312,-21297,0,0,0,"14",".",5798,0
"11005",153825,"LORAS COLLEGE                                               ","2003-2004",22,"Tennis",174,21472,-21298,87,11461,-11374,87,10011,-9924,"13","15",3732,2667
"4400",174604,"RAINY RIVER COMMUNITY COLLEGE                               ","2003-2004",7,"Football",24845,46144,-21299,24845,46144,-21299,0,0,0,"55",".",23436,0
"16509",236610,"SHORELINE COMMUNITY COLLEGE                                 ","2003-2004",39,"Total Participants",149148,170452,-21304,62015,77468,-15453,87133,92984,-5851,"59","57",57103,68887
"4213",232681,"MARY WASHINGTON COLLEGE                                     ","2003-2004",6,"Field hocky",31448,52797,-21349,0,0,0,31448,52797,-21349,".","25",0,16470
"16108",114938,"GAVILAN COLLEGE                                             ","2003-2004",39,"Total Participants",67284,88637,-21353,35854,42073,-6219,31430,46564,-15134,"112","40",74284,22643
"13153",208390,"CHEMEKETA COMMUNITY COLLEGE                                 ","2003-2004",26,"Volleyball",500,21883,-21383,0,0,0,500,21883,-21383,".","12",0,21882
"2439",181312,"MID PLAINS COMMUNITY COLLEGE AREA                           ","2003-2004",2,"Basketball",155434,176818,-21384,87599,93828,-6229,67835,82990,-15155,"33","26",39398,35728
"9127",161554,"UNIVERSITY OF SOUTHERN MAINE                                ","2003-2004",16,"Softball",56689,78097,-21408,0,0,0,56689,78097,-21408,".","20",0,57890
"724",133951,"FLORIDA INTERNATIONAL UNIVERSITY                            ","2003-2004",1,"Baseball",716452,737870,-21418,716452,737870,-21418,0,0,0,"38",".",184032,0
"13185",235167,"EVERGREEN STATE COLLEGE                                     ","2003-2004",26,"Volleyball",790,22213,-21423,0,0,0,790,22213,-21423,".","10",0,10785
"283",192925,"MEDAILLE COLLEGE                                            ","2003-2004",1,"Baseball",8440,29886,-21446,8440,29886,-21446,0,0,0,"21",".",25286,0
"1576",157401,"MURRAY STATE UNIVERSITY                                     ","2003-2004",1,"Baseball",313492,334938,-21446,313492,334938,-21446,0,0,0,"28",".",60454,0
"11800",231712,"CHRISTOPHER NEWPORT UNIVERSITY                              ","2003-2004",22,"Tennis",20000,41454,-21454,10000,18953,-8953,10000,22501,-12501,"9","10",7208,7087
"9964",233499,"SAINT PAULS COLLEGE                                         ","2003-2004",16,"Softball",900,22363,-21463,0,0,0,900,22363,-21463,".","16",0,11765
"4130",215929,"UNIVERSITY OF SCRANTON                                      ","2003-2004",6,"Field hocky",54149,75621,-21472,0,0,0,54149,75621,-21472,".","20",0,13782
"814",237701,"POTOMAC STATE COLLEGE OF WEST VIRGINIA UNIVERSITY           ","2003-2004",1,"Baseball",17000,38495,-21495,17000,38495,-21495,0,0,0,"36",".",19180,0
"9379",239248,"MILWAUKEE AREA TECHNICAL COLLEGE                            ","2003-2004",16,"Softball",1,21500,-21499,0,0,0,1,21500,-21499,".","18",0,14000
"673",169798,"EASTERN MICHIGAN UNIVERSITY                                 ","2003-2004",1,"Baseball",498354,519870,-21516,498354,519870,-21516,0,0,0,"35",".",162318,0
"6820",164173,"VILLA JULIE COLLEGE                                         ","2003-2004",11,"Lacrosse",34041,55594,-21553,19060,30152,-11092,14981,25442,-10461,"18","19",16552,14934
"13054",153384,"GRINNELL COLLEGE                                            ","2003-2004",26,"Volleyball",20210,41775,-21565,0,0,0,20210,41775,-21565,".","17",0,20142
"5969",110547,"CALIFORNIA STATE UNIVERSITY-DOMINGUEZ HILLS                 ","2003-2004",8,"Golf",7875,29463,-21588,7875,29463,-21588,0,0,0,"8",".",21845,0
"16110",179946,"WESTMINSTER COLLEGE                                         ","2003-2004",39,"Total Participants",119400,141000,-21600,58200,71500,-13300,61200,69500,-8300,"156","62",138500,73500
"4952",121619,"SANTA ANA COLLEGE                                           ","2003-2004",7,"Football",6202,27807,-21605,6202,27807,-21605,0,0,0,"84",".",21554,0
"9720",169798,"EASTERN MICHIGAN UNIVERSITY                                 ","2003-2004",16,"Softball",309448,331098,-21650,0,0,0,309448,331098,-21650,".","16",0,67246
"1033",173142,"BETHANY LUTHERAN COLLEGE                                    ","2003-2004",1,"Baseball",51429,73094,-21665,51429,73094,-21665,0,0,0,"18",".",16901,0
"15798",236188,"OLYMPIC COLLEGE                                             ","2003-2004",39,"Total Participants",100050,121720,-21670,43250,62565,-19315,56800,59155,-2355,"36","31",37883,26314
"9446",168254,"WESTERN NEW ENGLAND COLLEGE                                 ","2003-2004",16,"Softball",18345,40016,-21671,0,0,0,18345,40016,-21671,".","20",0,14930
"13552",189088,"BARD COLLEGE                                                ","2003-2004",26,"Volleyball",638,22320,-21682,319,7452,-7133,319,14868,-14549,"9","9",3400,6609
"2686",171304,"MUSKEGON COMMUNITY COLLEGE                                  ","2003-2004",2,"Basketball",66552,88238,-21686,36583,46813,-10230,29969,41425,-11456,"15","13",17369,15404
"1416",206330,"URBANA UNIVERSITY                                           ","2003-2004",1,"Baseball",13783,35476,-21693,13783,35476,-21693,0,0,0,"31",".",26945,0
"7469",234979,"COLUMBIA BASIN COLLEGE                                      ","2003-2004",15,"Soccer",37000,58708,-21708,18500,28754,-10254,18500,29954,-11454,"17","13",12973,14573
"3201",182670,"DARTMOUTH COLLEGE                                           ","2003-2004",2,"Basketball",782371,804085,-21714,427480,433347,-5867,354891,370738,-15847,"15","11",122051,71631
"8257",138293,"WEBBER INTERNATIONAL UNIVERSITY                             ","2003-2004",15,"Soccer",201958,223690,-21732,96692,103707,-7015,105266,119983,-14717,"23","25",12802,13250
"15678",134495,"HILLSBOROUGH COMMUNITY COLLEGE                              ","2003-2004",39,"Total Participants",45370,67107,-21737,15500,28787,-13287,29870,38320,-8450,"41","58",28300,42420
"10027",154934,"COLBY COMMUNITY COLLEGE                                     ","2003-2004",16,"Softball",1650,23431,-21781,0,0,0,1650,23431,-21781,".","15",0,18590
"2792",178387,"MISSOURI WESTERN STATE COLLEGE                              ","2003-2004",2,"Basketball",559091,580874,-21783,309643,332215,-22572,249448,248659,789,"15","13",40212,30490
"8851",140669,"NORTH GEORGIA COLLEGE AND STATE UNIVERSITY                  ","2003-2004",16,"Softball",103258,125058,-21800,0,0,0,103258,125058,-21800,".","16",0,64470
"10019",162007,"BOWIE STATE UNIVERSITY                                      ","2003-2004",16,"Softball",27932,49753,-21821,0,0,0,27932,49753,-21821,".","10",0,19787
"4123",162584,"FROSTBURG STATE UNIVERSITY                                  ","2003-2004",6,"Field hocky",49795,71622,-21827,0,0,0,49795,71622,-21827,".","23",0,22520
"14367",115728,"HOLY NAMES UNIVERSITY                                       ","2003-2004",26,"Volleyball",100,21932,-21832,0,0,0,100,21932,-21832,".","8",0,14265
"15313",207865,"SOUTHWESTERN OKLAHOMA STATE UNIVERSITY                      ","2003-2004",35,"Rodeo",21600,43434,-21834,10800,21717,-10917,10800,21717,-10917,"24","18",11243,11243
"14658",120971,"PALOMAR COLLEGE                                             ","2003-2004",27,"Water Polo",6923,28816,-21893,3512,14563,-11051,3411,14253,-10842,"13","10",4670,4860
"11069",237330,"CONCORD COLLEGE                                             ","2003-2004",22,"Tennis",23790,45688,-21898,12088,23172,-11084,11702,22516,-10814,"17","6",6046,2926
"13277",240480,"UNIVERSITY OF WISCONSIN-STEVENS POINT                       ","2003-2004",26,"Volleyball",24374,46274,-21900,0,0,0,24374,46274,-21900,".","18",0,16133
"12505",107071,"HENDERSON STATE UNIVERSITY                                  ","2003-2004",25,"Track and Field, X-Country",14730,36634,-21904,0,0,0,14730,36634,-21904,".","12",0,5407
"5970",228608,"TEMPLE COLLEGE                                              ","2003-2004",8,"Golf",24029,45937,-21908,24029,45937,-21908,0,0,0,"12",".",14904,0
"6011",154925,"COFFEYVILLE COMMUNITY COLLEGE &amp; AREA TECH SCHOOL            ","2003-2004",8,"Golf",3200,25131,-21931,3200,25131,-21931,0,0,0,"5",".",6715,0
"8173",203580,"LAKE ERIE COLLEGE                                           ","2003-2004",15,"Soccer",29377,51316,-21939,15646,26022,-10376,13731,25294,-11563,"17","15",12502,11544
"8452",196006,"SUNY COLLEGE OF TECHNOLOGY AT ALFRED                        ","2003-2004",15,"Soccer",36273,58212,-21939,19807,30631,-10824,16466,27581,-11115,"26","20",13096,8000
"5590",142294,"ALBERTSON COLLEGE OF IDAHO                                  ","2003-2004",8,"Golf",1960,23900,-21940,980,11950,-10970,980,11950,-10970,"7","2",3750,3750
"12017",109208,"AMERICAN RIVER COLLEGE                                      ","2003-2004",24,"Track and Field, Outdoor",9100,31055,-21955,4530,16311,-11781,4570,14744,-10174,"37","16",12856,11389
"270",102270,"STILLMAN COLLEGE                                            ","2003-2004",1,"Baseball",11000,33000,-22000,11000,33000,-22000,0,0,0,"24",".",11000,0
"14444",199412,"QUEENS UNIVERSITY OF CHARLOTTE                              ","2003-2004",26,"Volleyball",90464,112464,-22000,0,0,0,90464,112464,-22000,".","18",0,8624
"4180",221351,"RHODES COLLEGE                                              ","2003-2004",6,"Field hocky",24500,46547,-22047,0,0,0,24500,46547,-22047,".","17",0,24600
"14896",240329,"UNIVERSITY OF WISCONSIN-LA CROSSE                           ","2003-2004",28,"Wrestling",70711,92762,-22051,70711,92762,-22051,0,0,0,"30",".",34192,0
"4582",191968,"ITHACA COLLEGE                                              ","2003-2004",7,"Football",317687,339767,-22080,317687,339767,-22080,0,0,0,"86",".",174327,0
"2359",120290,"OHLONE COLLEGE                                              ","2003-2004",2,"Basketball",33444,55561,-22117,20371,33119,-12748,13073,22442,-9369,"15","12",16561,11731
"14425",206835,"OKLAHOMA WESLEYAN UNIVERSITY                                ","2003-2004",26,"Volleyball",59053,81172,-22119,0,0,0,59053,81172,-22119,".","15",0,10503
"12339",105297,"DINE COLLEGE                                                ","2003-2004",25,"Track and Field, X-Country",9770,31935,-22165,4885,18000,-13115,4885,13935,-9050,"8","4",8130,4065
"13509",147660,"NORTH CENTRAL COLLEGE                                       ","2003-2004",26,"Volleyball",28647,50859,-22212,0,0,0,28647,50859,-22212,".","23",0,17000
"1513",215275,"UNIVERSITY OF PITTSBURGH-GREENSBURG                         ","2003-2004",1,"Baseball",50,22263,-22213,50,22263,-22213,0,0,0,"18",".",12600,0
"4325",204200,"COLLEGE OF MOUNT SAINT JOSEPH                               ","2003-2004",7,"Football",212684,234919,-22235,212684,234919,-22235,0,0,0,"80",".",71626,0
"3481",121886,"RIO HONDO COLLEGE                                           ","2003-2004",2,"Basketball",37031,59286,-22255,20181,32289,-12108,16850,26997,-10147,"14","12",10560,14517
"11863",196006,"SUNY COLLEGE OF TECHNOLOGY AT ALFRED                        ","2003-2004",23,"Track and Field, Indoor",18006,40264,-22258,9003,25540,-16537,9003,14724,-5721,"15","9",8940,5364
"9859",224961,"GALVESTON COLLEGE                                           ","2003-2004",16,"Softball",2500,24763,-22263,0,0,0,2500,24763,-22263,".","16",0,13218
"15221",198543,"FAYETTEVILLE STATE UNIVERSITY                               ","2003-2004",33,"Bowling",1,22278,-22277,0,0,0,1,22278,-22277,".","8",0,17280
"2002",122597,"SAN FRANCISCO STATE UNIVERSITY                              ","2003-2004",2,"Basketball",344323,366628,-22305,176156,181593,-5437,168167,185035,-16868,"14","18",31751,32788
"10994",226833,"MIDWESTERN STATE UNIVERSITY                                 ","2003-2004",22,"Tennis",801,23149,-22348,1,12452,-12451,800,10697,-9897,"8","8",9450,9450
"9133",173805,"ITASCA COMMUNITY COLLEGE                                    ","2003-2004",16,"Softball",7839,30194,-22355,0,0,0,7839,30194,-22355,".","12",0,4549
"14175",153108,"CENTRAL COLLEGE                                             ","2003-2004",26,"Volleyball",89557,111940,-22383,0,0,0,89557,111940,-22383,".","33",0,25969
"9193",216357,"THIEL COLLEGE                                               ","2003-2004",16,"Softball",4942,27329,-22387,0,0,0,4942,27329,-22387,".","15",0,9692
"1910",185572,"MONMOUTH UNIVERSITY                                         ","2003-2004",2,"Basketball",1456278,1478667,-22389,826129,848642,-22513,630149,630025,124,"15","11",161978,85398
"6379",236577,"SEATTLE PACIFIC UNIVERSITY                                  ","2003-2004",9,"Gymnastics",302955,325344,-22389,0,0,0,302955,325344,-22389,".","15",0,46999
"5393",153825,"LORAS COLLEGE                                               ","2003-2004",8,"Golf",7245,29641,-22396,5703,18389,-12686,1542,11252,-9710,"14","10",6758,3058
"12141",218973,"WOFFORD COLLEGE                                             ","2003-2004",24,"Track and Field, Outdoor",21150,43551,-22401,10575,19873,-9298,10575,23678,-13103,"22","23",4574,4574
"12423",218973,"WOFFORD COLLEGE                                             ","2003-2004",25,"Track and Field, X-Country",21150,43551,-22401,10575,19873,-9298,10575,23678,-13103,"7","9",4574,13722
"983",218070,"FURMAN UNIVERSITY                                           ","2003-2004",1,"Baseball",452013,474422,-22409,452013,474422,-22409,0,0,0,"35",".",107227,0
"14482",240426,"UNIVERSITY OF WISCONSIN-SUPERIOR                            ","2003-2004",26,"Volleyball",25136,47557,-22421,0,0,0,25136,47557,-22421,".","15",0,24057
"4285",224527,"EAST TEXAS BAPTIST UNIVERSITY                               ","2003-2004",7,"Football",441802,464228,-22426,441802,464228,-22426,0,0,0,"94",".",131057,0
"11992",209250,"MT HOOD COMMUNITY COLLEGE                                   ","2003-2004",24,"Track and Field, Outdoor",1492,23940,-22448,746,11970,-11224,746,11970,-11224,"13","12",11793,11793
"738",174251,"UNIVERSITY OF MINNESOTA-MORRIS                              ","2003-2004",1,"Baseball",24519,46975,-22456,24519,46975,-22456,0,0,0,"24",".",20821,0
"311",243151,"UNIVERSITY OF PUERTO RICO-CAYEY UNIVERSITY COLLEGE          ","2003-2004",1,"Baseball",14280,36739,-22459,14280,36739,-22459,0,0,0,"21",".",7560,0
"13441",157809,"THOMAS MORE COLLEGE                                         ","2003-2004",26,"Volleyball",23709,46199,-22490,0,0,0,23709,46199,-22490,".","15",0,14280
"16249",141097,"SOUTHERN POLYTECHNIC STATE UNIVERSITY                       ","2003-2004",39,"Total Participants",181500,204000,-22500,181500,204000,-22500,0,0,0,"54","13",46820,24490
"5104",237330,"CONCORD COLLEGE                                             ","2003-2004",8,"Golf",51409,73918,-22509,51409,73918,-22509,0,0,0,"21",".",29689,0
"7106",170790,"MACOMB COMMUNITY COLLEGE                                    ","2003-2004",15,"Soccer",20645,43213,-22568,20645,43213,-22568,0,0,0,"20",".",31949,0
"2334",153366,"GRACELAND UNIVERSITY-LAMONI                                 ","2003-2004",2,"Basketball",349163,371760,-22597,186054,175632,10422,163109,196128,-33019,"28","22",31485,36599
"10766",175829,"ITAWAMBA COMMUNITY COLLEGE                                  ","2003-2004",22,"Tennis",2,22612,-22610,1,11306,-11305,1,11306,-11305,"8","6",4974,4974
"1346",201654,"CEDARVILLE UNIVERSITY                                       ","2003-2004",1,"Baseball",75333,97958,-22625,75333,97958,-22625,0,0,0,"29",".",30563,0
"3023",190594,"CUNY HUNTER COLLEGE                                         ","2003-2004",2,"Basketball",7878,30529,-22651,1275,13092,-11817,6603,17437,-10834,"13","27",7092,9937
"17170",228325,"SOUTHWESTERN ASSEMBLIES OF GOD UNIVERSITY                   ","2003-2004",39,"Total Participants",137743,160410,-22667,74029,76485,-2456,63714,83925,-20211,"106","35",114546,49891
"14088",216807,"WESTMINSTER COLLEGE                                         ","2003-2004",26,"Volleyball",44142,66817,-22675,0,0,0,44142,66817,-22675,".","11",0,14382
"9618",215275,"UNIVERSITY OF PITTSBURGH-GREENSBURG                         ","2003-2004",16,"Softball",1,22712,-22711,0,0,0,1,22712,-22711,".","13",0,7332
"1164",209825,"UNIVERSITY OF PORTLAND                                      ","2003-2004",1,"Baseball",521362,544106,-22744,521362,544106,-22744,0,0,0,"30",".",146980,0
"8991",157757,"SPALDING UNIVERSITY                                         ","2003-2004",16,"Softball",250,23035,-22785,0,0,0,250,23035,-22785,".","17",0,23035
"15385",243197,"UNIVERSITY OF PUERTO RICO-MAYAGUEZ                          ","2003-2004",37,"Table Tennis",3719,26515,-22796,1860,11732,-9872,1859,14783,-12924,"5","6",1860,1859
"13971",152336,"UNIVERSITY OF SAINT FRANCIS-FT WAYNE                        ","2003-2004",26,"Volleyball",13583,36398,-22815,0,0,0,13583,36398,-22815,".","18",0,15204
"16202",187444,"WILLIAM PATERSON UNIVERSITY OF NEW JERSEY                   ","2003-2004",39,"Total Participants",534117,556934,-22817,236763,249488,-12725,297354,307446,-10092,"220","148",183541,141283
"15884",149514,"TRINITY INTERNATIONAL UNIVERSITY                            ","2003-2004",39,"Total Participants",1220132,1242994,-22862,569427,590438,-21011,650705,652556,-1851,"120","70",208836,93459
"8163",196194,"SUNY COLLEGE AT OSWEGO                                      ","2003-2004",15,"Soccer",103675,126546,-22871,51353,60852,-9499,52322,65694,-13372,"36","28",27443,29552
"1558",239248,"MILWAUKEE AREA TECHNICAL COLLEGE                            ","2003-2004",1,"Baseball",1,22900,-22899,1,22900,-22899,0,0,0,"21",".",8900,0
"10140",203128,"HIRAM COLLEGE                                               ","2003-2004",18,"Swimming and Diving",56900,79800,-22900,28450,39900,-11450,28450,39900,-11450,"13","14",11250,11250
"14306",154749,"BETHEL COLLEGE                                              ","2003-2004",26,"Volleyball",16019,38927,-22908,0,0,0,16019,38927,-22908,".","17",0,14232
"7382",136215,"NOVA SOUTHEASTERN UNIVERSITY                                ","2003-2004",15,"Soccer",470868,493786,-22918,233884,242108,-8224,236984,251678,-14694,"19","21",40776,49489
"11921",185129,"NEW JERSEY CITY UNIVERSITY                                  ","2003-2004",23,"Track and Field, Indoor",5350,28293,-22943,2250,14146,-11896,3100,14147,-11047,"9","6",3005,2618
"16070",212133,"EASTERN UNIVERSITY                                          ","2003-2004",39,"Total Participants",169773,192720,-22947,59662,70610,-10948,110111,122110,-11999,"69","103",52200,87320
"8099",147660,"NORTH CENTRAL COLLEGE                                       ","2003-2004",15,"Soccer",25936,48897,-22961,13766,27397,-13631,12170,21500,-9330,"28","24",10397,12000
"7114",150145,"BETHEL COLLEGE                                              ","2003-2004",15,"Soccer",38700,61670,-22970,18350,26964,-8614,20350,34706,-14356,"26","20",22100,22350
"16372",153621,"IOWA WESLEYAN COLLEGE                                       ","2003-2004",39,"Total Participants",116078,139069,-22991,60819,67424,-6605,55259,71645,-16386,"167","83",169021,82579
"7253",168786,"AQUINAS COLLEGE                                             ","2003-2004",15,"Soccer",20000,43000,-23000,10000,23000,-13000,10000,20000,-10000,"22","23",24992,25001
"144",140669,"NORTH GEORGIA COLLEGE AND STATE UNIVERSITY                  ","2003-2004",1,"Baseball",157330,180338,-23008,157330,180338,-23008,0,0,0,"36",".",115056,0
"15772",175643,"EAST CENTRAL COMMUNITY COLLEGE                              ","2003-2004",39,"Total Participants",331813,354823,-23010,225816,225498,318,105997,129325,-23328,"133","42",122683,53400
"7203",120290,"OHLONE COLLEGE                                              ","2003-2004",15,"Soccer",16724,39743,-23019,8485,20350,-11865,8239,19393,-11154,"18","16",9139,8182
"508",240462,"UNIVERSITY OF WISCONSIN-PLATTEVILLE                         ","2003-2004",1,"Baseball",59116,82140,-23024,59116,82140,-23024,0,0,0,"32",".",30573,0
"4573",138293,"WEBBER INTERNATIONAL UNIVERSITY                             ","2003-2004",7,"Football",451952,475000,-23048,451952,475000,-23048,0,0,0,"105",".",82000,0
"3125",434672,"THE COMMUNITY COLLEGE OF BALTIMORE COUNTY                   ","2003-2004",2,"Basketball",69918,92968,-23050,50208,59538,-9330,19710,33430,-13720,"36","13",48955,31980
"2561",188438,"ADIRONDACK COMMUNITY COLLEGE                                ","2003-2004",2,"Basketball",2148,25230,-23082,1466,11782,-10316,682,13448,-12766,"15","8",8140,8130
"8237",239628,"RIPON COLLEGE                                               ","2003-2004",15,"Soccer",37000,60101,-23101,18500,31578,-13078,18500,28523,-10023,"27","17",18500,18500
"5564",227401,"PARIS JUNIOR COLLEGE                                        ","2003-2004",8,"Golf",1,23115,-23114,1,23115,-23114,0,0,0,"9",".",10041,0
"12187",155186,"HIGHLAND COMMUNITY COLLEGE                                  ","2003-2004",25,"Track and Field, X-Country",110447,133565,-23118,49655,63526,-13871,60792,70039,-9247,"19","22",30212,31224
"14397",112561,"COLUMBIA COLLEGE                                            ","2003-2004",26,"Volleyball",11129,34285,-23156,0,0,0,11129,34285,-23156,".","9",0,12691
"16310",112561,"COLUMBIA COLLEGE                                            ","2003-2004",39,"Total Participants",11129,34285,-23156,0,0,0,11129,34285,-23156,"11","9",18251,12691
"5807",170639,"LAKE SUPERIOR STATE UNIVERSITY                              ","2003-2004",8,"Golf",1882,25045,-23163,1882,25045,-23163,0,0,0,"5",".",6312,0
"289",157809,"THOMAS MORE COLLEGE                                         ","2003-2004",1,"Baseball",56092,79261,-23169,56092,79261,-23169,0,0,0,"55",".",20295,0
"6131",216357,"THIEL COLLEGE                                               ","2003-2004",8,"Golf",4129,27301,-23172,2194,14135,-11941,1935,13166,-11231,"9","6",1573,910
"15709",191241,"FORDHAM UNIVERSITY                                          ","2003-2004",39,"Total Participants",4213574,4236746,-23172,1533718,1503253,30465,2679856,2733493,-53637,"369","233",765925,490929
"11550",155858,"SEWARD COUNTY COMMUNITY COLLEGE                             ","2003-2004",22,"Tennis",31390,54584,-23194,15695,30801,-15106,15695,23783,-8088,"7","6",7354,7354
"10640",225627,"UNIVERSITY OF THE INCARNATE WORD                            ","2003-2004",20,"Synchronized swimming",38654,61855,-23201,0,0,0,38654,61855,-23201,".","7",0,11365
"7757",178402,"UNIVERSITY OF MISSOURI-KANSAS CITY                          ","2003-2004",15,"Soccer",316401,339605,-23204,316401,339605,-23204,0,0,0,"33",".",49183,0
"8809",175643,"EAST CENTRAL COMMUNITY COLLEGE                              ","2003-2004",16,"Softball",82285,105495,-23210,0,0,0,82285,105495,-23210,".","17",0,15805
"11878",239628,"RIPON COLLEGE                                               ","2003-2004",23,"Track and Field, Indoor",13250,36470,-23220,6625,18235,-11610,6625,18235,-11610,"23","19",6625,6625
"12113",239628,"RIPON COLLEGE                                               ","2003-2004",24,"Track and Field, Outdoor",13250,36470,-23220,6625,18235,-11610,6625,18235,-11610,"23","19",6625,6625
"5732",174844,"SAINT OLAF COLLEGE                                          ","2003-2004",8,"Golf",3650,26909,-23259,2100,13613,-11513,1550,13296,-11746,"12","9",10533,7000
"12931",153108,"CENTRAL COLLEGE                                             ","2003-2004",25,"Track and Field, X-Country",24586,47870,-23284,13160,24361,-11201,11426,23509,-12083,"19","14",9224,8410
"4884",240417,"UNIVERSITY OF WISCONSIN-STOUT                               ","2003-2004",7,"Football",226955,250252,-23297,226955,250252,-23297,0,0,0,"100",".",77300,0
"5207",152530,"TAYLOR UNIVERSITY-UPLAND                                    ","2003-2004",8,"Golf",15209,38515,-23306,15209,38515,-23306,0,0,0,"7",".",26240,0
"16155",236638,"SKAGIT VALLEY COLLEGE                                       ","2003-2004",39,"Total Participants",98504,121812,-23308,48513,59622,-11109,49991,62190,-12199,"74","76",60513,60991
"13696",154059,"NORTH IOWA AREA COMMUNITY COLLEGE                           ","2003-2004",26,"Volleyball",2389,25718,-23329,0,0,0,2389,25718,-23329,".","10",0,10518
"1360",207865,"SOUTHWESTERN OKLAHOMA STATE UNIVERSITY                      ","2003-2004",1,"Baseball",21486,44874,-23388,21486,44874,-23388,0,0,0,"42",".",21486,0
"6954",111948,"CHAPMAN UNIVERSITY                                          ","2003-2004",13,"Rowing",31000,54400,-23400,0,0,0,31000,54400,-23400,".","11",0,16000
"13751",183062,"KEENE STATE COLLEGE                                         ","2003-2004",26,"Volleyball",3570,26973,-23403,0,0,0,3570,26973,-23403,".","14",0,16905
"6825",434672,"THE COMMUNITY COLLEGE OF BALTIMORE COUNTY                   ","2003-2004",11,"Lacrosse",47698,71108,-23410,29365,43415,-14050,18333,27693,-9360,"52","27",29500,22920
"9819",228608,"TEMPLE COLLEGE                                              ","2003-2004",16,"Softball",76311,99789,-23478,0,0,0,76311,99789,-23478,".","16",0,28208
"8135",174437,"NORTH CENTRAL UNIVERSITY                                    ","2003-2004",15,"Soccer",8915,32395,-23480,4550,16535,-11985,4365,15860,-11495,"19","16",11550,10875
"12387",177940,"LINCOLN UNIVERSITY                                          ","2003-2004",25,"Track and Field, X-Country",10861,34357,-23496,0,0,0,10861,34357,-23496,".","6",0,10726
"12790",155511,"MCPHERSON COLLEGE                                           ","2003-2004",25,"Track and Field, X-Country",6023,29523,-23500,3011,14761,-11750,3012,14762,-11750,"2","3",3011,3012
"100",219259,"NORTHERN STATE UNIVERSITY                                   ","2003-2004",1,"Baseball",19342,42947,-23605,19342,42947,-23605,0,0,0,"28",".",16162,0
"12640",110547,"CALIFORNIA STATE UNIVERSITY-DOMINGUEZ HILLS                 ","2003-2004",25,"Track and Field, X-Country",4468,28087,-23619,0,0,0,4468,28087,-23619,".","44",0,27927
"714",133881,"FLORIDA INSTITUTE OF TECHNOLOGY-MELBOURNE                   ","2003-2004",1,"Baseball",304142,327771,-23629,304142,327771,-23629,0,0,0,"35",".",49533,0
"14072",237039,"WHATCOM COMMUNITY COLLEGE                                   ","2003-2004",26,"Volleyball",1,23631,-23630,0,0,0,1,23631,-23630,".","12",0,14928
"16960",237039,"WHATCOM COMMUNITY COLLEGE                                   ","2003-2004",39,"Total Participants",1,23631,-23630,0,0,0,1,23631,-23630,"13","21",9902,24630
"7074",211361,"CALIFORNIA UNIVERSITY OF PENNSYLVANIA                       ","2003-2004",15,"Soccer",289285,312966,-23681,145473,162670,-17197,143812,150296,-6484,"33","22",20204,18035
"10652",100663,"UNIVERSITY OF ALABAMA AT BIRMINGHAM                         ","2003-2004",22,"Tennis",387954,411642,-23688,161341,185029,-23688,226613,226613,0,"9","8",35326,40580
"4609",108807,"ALLAN HANCOCK COLLEGE                                       ","2003-2004",7,"Football",110200,133920,-23720,110200,133920,-23720,0,0,0,"68",".",47069,0
"10553",185828,"NEW JERSEY INSTITUTE OF TECHNOLOGY                          ","2003-2004",19,"Swimming",9450,33186,-23736,4725,15093,-10368,4725,18093,-13368,"10","11",4725,4725
"2740",183859,"BROOKDALE COMMUNITY COLLEGE                                 ","2003-2004",2,"Basketball",26000,49750,-23750,13000,24250,-11250,13000,25500,-12500,"15","15",16350,15255
"6386",240268,"UNIVERSITY OF WISCONSIN-EAU CLAIRE                          ","2003-2004",10,"Ice Hockey",123141,146903,-23762,67076,78247,-11171,56065,68656,-12591,"27","23",30744,24176
"15219",133650,"FLORIDA AGRICULTURAL AND MECHANICAL UNIVERSITY              ","2003-2004",33,"Bowling",1,23772,-23771,0,0,0,1,23772,-23771,".","7",0,21536
"2300",174136,"MINNEAPOLIS COMMUNITY AND TECHNICAL COLLEGE                 ","2003-2004",2,"Basketball",49082,72881,-23799,24541,39299,-14758,24541,33582,-9041,"15","10",24541,24541
"16332",196079,"SUNY AT BINGHAMTON                                          ","2003-2004",39,"Total Participants",3929210,3953010,-23800,2010068,2025978,-15910,1919142,1927032,-7890,"247","216",434055,366621
"9536",101143,"ENTERPRISE-OZARK COMMUNITY COLLEGE                          ","2003-2004",16,"Softball",15614,39416,-23802,0,0,0,15614,39416,-23802,".","18",0,38654
"946",123484,"COLLEGE OF THE SISKIYOUS                                    ","2003-2004",1,"Baseball",41339,65145,-23806,41339,65145,-23806,0,0,0,"25",".",40200,0
"16356",195988,"SULLIVAN COUNTY COMMUNITY COLLEGE                           ","2003-2004",39,"Total Participants",23660,47481,-23821,11830,20845,-9015,11830,26636,-14806,"28","33",47647,47744
"9727",159717,"MCNEESE STATE UNIVERSITY                                    ","2003-2004",16,"Softball",252804,276643,-23839,0,0,0,252804,276643,-23839,".","24",0,79571
"17005",154396,"SOUTHWESTERN COMMUNITY COLLEGE                              ","2003-2004",39,"Total Participants",38575,62438,-23863,13160,20798,-7638,25415,41640,-16225,"45","41",30382,47666
"10481",165936,"GORDON COLLEGE                                              ","2003-2004",19,"Swimming",5000,28908,-23908,2500,14454,-11954,2500,14454,-11954,"10","20",10220,1220
"9734",151306,"UNIVERSITY OF SOUTHERN INDIANA                              ","2003-2004",16,"Softball",72960,96874,-23914,0,0,0,72960,96874,-23914,".","18",0,26622
"13842",211079,"COMMUNITY COLLEGE OF BEAVER COUNTY                          ","2003-2004",26,"Volleyball",3200,27137,-23937,0,0,0,3200,27137,-23937,".","9",0,6461
"8423",223773,"CEDAR VALLEY COLLEGE                                        ","2003-2004",15,"Soccer",39220,63175,-23955,0,0,0,39220,63175,-23955,".","18",0,22922
"14724",212601,"GANNON UNIVERSITY                                           ","2003-2004",27,"Water Polo",127171,151137,-23966,63455,74356,-10901,63716,76781,-13065,"13","18",16144,17929
"4974",216278,"SUSQUEHANNA UNIVERSITY                                      ","2003-2004",7,"Football",193317,217313,-23996,193317,217313,-23996,0,0,0,"95",".",34313,0
"9515",226329,"LON MORRIS COLLEGE                                          ","2003-2004",16,"Softball",16282,40278,-23996,0,0,0,16282,40278,-23996,".","24",0,12278
"3257",225247,"HARDIN-SIMMONS UNIVERSITY                                   ","2003-2004",2,"Basketball",32000,56000,-24000,12000,28000,-16000,20000,28000,-8000,"15","23",25000,25000
"7197",157863,"UNION COLLEGE                                               ","2003-2004",15,"Soccer",248000,272000,-24000,124000,136000,-12000,124000,136000,-12000,"22","19",12000,12169
"11680",193292,"MOLLOY COLLEGE                                              ","2003-2004",22,"Tennis",5000,29000,-24000,0,0,0,5000,29000,-24000,".","6",0,3000
"13108",222567,"ALVIN COMMUNITY COLLEGE                                     ","2003-2004",26,"Volleyball",15819,39819,-24000,0,0,0,15819,39819,-24000,"0","11",0,15819
"13603",217873,"CLAFLIN UNIVERSITY                                          ","2003-2004",26,"Volleyball",2000,26000,-24000,0,0,0,2000,26000,-24000,".","9",0,6000
"5118",176071,"MISSISSIPPI GULF COAST COMMUNITY COLLEGE                    ","2003-2004",8,"Golf",1,24010,-24009,1,24010,-24009,0,0,0,"10",".",5572,0
"11597",168591,"ALMA COLLEGE                                                ","2003-2004",22,"Tennis",17097,41124,-24027,9245,16059,-6814,7852,25065,-17213,"8","9",12104,7485
"12069",155511,"MCPHERSON COLLEGE                                           ","2003-2004",24,"Track and Field, Outdoor",26762,50793,-24031,13340,25410,-12070,13422,25383,-11961,"15","12",13660,13633
"6752",199306,"PFEIFFER UNIVERSITY                                         ","2003-2004",11,"Lacrosse",13122,37177,-24055,2147,18077,-15930,10975,19100,-8125,"19","21",10904,15509
"15353",217518,"ROGER WILLIAMS UNIVERSITY                                   ","2003-2004",36,"Sailing",39449,63536,-24087,20513,33039,-12526,18936,30497,-11561,".","15",23001,21231
"10836",233295,"RANDOLPH-MACON COLLEGE                                      ","2003-2004",22,"Tennis",101,24212,-24111,100,11347,-11247,1,12865,-12864,"7","8",3925,5025
"11794",113634,"DIABLO VALLEY COLLEGE                                       ","2003-2004",22,"Tennis",1804,25917,-24113,902,13238,-12336,902,12679,-11777,"14","9",1848,1638
"9505",195720,"SAINT JOHN FISHER COLLEGE                                   ","2003-2004",16,"Softball",12200,36326,-24126,0,0,0,12200,36326,-24126,".","30",0,20594
"15234",163338,"UNIVERSITY OF MARYLAND-EASTERN SHORE                        ","2003-2004",33,"Bowling",80359,104496,-24137,0,0,0,80359,104496,-24137,".","8",0,29011
"13085",146719,"LOYOLA UNIVERSITY CHICAGO                                   ","2003-2004",26,"Volleyball",546507,570692,-24185,111363,122365,-11002,435144,448327,-13183,"15","15",40173,39699
"11804",196024,"SUNY COLLEGE OF TECHNOLOGY AT DELHI                         ","2003-2004",23,"Track and Field, Indoor",8070,32270,-24200,5070,19135,-14065,3000,13135,-10135,"27","8",9617,5089
"14507",154934,"COLBY COMMUNITY COLLEGE                                     ","2003-2004",26,"Volleyball",700,24921,-24221,0,0,0,700,24921,-24221,".","12",0,11389
"6548",236328,"UNIVERSITY OF PUGET SOUND                                   ","2003-2004",11,"Lacrosse",11238,35476,-24238,0,0,0,11238,35476,-24238,".","21",0,34487
"2274",113333,"DE ANZA COLLEGE                                             ","2003-2004",2,"Basketball",70911,95183,-24272,22933,33608,-10675,47978,61575,-13597,"14","9",10675,13597
"1220",212106,"DUQUESNE UNIVERSITY                                         ","2003-2004",1,"Baseball",384884,409160,-24276,384884,409160,-24276,0,0,0,"29",".",135280,0
"14807",243197,"UNIVERSITY OF PUERTO RICO-MAYAGUEZ                          ","2003-2004",28,"Wrestling",2142,26418,-24276,2142,26418,-24276,0,0,0,"14",".",2675,0
"4640",155140,"HASKELL INDIAN NATIONS UNIVERSITY                           ","2003-2004",7,"Football",48500,72790,-24290,48500,72790,-24290,0,0,0,"41",".",47000,0
"3638",213020,"INDIANA UNIVERSITY OF PENNSYLVANIA-MAIN CAMPUS              ","2003-2004",3,"All Track Combined",148279,172575,-24296,57486,73758,-16272,90793,98817,-8024,"54","39",25872,25874
"16277",173416,"DAKOTA COUNTY TECHNICAL COLLEGE                             ","2003-2004",39,"Total Participants",45000,69300,-24300,30000,46200,-16200,15000,23100,-8100,"34","23",30000,15000
"16131",236577,"SEATTLE PACIFIC UNIVERSITY                                  ","2003-2004",39,"Total Participants",1826492,1850796,-24304,594492,560964,33528,1232000,1289832,-57832,"107","194",212367,358884
"9760",240107,"VITERBO UNIVERSITY                                          ","2003-2004",16,"Softball",23319,47637,-24318,0,0,0,23319,47637,-24318,".","12",0,21998
"5097",204635,"OHIO NORTHERN UNIVERSITY                                    ","2003-2004",7,"Football",211595,235916,-24321,211595,235916,-24321,0,0,0,"130",".",60224,0
"8409",110334,"CABRILLO COLLEGE                                            ","2003-2004",15,"Soccer",5795,30130,-24335,2375,13240,-10865,3420,16890,-13470,"24","18",5675,6122
"16147",176169,"NORTHEAST MISSISSIPPI COMMUNITY COLLEGE                     ","2003-2004",39,"Total Participants",148977,173348,-24371,75722,103506,-27784,73255,69842,3413,"112","35",67254,29276
"5679",197984,"BELMONT ABBEY COLLEGE                                       ","2003-2004",8,"Golf",14350,38745,-24395,14350,38745,-24395,0,0,0,"9",".",9813,0
"5607",225247,"HARDIN-SIMMONS UNIVERSITY                                   ","2003-2004",8,"Golf",3600,28000,-24400,1800,14000,-12200,1800,14000,-12200,"10","7",11100,11100
"4843",173805,"ITASCA COMMUNITY COLLEGE                                    ","2003-2004",7,"Football",17179,41588,-24409,17179,41588,-24409,0,0,0,"39",".",6689,0
"12095",196006,"SUNY COLLEGE OF TECHNOLOGY AT ALFRED                        ","2003-2004",24,"Track and Field, Outdoor",18458,42874,-24416,9229,30264,-21035,9229,12610,-3381,"24","10",10752,4480
"3142",149727,"WAUBONSEE COMMUNITY COLLEGE                                 ","2003-2004",2,"Basketball",27700,52121,-24421,13850,27136,-13286,13850,24985,-11135,"17","11",13686,13135
"8643",175272,"WINONA STATE UNIVERSITY                                     ","2003-2004",16,"Softball",78933,103356,-24423,0,0,0,78933,103356,-24423,".","16",0,47658
"897",127918,"REGIS UNIVERSITY                                            ","2003-2004",1,"Baseball",308749,333192,-24443,308749,333192,-24443,0,0,0,"33",".",85928,0
"1922",110334,"CABRILLO COLLEGE                                            ","2003-2004",2,"Basketball",14795,39243,-24448,8425,24521,-16096,6370,14722,-8352,"13","10",7280,6910
"12762",151306,"UNIVERSITY OF SOUTHERN INDIANA                              ","2003-2004",25,"Track and Field, X-Country",97778,122280,-24502,49838,61789,-11951,47940,60491,-12551,"29","24",20855,16724
"164",191968,"ITHACA COLLEGE                                              ","2003-2004",1,"Baseball",152812,177322,-24510,152812,177322,-24510,0,0,0,"26",".",95762,0
"3163",236656,"SOUTH PUGET SOUND COMMUNITY COLLEGE                         ","2003-2004",2,"Basketball",63272,87785,-24513,32515,43308,-10793,30757,44477,-13720,"9","12",21786,22848
"3209",161554,"UNIVERSITY OF SOUTHERN MAINE                                ","2003-2004",2,"Basketball",166834,191375,-24541,60830,70930,-10100,106004,120445,-14441,"15","14",28573,59960
"13428",184782,"ROWAN UNIVERSITY                                            ","2003-2004",26,"Volleyball",689,25239,-24550,0,0,0,689,25239,-24550,"0","14",0,12739
"1885",173805,"ITASCA COMMUNITY COLLEGE                                    ","2003-2004",2,"Basketball",17915,42470,-24555,9395,23051,-13656,8520,19419,-10899,"13","11",5076,4633
"16554",207290,"NORTHEASTERN OKLAHOMA AGRICULTURAL AND MECH COLL            ","2003-2004",39,"Total Participants",176864,201448,-24584,67305,76253,-8948,109559,125195,-15636,"148","46",120250,58550
"1336",227997,"SAN JACINTO COLLEGE-NORTH CAMPUS                            ","2003-2004",1,"Baseball",115382,139975,-24593,115382,139975,-24593,0,0,0,"32",".",1135,0
"16517",227997,"SAN JACINTO COLLEGE-NORTH CAMPUS                            ","2003-2004",39,"Total Participants",115382,139975,-24593,115382,139975,-24593,0,0,0,"32","12",1135,725
"8706",155450,"LABETTE COMMUNITY COLLEGE                                   ","2003-2004",16,"Softball",3403,28006,-24603,0,0,0,3403,28006,-24603,".","14",0,16089
"14846",173920,"MINNESOTA STATE UNVERSITY-MANKATO                           ","2003-2004",28,"Wrestling",109212,133818,-24606,109212,133818,-24606,0,0,0,"32",".",31763,0
"9826",101675,"MILES COLLEGE                                               ","2003-2004",16,"Softball",27421,52037,-24616,0,0,0,27421,52037,-24616,".","11",0,4731
"4796",210429,"WESTERN OREGON UNIVERSITY                                   ","2003-2004",7,"Football",430596,455239,-24643,430596,455239,-24643,0,0,0,"109",".",141168,0
"10915",219356,"SOUTH DAKOTA STATE UNIVERSITY                               ","2003-2004",22,"Tennis",0,24652,-24652,0,12326,-12326,0,12326,-12326,"9","12",8618,8618
"12504",140960,"SAVANNAH STATE UNIVERSITY                                   ","2003-2004",25,"Track and Field, X-Country",0,24673,-24673,0,0,0,0,24673,-24673,"0","5",0,12616
"12228",220215,"FREED-HARDEMAN UNIVERSITY                                   ","2003-2004",25,"Track and Field, X-Country",10000,34674,-24674,5000,18587,-13587,5000,16087,-11087,"6","5",4375,4375
"13817",118693,"MENLO COLLEGE                                               ","2003-2004",26,"Volleyball",300,24984,-24684,0,0,0,300,24984,-24684,".","13",0,20300
"15051",200156,"JAMESTOWN COLLEGE                                           ","2003-2004",28,"Wrestling",23364,48064,-24700,23364,48064,-24700,0,0,0,"25",".",11213,0
"148",165936,"GORDON COLLEGE                                              ","2003-2004",1,"Baseball",13550,38274,-24724,13550,38274,-24724,0,0,0,"18",".",33159,0
"2201",181330,"MIDLAND LUTHERAN COLLEGE                                    ","2003-2004",2,"Basketball",42792,67526,-24734,18812,32633,-13821,23980,34893,-10913,"26","26",16164,21800
"8443",238476,"CARTHAGE COLLEGE                                            ","2003-2004",15,"Soccer",110608,135354,-24746,28746,48492,-19746,81862,86862,-5000,"53","29",13000,13000
"1362",183211,"RIVIER COLLEGE                                              ","2003-2004",1,"Baseball",800,25553,-24753,800,25553,-24753,0,0,0,"18",".",16704,0
"6947",191931,"IONA COLLEGE                                                ","2003-2004",13,"Rowing",9370,34126,-24756,6577,12539,-5962,2793,21587,-18794,"19","24",6702,5590
"17328",154350,"SIMPSON COLLEGE                                             ","2003-2004",39,"Total Participants",501005,525781,-24776,240568,251863,-11295,260437,273918,-13481,"298","174",242731,189568
"17266",225548,"HOWARD PAYNE UNIVERSITY                                     ","2003-2004",39,"Total Participants",304600,329413,-24813,158745,170030,-11285,145855,159383,-13528,"195","59",163850,91200
"3635",201548,"CAPITAL UNIVERSITY                                          ","2003-2004",3,"All Track Combined",90097,114927,-24830,44949,56775,-11826,45148,58152,-13004,"40","33",16769,17043
"5323",152099,"OAKLAND CITY UNIVERSITY                                     ","2003-2004",8,"Golf",8000,32861,-24861,4000,15852,-11852,4000,17009,-13009,"6","5",1213,1806
"6916",213987,"MERCYHURST COLLEGE                                          ","2003-2004",13,"Rowing",327592,352454,-24862,0,0,0,327592,352454,-24862,".","37",0,51000
"10359",123341,"SIERRA COLLEGE                                              ","2003-2004",18,"Swimming and Diving",6658,31606,-24948,2254,13744,-11490,4404,17862,-13458,"16","15",10096,11925
"11782",149772,"WESTERN ILLINOIS UNIVERSITY                                 ","2003-2004",22,"Tennis",56676,81628,-24952,28338,40814,-12476,28338,40814,-12476,"11","8",9682,9682
"12824",194161,"NYACK COLLEGE                                               ","2003-2004",25,"Track and Field, X-Country",22510,47472,-24962,11255,26986,-15731,11255,20486,-9231,"8","6",6750,6750
"7696",240365,"UNIVERSITY OF WISCONSIN-OSHKOSH                             ","2003-2004",15,"Soccer",96101,121081,-24980,75474,95031,-19557,20627,26050,-5423,"25","23",35227,23255
"421",199306,"PFEIFFER UNIVERSITY                                         ","2003-2004",1,"Baseball",39319,64308,-24989,39319,64308,-24989,0,0,0,"45",".",53142,0
"5090",179946,"WESTMINSTER COLLEGE                                         ","2003-2004",7,"Football",1e+05,125000,-25000,1e+05,125000,-25000,0,0,0,"80",".",75000,0
"11857",233426,"ROANOKE COLLEGE                                             ","2003-2004",23,"Track and Field, Indoor",7836,32886,-25050,3918,16443,-12525,3918,16443,-12525,"20","22",6302,6302
"11958",233426,"ROANOKE COLLEGE                                             ","2003-2004",24,"Track and Field, Outdoor",7836,32886,-25050,3918,16443,-12525,3918,16443,-12525,"20","22",6302,6302
"457",199582,"SAINT AUGUSTINES COLLEGE                                    ","2003-2004",1,"Baseball",96684,121742,-25058,96684,121742,-25058,0,0,0,"17",".",34876,0
"5886",228149,"ST MARYS UNIVERSITY                                         ","2003-2004",8,"Golf",58566,83632,-25066,33623,46914,-13291,24943,36718,-11775,"12","10",42492,33902
"9369",157809,"THOMAS MORE COLLEGE                                         ","2003-2004",16,"Softball",29323,54393,-25070,0,0,0,29323,54393,-25070,".","18",0,18954
"1328",179292,"SAINT LOUIS COMMUNITY COLLEGE-FLORISSANT VALLEY             ","2003-2004",1,"Baseball",8915,33998,-25083,8915,33998,-25083,0,0,0,"26",".",23256,0
"5386",170082,"GRAND VALLEY STATE UNIVERSITY                               ","2003-2004",8,"Golf",437621,462728,-25107,140093,147358,-7265,297528,315370,-17842,"14","12",41030,78064
"13378",163268,"UNIVERSITY OF MARYLAND-BALTIMORE COUNTY                     ","2003-2004",26,"Volleyball",67574,92686,-25112,0,0,0,67574,92686,-25112,".","14",0,48032
"13880",216357,"THIEL COLLEGE                                               ","2003-2004",26,"Volleyball",7261,32373,-25112,0,0,0,7261,32373,-25112,".","14",0,14700
"10425",164580,"BABSON COLLEGE                                              ","2003-2004",18,"Swimming and Diving",37330,62458,-25128,18665,31229,-12564,18665,31229,-12564,"21","19",18665,18665
"16298",113980,"EL CAMINO COLLEGE                                           ","2003-2004",39,"Total Participants",337590,362719,-25129,177223,191686,-14463,160367,171033,-10666,"286","146",148438,87825
"939",123457,"SIMPSON COLLEGE                                             ","2003-2004",1,"Baseball",1295,26452,-25157,1295,26452,-25157,0,0,0,"15",".",16448,0
"12820",168421,"WORCESTER POLYTECHNIC INSTITUTE                             ","2003-2004",25,"Track and Field, X-Country",24363,49541,-25178,13245,24538,-11293,11118,25003,-13885,"92","47",13288,13753
"16146",156356,"BRESCIA UNIVERSITY                                          ","2003-2004",39,"Total Participants",77394,102575,-25181,42396,58050,-15654,34998,44525,-9527,"84","84",75745,64916
"9177",219259,"NORTHERN STATE UNIVERSITY                                   ","2003-2004",16,"Softball",25374,50566,-25192,0,0,0,25374,50566,-25192,".","11",0,9831
"11834",110547,"CALIFORNIA STATE UNIVERSITY-DOMINGUEZ HILLS                 ","2003-2004",23,"Track and Field, Indoor",160,25355,-25195,0,0,0,160,25355,-25195,".","16",0,24216
"12045",155937,"STERLING COLLEGE                                            ","2003-2004",24,"Track and Field, Outdoor",2,25200,-25198,1,12141,-12140,1,13059,-13058,"13","7",12140,13058
"5921",175272,"WINONA STATE UNIVERSITY                                     ","2003-2004",8,"Golf",42259,67460,-25201,24973,27532,-2559,17286,39928,-22642,"8","15",12270,15131
"1097",240125,"WAUKESHA COUNTY TECHNICAL COLLEGE                           ","2003-2004",1,"Baseball",2836,28054,-25218,2836,28054,-25218,0,0,0,"13",".",11002,0
"11561",229027,"THE UNIVERSITY OF TEXAS AT SAN ANTONIO                      ","2003-2004",22,"Tennis",378484,403728,-25244,151017,160540,-9523,227467,243188,-15721,"9","10",25239,21273
"6802",163462,"MOUNT SAINT MARYS COLLEGE                                   ","2003-2004",11,"Lacrosse",299572,324871,-25299,138466,160944,-22478,161106,163927,-2821,"48","25",41997,59651
"8687",141167,"THOMAS UNIVERSITY                                           ","2003-2004",16,"Softball",44016,69346,-25330,0,0,0,44016,69346,-25330,".","16",0,35077
"2732",196194,"SUNY COLLEGE AT OSWEGO                                      ","2003-2004",2,"Basketball",129944,155288,-25344,77684,86838,-9154,52260,68450,-16190,"15","12",24532,33068
"16403",207157,"HILLSDALE FREE WILL BAPTIST COLLEGE                         ","2003-2004",39,"Total Participants",10600,35950,-25350,6800,24000,-17200,3800,11950,-8150,"34","31",39700,23200
"4840",126678,"COLORADO COLLEGE                                            ","2003-2004",7,"Football",210420,235783,-25363,210420,235783,-25363,0,0,0,"38",".",66350,0
"5035",187897,"NEW MEXICO HIGHLANDS UNIVERSITY                             ","2003-2004",7,"Football",315365,340728,-25363,315365,340728,-25363,0,0,0,"90",".",53614,0
"12352",171128,"MICHIGAN TECHNOLOGICAL UNIVERSITY                           ","2003-2004",25,"Track and Field, X-Country",124094,149474,-25380,37082,54672,-17590,87012,94802,-7790,"69","29",23717,23717
"6102",237969,"WEST VIRGINIA WESLEYAN COLLEGE                              ","2003-2004",8,"Golf",22363,47763,-25400,22363,47763,-25400,0,0,0,"9",".",13587,0
"6781",131283,"CATHOLIC UNIVERSITY OF AMERICA                              ","2003-2004",11,"Lacrosse",14000,39400,-25400,10000,23400,-13400,4000,16000,-12000,"30","18",10500,10500
"7853",235149,"EVERETT COMMUNITY COLLEGE                                   ","2003-2004",15,"Soccer",800,26200,-25400,400,12900,-12500,400,13300,-12900,"18","16",1400,1400
"2185",240107,"VITERBO UNIVERSITY                                          ","2003-2004",2,"Basketball",80517,105920,-25403,40301,54795,-14494,40216,51125,-10909,"14","14",23813,23066
"426",105525,"PIMA COMMUNITY COLLEGE                                      ","2003-2004",1,"Baseball",38272,63713,-25441,38272,63713,-25441,0,0,0,"30",".",24058,0
"6193",149772,"WESTERN ILLINOIS UNIVERSITY                                 ","2003-2004",8,"Golf",83327,108770,-25443,41763,56574,-14811,41564,52196,-10632,"13","7",27656,12978
"175",238263,"MADISON AREA TECHNICAL COLLEGE                              ","2003-2004",1,"Baseball",61745,87204,-25459,61745,87204,-25459,0,0,0,"38",".",64943,0
"563",123341,"SIERRA COLLEGE                                              ","2003-2004",1,"Baseball",27365,52836,-25471,27365,52836,-25471,0,0,0,"29",".",20213,0
"12589",211361,"CALIFORNIA UNIVERSITY OF PENNSYLVANIA                       ","2003-2004",25,"Track and Field, X-Country",131582,157086,-25504,65791,76160,-10369,65791,80926,-15135,"14","5",20196,20196
"14184",122597,"SAN FRANCISCO STATE UNIVERSITY                              ","2003-2004",26,"Volleyball",120595,146106,-25511,0,0,0,120595,146106,-25511,".","14",0,28796
"1537",125727,"WESTMONT COLLEGE                                            ","2003-2004",1,"Baseball",110797,136321,-25524,110797,136321,-25524,0,0,0,"24",".",56234,0
"13752",164216,"WASHINGTON COLLEGE                                          ","2003-2004",26,"Volleyball",708,26264,-25556,0,0,0,708,26264,-25556,".","9",0,12293
"6648",216764,"WEST CHESTER UNIVERSITY OF PENNSYLVANIA                     ","2003-2004",11,"Lacrosse",30764,56349,-25585,0,0,0,30764,56349,-25585,".","29",0,39167
"16596",121707,"COLLEGE OF THE REDWOODS                                     ","2003-2004",39,"Total Participants",89823,115409,-25586,29996,40870,-10874,59827,74539,-14712,"96","43",80394,51648
"2413",161244,"UNIVERSITY OF MAINE AT MACHIAS                              ","2003-2004",2,"Basketball",86351,111942,-25591,46891,67572,-20681,39460,44370,-4910,"13","12",34964,23698
"16433",140696,"OGLETHORPE UNIVERSITY                                       ","2003-2004",39,"Total Participants",121087,146710,-25623,72793,82105,-9312,48294,64605,-16311,"107","90",73090,56230
"828",113573,"COLLEGE OF THE DESERT                                       ","2003-2004",1,"Baseball",20000,45671,-25671,20000,45671,-25671,0,0,0,"24",".",14016,0
"9443",262031,"ST CHARLES COMMUNITY COLLEGE                                ","2003-2004",16,"Softball",92005,117700,-25695,0,0,0,92005,117700,-25695,".","15",0,21979
"2096",231420,"AVERETT UNIVERSITY                                          ","2003-2004",2,"Basketball",48000,73740,-25740,26500,38045,-11545,21500,35695,-14195,"15","13",26500,24500
"11423",228981,"TEXAS LUTHERAN UNIVERSITY                                   ","2003-2004",22,"Tennis",112,25852,-25740,50,11887,-11837,62,13965,-13903,"12","6",2457,4534
"3955",162928,"JOHNS HOPKINS UNIVERSITY                                    ","2003-2004",3,"All Track Combined",101249,127002,-25753,57398,73339,-15941,43851,53663,-9812,"41","30",28063,20534
"4664",212106,"DUQUESNE UNIVERSITY                                         ","2003-2004",7,"Football",506876,532667,-25791,506876,532667,-25791,0,0,0,"91",".",151950,0
"5413",175078,"SOUTHWEST MINNESOTA STATE UNIVERSITY                        ","2003-2004",8,"Golf",1183,26978,-25795,0,0,0,1183,26978,-25795,".","10",0,14218
"2022",123341,"SIERRA COLLEGE                                              ","2003-2004",2,"Basketball",21681,47482,-25801,12652,23506,-10854,9029,23976,-14947,"12","11",15864,13233
"5370",198871,"LOUISBURG COLLEGE                                           ","2003-2004",8,"Golf",2,25820,-25818,1,11178,-11177,1,14642,-14641,"8","4",4453,3642
"12342",216764,"WEST CHESTER UNIVERSITY OF PENNSYLVANIA                     ","2003-2004",25,"Track and Field, X-Country",43045,68872,-25827,22119,34436,-12317,20926,34436,-13510,"59","62",22870,22870
"15527",164739,"BENTLEY COLLEGE                                             ","2003-2004",39,"Total Participants",1532999,1558853,-25854,858504,884709,-26205,674495,674144,351,"302","182",349223,221537
"12893",122931,"SANTA CLARA UNIVERSITY                                      ","2003-2004",25,"Track and Field, X-Country",98862,124721,-25859,45024,63615,-18591,53838,61106,-7268,"13","15",9971,8732
"8981",154527,"WARTBURG COLLEGE                                            ","2003-2004",16,"Softball",22326,48203,-25877,0,0,0,22326,48203,-25877,".","37",0,20443
"8946",240426,"UNIVERSITY OF WISCONSIN-SUPERIOR                            ","2003-2004",16,"Softball",42147,68052,-25905,0,0,0,42147,68052,-25905,".","17",0,43052
"15127",144892,"EASTERN ILLINOIS UNIVERSITY                                 ","2003-2004",29,"Other Sports",41420,67378,-25958,0,0,0,41420,67378,-25958,".","26",0,28571
"16594",224642,"EL PASO COMMUNITY COLLEGE                                   ","2003-2004",39,"Total Participants",250000,275970,-25970,125000,143525,-18525,125000,132445,-7445,"39","30",67621,67622
"10411",211644,"CLARION UNIVERSITY OF PENNSYLVANIA                          ","2003-2004",18,"Swimming and Diving",242652,268628,-25976,112797,123642,-10845,129855,144986,-15131,"20","31",11623,24390
"195",238430,"CARDINAL STRITCH UNIVERSITY                                 ","2003-2004",1,"Baseball",20118,46095,-25977,20118,46095,-25977,0,0,0,"18",".",17224,0
"1899",144175,"CITY COLLEGES OF CHICAGO-OLIVE-HARVEY COLLEGE               ","2003-2004",2,"Basketball",14000,40000,-26000,7000,20000,-13000,7000,20000,-13000,"20","20",10000,15000
"12826",193292,"MOLLOY COLLEGE                                              ","2003-2004",25,"Track and Field, X-Country",10000,36000,-26000,5000,18000,-13000,5000,18000,-13000,"6","6",1500,1500
"15189",147013,"MCKENDREE COLLEGE                                           ","2003-2004",33,"Bowling",53472,79472,-26000,15868,30368,-14500,37604,49104,-11500,"11","18",15868,16029
"16474",214166,"MOUNT ALOYSIUS COLLEGE                                      ","2003-2004",39,"Total Participants",82200,108200,-26000,37400,49900,-12500,44800,58300,-13500,"62","58",64770,72320
"7110",128106,"COLORADO STATE UNIVERSITY-PUEBLO                            ","2003-2004",15,"Soccer",106870,132911,-26041,54319,64805,-10486,52551,68106,-15555,"35","22",22390,22691
"10736",239628,"RIPON COLLEGE                                               ","2003-2004",22,"Tennis",15036,41081,-26045,7518,23525,-16007,7518,17556,-10038,"10","6",7518,7518
"1377",233499,"SAINT PAULS COLLEGE                                         ","2003-2004",1,"Baseball",7400,33462,-26062,7400,33462,-26062,0,0,0,"19",".",22833,0
"565",179955,"WILLIAM JEWELL COLLEGE                                      ","2003-2004",1,"Baseball",35470,61534,-26064,35470,61534,-26064,0,0,0,"21",".",33034,0
"6988",212106,"DUQUESNE UNIVERSITY                                         ","2003-2004",13,"Rowing",267074,293195,-26121,0,0,0,267074,293195,-26121,".","69",0,89250
"5224",115728,"HOLY NAMES UNIVERSITY                                       ","2003-2004",8,"Golf",100,26231,-26131,100,26231,-26131,0,0,0,"10",".",18181,0
"3578",162007,"BOWIE STATE UNIVERSITY                                      ","2003-2004",3,"All Track Combined",91298,117444,-26146,46076,78296,-32220,45222,39148,6074,"22","17",30376,29185
"9361",171535,"OAKLAND COMMUNITY COLLEGE                                   ","2003-2004",16,"Softball",29342,55518,-26176,0,0,0,29342,55518,-26176,".","16",0,44773
"12129",217873,"CLAFLIN UNIVERSITY                                          ","2003-2004",24,"Track and Field, Outdoor",800,27000,-26200,400,12000,-11600,400,15000,-14600,"17","21",9500,11000
"13837",231712,"CHRISTOPHER NEWPORT UNIVERSITY                              ","2003-2004",26,"Volleyball",12617,38851,-26234,0,0,0,12617,38851,-26234,".","12",0,7721
"5100",177214,"DRURY UNIVERSITY                                            ","2003-2004",8,"Golf",53523,79763,-26240,26696,40047,-13351,26827,39716,-12889,"12","7",34396,29334
"12394",238078,"WHEELING JESUIT UNIVERSITY                                  ","2003-2004",25,"Track and Field, X-Country",1000,27255,-26255,500,16705,-16205,500,10550,-10050,"19","12",12280,7756
"8637",155973,"TABOR COLLEGE                                               ","2003-2004",16,"Softball",814,27103,-26289,0,0,0,814,27103,-26289,".","10",0,4700
"4331",153001,"BUENA VISTA UNIVERSITY                                      ","2003-2004",7,"Football",250113,276432,-26319,250113,276432,-26319,0,0,0,"85",".",31865,0
"6975",147679,"NORTH PARK UNIVERSITY                                       ","2003-2004",13,"Rowing",60929,87250,-26321,0,0,0,60929,87250,-26321,".","17",0,58671
"6005",207740,"SEMINOLE STATE COLLEGE                                      ","2003-2004",8,"Golf",33376,59730,-26354,16688,34118,-17430,16688,25612,-8924,"10","4",10836,7690
"3316",130183,"TEIKYO POST UNIVERSITY                                      ","2003-2004",2,"Basketball",2770,29130,-26360,953,15301,-14348,1817,13829,-12012,"15","15",14091,12572
"4862",173993,"MESABI RANGE COMMUNITY AND TECHNICAL COLLEGE                ","2003-2004",7,"Football",530,26898,-26368,530,26898,-26368,0,0,0,"74",".",18255,0
"1743",144892,"EASTERN ILLINOIS UNIVERSITY                                 ","2003-2004",2,"Basketball",783522,809898,-26376,478226,411618,66608,305296,398280,-92984,"15","14",127616,110269
"207",192323,"LE MOYNE COLLEGE                                            ","2003-2004",1,"Baseball",45781,72170,-26389,45781,72170,-26389,0,0,0,"28",".",45781,0
"208",151306,"UNIVERSITY OF SOUTHERN INDIANA                              ","2003-2004",1,"Baseball",109131,135532,-26401,109131,135532,-26401,0,0,0,"32",".",51669,0
"9026",238430,"CARDINAL STRITCH UNIVERSITY                                 ","2003-2004",16,"Softball",18777,45223,-26446,0,0,0,18777,45223,-26446,".","14",0,13064
"9975",228529,"TARLETON STATE UNIVERSITY                                   ","2003-2004",16,"Softball",102646,129096,-26450,0,0,0,102646,129096,-26450,".","16",0,53367
"12351",216010,"SHIPPENSBURG UNIVERSITY OF PENNSYLVANIA                     ","2003-2004",25,"Track and Field, X-Country",293584,320042,-26458,149714,168559,-18845,143870,151483,-7613,"130","115",51101,40754
"8001",206604,"WRIGHT STATE UNIVERSITY-MAIN CAMPUS                         ","2003-2004",15,"Soccer",666117,692583,-26466,357759,368542,-10783,308358,324041,-15683,"25","29",73775,45146
"8597",177968,"LINDENWOOD UNIVERSITY                                       ","2003-2004",16,"Softball",20125,46598,-26473,0,0,0,20125,46598,-26473,".","19",0,26473
"2110",199999,"WINSTON-SALEM STATE UNIVERSITY                              ","2003-2004",2,"Basketball",194224,220711,-26487,107004,84193,22811,87220,136518,-49298,"14","14",24420,26220
"3425",156295,"BEREA COLLEGE                                               ","2003-2004",2,"Basketball",44444,70940,-26496,24444,37661,-13217,20000,33279,-13279,"15","15",24257,22503
"1796",111948,"CHAPMAN UNIVERSITY                                          ","2003-2004",2,"Basketball",134100,160600,-26500,61700,75600,-13900,72400,85000,-12600,"14","14",21000,18000
"2690",131283,"CATHOLIC UNIVERSITY OF AMERICA                              ","2003-2004",2,"Basketball",22000,48500,-26500,12000,28000,-16000,10000,20500,-10500,"13","14",16750,16750
"13227",176947,"CENTRAL METHODIST COLLEGE                                   ","2003-2004",26,"Volleyball",14224,40724,-26500,0,0,0,14224,40724,-26500,".","18",0,14224
"13506",101240,"GADSDEN STATE COMMUNITY COLLEGE                             ","2003-2004",26,"Volleyball",43713,70218,-26505,0,0,0,43713,70218,-26505,".","14",0,25998
"6356",102553,"UNIVERSITY OF ALASKA ANCHORAGE                              ","2003-2004",9,"Gymnastics",208333,234874,-26541,0,0,0,208333,234874,-26541,".","12",0,61222
"3211",161341,"UNIVERSITY OF MAINE AT PRESQUE ISLE                         ","2003-2004",2,"Basketball",1807,28349,-26542,1382,17068,-15686,425,11281,-10856,"16","13",14900,10217
"7563",113218,"CUYAMACA COLLEGE                                            ","2003-2004",15,"Soccer",14747,41301,-26554,6977,19792,-12815,7770,21509,-13739,"23","19",13035,16958
"5270",233295,"RANDOLPH-MACON COLLEGE                                      ","2003-2004",8,"Golf",2182,28771,-26589,2182,28771,-26589,0,0,0,"12",".",8030,0
"8731",174358,"MINNESOTA STATE UNIVERSITY-MOORHEAD                         ","2003-2004",16,"Softball",65683,92347,-26664,0,0,0,65683,92347,-26664,".","22",0,31545
"9119",118684,"MENDOCINO COLLEGE                                           ","2003-2004",16,"Softball",1803,28470,-26667,0,0,0,1803,28470,-26667,".","11",0,18330
"13430",211361,"CALIFORNIA UNIVERSITY OF PENNSYLVANIA                       ","2003-2004",26,"Volleyball",105091,131763,-26672,0,0,0,105091,131763,-26672,".","11",0,31812
"9918",140960,"SAVANNAH STATE UNIVERSITY                                   ","2003-2004",16,"Softball",0,26718,-26718,0,0,0,0,26718,-26718,".","17",0,13689
"5127",156408,"CENTRE COLLEGE                                              ","2003-2004",8,"Golf",8194,34913,-26719,6514,19347,-12833,1680,15566,-13886,"8","4",4942,4224
"3058",190169,"COLUMBIA-GREENE COMMUNITY COLLEGE                           ","2003-2004",2,"Basketball",1250,28000,-26750,750,15000,-14250,500,13000,-12500,"11","17",14500,12500
"6108",219471,"UNIVERSITY OF SOUTH DAKOTA                                  ","2003-2004",8,"Golf",25418,52181,-26763,13759,26023,-12264,11659,26158,-14499,"13","7",18008,14056
"7545",204501,"OBERLIN COLLEGE                                             ","2003-2004",15,"Soccer",66007,92770,-26763,38915,52051,-13136,27092,40719,-13627,"20","19",16040,17626
"13006",233426,"ROANOKE COLLEGE                                             ","2003-2004",26,"Volleyball",66,26850,-26784,0,0,0,66,26850,-26784,".","14",0,20850
"12547",195243,"SAINT THOMAS AQUINAS COLLEGE                                ","2003-2004",25,"Track and Field, X-Country",10255,37054,-26799,5345,19750,-14405,4910,17304,-12394,"9","9",4606,4304
"3539",164465,"AMHERST COLLEGE                                             ","2003-2004",3,"All Track Combined",84948,111772,-26824,42474,55628,-13154,42474,56144,-13670,"68","48",15313,15873
"15894",162104,"CECIL COMMUNITY COLLEGE                                     ","2003-2004",39,"Total Participants",3318,30146,-26828,1106,15582,-14476,2212,14564,-12352,"51","42",6210,6715
"8083",196024,"SUNY COLLEGE OF TECHNOLOGY AT DELHI                         ","2003-2004",15,"Soccer",23163,50004,-26841,12458,31419,-18961,10705,18585,-7880,"20","19",16361,8033
"15194",140960,"SAVANNAH STATE UNIVERSITY                                   ","2003-2004",33,"Bowling",0,26844,-26844,0,0,0,0,26844,-26844,".","6",0,6656
"9946",155061,"FORT HAYS STATE UNIVERSITY                                  ","2003-2004",16,"Softball",41470,68320,-26850,0,0,0,41470,68320,-26850,".","17",0,20516
"14889",144892,"EASTERN ILLINOIS UNIVERSITY                                 ","2003-2004",28,"Wrestling",78325,105213,-26888,78325,105213,-26888,0,0,0,"26",".",26988,0
"12768",120883,"UNIVERSITY OF THE PACIFIC                                   ","2003-2004",25,"Track and Field, X-Country",3177,30071,-26894,0,0,0,3177,30071,-26894,".","10",0,5436
"4086",177968,"LINDENWOOD UNIVERSITY                                       ","2003-2004",6,"Field hocky",19067,45963,-26896,0,0,0,19067,45963,-26896,".","18",0,26896
"1200",154776,"THE BROWN MACKIE COLLEGE                                    ","2003-2004",1,"Baseball",100,27000,-26900,100,27000,-26900,0,0,0,"30",".",1250,0
"6041",240277,"UNIVERSITY OF WISCONSIN-GREEN BAY                           ","2003-2004",8,"Golf",44540,71499,-26959,44540,71499,-26959,0,0,0,"10",".",18980,0
"11452",172644,"WAYNE STATE UNIVERSITY                                      ","2003-2004",22,"Tennis",177346,204343,-26997,105535,109583,-4048,71811,94760,-22949,"11","9",24712,8672
"700",225247,"HARDIN-SIMMONS UNIVERSITY                                   ","2003-2004",1,"Baseball",14000,41000,-27000,14000,41000,-27000,0,0,0,"26",".",39021,0
"11430",233897,"THE UNIVERSITY OF VIRGINIA'S COLLEGE AT WISE                ","2003-2004",22,"Tennis",6300,33335,-27035,3150,14034,-10884,3150,19301,-16151,"7","9",5993,6710
"8762",208390,"CHEMEKETA COMMUNITY COLLEGE                                 ","2003-2004",16,"Softball",600,27666,-27066,0,0,0,600,27666,-27066,".","14",0,27665
"12914",155973,"TABOR COLLEGE                                               ","2003-2004",25,"Track and Field, X-Country",2877,29969,-27092,1877,16137,-14260,1000,13832,-12832,"7","6",2331,1998
"2619",113218,"CUYAMACA COLLEGE                                            ","2003-2004",2,"Basketball",30057,57177,-27120,15885,30617,-14732,14172,26560,-12388,"14","15",16502,15095
"16242",194240,"ORANGE COUNTY COMMUNITY COLLEGE                             ","2003-2004",39,"Total Participants",74019,101154,-27135,39734,58449,-18715,34285,42705,-8420,"66","43",58534,52218
"13906",240462,"UNIVERSITY OF WISCONSIN-PLATTEVILLE                         ","2003-2004",26,"Volleyball",79702,106843,-27141,0,0,0,79702,106843,-27141,".","17",0,36135
"14154",231420,"AVERETT UNIVERSITY                                          ","2003-2004",26,"Volleyball",18000,45144,-27144,0,0,0,18000,45144,-27144,"0","16",0,20000
"3838",179292,"SAINT LOUIS COMMUNITY COLLEGE-FLORISSANT VALLEY             ","2003-2004",3,"All Track Combined",3574,30728,-27154,2909,25038,-22129,665,5690,-5025,"22","5",21978,4995
"9317",217998,"ERSKINE COLLEGE AND SEMINARY                                ","2003-2004",16,"Softball",14000,41186,-27186,0,0,0,14000,41186,-27186,".","15",0,19686
"11938",117052,"REEDLEY COLLEGE                                             ","2003-2004",24,"Track and Field, Outdoor",5000,32204,-27204,2500,16102,-13602,2500,16102,-13602,"15","3",2567,2566
"11885",231712,"CHRISTOPHER NEWPORT UNIVERSITY                              ","2003-2004",23,"Track and Field, Indoor",6935,34145,-27210,3468,17072,-13604,3467,17073,-13606,"36","23",3210,3210
"11996",231712,"CHRISTOPHER NEWPORT UNIVERSITY                              ","2003-2004",24,"Track and Field, Outdoor",6934,34144,-27210,3467,17072,-13605,3467,17072,-13605,"36","28",3210,3210
"12509",231712,"CHRISTOPHER NEWPORT UNIVERSITY                              ","2003-2004",25,"Track and Field, X-Country",6932,34144,-27212,3466,17072,-13606,3466,17072,-13606,"12","10",3210,3210
"13647",115755,"HUMBOLDT STATE UNIVERSITY                                   ","2003-2004",26,"Volleyball",107565,134795,-27230,0,0,0,107565,134795,-27230,".","16",0,36049
"905",403478,"ILLINOIS EASTERN COMMUNITY COLLS-LINCOLN TR COLL            ","2003-2004",1,"Baseball",97650,124901,-27251,97650,124901,-27251,0,0,0,"24",".",27382,0
"378",152637,"VINCENNES UNIVERSITY                                        ","2003-2004",1,"Baseball",32305,59594,-27289,32305,59594,-27289,0,0,0,"24",".",32305,0
"3718",113634,"DIABLO VALLEY COLLEGE                                       ","2003-2004",3,"All Track Combined",1804,29110,-27306,902,15555,-14653,902,13555,-12653,"38","21",6840,3612
"5018",216764,"WEST CHESTER UNIVERSITY OF PENNSYLVANIA                     ","2003-2004",7,"Football",218335,245655,-27320,218335,245655,-27320,0,0,0,"90",".",63356,0
"8108",101295,"GEORGE C WALLACE STATE COMMUNITY COLL-HANCEVILLE            ","2003-2004",15,"Soccer",9153,36526,-27373,9153,36526,-27373,0,0,0,"18","0",8892,0
"2922",151379,"INDIANA UNIVERSITY-SOUTHEAST                                ","2003-2004",2,"Basketball",99724,127098,-27374,61988,69309,-7321,37736,57789,-20053,"11","14",31764,32142
"15995",173993,"MESABI RANGE COMMUNITY AND TECHNICAL COLLEGE                ","2003-2004",39,"Total Participants",27273,54659,-27386,10177,18461,-8284,17096,36198,-19102,"113","36",38894,27801
"3070",164465,"AMHERST COLLEGE                                             ","2003-2004",2,"Basketball",329055,356445,-27390,162060,198569,-36509,166995,157876,9119,"16","13",37228,24964
"12251",113218,"CUYAMACA COLLEGE                                            ","2003-2004",25,"Track and Field, X-Country",8490,35904,-27414,4245,17952,-13707,4245,17952,-13707,"9","10",10473,10473
"5638",219356,"SOUTH DAKOTA STATE UNIVERSITY                               ","2003-2004",8,"Golf",2050,29495,-27445,0,14448,-14448,2050,15047,-12997,"11","9",10522,10065
"4983",239628,"RIPON COLLEGE                                               ","2003-2004",7,"Football",60021,87480,-27459,60021,87480,-27459,0,0,0,"78",".",52000,0
"14159",170541,"KALAMAZOO VALLEY COMMUNITY COLLEGE                          ","2003-2004",26,"Volleyball",1,27472,-27471,0,0,0,1,27472,-27471,".","13",0,12996
"6434",164580,"BABSON COLLEGE                                              ","2003-2004",10,"Ice Hockey",29259,56744,-27485,29259,56744,-27485,0,0,0,"28","0",29259,0
"1013",157757,"SPALDING UNIVERSITY                                         ","2003-2004",1,"Baseball",500,28000,-27500,500,28000,-27500,0,0,0,"28",".",28000,0
"13637",122205,"SADDLEBACK COLLEGE                                          ","2003-2004",26,"Volleyball",10498,38000,-27502,0,0,0,10498,38000,-27502,".","9",0,10494
"10391",221351,"RHODES COLLEGE                                              ","2003-2004",18,"Swimming and Diving",22900,50406,-27506,11450,25203,-13753,11450,25203,-13753,"7","4",10800,6400
"15059",234827,"CENTRAL WASHINGTON UNIVERSITY                               ","2003-2004",28,"Wrestling",5868,33377,-27509,5868,33377,-27509,0,0,0,"20",".",25330,0
"4117",195030,"UNIVERSITY OF ROCHESTER                                     ","2003-2004",6,"Field hocky",31841,59399,-27558,0,0,0,31841,59399,-27558,".","21",0,20491
"2198",110413,"CALIFORNIA LUTHERAN UNIVERSITY                              ","2003-2004",2,"Basketball",154056,181628,-27572,82954,97378,-14424,71102,84250,-13148,"13","13",22589,31097
"12252",105525,"PIMA COMMUNITY COLLEGE                                      ","2003-2004",25,"Track and Field, X-Country",18248,45823,-27575,9124,21533,-12409,9124,24290,-15166,"18","9",4837,4837
"14563",102553,"UNIVERSITY OF ALASKA ANCHORAGE                              ","2003-2004",26,"Volleyball",252315,279919,-27604,0,0,0,252315,279919,-27604,".","17",0,66486
"706",243197,"UNIVERSITY OF PUERTO RICO-MAYAGUEZ                          ","2003-2004",1,"Baseball",7931,35556,-27625,7931,35556,-27625,0,0,0,"21",".",8064,0
"10497",225627,"UNIVERSITY OF THE INCARNATE WORD                            ","2003-2004",19,"Swimming",34146,61775,-27629,0,0,0,34146,61775,-27629,".","3",0,7571
"5800",153108,"CENTRAL COLLEGE                                             ","2003-2004",8,"Golf",39087,66745,-27658,28187,42409,-14222,10900,24336,-13436,"40","17",19504,10695
"10286",226587,"MCMURRY UNIVERSITY                                          ","2003-2004",18,"Swimming and Diving",48590,76255,-27665,24295,37942,-13647,24295,38313,-14018,"22","17",22342,22342
"8419",169798,"EASTERN MICHIGAN UNIVERSITY                                 ","2003-2004",15,"Soccer",445304,472975,-27671,0,0,0,445304,472975,-27671,".","26",0,37431
"8780",213507,"LEBANON VALLEY COLLEGE                                      ","2003-2004",16,"Softball",10979,38658,-27679,0,0,0,10979,38658,-27679,".","17",0,8952
"1497",162168,"CHESAPEAKE COLLEGE                                          ","2003-2004",1,"Baseball",16645,44338,-27693,16645,44338,-27693,0,0,0,"20",".",25156,0
"4051",213783,"MANSFIELD UNIVERSITY OF PENNSYLVANIA                        ","2003-2004",6,"Field hocky",77633,105333,-27700,0,0,0,77633,105333,-27700,".","16",0,18153
"2890",190558,"CUNY COLLEGE OF STATEN ISLAND                               ","2003-2004",2,"Basketball",42806,70515,-27709,22050,34309,-12259,20756,36206,-15450,"9","13",22050,20756
"596",110671,"UNIVERSITY OF CALIFORNIA-RIVERSIDE                          ","2003-2004",1,"Baseball",609914,637695,-27781,609914,637695,-27781,0,0,0,"32",".",29357,0
"12085",123800,"SOUTHWESTERN COLLEGE                                        ","2003-2004",24,"Track and Field, Outdoor",10734,38526,-27792,5367,19263,-13896,5367,19263,-13896,"25","6",4350,5199
"16518",238661,"EDGEWOOD COLLEGE                                            ","2003-2004",39,"Total Participants",243588,271413,-27825,109383,113840,-4457,134205,157573,-23368,"82","90",81143,91673
"12571",154934,"COLBY COMMUNITY COLLEGE                                     ","2003-2004",25,"Track and Field, X-Country",200,28060,-27860,100,14030,-13930,100,14030,-13930,"35","21",6836,6836
"13861",130989,"GOLDEY-BEACOM COLLEGE                                       ","2003-2004",26,"Volleyball",29547,57421,-27874,0,0,0,29547,57421,-27874,".","10",0,15631
"8842",228149,"ST MARYS UNIVERSITY                                         ","2003-2004",16,"Softball",52226,80125,-27899,0,0,0,52226,80125,-27899,".","20",0,60975
"1081",113634,"DIABLO VALLEY COLLEGE                                       ","2003-2004",1,"Baseball",902,28833,-27931,902,28833,-27931,0,0,0,"34",".",8398,0
"5231",198543,"FAYETTEVILLE STATE UNIVERSITY                               ","2003-2004",8,"Golf",1,27940,-27939,1,27940,-27939,0,0,0,"10",".",26027,0
"13439",221351,"RHODES COLLEGE                                              ","2003-2004",26,"Volleyball",29900,57860,-27960,0,0,0,29900,57860,-27960,".","14",0,21520
"8403",211088,"ARCADIA UNIVERSITY                                          ","2003-2004",15,"Soccer",16763,44731,-27968,8713,23835,-15122,8050,20896,-12846,"25","19",14110,12596
"12927",123800,"SOUTHWESTERN COLLEGE                                        ","2003-2004",25,"Track and Field, X-Country",10036,38038,-28002,5018,19019,-14001,5018,19019,-14001,"12","7",4808,4808
"9412",177065,"COLUMBIA COLLEGE                                            ","2003-2004",16,"Softball",968,29012,-28044,0,0,0,968,29012,-28044,".","12",0,18259
"360",220710,"MARYVILLE COLLEGE                                           ","2003-2004",1,"Baseball",32009,60101,-28092,32009,60101,-28092,0,0,0,"36",".",30991,0
"17157",148380,"ROCK VALLEY COLLEGE                                         ","2003-2004",39,"Total Participants",75000,103128,-28128,37000,61441,-24441,38000,41687,-3687,"158","46",50785,20842
"1677",155140,"HASKELL INDIAN NATIONS UNIVERSITY                           ","2003-2004",2,"Basketball",30125,58319,-28194,14980,17000,-2020,15145,41319,-26174,"17","16",13000,13000
"12815",198066,"BREVARD COLLEGE                                             ","2003-2004",25,"Track and Field, X-Country",50000,78256,-28256,25000,39127,-14127,25000,39129,-14129,"10","10",9127,9129
"14557",243151,"UNIVERSITY OF PUERTO RICO-CAYEY UNIVERSITY COLLEGE          ","2003-2004",26,"Volleyball",25760,54020,-28260,8400,25135,-16735,17360,28885,-11525,"12","11",6240,6175
"6510",164739,"BENTLEY COLLEGE                                             ","2003-2004",10,"Ice Hockey",397853,426122,-28269,397853,426122,-28269,0,0,0,"28",".",90299,0
"7024",240277,"UNIVERSITY OF WISCONSIN-GREEN BAY                           ","2003-2004",14,"Skiing",98427,126721,-28294,41886,65495,-23609,56541,61226,-4685,"13","7",14980,17632
"3505",100706,"UNIVERSITY OF ALABAMA IN HUNTSVILLE                         ","2003-2004",3,"All Track Combined",138853,167158,-28305,53857,68009,-14152,84996,99149,-14153,"28","58",24696,24696
"3779",166513,"UNIVERSITY OF MASSACHUSETTS-LOWELL                          ","2003-2004",3,"All Track Combined",210114,238447,-28333,105057,115165,-10108,105057,123282,-18225,"46","37",30267,30267
"7002",133881,"FLORIDA INSTITUTE OF TECHNOLOGY-MELBOURNE                   ","2003-2004",13,"Rowing",80967,109316,-28349,0,0,0,80967,109316,-28349,".","42",0,25534
"4062",206589,"COLLEGE OF WOOSTER                                          ","2003-2004",6,"Field hocky",580,28954,-28374,0,0,0,580,28954,-28374,".","32",0,21426
"11201",144892,"EASTERN ILLINOIS UNIVERSITY                                 ","2003-2004",22,"Tennis",143943,172327,-28384,54601,69242,-14641,89342,103085,-13743,"9","8",15054,14155
"3563",233499,"SAINT PAULS COLLEGE                                         ","2003-2004",3,"All Track Combined",24544,52929,-28385,5050,19243,-14193,19494,33686,-14192,"24","23",9349,9348
"6721",196167,"SUNY COLLEGE AT GENESEO                                     ","2003-2004",11,"Lacrosse",107176,135583,-28407,62465,72416,-9951,44711,63167,-18456,"40","23",34652,34592
"13330",155140,"HASKELL INDIAN NATIONS UNIVERSITY                           ","2003-2004",26,"Volleyball",13405,41884,-28479,0,0,0,13405,41884,-28479,"0","13",0,13000
"9149",202356,"CUYAHOGA COMMUNITY COLLEGE DISTRICT                         ","2003-2004",16,"Softball",40435,68915,-28480,0,0,0,40435,68915,-28480,".","14",0,40435
"7142",175829,"ITAWAMBA COMMUNITY COLLEGE                                  ","2003-2004",15,"Soccer",1,28485,-28484,1,28485,-28484,0,0,0,"20",".",13335,0
"13104",199698,"ST ANDREWS PRESBYTERIAN COLLEGE                             ","2003-2004",26,"Volleyball",56678,85178,-28500,0,0,0,56678,85178,-28500,".","11",0,20178
"10626",162928,"JOHNS HOPKINS UNIVERSITY                                    ","2003-2004",19,"Swimming",189487,218024,-28537,102729,118933,-16204,86758,99091,-12333,"24","20",25507,21237
"9924",226833,"MIDWESTERN STATE UNIVERSITY                                 ","2003-2004",16,"Softball",2418,30996,-28578,0,0,0,2418,30996,-28578,".","14",0,26500
"13605",227766,"RICHLAND COLLEGE                                            ","2003-2004",26,"Volleyball",100,28700,-28600,0,0,0,100,28700,-28600,".","18",0,6200
"12392",196866,"UNION COLLEGE                                               ","2003-2004",25,"Track and Field, X-Country",33129,61731,-28602,30205,34908,-4703,2924,26823,-23899,"58","51",8534,8534
"1258",153384,"GRINNELL COLLEGE                                            ","2003-2004",1,"Baseball",24232,52839,-28607,24232,52839,-28607,0,0,0,"30",".",24474,0
"818",110547,"CALIFORNIA STATE UNIVERSITY-DOMINGUEZ HILLS                 ","2003-2004",1,"Baseball",23009,51622,-28613,23009,51622,-28613,0,0,0,"30",".",35914,0
"6207",240727,"UNIVERSITY OF WYOMING                                       ","2003-2004",8,"Golf",327997,356657,-28660,156548,184872,-28324,171449,171785,-336,"7","9",42741,41925
"11218",185590,"MONTCLAIR STATE UNIVERSITY                                  ","2003-2004",22,"Tennis",1380,30045,-28665,0,0,0,1380,30045,-28665,".","9",0,4439
"3664",213783,"MANSFIELD UNIVERSITY OF PENNSYLVANIA                        ","2003-2004",3,"All Track Combined",93095,121771,-28676,42940,55323,-12383,50155,66448,-16293,"110","96",19148,19148
"13540",175078,"SOUTHWEST MINNESOTA STATE UNIVERSITY                        ","2003-2004",26,"Volleyball",11255,39952,-28697,0,0,0,11255,39952,-28697,".","17",0,31699
"6618",204501,"OBERLIN COLLEGE                                             ","2003-2004",11,"Lacrosse",81586,110290,-28704,47502,60456,-12954,34084,49834,-15750,"18","15",32242,23843
"12314",240277,"UNIVERSITY OF WISCONSIN-GREEN BAY                           ","2003-2004",25,"Track and Field, X-Country",119790,148523,-28733,62506,77160,-14654,57284,71363,-14079,"13","11",14001,14001
"12322",112075,"CONCORDIA UNIVERSITY                                        ","2003-2004",25,"Track and Field, X-Country",79618,108370,-28752,39809,54185,-14376,39809,54185,-14376,"21","23",22310,22310
"8993",102368,"TROY STATE UNIVERSITY-MAIN CAMPUS                           ","2003-2004",16,"Softball",282551,311308,-28757,0,0,0,282551,311308,-28757,".","23",0,57865
"9200",241739,"UNIVERSIDAD METROPOLITANA                                   ","2003-2004",16,"Softball",1,28764,-28763,0,0,0,1,28764,-28763,".","15",0,5450
"13113",155973,"TABOR COLLEGE                                               ","2003-2004",26,"Volleyball",9143,37911,-28768,0,0,0,9143,37911,-28768,".","18",0,12312
"8909",174783,"SAINT CLOUD STATE UNIVERSITY                                ","2003-2004",16,"Softball",66415,95200,-28785,0,0,0,66415,95200,-28785,".","17",0,27519
"10303",174783,"SAINT CLOUD STATE UNIVERSITY                                ","2003-2004",18,"Swimming and Diving",75607,104410,-28803,35865,37868,-2003,39742,66542,-26800,"24","26",10408,13432
"4893",201548,"CAPITAL UNIVERSITY                                          ","2003-2004",7,"Football",209732,238549,-28817,209732,238549,-28817,0,0,0,"117",".",70721,0
"7668",157809,"THOMAS MORE COLLEGE                                         ","2003-2004",15,"Soccer",25127,53957,-28830,11274,26204,-14930,13853,27753,-13900,"23","22",9522,10736
"6374",196149,"SUNY COLLEGE AT CORTLAND                                    ","2003-2004",9,"Gymnastics",38868,67720,-28852,0,0,0,38868,67720,-28852,".","20",0,33368
"4767",207041,"EAST CENTRAL UNIVERSITY                                     ","2003-2004",7,"Football",147362,176216,-28854,147362,176216,-28854,0,0,0,"103",".",80110,0
"4043",168254,"WESTERN NEW ENGLAND COLLEGE                                 ","2003-2004",6,"Field hocky",7225,36096,-28871,0,0,0,7225,36096,-28871,".","23",0,12145
"15261",217819,"COLLEGE OF CHARLESTON                                       ","2003-2004",34,"Equestrian",5984,34855,-28871,0,0,0,5984,34855,-28871,".","41",0,26160
"2955",176406,"TOUGALOO COLLEGE                                            ","2003-2004",2,"Basketball",268187,297187,-29000,148855,158855,-10000,119332,138332,-19000,"17","15",24000,25000
"6504",240426,"UNIVERSITY OF WISCONSIN-SUPERIOR                            ","2003-2004",10,"Ice Hockey",242450,271454,-29004,144180,152208,-8028,98270,119246,-20976,"25","21",120647,99246
"5591",172200,"SCHOOLCRAFT COLLEGE                                         ","2003-2004",8,"Golf",14673,43685,-29012,14673,43685,-29012,0,0,0,"6",".",16473,0
"14106",241225,"BAYAMON CENTRAL UNIVERSITY                                  ","2003-2004",26,"Volleyball",4500,33520,-29020,2250,16760,-14510,2250,16760,-14510,"12","12",3800,3800
"9407",152336,"UNIVERSITY OF SAINT FRANCIS-FT WAYNE                        ","2003-2004",16,"Softball",20650,49709,-29059,0,0,0,20650,49709,-29059,".","24",0,17389
"2319",101301,"GEORGE C WALLACE STATE COMMUNITY COLLEGE-SELMA              ","2003-2004",2,"Basketball",1354,30429,-29075,677,14386,-13709,677,16043,-15366,"10","15",8562,10023
"9116",153384,"GRINNELL COLLEGE                                            ","2003-2004",16,"Softball",20570,49678,-29108,0,0,0,20570,49678,-29108,".","17",0,20496
"15082",111188,"CALIFORNIA MARITIME ACADEMY                                 ","2003-2004",29,"Other Sports",53000,82125,-29125,53000,82125,-29125,0,0,0,"40",".",6755,0
"8585",146719,"LOYOLA UNIVERSITY CHICAGO                                   ","2003-2004",16,"Softball",354774,383908,-29134,0,0,0,354774,383908,-29134,".","14",0,49011
"7035",173647,"GUSTAVUS ADOLPHUS COLLEGE                                   ","2003-2004",14,"Skiing",56612,85756,-29144,29340,44768,-15428,27272,40988,-13716,"9","8",29735,26432
"7092",224527,"EAST TEXAS BAPTIST UNIVERSITY                               ","2003-2004",15,"Soccer",103650,132825,-29175,44317,66663,-22346,59333,66162,-6829,"23","23",22744,21361
"13632",153737,"KIRKWOOD COMMUNITY COLLEGE                                  ","2003-2004",26,"Volleyball",10250,39425,-29175,0,0,0,10250,39425,-29175,".","10",0,12250
"10120",196167,"SUNY COLLEGE AT GENESEO                                     ","2003-2004",18,"Swimming and Diving",92515,121698,-29183,46424,60849,-14425,46091,60849,-14758,"27","24",33295,33295
"17333",211307,"BUCKS COUNTY COMMUNITY COLLEGE                              ","2003-2004",39,"Total Participants",46060,75260,-29200,30709,47309,-16600,15351,27951,-12600,"58","20",41259,15351
"914",213303,"KEYSTONE COLLEGE                                            ","2003-2004",1,"Baseball",29517,58777,-29260,29517,58777,-29260,0,0,0,"25",".",29517,0
"8286",199306,"PFEIFFER UNIVERSITY                                         ","2003-2004",15,"Soccer",380,29648,-29268,330,15767,-15437,50,13881,-13831,"21","26",6570,10486
"12407",231174,"UNIVERSITY OF VERMONT AND STATE AGRICULTURAL COLL           ","2003-2004",25,"Track and Field, X-Country",143694,172962,-29268,45328,83645,-38317,98366,89317,9049,"9","15",13540,18054
"9429",113634,"DIABLO VALLEY COLLEGE                                       ","2003-2004",16,"Softball",902,30173,-29271,0,0,0,902,30173,-29271,".","15",0,3270
"8980",102270,"STILLMAN COLLEGE                                            ","2003-2004",16,"Softball",12000,41375,-29375,0,0,0,12000,41375,-29375,".","24",0,12000
"15734",178679,"OZARK CHRISTIAN COLLEGE                                     ","2003-2004",39,"Total Participants",2000,31380,-29380,1000,15600,-14600,1000,15780,-14780,"39","29",30650,28500
"12217",207041,"EAST CENTRAL UNIVERSITY                                     ","2003-2004",25,"Track and Field, X-Country",12006,41420,-29414,6003,20710,-14707,6003,20710,-14707,"20","9",6251,6251
"9125",237367,"FAIRMONT STATE COLLEGE                                      ","2003-2004",16,"Softball",16800,46243,-29443,0,0,0,16800,46243,-29443,".","21",0,21732
"7419",182670,"DARTMOUTH COLLEGE                                           ","2003-2004",15,"Soccer",460046,489493,-29447,216175,257395,-41220,243871,232098,11773,"27","26",63927,62285
"3095",190691,"CUNY YORK COLLEGE                                           ","2003-2004",2,"Basketball",28772,58224,-29452,14435,32412,-17977,14337,25812,-11475,"12","10",14435,14337
"473",232089,"FERRUM COLLEGE                                              ","2003-2004",1,"Baseball",99865,129328,-29463,99865,129328,-29463,0,0,0,"44",".",74748,0
"8956",233295,"RANDOLPH-MACON COLLEGE                                      ","2003-2004",16,"Softball",450,29960,-29510,0,0,0,450,29960,-29510,".","14",0,13150
"17283",192192,"KEUKA COLLEGE                                               ","2003-2004",39,"Total Participants",240109,269632,-29523,102961,112972,-10011,137148,156660,-19512,"116","105",68113,94002
"12007",123484,"COLLEGE OF THE SISKIYOUS                                    ","2003-2004",24,"Track and Field, Outdoor",28398,57922,-29524,21846,44559,-22713,6552,13363,-6811,"20","6",20920,6276
"766",170541,"KALAMAZOO VALLEY COMMUNITY COLLEGE                          ","2003-2004",1,"Baseball",1,29534,-29533,1,29534,-29533,0,0,0,"28",".",12342,0
"2116",214731,"PENNSYLVANIA STATE UNIVERSITY-DELAWARE COUNTY               ","2003-2004",2,"Basketball",5164,34713,-29549,3183,19597,-16414,1981,15116,-13135,"12","12",14097,9816
"3700",181330,"MIDLAND LUTHERAN COLLEGE                                    ","2003-2004",3,"All Track Combined",20134,49696,-29562,10067,26536,-16469,10067,23160,-13093,"18","27",10067,10067
"5203",181330,"MIDLAND LUTHERAN COLLEGE                                    ","2003-2004",8,"Golf",7682,37244,-29562,3841,20310,-16469,3841,16934,-13093,"13","13",3841,3841
"7282",181330,"MIDLAND LUTHERAN COLLEGE                                    ","2003-2004",15,"Soccer",28003,57565,-29562,14623,31092,-16469,13380,26473,-13093,"20","21",14623,13380
"10888",181330,"MIDLAND LUTHERAN COLLEGE                                    ","2003-2004",22,"Tennis",2827,32389,-29562,1413,17882,-16469,1414,14507,-13093,"8","8",1413,1414
"13716",172200,"SCHOOLCRAFT COLLEGE                                         ","2003-2004",26,"Volleyball",54873,84445,-29572,0,0,0,54873,84445,-29572,".","17",0,29393
"14752",121345,"POMONA COLLEGE                                              ","2003-2004",27,"Water Polo",20041,49631,-29590,7910,23106,-15196,12131,26525,-14394,"14","13",8470,11564
"9662",155140,"HASKELL INDIAN NATIONS UNIVERSITY                           ","2003-2004",16,"Softball",13000,42605,-29605,0,0,0,13000,42605,-29605,".","16",0,13000
"16149",177214,"DRURY UNIVERSITY                                            ","2003-2004",39,"Total Participants",413969,443588,-29619,190278,210268,-19990,223691,233320,-9629,"90","89",308872,350247
"5229",151102,"INDIANA UNIVERSITY-PURDUE UNIVERSITY-FORT WAYNE             ","2003-2004",8,"Golf",950,30571,-29621,950,30571,-29621,0,0,0,"11",".",13515,0
"12061",216357,"THIEL COLLEGE                                               ","2003-2004",24,"Track and Field, Outdoor",17935,47565,-29630,9248,23543,-14295,8687,24022,-15335,"32","22",10728,10054
"10558",238078,"WHEELING JESUIT UNIVERSITY                                  ","2003-2004",19,"Swimming",1000,30638,-29638,500,11915,-11415,500,18723,-18223,"7","11",4902,7704
"4014",162928,"JOHNS HOPKINS UNIVERSITY                                    ","2003-2004",5,"Fencing",79214,108853,-29639,44880,55115,-10235,34334,53738,-19404,"11","18",27016,28720
"12502",221971,"UNION UNIVERSITY                                            ","2003-2004",25,"Track and Field, X-Country",71695,101390,-29695,35872,50720,-14848,35823,50670,-14847,"6","8",3833,3898
"561",176947,"CENTRAL METHODIST COLLEGE                                   ","2003-2004",1,"Baseball",24358,54058,-29700,24358,54058,-29700,0,0,0,"43",".",24358,0
"11803",195243,"SAINT THOMAS AQUINAS COLLEGE                                ","2003-2004",23,"Track and Field, Indoor",8982,38718,-29736,4491,21886,-17395,4491,16832,-12341,"9","8",1636,1832
"12271",224226,"DALLAS BAPTIST UNIVERSITY                                   ","2003-2004",25,"Track and Field, X-Country",138494,168409,-29915,61704,73171,-11467,76790,95238,-18448,"47","38",45383,36315
"5547",140696,"OGLETHORPE UNIVERSITY                                       ","2003-2004",8,"Golf",20293,50210,-29917,13505,28105,-14600,6788,22105,-15317,"12","10",10000,4000
"522",221971,"UNION UNIVERSITY                                            ","2003-2004",1,"Baseball",266062,295981,-29919,266062,295981,-29919,0,0,0,"23",".",38421,0
"12580",131399,"UNIVERSITY OF THE DISTRICT OF COLUMBIA                      ","2003-2004",25,"Track and Field, X-Country",40000,69926,-29926,20000,43315,-23315,20000,26611,-6611,"8","6",6187,3326
"2517",193326,"MONROE COMMUNITY COLLEGE                                    ","2003-2004",2,"Basketball",195651,225604,-29953,99667,118662,-18995,95984,106942,-10958,"15","12",33088,46530
"7700",162928,"JOHNS HOPKINS UNIVERSITY                                    ","2003-2004",15,"Soccer",203703,233682,-29979,117815,124759,-6944,85888,108923,-23035,"27","24",30869,32374
"8",237215,"BLUEFIELD STATE COLLEGE                                     ","2003-2004",1,"Baseball",33975,63958,-29983,33975,63958,-29983,0,0,0,"22",".",25360,0
"7613",240107,"VITERBO UNIVERSITY                                          ","2003-2004",15,"Soccer",57370,87353,-29983,20850,45028,-24178,36520,42325,-5805,"22","20",21574,18230
"3230",179946,"WESTMINSTER COLLEGE                                         ","2003-2004",2,"Basketball",55000,85000,-30000,30000,45000,-15000,25000,40000,-15000,"15","14",20000,20000
"3391",154776,"THE BROWN MACKIE COLLEGE                                    ","2003-2004",2,"Basketball",5500,35500,-30000,5200,18500,-13300,300,17000,-16700,"23","19",1275,1235
"7147",140669,"NORTH GEORGIA COLLEGE AND STATE UNIVERSITY                  ","2003-2004",15,"Soccer",100355,130355,-30000,54062,69062,-15000,46293,61293,-15000,"20","19",31902,30280
"8232",185873,"OCEAN COUNTY COLLEGE                                        ","2003-2004",15,"Soccer",4500,34500,-30000,2000,17200,-15200,2500,17300,-14800,"16","15",8000,8000
"10596",238476,"CARTHAGE COLLEGE                                            ","2003-2004",19,"Swimming",145951,175951,-30000,75062,90062,-15000,70889,85889,-15000,"24","30",12000,12000
"6020",110422,"CALIFORNIA POLYTECHNIC STATE UNIV-SAN LUIS OBISPO           ","2003-2004",8,"Golf",101606,131627,-30021,48768,65119,-16351,52838,66508,-13670,"14","13",20584,24311
"5600",198613,"GUILFORD COLLEGE                                            ","2003-2004",8,"Golf",26817,56844,-30027,26817,56844,-30027,0,0,0,"16",".",12234,0
"16818",403478,"ILLINOIS EASTERN COMMUNITY COLLS-LINCOLN TR COLL            ","2003-2004",39,"Total Participants",149714,179760,-30046,97650,124901,-27251,52064,54859,-2795,"37","26",44748,20210
"8380",194541,"POLYTECHNIC UNIVERSITY                                      ","2003-2004",15,"Soccer",10000,40065,-30065,7000,30503,-23503,3000,9562,-6562,"20","12",18019,1078
"3833",186371,"RUTGERS UNIVERSITY-CAMDEN                                   ","2003-2004",3,"All Track Combined",549,30624,-30075,0,15862,-15862,549,14762,-14213,"24","23",7378,6378
"14510",139719,"FORT VALLEY STATE UNIVERSITY                                ","2003-2004",26,"Volleyball",4000,34090,-30090,0,0,0,4000,34090,-30090,".","10",0,9500
"2544",112084,"CHRISTIAN HERITAGE COLLEGE                                  ","2003-2004",2,"Basketball",67845,97982,-30137,39939,57003,-17064,27906,40979,-13073,"13","10",17003,14479
"3720",174783,"SAINT CLOUD STATE UNIVERSITY                                ","2003-2004",3,"All Track Combined",130365,160538,-30173,64468,77568,-13100,65897,82970,-17073,"62","70",23745,24539
"6567",231712,"CHRISTOPHER NEWPORT UNIVERSITY                              ","2003-2004",11,"Lacrosse",15123,45297,-30174,0,0,0,15123,45297,-30174,".","20",0,10875
"3807",216287,"SWARTHMORE COLLEGE                                          ","2003-2004",3,"All Track Combined",13080,43270,-30190,6080,21135,-15055,7000,22135,-15135,"83","77",20648,20649
"2191",240125,"WAUKESHA COUNTY TECHNICAL COLLEGE                           ","2003-2004",2,"Basketball",4344,34551,-30207,2286,18017,-15731,2058,16534,-14476,"13","10",10852,9508
"1490",130183,"TEIKYO POST UNIVERSITY                                      ","2003-2004",1,"Baseball",34181,64440,-30259,34181,64440,-30259,0,0,0,"42",".",63470,0
"8609",118693,"MENLO COLLEGE                                               ","2003-2004",16,"Softball",300,30563,-30263,0,0,0,300,30563,-30263,".","12",0,21275
"9754",117645,"LONG BEACH CITY COLLEGE                                     ","2003-2004",16,"Softball",18146,48409,-30263,0,0,0,18146,48409,-30263,".","13",0,15486
"17163",214698,"PENNSYLVANIA STATE UNIVERSITY-PENN STATE BEAVER             ","2003-2004",39,"Total Participants",104,30403,-30299,2,21500,-21498,102,8903,-8801,"46","26",29799,8801
"8072",132471,"BARRY UNIVERSITY                                            ","2003-2004",15,"Soccer",222780,253080,-30300,116140,130440,-14300,106640,122640,-16000,"25","22",71840,77640
"16765",209074,"LINN-BENTON COMMUNITY COLLEGE                               ","2003-2004",39,"Total Participants",15211,45545,-30334,12857,25712,-12855,2354,19833,-17479,"39","24",34453,24763
"3076",228325,"SOUTHWESTERN ASSEMBLIES OF GOD UNIVERSITY                   ","2003-2004",2,"Basketball",160491,190857,-30366,99960,113774,-13814,60531,77083,-16552,"19","12",39007,21010
"2037",232937,"NORFOLK STATE UNIVERSITY                                    ","2003-2004",2,"Basketball",1077281,1107650,-30369,632126,616379,15747,445155,491271,-46116,"9","13",357311,281574
"8994",220312,"HIWASSEE COLLEGE                                            ","2003-2004",16,"Softball",17700,48086,-30386,0,0,0,17700,48086,-30386,".","13",0,5031
"2989",236328,"UNIVERSITY OF PUGET SOUND                                   ","2003-2004",2,"Basketball",71650,102073,-30423,58891,59930,-1039,12759,42143,-29384,"17","13",52251,40473
"764",211361,"CALIFORNIA UNIVERSITY OF PENNSYLVANIA                       ","2003-2004",1,"Baseball",98314,128756,-30442,98314,128756,-30442,0,0,0,"36",".",41828,0
"5531",201690,"CENTRAL STATE UNIVERSITY                                    ","2003-2004",8,"Golf",5250,35720,-30470,2625,17860,-15235,2625,17860,-15235,"5","5",2500,2500
"9179",130989,"GOLDEY-BEACOM COLLEGE                                       ","2003-2004",16,"Softball",37320,67800,-30480,0,0,0,37320,67800,-30480,".","12",0,18700
"5214",173920,"MINNESOTA STATE UNVERSITY-MANKATO                           ","2003-2004",8,"Golf",54427,84916,-30489,23124,31323,-8199,31303,53593,-22290,"10","13",21294,24121
"16001",121886,"RIO HONDO COLLEGE                                           ","2003-2004",39,"Total Participants",257536,288031,-30495,144647,151315,-6668,112889,136716,-23827,"129","104",69583,58684
"7373",235167,"EVERGREEN STATE COLLEGE                                     ","2003-2004",15,"Soccer",8525,39031,-30506,4130,22287,-18157,4395,16744,-12349,"21","19",11795,11795
"468",212009,"DICKINSON COLLEGE                                           ","2003-2004",1,"Baseball",11931,42550,-30619,11931,42550,-30619,0,0,0,"19",".",12431,0
"7604",213783,"MANSFIELD UNIVERSITY OF PENNSYLVANIA                        ","2003-2004",15,"Soccer",46543,77173,-30630,0,0,0,46543,77173,-30630,".","21",0,20345
"4205",212009,"DICKINSON COLLEGE                                           ","2003-2004",6,"Field hocky",14177,44811,-30634,0,0,0,14177,44811,-30634,".","28",0,16677
"7442",237330,"CONCORD COLLEGE                                             ","2003-2004",15,"Soccer",62169,92807,-30638,0,0,0,62169,92807,-30638,".","15",0,9919
"183",101675,"MILES COLLEGE                                               ","2003-2004",1,"Baseball",33087,63736,-30649,33087,63736,-30649,0,0,0,"14",".",4553,0
"12094",119137,"MOORPARK COLLEGE                                            ","2003-2004",24,"Track and Field, Outdoor",19656,50342,-30686,9828,25171,-15343,9828,25171,-15343,"49","10",9828,9828
"1167",226329,"LON MORRIS COLLEGE                                          ","2003-2004",1,"Baseball",18646,49357,-30711,18646,49357,-30711,0,0,0,"48",".",18607,0
"13339",126678,"COLORADO COLLEGE                                            ","2003-2004",26,"Volleyball",86767,117485,-30718,0,0,0,86767,117485,-30718,".","23",0,32267
"11499",201690,"CENTRAL STATE UNIVERSITY                                    ","2003-2004",22,"Tennis",5000,35720,-30720,2500,17860,-15360,2500,17860,-15360,"6","6",2500,2500
"10876",198543,"FAYETTEVILLE STATE UNIVERSITY                               ","2003-2004",22,"Tennis",1,30730,-30729,0,0,0,1,30730,-30729,".","7",0,24918
"8611",173920,"MINNESOTA STATE UNVERSITY-MANKATO                           ","2003-2004",16,"Softball",169308,200040,-30732,0,0,0,169308,200040,-30732,".","15",0,65770
"6097",230603,"SOUTHERN UTAH UNIVERSITY                                    ","2003-2004",8,"Golf",42426,73166,-30740,42426,73166,-30740,0,0,0,"8",".",28998,0
"3362",181738,"UNION COLLEGE                                               ","2003-2004",2,"Basketball",14773,45522,-30749,10687,27893,-17206,4086,17629,-13543,"12","12",17206,13543
"11902",199582,"SAINT AUGUSTINES COLLEGE                                    ","2003-2004",23,"Track and Field, Indoor",109034,139786,-30752,30243,81430,-51187,78791,58356,20435,"20","14",9647,8250
"11341",183044,"UNIVERSITY OF NEW HAMPSHIRE-MAIN CAMPUS                     ","2003-2004",22,"Tennis",105113,135873,-30760,1,28277,-28276,105112,107596,-2484,"9","10",21247,24987
"5897",178402,"UNIVERSITY OF MISSOURI-KANSAS CITY                          ","2003-2004",8,"Golf",246988,277766,-30778,141997,140659,1338,104991,137107,-32116,"12","10",23403,18600
"16946",238263,"MADISON AREA TECHNICAL COLLEGE                              ","2003-2004",39,"Total Participants",156988,187797,-30809,98002,149616,-51614,58986,38181,20805,"100","46",129682,34166
"6026",228246,"SOUTHERN METHODIST UNIVERSITY                               ","2003-2004",8,"Golf",976563,1007535,-30972,602139,612764,-10625,374424,394771,-20347,"10","7",98142,64183
"9991",229160,"TEXAS WESLEYAN UNIVERSITY                                   ","2003-2004",16,"Softball",22054,53027,-30973,0,0,0,22054,53027,-30973,".","23",0,21270
"9897",217873,"CLAFLIN UNIVERSITY                                          ","2003-2004",16,"Softball",4000,35000,-31000,0,0,0,4000,35000,-31000,".","15",0,10000
"4267",236230,"PACIFIC LUTHERAN UNIVERSITY                                 ","2003-2004",7,"Football",47300,78305,-31005,47300,78305,-31005,0,0,0,"103",".",47300,0
"16412",191676,"HOUGHTON COLLEGE                                            ","2003-2004",39,"Total Participants",646110,677118,-31008,223228,228599,-5371,422882,448519,-25637,"67","109",92729,154375
"6684",232681,"MARY WASHINGTON COLLEGE                                     ","2003-2004",11,"Lacrosse",72030,103050,-31020,33710,49474,-15764,38320,53576,-15256,"34","25",20670,19788
"12822",141565,"UNIVERSITY OF HAWAII AT HILO                                ","2003-2004",25,"Track and Field, X-Country",117675,148702,-31027,58896,71960,-13064,58779,76742,-17963,"8","9",8442,8442
"10587",237367,"FAIRMONT STATE COLLEGE                                      ","2003-2004",19,"Swimming",37595,68626,-31031,18320,35672,-17352,19275,32954,-13679,"8","7",7566,6815
"11882",198969,"METHODIST COLLEGE                                           ","2003-2004",23,"Track and Field, Indoor",1160,32210,-31050,580,16075,-15495,580,16135,-15555,"29","12",6700,2250
"13896",201690,"CENTRAL STATE UNIVERSITY                                    ","2003-2004",26,"Volleyball",10000,41095,-31095,0,0,0,10000,41095,-31095,"0","9",0,10000
"2285",141097,"SOUTHERN POLYTECHNIC STATE UNIVERSITY                       ","2003-2004",2,"Basketball",391900,423000,-31100,204000,219000,-15000,187900,204000,-16100,"15","13",21000,24490
"5602",151306,"UNIVERSITY OF SOUTHERN INDIANA                              ","2003-2004",8,"Golf",55422,86529,-31107,27074,40104,-13030,28348,46425,-18077,"11","10",16747,24281
"6814",192925,"MEDAILLE COLLEGE                                            ","2003-2004",11,"Lacrosse",4890,36037,-31147,4254,21706,-17452,636,14331,-13695,"18","12",15506,8781
"7464",198613,"GUILFORD COLLEGE                                            ","2003-2004",15,"Soccer",128685,159843,-31158,36340,58247,-21907,92345,101596,-9251,"24","29",18108,21852
"11446",110097,"BIOLA UNIVERSITY                                            ","2003-2004",22,"Tennis",11367,42532,-31165,0,0,0,11367,42532,-31165,".","8",0,7938
"7764",240462,"UNIVERSITY OF WISCONSIN-PLATTEVILLE                         ","2003-2004",15,"Soccer",47107,78308,-31201,23179,37410,-14231,23928,40898,-16970,"25","23",18633,22926
"14965",147013,"MCKENDREE COLLEGE                                           ","2003-2004",28,"Wrestling",134388,165606,-31218,134388,165606,-31218,0,0,0,"28",".",37688,0
"478",240426,"UNIVERSITY OF WISCONSIN-SUPERIOR                            ","2003-2004",1,"Baseball",42310,73551,-31241,42310,73551,-31241,0,0,0,"22",".",49907,0
"13543",154952,"COWLEY COUNTY COMMUNITY COLLEGE                             ","2003-2004",26,"Volleyball",11586,42846,-31260,0,0,0,11586,42846,-31260,".","12",0,11586
"16920",154952,"COWLEY COUNTY COMMUNITY COLLEGE                             ","2003-2004",39,"Total Participants",462437,493697,-31260,225660,225660,0,236777,268037,-31260,"92","132",104541,111412
"16383",161244,"UNIVERSITY OF MAINE AT MACHIAS                              ","2003-2004",39,"Total Participants",93213,124483,-31270,33647,50424,-16777,59566,74059,-14493,"36","44",67528,70823
"16994",207670,"ROSE STATE COLLEGE                                          ","2003-2004",39,"Total Participants",24514,55816,-31302,12647,28649,-16002,11867,27167,-15300,"40","40",36402,30918
"7228",216764,"WEST CHESTER UNIVERSITY OF PENNSYLVANIA                     ","2003-2004",15,"Soccer",63263,94588,-31325,36045,41900,-5855,27218,52688,-25470,"28","24",21973,25986
"3842",142285,"UNIVERSITY OF IDAHO                                         ","2003-2004",3,"All Track Combined",816839,848199,-31360,318240,342928,-24688,498599,505271,-6672,"55","56",115180,148792
"5470",207458,"OKLAHOMA CITY UNIVERSITY                                    ","2003-2004",8,"Golf",14572,45966,-31394,7080,23611,-16531,7492,22355,-14863,"8","7",16417,16750
"8798",196149,"SUNY COLLEGE AT CORTLAND                                    ","2003-2004",16,"Softball",70434,101872,-31438,0,0,0,70434,101872,-31438,".","22",0,58523
"1278",138716,"ALBANY STATE UNIVERSITY                                     ","2003-2004",1,"Baseball",53454,84894,-31440,53454,84894,-31440,0,0,0,"26",".",53454,0
"10747",176071,"MISSISSIPPI GULF COAST COMMUNITY COLLEGE                    ","2003-2004",22,"Tennis",2,31474,-31472,1,14447,-14446,1,17027,-17026,"8","5",1725,1725
"12908",208406,"CLACKAMAS COMMUNITY COLLEGE                                 ","2003-2004",25,"Track and Field, X-Country",12412,43908,-31496,6206,21936,-15730,6206,21972,-15766,"20","18",11889,11190
"14129",233295,"RANDOLPH-MACON COLLEGE                                      ","2003-2004",26,"Volleyball",3000,34541,-31541,0,0,0,3000,34541,-31541,".","14",0,14300
"1473",136330,"PALM BEACH ATLANTIC UNIVERSITY-WEST PALM BEACH              ","2003-2004",1,"Baseball",4229,35776,-31547,4229,35776,-31547,0,0,0,"33",".",24774,0
"11439",170082,"GRAND VALLEY STATE UNIVERSITY                               ","2003-2004",22,"Tennis",84766,116329,-31563,46355,62451,-16096,38411,53878,-15467,"14","10",16651,16651
"10357",193326,"MONROE COMMUNITY COLLEGE                                    ","2003-2004",18,"Swimming and Diving",49936,81518,-31582,24968,40759,-15791,24968,40759,-15791,"8","8",17662,17662
"9105",155858,"SEWARD COUNTY COMMUNITY COLLEGE                             ","2003-2004",16,"Softball",63075,94667,-31592,0,0,0,63075,94667,-31592,".","12",0,18785
"3105",120971,"PALOMAR COLLEGE                                             ","2003-2004",2,"Basketball",23045,54646,-31601,12610,28809,-16199,10435,25837,-15402,"14","14",15584,12112
"15324",228158,"SOUTH PLAINS COLLEGE                                        ","2003-2004",35,"Rodeo",1000,32640,-31640,500,17085,-16585,500,15555,-15055,"18","5",10530,9000
"14315",239318,"MILWAUKEE SCHOOL OF ENGINEERING                             ","2003-2004",26,"Volleyball",12700,44364,-31664,6335,25142,-18807,6365,19222,-12857,"15","17",19392,12418
"7229",192925,"MEDAILLE COLLEGE                                            ","2003-2004",15,"Soccer",3001,34696,-31695,1165,18833,-17668,1836,15863,-14027,"24","17",12633,9713
"11524",153384,"GRINNELL COLLEGE                                            ","2003-2004",22,"Tennis",18190,49890,-31700,10650,32454,-21804,7540,17436,-9896,"18","16",11787,6887
"8091",153366,"GRACELAND UNIVERSITY-LAMONI                                 ","2003-2004",15,"Soccer",409696,441409,-31713,199307,229997,-30690,210389,211412,-1023,"35","41",53286,39424
"13492",113573,"COLLEGE OF THE DESERT                                       ","2003-2004",26,"Volleyball",2500,34213,-31713,0,0,0,2500,34213,-31713,".","9",0,7299
"3401",228529,"TARLETON STATE UNIVERSITY                                   ","2003-2004",2,"Basketball",350327,382064,-31737,172624,202624,-30000,177703,179440,-1737,"16","11",61565,40391
"8431",155511,"MCPHERSON COLLEGE                                           ","2003-2004",15,"Soccer",17710,49460,-31750,8630,24880,-16250,9080,24580,-15500,"19","13",8630,9080
"10592",117645,"LONG BEACH CITY COLLEGE                                     ","2003-2004",19,"Swimming",3006,34793,-31787,1503,14132,-12629,1503,20661,-19158,"12","13",1503,1503
"5355",213543,"LEHIGH UNIVERSITY                                           ","2003-2004",8,"Golf",121274,153068,-31794,99370,106129,-6759,21904,46939,-25035,"13","13",24899,20239
"8536",227401,"PARIS JUNIOR COLLEGE                                        ","2003-2004",16,"Softball",1,31815,-31814,0,0,0,1,31815,-31814,".","18",0,10132
"527",195030,"UNIVERSITY OF ROCHESTER                                     ","2003-2004",1,"Baseball",64129,95966,-31837,64129,95966,-31837,0,0,0,"24",".",45481,0
"10442",161253,"UNIVERSITY OF MAINE                                         ","2003-2004",18,"Swimming and Diving",297519,329387,-31868,82224,97645,-15421,215295,231742,-16447,"17","28",28536,30845
"9912",212009,"DICKINSON COLLEGE                                           ","2003-2004",16,"Softball",7132,39025,-31893,0,0,0,7132,39025,-31893,".","16",0,9192
"7532",157757,"SPALDING UNIVERSITY                                         ","2003-2004",15,"Soccer",500,32410,-31910,250,14490,-14240,250,17920,-17670,"19","20",14478,17920
"13273",168254,"WESTERN NEW ENGLAND COLLEGE                                 ","2003-2004",26,"Volleyball",9500,41446,-31946,0,0,0,9500,41446,-31946,".","21",0,15410
"585",153630,"IOWA WESTERN COMMUNITY COLLEGE                              ","2003-2004",1,"Baseball",132296,164258,-31962,132296,164258,-31962,0,0,0,"26",".",30891,0
"3648",194824,"RENSSELAER POLYTECHNIC INSTITUTE                            ","2003-2004",3,"All Track Combined",110044,142044,-32000,55022,71022,-16000,55022,71022,-16000,"118","62",33390,33390
"5791",157632,"SAINT CATHARINE COLLEGE                                     ","2003-2004",8,"Golf",73142,105207,-32065,43065,57099,-14034,30077,48108,-18031,"18","2",8000,6000
"16029",125727,"WESTMONT COLLEGE                                            ","2003-2004",39,"Total Participants",784423,816506,-32083,413816,441035,-27219,370607,375471,-4864,"97","93",139040,112548
"13781",143279,"BLACK HAWK COLLEGE                                          ","2003-2004",26,"Volleyball",38162,70307,-32145,0,0,0,38162,70307,-32145,".","22",0,32609
"3052",136330,"PALM BEACH ATLANTIC UNIVERSITY-WEST PALM BEACH              ","2003-2004",2,"Basketball",57760,89922,-32162,33486,46028,-12542,24274,43894,-19620,"21","13",36378,34362
"13778",243443,"UNIVERSITY OF SACRED HEART                                  ","2003-2004",26,"Volleyball",50547,82726,-32179,2681,34857,-32176,47866,47869,-3,"13","13",34853,47866
"16641",178387,"MISSOURI WESTERN STATE COLLEGE                              ","2003-2004",39,"Total Participants",626027,658236,-32209,197247,218466,-21219,428780,439770,-10990,"191","61",168990,96121
"475",194541,"POLYTECHNIC UNIVERSITY                                      ","2003-2004",1,"Baseball",7500,39720,-32220,7500,39720,-32220,0,0,0,"15",".",13458,0
"9471",139719,"FORT VALLEY STATE UNIVERSITY                                ","2003-2004",16,"Softball",5000,37227,-32227,0,0,0,5000,37227,-32227,".","16",0,10309
"17066",174604,"RAINY RIVER COMMUNITY COLLEGE                               ","2003-2004",39,"Total Participants",26606,58849,-32243,0,0,0,26606,58849,-32243,"70","33",36403,41117
"11559",221838,"TENNESSEE STATE UNIVERSITY                                  ","2003-2004",22,"Tennis",72962,105283,-32321,35322,50969,-15647,37640,54314,-16674,"6","5",15911,11893
"3120",216287,"SWARTHMORE COLLEGE                                          ","2003-2004",2,"Basketball",30700,63025,-32325,16500,25973,-9473,14200,37052,-22852,"14","13",24385,32128
"4131",164465,"AMHERST COLLEGE                                             ","2003-2004",6,"Field hocky",53545,85895,-32350,0,0,0,53545,85895,-32350,".","22",0,25871
"1420",224961,"GALVESTON COLLEGE                                           ","2003-2004",1,"Baseball",4000,36358,-32358,4000,36358,-32358,0,0,0,"28",".",20860,0
"9016",206835,"OKLAHOMA WESLEYAN UNIVERSITY                                ","2003-2004",16,"Softball",22638,55043,-32405,0,0,0,22638,55043,-32405,".","15",0,13577
"15932",117894,"LOS MEDANOS COLLEGE                                         ","2003-2004",39,"Total Participants",17596,50010,-32414,7672,15417,-7745,9924,34593,-24669,"91","43",34325,17343
"6030",195243,"SAINT THOMAS AQUINAS COLLEGE                                ","2003-2004",8,"Golf",18983,51408,-32425,16983,49408,-32425,2000,2000,0,"11","1",18983,1000
"8988",147660,"NORTH CENTRAL COLLEGE                                       ","2003-2004",16,"Softball",27097,59551,-32454,0,0,0,27097,59551,-32454,".","22",0,10340
"2643",194310,"PACE UNIVERSITY-NEW YORK                                    ","2003-2004",2,"Basketball",884852,917331,-32479,452220,476950,-24730,432632,440381,-7749,"15","11",57985,50892
"9012",213303,"KEYSTONE COLLEGE                                            ","2003-2004",16,"Softball",21375,53875,-32500,0,0,0,21375,53875,-32500,".","18",0,21375
"6122",144892,"EASTERN ILLINOIS UNIVERSITY                                 ","2003-2004",8,"Golf",117184,149686,-32502,57424,75648,-18224,59760,74038,-14278,"11","7",21259,17076
"13362",155511,"MCPHERSON COLLEGE                                           ","2003-2004",26,"Volleyball",16753,49272,-32519,0,0,0,16753,49272,-32519,".","19",0,15937
"3012",228608,"TEMPLE COLLEGE                                              ","2003-2004",2,"Basketball",178239,210775,-32536,88358,104623,-16265,89881,106152,-16271,"14","15",28308,20985
"11055",222178,"ABILENE CHRISTIAN UNIVERSITY                                ","2003-2004",22,"Tennis",338248,370814,-32566,154434,192301,-37867,183814,178513,5301,"12","9",56389,20745
"10309",234085,"VIRGINIA MILITARY INSTITUTE                                 ","2003-2004",18,"Swimming and Diving",8441,41022,-32581,8441,41022,-32581,0,0,0,"40",".",11093,0
"8231",168254,"WESTERN NEW ENGLAND COLLEGE                                 ","2003-2004",15,"Soccer",24270,56941,-32671,17150,37286,-20136,7120,19655,-12535,"29","23",12200,10320
"998",175078,"SOUTHWEST MINNESOTA STATE UNIVERSITY                        ","2003-2004",1,"Baseball",19557,52238,-32681,19557,52238,-32681,0,0,0,"55",".",31365,0
"6858",215132,"UNIVERSITY OF THE SCIENCES IN PHILADELPHIA                  ","2003-2004",12,"Rifle",1,32700,-32699,1,32700,-32699,0,0,0,"9",".",4800,0
"4780",168254,"WESTERN NEW ENGLAND COLLEGE                                 ","2003-2004",7,"Football",29359,62070,-32711,29359,62070,-32711,0,0,0,"78",".",35745,0
"4850",120971,"PALOMAR COLLEGE                                             ","2003-2004",7,"Football",30527,63268,-32741,30527,63268,-32741,0,0,0,"79",".",28849,0
"5628",199698,"ST ANDREWS PRESBYTERIAN COLLEGE                             ","2003-2004",8,"Golf",67779,100529,-32750,38780,63530,-24750,28999,36999,-8000,"21","5",20280,8999
"10803",155973,"TABOR COLLEGE                                               ","2003-2004",22,"Tennis",2437,35230,-32793,730,17081,-16351,1707,18149,-16442,"8","7",1656,2478
"10976",172334,"SPRING ARBOR UNIVERSITY                                     ","2003-2004",22,"Tennis",8905,41705,-32800,4830,24172,-19342,4075,17533,-13458,"7","6",4830,4075
"10225",219356,"SOUTH DAKOTA STATE UNIVERSITY                               ","2003-2004",18,"Swimming and Diving",0,32820,-32820,0,17068,-17068,0,15752,-15752,"12","14",6206,6206
"2134",167251,"NEWBURY COLLEGE-BROOKLINE                                   ","2003-2004",2,"Basketball",7085,39953,-32868,3375,16260,-12885,3710,23693,-19983,"12","11",7311,6642
"14990",211644,"CLARION UNIVERSITY OF PENNSYLVANIA                          ","2003-2004",28,"Wrestling",190106,222981,-32875,190106,222981,-32875,0,0,0,"17",".",30750,0
"27",237330,"CONCORD COLLEGE                                             ","2003-2004",1,"Baseball",89018,121897,-32879,89018,121897,-32879,0,0,0,"27",".",21226,0
"1187",234979,"COLUMBIA BASIN COLLEGE                                      ","2003-2004",1,"Baseball",52357,85244,-32887,52357,85244,-32887,0,0,0,"33",".",33043,0
"10026",186371,"RUTGERS UNIVERSITY-CAMDEN                                   ","2003-2004",16,"Softball",17040,49943,-32903,0,0,0,17040,49943,-32903,".","19",0,35188
"11735",232937,"NORFOLK STATE UNIVERSITY                                    ","2003-2004",22,"Tennis",217805,250742,-32937,95627,120706,-25079,122178,130036,-7858,"6","6",105368,113454
"13891",221856,"TENNESSEE TEMPLE UNIVERSITY                                 ","2003-2004",26,"Volleyball",11099,44036,-32937,0,0,0,11099,44036,-32937,".","12",0,8036
"8841",156408,"CENTRE COLLEGE                                              ","2003-2004",16,"Softball",310,33286,-32976,0,0,0,310,33286,-32976,".","14",0,22502
"9327",207236,"MURRAY STATE COLLEGE                                        ","2003-2004",16,"Softball",16957,49963,-33006,0,0,0,16957,49963,-33006,".","15",0,16446
"8845",136330,"PALM BEACH ATLANTIC UNIVERSITY-WEST PALM BEACH              ","2003-2004",16,"Softball",6828,39886,-33058,0,0,0,6828,39886,-33058,".","14",0,19788
"3755",190594,"CUNY HUNTER COLLEGE                                         ","2003-2004",3,"All Track Combined",1839,34901,-33062,491,17753,-17262,1348,17148,-15800,"46","42",8049,7444
"354",142559,"COLLEGE OF SOUTHERN IDAHO                                   ","2003-2004",1,"Baseball",97446,130550,-33104,97446,130550,-33104,0,0,0,"21",".",124550,0
"3193",138293,"WEBBER INTERNATIONAL UNIVERSITY                             ","2003-2004",2,"Basketball",194230,227353,-33123,111400,125608,-14208,82830,101745,-18915,"15","14",16579,14363
"7277",100706,"UNIVERSITY OF ALABAMA IN HUNTSVILLE                         ","2003-2004",15,"Soccer",272257,305419,-33162,150220,167819,-17599,122037,137600,-15563,"22","23",26553,18440
"12639",142328,"LEWIS-CLARK STATE COLLEGE                                   ","2003-2004",25,"Track and Field, X-Country",41963,75160,-33197,18264,31715,-13451,23699,43445,-19746,"9","13",9662,12760
"14781",175078,"SOUTHWEST MINNESOTA STATE UNIVERSITY                        ","2003-2004",28,"Wrestling",9517,42716,-33199,9517,42716,-33199,0,0,0,"35",".",19900,0
"13483",153214,"DES MOINES AREA COMMUNITY COLLEGE                           ","2003-2004",26,"Volleyball",3095,36295,-33200,0,0,0,3095,36295,-33200,".","10",0,17795
"104",213783,"MANSFIELD UNIVERSITY OF PENNSYLVANIA                        ","2003-2004",1,"Baseball",196802,230024,-33222,196802,230024,-33222,0,0,0,"32",".",55518,0
"14279",198899,"MARS HILL COLLEGE                                           ","2003-2004",26,"Volleyball",47462,80702,-33240,0,0,0,47462,80702,-33240,".","15",0,20155
"3249",164720,"BECKER COLLEGE                                              ","2003-2004",2,"Basketball",15580,48854,-33274,8088,27472,-19384,7492,21382,-13890,"12","12",18234,14219
"1623",174437,"NORTH CENTRAL UNIVERSITY                                    ","2003-2004",2,"Basketball",15015,48290,-33275,7550,24425,-16875,7465,23865,-16400,"9","10",16325,16065
"1134",221351,"RHODES COLLEGE                                              ","2003-2004",1,"Baseball",52950,86252,-33302,52950,86252,-33302,0,0,0,"28",".",37410,0
"4133",156408,"CENTRE COLLEGE                                              ","2003-2004",6,"Field hocky",2051,35373,-33322,0,0,0,2051,35373,-33322,".","17",0,20123
"7609",240426,"UNIVERSITY OF WISCONSIN-SUPERIOR                            ","2003-2004",15,"Soccer",34286,67610,-33324,17491,34364,-16873,16795,33246,-16451,"28","17",17646,18496
"11103",127060,"UNIVERSITY OF DENVER                                        ","2003-2004",22,"Tennis",687298,720627,-33329,285724,293536,-7812,401574,427091,-25517,"8","9",63486,86824
"2178",207670,"ROSE STATE COLLEGE                                          ","2003-2004",2,"Basketball",27057,60395,-33338,13202,32262,-19060,13855,28133,-14278,"16","16",19730,14948
"231",168591,"ALMA COLLEGE                                                ","2003-2004",1,"Baseball",48445,81792,-33347,48445,81792,-33347,0,0,0,"39",".",29670,0
"10392",152600,"VALPARAISO UNIVERSITY                                       ","2003-2004",18,"Swimming and Diving",116882,150253,-33371,59355,76041,-16686,57527,74212,-16685,"18","24",3446,3446
"2584",112561,"COLUMBIA COLLEGE                                            ","2003-2004",2,"Basketball",27782,61182,-33400,27782,61182,-33400,0,0,0,"11",".",18251,0
"2777",211158,"BLOOMSBURG UNIVERSITY OF PENNSYLVANIA                       ","2003-2004",2,"Basketball",358872,392279,-33407,210377,218916,-8539,148495,173363,-24868,"13","16",21845,20954
"1409",232681,"MARY WASHINGTON COLLEGE                                     ","2003-2004",1,"Baseball",47350,80777,-33427,47350,80777,-33427,0,0,0,"44",".",21831,0
"7049",142294,"ALBERTSON COLLEGE OF IDAHO                                  ","2003-2004",14,"Skiing",8840,42280,-33440,4420,21140,-16720,4420,21140,-16720,"18","14",10000,10000
"9825",140483,"MIDDLE GEORGIA COLLEGE                                      ","2003-2004",16,"Softball",2004,35445,-33441,0,0,0,2004,35445,-33441,".","17",0,16108
"3680",100724,"ALABAMA STATE UNIVERSITY                                    ","2003-2004",3,"All Track Combined",105654,139102,-33448,48596,62044,-13448,57058,77058,-20000,"19","17",57057,57060
"15754",262031,"ST CHARLES COMMUNITY COLLEGE                                ","2003-2004",39,"Total Participants",215922,249385,-33463,123917,131685,-7768,92005,117700,-25695,"30","15",27944,21979
"10284",151111,"INDIANA UNIVERSITY-PURDUE UNIVERSITY-INDIANAPOLIS           ","2003-2004",18,"Swimming and Diving",7124,40605,-33481,3562,18924,-15362,3562,21681,-18119,"16","20",2489,2621
"5145",168591,"ALMA COLLEGE                                                ","2003-2004",8,"Golf",13342,46833,-33491,8939,11419,-2480,4403,35414,-31011,"15","7",4791,4567
"4088",183062,"KEENE STATE COLLEGE                                         ","2003-2004",6,"Field hocky",2345,35838,-33493,0,0,0,2345,35838,-33493,".","25",0,21109
"11444",216807,"WESTMINSTER COLLEGE                                         ","2003-2004",22,"Tennis",15740,49242,-33502,8315,23744,-15429,7425,25498,-18073,"11","13",4758,5343
"10368",206604,"WRIGHT STATE UNIVERSITY-MAIN CAMPUS                         ","2003-2004",18,"Swimming and Diving",699415,732942,-33527,329989,345342,-15353,369426,387600,-18174,"22","23",73012,42175
"3782",152637,"VINCENNES UNIVERSITY                                        ","2003-2004",3,"All Track Combined",34788,68326,-33538,17394,34163,-16769,17394,34163,-16769,"53","5",17394,17394
"8079",154749,"BETHEL COLLEGE                                              ","2003-2004",15,"Soccer",21974,55570,-33596,11100,32463,-21363,10874,23107,-12233,"17","14",11734,11953
"2138",238430,"CARDINAL STRITCH UNIVERSITY                                 ","2003-2004",2,"Basketball",50871,84487,-33616,24660,32383,-7723,26211,52104,-25893,"16","15",20706,20119
"15497",196699,"SUNY ULSTER COUNTY COMMUNITY COLLEGE                        ","2003-2004",39,"Total Participants",19300,52920,-33620,12600,38225,-25625,6700,14695,-7995,"70","25",27625,8045
"5688",207351,"OKLAHOMA PANHANDLE STATE UNIVERSITY                         ","2003-2004",8,"Golf",10196,43826,-33630,5098,26474,-21376,5098,17352,-12254,"12","8",5860,5860
"15112",197036,"UNITED STATES MILITARY ACADEMY                              ","2003-2004",29,"Other Sports",41935,75641,-33706,41935,75641,-33706,0,0,0,"80",".",18987,0
"11372",132471,"BARRY UNIVERSITY                                            ","2003-2004",22,"Tennis",84570,118350,-33780,42300,59100,-16800,42270,59250,-16980,"10","7",29050,29200
"12654",130989,"GOLDEY-BEACOM COLLEGE                                       ","2003-2004",25,"Track and Field, X-Country",27000,60818,-33818,13500,34784,-21284,13500,26034,-12534,"14","7",7134,7134
"16557",169275,"MOTT COMMUNITY COLLEGE                                      ","2003-2004",39,"Total Participants",17900,51745,-33845,8600,30080,-21480,9300,21665,-12365,"51","41",32168,23070
"14244",196149,"SUNY COLLEGE AT CORTLAND                                    ","2003-2004",26,"Volleyball",56758,90604,-33846,0,0,0,56758,90604,-33846,".","14",0,40887
"5572",201104,"ASHLAND UNIVERSITY                                          ","2003-2004",8,"Golf",124275,158129,-33854,74096,91141,-17045,50179,66988,-16809,"10","6",6000,6000
"13257",190594,"CUNY HUNTER COLLEGE                                         ","2003-2004",26,"Volleyball",2,33882,-33880,1,15269,-15268,1,18613,-18612,"14","29",10869,12613
"14343",203845,"MARIETTA COLLEGE                                            ","2003-2004",26,"Volleyball",20887,54776,-33889,0,0,0,20887,54776,-33889,".","16",0,21487
"14935",180948,"CHADRON STATE COLLEGE                                       ","2003-2004",28,"Wrestling",47236,81163,-33927,47236,81163,-33927,0,0,0,"27","0",15651,0
"4590",204501,"OBERLIN COLLEGE                                             ","2003-2004",7,"Football",143786,177777,-33991,143786,177777,-33991,0,0,0,"46",".",51572,0
"1533",164580,"BABSON COLLEGE                                              ","2003-2004",1,"Baseball",18959,52959,-34000,18959,52959,-34000,0,0,0,"27",".",18959,0
"8358",192323,"LE MOYNE COLLEGE                                            ","2003-2004",15,"Soccer",62703,96703,-34000,30458,47458,-17000,32245,49245,-17000,"24","21",30458,32245
"2856",173142,"BETHANY LUTHERAN COLLEGE                                    ","2003-2004",2,"Basketball",68070,102086,-34016,38823,58968,-20145,29247,43118,-13871,"15","14",19908,13459
"47",153108,"CENTRAL COLLEGE                                             ","2003-2004",1,"Baseball",24520,58545,-34025,24520,58545,-34025,0,0,0,"31",".",24243,0
"2784",241377,"CARIBBEAN UNIVERSITY-BAYAMON                                ","2003-2004",2,"Basketball",3000,37027,-34027,3000,37027,-34027,0,0,0,"11",".",5271,0
"12819",139931,"GEORGIA SOUTHERN UNIVERSITY                                 ","2003-2004",25,"Track and Field, X-Country",7379,41426,-34047,0,0,0,7379,41426,-34047,".","7",0,11119
"1590",207458,"OKLAHOMA CITY UNIVERSITY                                    ","2003-2004",1,"Baseball",11175,45238,-34063,11175,45238,-34063,0,0,0,"26",".",24000,0
"8613",100706,"UNIVERSITY OF ALABAMA IN HUNTSVILLE                         ","2003-2004",16,"Softball",202339,236506,-34167,0,0,0,202339,236506,-34167,".","15",0,59780
"8039",219718,"BETHEL COLLEGE                                              ","2003-2004",15,"Soccer",124582,158766,-34184,50859,28268,22591,73723,130498,-56775,"17","19",26147,64092
"10718",155025,"EMPORIA STATE UNIVERSITY                                    ","2003-2004",22,"Tennis",35620,69812,-34192,15380,27087,-11707,20240,42725,-22485,"10","7",6422,5954
"8874",198543,"FAYETTEVILLE STATE UNIVERSITY                               ","2003-2004",16,"Softball",1,34216,-34215,0,0,0,1,34216,-34215,".","15",0,29376
"5450",188182,"COLLEGE OF THE SOUTHWEST                                    ","2003-2004",8,"Golf",2,34240,-34238,1,17120,-17119,1,17120,-17119,"9","5",8410,8410
"16582",152266,"PURDUE UNIVERSITY-NORTH CENTRAL CAMPUS                      ","2003-2004",39,"Total Participants",71681,105969,-34288,45691,60736,-15045,25990,45233,-19243,"34","17",89719,28482
"10430",240329,"UNIVERSITY OF WISCONSIN-LA CROSSE                           ","2003-2004",18,"Swimming and Diving",97364,131693,-34329,42406,63969,-21563,54958,67724,-12766,"24","41",18171,21926
"2870",237039,"WHATCOM COMMUNITY COLLEGE                                   ","2003-2004",2,"Basketball",3381,37762,-34381,2028,19136,-17108,1353,18626,-17273,"13","9",9902,9702
"13587",226329,"LON MORRIS COLLEGE                                          ","2003-2004",26,"Volleyball",9032,43424,-34392,0,0,0,9032,43424,-34392,"0","15",0,12924
"12712",236328,"UNIVERSITY OF PUGET SOUND                                   ","2003-2004",25,"Track and Field, X-Country",3409,37816,-34407,1636,18152,-16516,1773,19664,-17891,"41","43",10760,11817
"8507",243197,"UNIVERSITY OF PUERTO RICO-MAYAGUEZ                          ","2003-2004",15,"Soccer",4401,38845,-34444,4401,38845,-34444,0,0,0,"24",".",4401,0
"1637",123800,"SOUTHWESTERN COLLEGE                                        ","2003-2004",2,"Basketball",26868,61328,-34460,16196,36759,-20563,10672,24569,-13897,"12","11",12410,8216
"13296",198871,"LOUISBURG COLLEGE                                           ","2003-2004",26,"Volleyball",1,34463,-34462,0,0,0,1,34463,-34462,".","7",0,10713
"16021",247603,"SUSSEX COUNTY COMMUNITY COLLEGE                             ","2003-2004",39,"Total Participants",61851,96328,-34477,36181,51866,-15685,25670,44462,-18792,"54","31",28704,13191
"1289",120421,"OXNARD COLLEGE                                              ","2003-2004",1,"Baseball",20008,54500,-34492,20008,54500,-34492,0,0,0,"21",".",20008,0
"9970",142294,"ALBERTSON COLLEGE OF IDAHO                                  ","2003-2004",16,"Softball",18424,52930,-34506,0,0,0,18424,52930,-34506,".","19",0,23290
"6956",186371,"RUTGERS UNIVERSITY-CAMDEN                                   ","2003-2004",13,"Rowing",4116,38670,-34554,2058,19319,-17261,2058,19351,-17293,"11","9",4537,4537
"7524",231420,"AVERETT UNIVERSITY                                          ","2003-2004",15,"Soccer",34500,69066,-34566,19500,38018,-18518,15000,31048,-16048,"18","14",21500,17000
"11114",217998,"ERSKINE COLLEGE AND SEMINARY                                ","2003-2004",22,"Tennis",28000,62569,-34569,8000,10519,-2519,20000,52050,-32050,"7","8",7419,22050
"7847",212009,"DICKINSON COLLEGE                                           ","2003-2004",15,"Soccer",21950,56532,-34582,10705,17710,-7005,11245,38822,-27577,"27","24",13705,13745
"2568",139630,"EMMANUEL COLLEGE                                            ","2003-2004",2,"Basketball",234071,268675,-34604,123146,124809,-1663,110925,143866,-32941,"15","13",25350,22505
"11617",110583,"CALIFORNIA STATE UNIVERSITY-LONG BEACH                      ","2003-2004",22,"Tennis",205616,240230,-34614,0,0,0,205616,240230,-34614,".","11",0,36631
"7379",174251,"UNIVERSITY OF MINNESOTA-MORRIS                              ","2003-2004",15,"Soccer",25012,59630,-34618,0,0,0,25012,59630,-34618,".","19",0,16048
"11656",110565,"CALIFORNIA STATE UNIVERSITY-FULLERTON                       ","2003-2004",22,"Tennis",103715,138363,-34648,0,0,0,103715,138363,-34648,".","11",0,13796
"9596",117052,"REEDLEY COLLEGE                                             ","2003-2004",16,"Softball",11800,46456,-34656,0,0,0,11800,46456,-34656,".","13",0,10310
"7692",226329,"LON MORRIS COLLEGE                                          ","2003-2004",15,"Soccer",27340,61998,-34658,13510,30822,-17312,13830,31176,-17346,"20","17",7572,7926
"16606",211079,"COMMUNITY COLLEGE OF BEAVER COUNTY                          ","2003-2004",39,"Total Participants",9500,44177,-34677,0,0,0,9500,44177,-34677,"12","20",35381,19098
"317",117645,"LONG BEACH CITY COLLEGE                                     ","2003-2004",1,"Baseball",20801,55528,-34727,20801,55528,-34727,0,0,0,"27",".",25390,0
"10073",168342,"WILLIAMS COLLEGE                                            ","2003-2004",17,"Squash",14296,49059,-34763,0,0,0,14296,49059,-34763,"0","15",0,18448
"16026",112084,"CHRISTIAN HERITAGE COLLEGE                                  ","2003-2004",39,"Total Participants",65449,100310,-34861,23765,36119,-12354,41684,64191,-22507,"41","43",30715,39092
"2663",179292,"SAINT LOUIS COMMUNITY COLLEGE-FLORISSANT VALLEY             ","2003-2004",2,"Basketball",25712,60575,-34863,19301,38457,-19156,6411,22118,-15707,"15","11",18505,16404
"17353",179867,"WASHINGTON UNIVERSITY IN ST LOUIS                           ","2003-2004",39,"Total Participants",973851,1008732,-34881,403099,415136,-12037,570752,593596,-22844,"239","160",398987,336569
"9865",179894,"WEBSTER UNIVERSITY                                          ","2003-2004",16,"Softball",7820,42702,-34882,0,0,0,7820,42702,-34882,".","23",0,23336
"15983",176938,"CENTRAL BIBLE COLLEGE                                       ","2003-2004",39,"Total Participants",100,35000,-34900,50,17000,-16950,50,18000,-17950,"26","21",46000,25850
"4219",185590,"MONTCLAIR STATE UNIVERSITY                                  ","2003-2004",6,"Field hocky",27304,62211,-34907,0,0,0,27304,62211,-34907,".","21",0,28680
"12617",195164,"SAINT BONAVENTURE UNIVERSITY                                ","2003-2004",25,"Track and Field, X-Country",2132,37057,-34925,1141,19390,-18249,991,17667,-16676,"10","12",7506,7682
"12066",153108,"CENTRAL COLLEGE                                             ","2003-2004",24,"Track and Field, Outdoor",36878,71805,-34927,19740,36541,-16801,17138,35264,-18126,"52","33",13835,12614
"14145",194958,"ROBERTS WESLEYAN COLLEGE                                    ","2003-2004",26,"Volleyball",48499,83426,-34927,0,0,0,48499,83426,-34927,".","14",0,22317
"11907",153108,"CENTRAL COLLEGE                                             ","2003-2004",23,"Track and Field, Indoor",36878,71806,-34928,19740,36542,-16802,17138,35264,-18126,"47","34",13835,12614
"16439",127778,"OTERO JUNIOR COLLEGE                                        ","2003-2004",39,"Total Participants",130749,165721,-34972,55858,70859,-15001,74891,94862,-19971,"68","68",34725,46855
"13960",200156,"JAMESTOWN COLLEGE                                           ","2003-2004",26,"Volleyball",34903,69890,-34987,0,0,0,34903,69890,-34987,".","14",0,13422
"7804",151111,"INDIANA UNIVERSITY-PURDUE UNIVERSITY-INDIANAPOLIS           ","2003-2004",15,"Soccer",14012,49002,-34990,11131,29281,-18150,2881,19721,-16840,"32","25",7440,10213
"15639",198039,"BLUE RIDGE COMMUNITY COLLEGE                                ","2003-2004",39,"Total Participants",10000,45000,-35000,5000,25000,-20000,5000,20000,-15000,"45","12",15000,15000
"16179",220181,"FISK UNIVERSITY                                             ","2003-2004",39,"Total Participants",53000,88000,-35000,24000,39000,-15000,29000,49000,-20000,"70","79",33500,39000
"10017",197027,"UNITED STATES MERCHANT MARINE ACADEMY                       ","2003-2004",16,"Softball",2450,37513,-35063,0,0,0,2450,37513,-35063,".","19",0,6905
"12429",110680,"UNIVERSITY OF CALIFORNIA-SAN DIEGO                          ","2003-2004",25,"Track and Field, X-Country",230557,265630,-35073,115325,132212,-16887,115232,133418,-18186,"63","62",57289,57555
"13926",198969,"METHODIST COLLEGE                                           ","2003-2004",26,"Volleyball",3007,38081,-35074,0,0,0,3007,38081,-35074,".","9",0,12116
"2521",211088,"ARCADIA UNIVERSITY                                          ","2003-2004",2,"Basketball",14182,49269,-35087,8075,25400,-17325,6107,23869,-17762,"15","14",13100,11869
"12202",153384,"GRINNELL COLLEGE                                            ","2003-2004",25,"Track and Field, X-Country",15140,50252,-35112,8464,27762,-19298,6676,22490,-15814,"34","43",8294,4957
"14591",223773,"CEDAR VALLEY COLLEGE                                        ","2003-2004",26,"Volleyball",45988,81136,-35148,0,0,0,45988,81136,-35148,".","13",0,18288
"1886",219082,"DAKOTA STATE UNIVERSITY                                     ","2003-2004",2,"Basketball",137315,172492,-35177,68425,91388,-22963,68890,81104,-12214,"20","13",22220,18750
"14805",219259,"NORTHERN STATE UNIVERSITY                                   ","2003-2004",28,"Wrestling",38810,74003,-35193,38810,74003,-35193,0,0,0,"22",".",12643,0
"1787",209250,"MT HOOD COMMUNITY COLLEGE                                   ","2003-2004",2,"Basketball",7133,42329,-35196,3726,24466,-20740,3407,17863,-14456,"15","12",18564,17263
"2401",227766,"RICHLAND COLLEGE                                            ","2003-2004",2,"Basketball",100,35316,-35216,100,35316,-35216,0,0,0,"15",".",15675,0
"9509",227526,"PRAIRIE VIEW A &amp; M UNIVERSITY                               ","2003-2004",16,"Softball",48956,84173,-35217,0,0,0,48956,84173,-35217,".","23",0,48956
"3146",178679,"OZARK CHRISTIAN COLLEGE                                     ","2003-2004",2,"Basketball",10000,45220,-35220,6000,21195,-15195,4000,24025,-20025,"15","15",17700,15900
"13497",172334,"SPRING ARBOR UNIVERSITY                                     ","2003-2004",26,"Volleyball",15375,50603,-35228,0,0,0,15375,50603,-35228,"0","13",0,15375
"10383",240727,"UNIVERSITY OF WYOMING                                       ","2003-2004",18,"Swimming and Diving",539220,574463,-35243,224057,257905,-33848,315163,316558,-1395,"22","31",34816,52835
"1329",223773,"CEDAR VALLEY COLLEGE                                        ","2003-2004",1,"Baseball",40934,76195,-35261,40934,76195,-35261,0,0,0,"28",".",9255,0
"46",237367,"FAIRMONT STATE COLLEGE                                      ","2003-2004",1,"Baseball",32294,67561,-35267,32294,67561,-35267,0,0,0,"38",".",24609,0
"1694",195988,"SULLIVAN COUNTY COMMUNITY COLLEGE                           ","2003-2004",2,"Basketball",12640,47916,-35276,6725,26805,-20080,5915,21111,-15196,"17","14",26804,21110
"6353",127060,"UNIVERSITY OF DENVER                                        ","2003-2004",9,"Gymnastics",945356,980662,-35306,0,0,0,945356,980662,-35306,".","15",0,109379
"873",217633,"ANDERSON COLLEGE                                            ","2003-2004",1,"Baseball",130880,166226,-35346,130880,166226,-35346,0,0,0,"45",".",39195,0
"10780",225627,"UNIVERSITY OF THE INCARNATE WORD                            ","2003-2004",22,"Tennis",248759,284109,-35350,104585,122260,-17675,144174,161849,-17675,"8","12",9785,10724
"501",240453,"UNIVERSITY OF WISCONSIN-MILWAUKEE                           ","2003-2004",1,"Baseball",343533,378901,-35368,343533,378901,-35368,0,0,0,"31",".",151220,0
"9678",164216,"WASHINGTON COLLEGE                                          ","2003-2004",16,"Softball",9781,45163,-35382,0,0,0,9781,45163,-35382,".","16",0,18448
"8689",217633,"ANDERSON COLLEGE                                            ","2003-2004",16,"Softball",64517,99902,-35385,0,0,0,64517,99902,-35385,".","14",0,23492
"2132",239318,"MILWAUKEE SCHOOL OF ENGINEERING                             ","2003-2004",2,"Basketball",33445,68882,-35437,20085,43776,-23691,13360,25106,-11746,"13","9",30876,16056
"11000",207740,"SEMINOLE STATE COLLEGE                                      ","2003-2004",22,"Tennis",31580,67020,-35440,16100,41926,-25826,15480,25094,-9614,"7","6",8668,8090
"5465",176044,"MISSISSIPPI VALLEY STATE UNIVERSITY                         ","2003-2004",8,"Golf",24486,59946,-35460,12243,29163,-16920,12243,30783,-18540,"5","5",18328,18328
"16925",193946,"NIAGARA COUNTY COMMUNITY COLLEGE                            ","2003-2004",39,"Total Participants",40922,76427,-35505,25978,44613,-18635,14944,31814,-16870,"85","53",24740,16568
"16259",111948,"CHAPMAN UNIVERSITY                                          ","2003-2004",39,"Total Participants",372390,407900,-35510,153150,149800,3350,219240,258100,-38860,"176","139",139300,112800
"3592",147013,"MCKENDREE COLLEGE                                           ","2003-2004",3,"All Track Combined",211418,246943,-35525,115675,129400,-13725,95743,117543,-21800,"14","14",19390,20263
"4911",115755,"HUMBOLDT STATE UNIVERSITY                                   ","2003-2004",7,"Football",429608,465229,-35621,429608,465229,-35621,0,0,0,"89",".",118981,0
"9421",243197,"UNIVERSITY OF PUERTO RICO-MAYAGUEZ                          ","2003-2004",16,"Softball",3217,38861,-35644,0,0,0,3217,38861,-35644,".","20",0,3647
"13555",192925,"MEDAILLE COLLEGE                                            ","2003-2004",26,"Volleyball",1251,36913,-35662,804,21641,-20837,447,15272,-14825,"15","11",16141,9672
"7057",102553,"UNIVERSITY OF ALASKA ANCHORAGE                              ","2003-2004",14,"Skiing",353780,389458,-35678,182564,200460,-17896,171216,188998,-17782,"16","7",80431,78442
"5072",123341,"SIERRA COLLEGE                                              ","2003-2004",7,"Football",10718,46398,-35680,10718,46398,-35680,0,0,0,"65",".",35230,0
"214",238476,"CARTHAGE COLLEGE                                            ","2003-2004",1,"Baseball",136676,172366,-35690,136676,172366,-35690,0,0,0,"46",".",23000,0
"13832",211644,"CLARION UNIVERSITY OF PENNSYLVANIA                          ","2003-2004",26,"Volleyball",77722,113419,-35697,0,0,0,77722,113419,-35697,".","14",0,18887
"14953",209807,"PORTLAND STATE UNIVERSITY                                   ","2003-2004",28,"Wrestling",103818,139537,-35719,103818,139537,-35719,0,0,0,"23",".",36317,0
"12139",185129,"NEW JERSEY CITY UNIVERSITY                                  ","2003-2004",24,"Track and Field, Outdoor",5250,40981,-35731,2250,20815,-18565,3000,20166,-17166,"10","5",3005,2618
"13176",155858,"SEWARD COUNTY COMMUNITY COLLEGE                             ","2003-2004",26,"Volleyball",81219,116958,-35739,0,0,0,81219,116958,-35739,".","11",0,14266
"9486",195030,"UNIVERSITY OF ROCHESTER                                     ","2003-2004",16,"Softball",36724,72518,-35794,0,0,0,36724,72518,-35794,".","17",0,35143
"6393",171456,"NORTHERN MICHIGAN UNIVERSITY                                ","2003-2004",10,"Ice Hockey",1363656,1399474,-35818,1363656,1399474,-35818,0,0,0,"29","0",256996,0
"10117",156408,"CENTRE COLLEGE                                              ","2003-2004",18,"Swimming and Diving",10670,46490,-35820,5335,23245,-17910,5335,23245,-17910,"14","14",16055,16055
"10397",181215,"UNIVERSITY OF NEBRASKA AT KEARNEY                           ","2003-2004",18,"Swimming and Diving",3006,38832,-35826,0,0,0,3006,38832,-35826,".","12",0,8056
"10946",139719,"FORT VALLEY STATE UNIVERSITY                                ","2003-2004",22,"Tennis",14060,49886,-35826,7030,23573,-16543,7030,26313,-19283,"8","6",4498,4498
"16025",231059,"SAINT MICHAELS COLLEGE                                      ","2003-2004",39,"Total Participants",1208829,1244664,-35835,580804,605534,-24730,628025,639130,-11105,"169","207",201286,241118
"15862",190716,"D'YOUVILLE COLLEGE                                          ","2003-2004",39,"Total Participants",69376,105212,-35836,38975,52756,-13781,30401,52456,-22055,"67","57",52484,46571
"10837",168254,"WESTERN NEW ENGLAND COLLEGE                                 ","2003-2004",22,"Tennis",5075,40920,-35845,2650,20035,-17385,2425,20885,-18460,"14","18",4100,4950
"222",141167,"THOMAS UNIVERSITY                                           ","2003-2004",1,"Baseball",38010,73870,-35860,38010,73870,-35860,0,0,0,"23",".",33505,0
"2493",213303,"KEYSTONE COLLEGE                                            ","2003-2004",2,"Basketball",43908,79778,-35870,24528,40613,-16085,19380,39165,-19785,"14","11",22113,18965
"5158",213376,"LACKAWANNA COLLEGE                                          ","2003-2004",8,"Golf",170,36046,-35876,85,27035,-26950,85,9011,-8926,"5",".",18822,798
"9958",168591,"ALMA COLLEGE                                                ","2003-2004",16,"Softball",66537,102444,-35907,0,0,0,66537,102444,-35907,".","35",0,23190
"12999",171571,"OAKLAND UNIVERSITY                                          ","2003-2004",26,"Volleyball",132647,168587,-35940,0,0,0,132647,168587,-35940,".","15",0,37269
"16541",169080,"CALVIN COLLEGE                                              ","2003-2004",39,"Total Participants",478053,514074,-36021,227694,251652,-23958,250359,262422,-12063,"133","141",153883,136973
"9742",138716,"ALBANY STATE UNIVERSITY                                     ","2003-2004",16,"Softball",31769,67806,-36037,0,0,0,31769,67806,-36037,".","14",0,31769
"8020",123800,"SOUTHWESTERN COLLEGE                                        ","2003-2004",15,"Soccer",16738,52834,-36096,11237,33269,-22032,5501,19565,-14064,"38","18",7284,5501
"13873",226833,"MIDWESTERN STATE UNIVERSITY                                 ","2003-2004",26,"Volleyball",843,36939,-36096,0,0,0,843,36939,-36096,".","12",0,29500
"12280",138983,"AUGUSTA STATE UNIVERSITY                                    ","2003-2004",25,"Track and Field, X-Country",250,36368,-36118,0,0,0,250,36368,-36118,".","7",0,4490
"13874",219347,"SOUTH DAKOTA SCHOOL OF MINES AND TECHNOLOGY                 ","2003-2004",26,"Volleyball",16000,52131,-36131,0,0,0,16000,52131,-36131,".","9",0,15631
"11810",144892,"EASTERN ILLINOIS UNIVERSITY                                 ","2003-2004",23,"Track and Field, Indoor",132939,169082,-36143,58490,75195,-16705,74449,93887,-19438,"47","41",14238,14941
"17274",201548,"CAPITAL UNIVERSITY                                          ","2003-2004",39,"Total Participants",499526,535720,-36194,201139,233261,-32122,298387,302459,-4072,"256","145",179471,125880
"7413",146719,"LOYOLA UNIVERSITY CHICAGO                                   ","2003-2004",15,"Soccer",698376,734597,-36221,332293,361978,-29685,366083,372619,-6536,"27","27",43535,55565
"11487",199157,"NORTH CAROLINA CENTRAL UNIVERSITY                           ","2003-2004",22,"Tennis",31502,67733,-36231,16001,36693,-20692,15501,31040,-15539,"8","8",4906,6074
"16662",100663,"UNIVERSITY OF ALABAMA AT BIRMINGHAM                         ","2003-2004",39,"Total Participants",3799733,3836012,-36279,1368655,1368618,37,2431078,2467394,-36316,"202","190",1668089,618060
"2722",163657,"PRINCE GEORGES COMMUNITY COLLEGE                            ","2003-2004",2,"Basketball",8576,44916,-36340,6122,26894,-20772,2454,18022,-15568,"16","10",11910,7132
"15708",214041,"MILLERSVILLE UNIVERSITY OF PENNSYLVANIA                     ","2003-2004",39,"Total Participants",846766,883134,-36368,344774,363894,-19120,501992,519240,-17248,"296","221",212162,139003
"11528",143358,"BRADLEY UNIVERSITY                                          ","2003-2004",22,"Tennis",168692,205061,-36369,79510,107533,-28023,89182,97528,-8346,"11","9",18832,10061
"324",142294,"ALBERTSON COLLEGE OF IDAHO                                  ","2003-2004",1,"Baseball",62787,99170,-36383,62787,99170,-36383,0,0,0,"33",".",37945,0
"12602",204501,"OBERLIN COLLEGE                                             ","2003-2004",25,"Track and Field, X-Country",142740,179171,-36431,71429,90712,-19283,71311,88459,-17148,"57","53",33551,33987
"5374",230728,"UTAH STATE UNIVERSITY                                       ","2003-2004",8,"Golf",20000,56450,-36450,20000,56450,-36450,0,0,0,"13",".",16040,0
"14753",117645,"LONG BEACH CITY COLLEGE                                     ","2003-2004",27,"Water Polo",22811,59308,-36497,11405,29607,-18202,11406,29701,-18295,"17","15",10442,10432
"9072",199698,"ST ANDREWS PRESBYTERIAN COLLEGE                             ","2003-2004",16,"Softball",54228,90728,-36500,0,0,0,54228,90728,-36500,".","18",0,17228
"11903",185262,"KEAN UNIVERSITY                                             ","2003-2004",23,"Track and Field, Indoor",2,36534,-36532,1,18267,-18266,1,18267,-18266,"16","11",7842,7842
"12104",185262,"KEAN UNIVERSITY                                             ","2003-2004",24,"Track and Field, Outdoor",2,36534,-36532,1,18267,-18266,1,18267,-18266,"21","16",7842,7842
"12495",185262,"KEAN UNIVERSITY                                             ","2003-2004",25,"Track and Field, X-Country",2,36534,-36532,1,18267,-18266,1,18267,-18266,"12","8",7842,7842
"12160",233426,"ROANOKE COLLEGE                                             ","2003-2004",25,"Track and Field, X-Country",300,36840,-36540,100,18420,-18320,200,18420,-18220,"13","15",7328,7328
"7724",163268,"UNIVERSITY OF MARYLAND-BALTIMORE COUNTY                     ","2003-2004",15,"Soccer",174246,210789,-36543,73752,143135,-69383,100494,67654,32840,"28","19",39569,35795
"9260",154059,"NORTH IOWA AREA COMMUNITY COLLEGE                           ","2003-2004",16,"Softball",2830,39405,-36575,0,0,0,2830,39405,-36575,".","13",0,24518
"13473",206330,"URBANA UNIVERSITY                                           ","2003-2004",26,"Volleyball",3956,40584,-36628,0,0,0,3956,40584,-36628,".","17",0,13501
"3252",110547,"CALIFORNIA STATE UNIVERSITY-DOMINGUEZ HILLS                 ","2003-2004",2,"Basketball",59123,95868,-36745,21673,48649,-26976,37450,47219,-9769,"15","21",32104,30055
"2848",224527,"EAST TEXAS BAPTIST UNIVERSITY                               ","2003-2004",2,"Basketball",162515,199267,-36752,90065,107921,-17856,72450,91346,-18896,"31","12",36929,36396
"10277",130943,"UNIVERSITY OF DELAWARE                                      ","2003-2004",18,"Swimming and Diving",201608,238363,-36755,59422,73462,-14040,142186,164901,-22715,"27","24",15471,24492
"12481",232566,"LONGWOOD UNIVERSITY                                         ","2003-2004",25,"Track and Field, X-Country",746,37577,-36831,503,18267,-17764,243,19310,-19067,"7","8",6567,5382
"5951",226329,"LON MORRIS COLLEGE                                          ","2003-2004",8,"Golf",16700,53537,-36837,8350,26768,-18418,8350,26769,-18419,"14","7",12768,12769
"12004",218070,"FURMAN UNIVERSITY                                           ","2003-2004",24,"Track and Field, Outdoor",110909,147804,-36895,43275,63303,-20028,67634,84501,-16867,"37","31",5808,7089
"11330",142328,"LEWIS-CLARK STATE COLLEGE                                   ","2003-2004",22,"Tennis",29314,66266,-36952,15575,32397,-16822,13739,33869,-20130,"10","10",7147,7931
"8097",232089,"FERRUM COLLEGE                                              ","2003-2004",15,"Soccer",49620,86579,-36959,30820,52009,-21189,18800,34570,-15770,"19","15",22509,15770
"7033",164924,"BOSTON COLLEGE                                              ","2003-2004",14,"Skiing",26530,63490,-36960,13265,31745,-18480,13265,31745,-18480,"11","12",29699,29699
"9048",153630,"IOWA WESTERN COMMUNITY COLLEGE                              ","2003-2004",16,"Softball",93400,130362,-36962,0,0,0,93400,130362,-36962,".","14",0,31264
"4872",113333,"DE ANZA COLLEGE                                             ","2003-2004",7,"Football",69613,106605,-36992,69613,106605,-36992,0,0,0,"63",".",36992,0
"1578",217873,"CLAFLIN UNIVERSITY                                          ","2003-2004",1,"Baseball",8000,45000,-37000,8000,45000,-37000,0,0,0,"29",".",22000,0
"2674",185873,"OCEAN COUNTY COLLEGE                                        ","2003-2004",2,"Basketball",3000,40000,-37000,1500,20000,-18500,1500,20000,-18500,"13","10",12000,12000
"7590",225247,"HARDIN-SIMMONS UNIVERSITY                                   ","2003-2004",15,"Soccer",7000,44000,-37000,2000,22000,-20000,5000,22000,-17000,"26","25",19820,19820
"11396",123800,"SOUTHWESTERN COLLEGE                                        ","2003-2004",22,"Tennis",9633,46664,-37031,2734,26255,-23521,6899,20409,-13510,"10","9",2700,4283
"13272",198543,"FAYETTEVILLE STATE UNIVERSITY                               ","2003-2004",26,"Volleyball",1,37036,-37035,0,0,0,1,37036,-37035,".","12",0,13656
"9878",232089,"FERRUM COLLEGE                                              ","2003-2004",16,"Softball",31480,68550,-37070,0,0,0,31480,68550,-37070,".","15",0,31390
"997",233426,"ROANOKE COLLEGE                                             ","2003-2004",1,"Baseball",2683,39782,-37099,2683,39782,-37099,0,0,0,"22",".",23782,0
"8418",156356,"BRESCIA UNIVERSITY                                          ","2003-2004",15,"Soccer",1500,38600,-37100,750,23600,-22850,750,15000,-14250,"27","23",21449,14943
"1550",198613,"GUILFORD COLLEGE                                            ","2003-2004",1,"Baseball",56614,93770,-37156,56614,93770,-37156,0,0,0,"37",".",15295,0
"15367",231712,"CHRISTOPHER NEWPORT UNIVERSITY                              ","2003-2004",36,"Sailing",10342,47532,-37190,5171,25016,-19845,5171,22516,-17345,"16",".",4103,4103
"14799",216357,"THIEL COLLEGE                                               ","2003-2004",28,"Wrestling",13511,50711,-37200,13511,50711,-37200,0,0,0,"41",".",26769,0
"9631",237011,"WESTERN WASHINGTON UNIVERSITY                               ","2003-2004",16,"Softball",96659,133861,-37202,0,0,0,96659,133861,-37202,".","17",0,42807
"1568",236328,"UNIVERSITY OF PUGET SOUND                                   ","2003-2004",1,"Baseball",22300,59527,-37227,22300,59527,-37227,0,0,0,"30",".",40873,0
"9866",172334,"SPRING ARBOR UNIVERSITY                                     ","2003-2004",16,"Softball",17120,54358,-37238,0,0,0,17120,54358,-37238,".","14",0,17120
"14186",179894,"WEBSTER UNIVERSITY                                          ","2003-2004",26,"Volleyball",2585,39843,-37258,0,0,0,2585,39843,-37258,".","13",0,18985
"14493",142294,"ALBERTSON COLLEGE OF IDAHO                                  ","2003-2004",26,"Volleyball",9571,46887,-37316,0,0,0,9571,46887,-37316,".","17",0,23827
"17261",162168,"CHESAPEAKE COLLEGE                                          ","2003-2004",39,"Total Participants",25332,62649,-37317,24726,61734,-37008,606,915,-309,"44","7",45266,122
"6571",130697,"WESLEYAN UNIVERSITY                                         ","2003-2004",11,"Lacrosse",133917,171250,-37333,67575,94582,-27007,66342,76668,-10326,"33","23",49601,28962
"17217",146418,"KISHWAUKEE COLLEGE                                          ","2003-2004",39,"Total Participants",71437,108858,-37421,41118,58668,-17550,30319,50190,-19871,"63","42",55621,46086
"10545",212009,"DICKINSON COLLEGE                                           ","2003-2004",19,"Swimming",13024,50460,-37436,6512,25230,-18718,6512,25230,-18718,"17","23",8525,8525
"10872",181215,"UNIVERSITY OF NEBRASKA AT KEARNEY                           ","2003-2004",22,"Tennis",4448,41930,-37482,3195,22637,-19442,1253,19293,-18040,"11","8",5017,4162
"12185",180179,"MONTANA STATE UNIVERSITY-BILLINGS                           ","2003-2004",25,"Track and Field, X-Country",2560,40105,-37545,1392,18971,-17579,1168,21134,-19966,"6","7",6286,6163
"13335",137078,"ST PETERSBURG COLLEGE                                       ","2003-2004",26,"Volleyball",114260,151832,-37572,0,0,0,114260,151832,-37572,".","14",0,38100
"14461",123484,"COLLEGE OF THE SISKIYOUS                                    ","2003-2004",26,"Volleyball",19059,56637,-37578,0,0,0,19059,56637,-37578,".","16",0,18320
"2849",180902,"CENTRAL COMMUNITY COLLEGE                                   ","2003-2004",2,"Basketball",2156,39744,-37588,2156,39744,-37588,0,0,0,"15",".",12505,0
"15540",146685,"LINCOLN LAND COMMUNITY COLLEGE                              ","2003-2004",39,"Total Participants",65526,103149,-37623,51852,64703,-12851,13674,38446,-24772,"57","42",31937,21838
"9274",176947,"CENTRAL METHODIST COLLEGE                                   ","2003-2004",16,"Softball",15785,53415,-37630,0,0,0,15785,53415,-37630,".","18",0,15765
"16814",214731,"PENNSYLVANIA STATE UNIVERSITY-DELAWARE COUNTY               ","2003-2004",39,"Total Participants",3157,40788,-37631,2622,27451,-24829,535,13337,-12802,"47","23",29448,14565
"12641",198215,"CATAWBA COLLEGE                                             ","2003-2004",25,"Track and Field, X-Country",14380,52013,-37633,7190,26007,-18817,7190,26006,-18816,"9","9",6340,6340
"7984",210401,"WILLAMETTE UNIVERSITY                                       ","2003-2004",15,"Soccer",66449,104130,-37681,17845,33433,-15588,48604,70697,-22093,"23","40",20208,43814
"14632",240693,"WESTERN WYOMING COMMUNITY COLLEGE                           ","2003-2004",26,"Volleyball",781,38475,-37694,0,0,0,781,38475,-37694,".","15",0,31334
"13687",180902,"CENTRAL COMMUNITY COLLEGE                                   ","2003-2004",26,"Volleyball",823,38536,-37713,0,0,0,823,38536,-37713,".","13",0,10520
"15844",180902,"CENTRAL COMMUNITY COLLEGE                                   ","2003-2004",39,"Total Participants",823,38536,-37713,0,0,0,823,38536,-37713,"15","13",12505,10520
"2557",117788,"LOS ANGELES CITY COLLEGE                                    ","2003-2004",2,"Basketball",35814,73584,-37770,23916,38542,-14626,11898,35042,-23144,"11","13",22738,19980
"9360",198969,"METHODIST COLLEGE                                           ","2003-2004",16,"Softball",2989,40766,-37777,0,0,0,2989,40766,-37777,".","27",0,12741
"1389",227766,"RICHLAND COLLEGE                                            ","2003-2004",1,"Baseball",4500,42290,-37790,4500,42290,-37790,0,0,0,"30",".",18900,0
"11435",164580,"BABSON COLLEGE                                              ","2003-2004",22,"Tennis",11103,48983,-37880,4822,23762,-18940,6281,25221,-18940,"10","10",4822,6281
"12741",152530,"TAYLOR UNIVERSITY-UPLAND                                    ","2003-2004",25,"Track and Field, X-Country",12,37902,-37890,6,20785,-20779,6,17117,-17111,"8","10",8917,8961
"14485",215062,"UNIVERSITY OF PENNSYLVANIA                                  ","2003-2004",26,"Volleyball",186751,224644,-37893,0,0,0,186751,224644,-37893,".","24",0,76442
"530",176479,"WILLIAM CAREY COLLEGE                                       ","2003-2004",1,"Baseball",205675,243569,-37894,205675,243569,-37894,0,0,0,"32",".",46753,0
"13365",153630,"IOWA WESTERN COMMUNITY COLLEGE                              ","2003-2004",26,"Volleyball",71460,109361,-37901,0,0,0,71460,109361,-37901,"0","11",0,20503
"4866",162928,"JOHNS HOPKINS UNIVERSITY                                    ","2003-2004",7,"Football",295250,333161,-37911,295250,333161,-37911,0,0,0,"80",".",72161,0
"8067",237701,"POTOMAC STATE COLLEGE OF WEST VIRGINIA UNIVERSITY           ","2003-2004",15,"Soccer",18000,55917,-37917,9000,27198,-18198,9000,28719,-19719,"22","17",5703,7224
"8844",175829,"ITAWAMBA COMMUNITY COLLEGE                                  ","2003-2004",16,"Softball",1,37949,-37948,0,0,0,1,37949,-37948,".","13",0,15314
"3208",204501,"OBERLIN COLLEGE                                             ","2003-2004",2,"Basketball",133259,171252,-37993,74265,92361,-18096,58994,78891,-19897,"11","9",24734,21269
"8867",153737,"KIRKWOOD COMMUNITY COLLEGE                                  ","2003-2004",16,"Softball",7300,45325,-38025,0,0,0,7300,45325,-38025,".","18",0,11580
"5803",178615,"TRUMAN STATE UNIVERSITY                                     ","2003-2004",8,"Golf",13290,51365,-38075,8232,28334,-20102,5058,23031,-17973,"9","14",7135,6103
"8759",206589,"COLLEGE OF WOOSTER                                          ","2003-2004",16,"Softball",420,38499,-38079,0,0,0,420,38499,-38079,".","21",0,35925
"5335",154697,"BARTON COUNTY COMMUNITY COLLEGE                             ","2003-2004",8,"Golf",16985,55083,-38098,11225,34873,-23648,5760,20210,-14450,"9","3",15087,7758
"10585",236328,"UNIVERSITY OF PUGET SOUND                                   ","2003-2004",19,"Swimming",29061,67214,-38153,10171,23525,-13354,18890,43689,-24799,"13","24",21921,40170
"15814",243443,"UNIVERSITY OF SACRED HEART                                  ","2003-2004",39,"Total Participants",152796,190959,-38163,73335,111488,-38153,79461,79471,-10,"54","43",152398,98073
"13522",101295,"GEORGE C WALLACE STATE COMMUNITY COLL-HANCEVILLE            ","2003-2004",26,"Volleyball",12290,50480,-38190,0,0,0,12290,50480,-38190,"0","14",0,10598
"3463",204635,"OHIO NORTHERN UNIVERSITY                                    ","2003-2004",2,"Basketball",106660,144889,-38229,54178,78747,-24569,52482,66142,-13660,"20","22",30561,29606
"13442",237367,"FAIRMONT STATE COLLEGE                                      ","2003-2004",26,"Volleyball",44830,83059,-38229,0,0,0,44830,83059,-38229,".","17",0,17993
"11460",243197,"UNIVERSITY OF PUERTO RICO-MAYAGUEZ                          ","2003-2004",22,"Tennis",6234,44480,-38246,3028,31034,-28006,3206,13446,-10240,"14","5",9834,4046
"15846",121619,"SANTA ANA COLLEGE                                           ","2003-2004",39,"Total Participants",110900,149154,-38254,57400,79465,-22065,53500,69689,-16189,"222","113",96431,65664
"6655",198969,"METHODIST COLLEGE                                           ","2003-2004",11,"Lacrosse",3876,42149,-38273,0,0,0,3876,42149,-38273,".","13",0,14149
"6",204936,"OTTERBEIN COLLEGE                                           ","2003-2004",1,"Baseball",38892,77192,-38300,38892,77192,-38300,0,0,0,"47",".",9245,0
"9083",204936,"OTTERBEIN COLLEGE                                           ","2003-2004",16,"Softball",20772,59072,-38300,0,0,0,20772,59072,-38300,".","19",0,15008
"13523",204936,"OTTERBEIN COLLEGE                                           ","2003-2004",26,"Volleyball",19941,58241,-38300,0,0,0,19941,58241,-38300,".","23",0,13757
"16009",101143,"ENTERPRISE-OZARK COMMUNITY COLLEGE                          ","2003-2004",39,"Total Participants",49343,87682,-38339,33729,48266,-14537,15614,39416,-23802,"39","29",58930,61466
"7244",189088,"BARD COLLEGE                                                ","2003-2004",15,"Soccer",986,39331,-38345,493,20899,-20406,493,18432,-17939,"22","18",10572,7506
"4583",118684,"MENDOCINO COLLEGE                                           ","2003-2004",7,"Football",12640,51054,-38414,12640,51054,-38414,0,0,0,"50",".",28295,0
"12380",232681,"MARY WASHINGTON COLLEGE                                     ","2003-2004",25,"Track and Field, X-Country",77186,115607,-38421,38593,57918,-19325,38593,57689,-19096,"35","46",24821,23995
"14567",147679,"NORTH PARK UNIVERSITY                                       ","2003-2004",26,"Volleyball",31860,70294,-38434,0,0,0,31860,70294,-38434,".","17",0,28474
"14423",197027,"UNITED STATES MERCHANT MARINE ACADEMY                       ","2003-2004",26,"Volleyball",775,39236,-38461,0,0,0,775,39236,-38461,".","14",0,5651
"15978",153126,"CLARKE COLLEGE                                              ","2003-2004",39,"Total Participants",223993,262488,-38495,119231,142051,-22820,104762,120437,-15675,"92","93",96082,77991
"5517",164988,"BOSTON UNIVERSITY                                           ","2003-2004",8,"Golf",4900,43399,-38499,2693,18809,-16116,2207,24590,-22383,"11","9",8759,14318
"11154",162654,"GOUCHER COLLEGE                                             ","2003-2004",22,"Tennis",13610,52114,-38504,10620,11237,-617,2990,40877,-37887,"8","9",3557,3644
"6960",197027,"UNITED STATES MERCHANT MARINE ACADEMY                       ","2003-2004",13,"Rowing",16800,55348,-38548,8400,27674,-19274,8400,27674,-19274,"26","11",4336,4336
"910",179894,"WEBSTER UNIVERSITY                                          ","2003-2004",1,"Baseball",7118,45769,-38651,7118,45769,-38651,0,0,0,"33",".",22768,0
"14054",102429,"BEVILL STATE COMMUNITY COLLEGE                              ","2003-2004",26,"Volleyball",18045,56717,-38672,0,0,0,18045,56717,-38672,".","14",0,5127
"13668",117052,"REEDLEY COLLEGE                                             ","2003-2004",26,"Volleyball",15511,54242,-38731,0,0,0,15511,54242,-38731,"0","11",0,10938
"637",200341,"WILLISTON STATE COLLEGE                                     ","2003-2004",1,"Baseball",13849,52625,-38776,13849,52625,-38776,0,0,0,"13",".",19491,0
"7495",131520,"HOWARD UNIVERSITY                                           ","2003-2004",15,"Soccer",637578,676377,-38799,348381,361827,-13446,289197,314550,-25353,"29","22",62850,48025
"2273",237701,"POTOMAC STATE COLLEGE OF WEST VIRGINIA UNIVERSITY           ","2003-2004",2,"Basketball",18000,56828,-38828,9000,30636,-21636,9000,26192,-17192,"15","11",17739,13295
"5404",123572,"SONOMA STATE UNIVERSITY                                     ","2003-2004",8,"Golf",28495,67334,-38839,28495,67334,-38839,0,0,0,"10",".",36285,0
"8537",194161,"NYACK COLLEGE                                               ","2003-2004",16,"Softball",34444,73302,-38858,0,0,0,34444,73302,-38858,".","15",0,25200
"9626",113573,"COLLEGE OF THE DESERT                                       ","2003-2004",16,"Softball",5600,44458,-38858,0,0,0,5600,44458,-38858,".","15",0,17595
"13022",156408,"CENTRE COLLEGE                                              ","2003-2004",26,"Volleyball",3800,42700,-38900,0,0,0,3800,42700,-38900,".","11",0,30610
"4748",154721,"BETHANY COLLEGE                                             ","2003-2004",7,"Football",477932,516841,-38909,477932,516841,-38909,0,0,0,"123",".",58372,0
"11247",127556,"MESA STATE COLLEGE                                          ","2003-2004",22,"Tennis",34204,73153,-38949,13243,35879,-22636,20961,37274,-16313,"11","9",25859,24449
"7004",196866,"UNION COLLEGE                                               ","2003-2004",13,"Rowing",54162,93128,-38966,4923,46564,-41641,49239,46564,2675,"15","20",8872,8872
"6245",101295,"GEORGE C WALLACE STATE COMMUNITY COLL-HANCEVILLE            ","2003-2004",8,"Golf",14200,53167,-38967,14200,53167,-38967,0,0,0,"9","0",14193,0
"2209",162584,"FROSTBURG STATE UNIVERSITY                                  ","2003-2004",2,"Basketball",222719,261729,-39010,117084,138834,-21750,105635,122895,-17260,"25","12",31759,28309
"16435",182661,"DANIEL WEBSTER COLLEGE                                      ","2003-2004",39,"Total Participants",35430,74442,-39012,25417,41929,-16512,10013,32513,-22500,"69","33",35955,15772
"12907",143358,"BRADLEY UNIVERSITY                                          ","2003-2004",25,"Track and Field, X-Country",194784,233913,-39129,58695,64614,-5919,136089,169299,-33210,"7","63",10137,39328
"16350",202222,"COLUMBUS STATE COMMUNITY COLLEGE                            ","2003-2004",39,"Total Participants",115800,154941,-39141,62375,87072,-24697,53425,67869,-14444,"76","56",75135,55881
"1001",231420,"AVERETT UNIVERSITY                                          ","2003-2004",1,"Baseball",27000,66158,-39158,27000,66158,-39158,0,0,0,"29",".",30000,0
"11104",211158,"BLOOMSBURG UNIVERSITY OF PENNSYLVANIA                       ","2003-2004",22,"Tennis",174260,213439,-39179,86593,107277,-20684,87667,106162,-18495,"9","7",12937,14922
"8521",219134,"SI TANKA UNIVERSITY-HURON CAMPUS                            ","2003-2004",15,"Soccer",72418,111605,-39187,34448,57635,-23187,37970,53970,-16000,"21","13",34448,37970
"14811",240693,"WESTERN WYOMING COMMUNITY COLLEGE                           ","2003-2004",28,"Wrestling",313,39518,-39205,313,39518,-39205,0,0,0,"24",".",32657,0
"16815",163657,"PRINCE GEORGES COMMUNITY COLLEGE                            ","2003-2004",39,"Total Participants",37399,76655,-39256,7321,41070,-33749,30078,35585,-5507,"68","54",30914,16984
"11710",142285,"UNIVERSITY OF IDAHO                                         ","2003-2004",22,"Tennis",293494,332785,-39291,110134,132944,-22810,183360,199841,-16481,"9","7",26942,30015
"8793",220057,"DYERSBURG STATE COMMUNITY COLLEGE                           ","2003-2004",16,"Softball",11129,50458,-39329,0,0,0,11129,50458,-39329,".","14",0,17149
"7810",120421,"OXNARD COLLEGE                                              ","2003-2004",15,"Soccer",7102,46500,-39398,3109,23000,-19891,3993,23500,-19507,"22","18",3109,3993
"8402",196167,"SUNY COLLEGE AT GENESEO                                     ","2003-2004",15,"Soccer",75940,115468,-39528,38422,58933,-20511,37518,56535,-19017,"26","25",30791,36260
"10785",175935,"MERIDIAN COMMUNITY COLLEGE                                  ","2003-2004",22,"Tennis",19000,58580,-39580,9500,28510,-19010,9500,30070,-20570,"8","8",11670,11670
"5193",196060,"SUNY AT ALBANY                                              ","2003-2004",8,"Golf",15260,54874,-39614,0,0,0,15260,54874,-39614,".","6",0,17873
"13660",218229,"LANDER UNIVERSITY                                           ","2003-2004",26,"Volleyball",65210,104875,-39665,0,0,0,65210,104875,-39665,".","11",0,23902
"749",154934,"COLBY COMMUNITY COLLEGE                                     ","2003-2004",1,"Baseball",100,39785,-39685,100,39785,-39685,0,0,0,"31",".",22147,0
"7477",219259,"NORTHERN STATE UNIVERSITY                                   ","2003-2004",15,"Soccer",32094,71841,-39747,0,0,0,32094,71841,-39747,".","20",0,16413
"418",240329,"UNIVERSITY OF WISCONSIN-LA CROSSE                           ","2003-2004",1,"Baseball",38832,78593,-39761,38832,78593,-39761,0,0,0,"30",".",24715,0
"4947",240480,"UNIVERSITY OF WISCONSIN-STEVENS POINT                       ","2003-2004",7,"Football",123888,163684,-39796,123888,163684,-39796,0,0,0,"100",".",50607,0
"1216",136215,"NOVA SOUTHEASTERN UNIVERSITY                                ","2003-2004",1,"Baseball",314121,353960,-39839,314121,353960,-39839,0,0,0,"29",".",109085,0
"14529",229814,"WEST TEXAS A &amp; M UNIVERSITY                                 ","2003-2004",26,"Volleyball",88648,128508,-39860,0,0,0,88648,128508,-39860,".","14",0,41141
"1824",125763,"WHITTIER COLLEGE                                            ","2003-2004",2,"Basketball",95400,135290,-39890,51090,71200,-20110,44310,64090,-19780,"17","13",47265,49980
"3231",176938,"CENTRAL BIBLE COLLEGE                                       ","2003-2004",2,"Basketball",10100,50000,-39900,10000,35000,-25000,100,15000,-14900,"10","9",32000,12850
"603",217998,"ERSKINE COLLEGE AND SEMINARY                                ","2003-2004",1,"Baseball",32000,71936,-39936,32000,71936,-39936,0,0,0,"39",".",49936,0
"6871",217864,"CITADEL MILITARY COLLEGE OF SOUTH CAROLINA                  ","2003-2004",12,"Rifle",3780,43726,-39946,1890,21863,-19973,1890,21863,-19973,"5","6",9731,9731
"6063",222062,"WALTERS STATE COMMUNITY COLLEGE                             ","2003-2004",8,"Golf",1900,41863,-39963,1900,41863,-39963,0,0,0,"9","0",14905,0
"1434",221856,"TENNESSEE TEMPLE UNIVERSITY                                 ","2003-2004",1,"Baseball",21210,61174,-39964,21210,61174,-39964,0,0,0,"20",".",15174,0
"2498",243151,"UNIVERSITY OF PUERTO RICO-CAYEY UNIVERSITY COLLEGE          ","2003-2004",2,"Basketball",31900,71870,-39970,13150,35820,-22670,18750,36050,-17300,"14","9",5250,3600
"14492",208822,"GEORGE FOX UNIVERSITY                                       ","2003-2004",26,"Volleyball",1360,41341,-39981,0,0,0,1360,41341,-39981,".","14",0,18447
"10170",133650,"FLORIDA AGRICULTURAL AND MECHANICAL UNIVERSITY              ","2003-2004",18,"Swimming and Diving",2,39984,-39982,1,19992,-19991,1,19992,-19991,"18","13",18048,18947
"7553",213303,"KEYSTONE COLLEGE                                            ","2003-2004",15,"Soccer",26512,66512,-40000,12885,20385,-7500,13627,46127,-32500,"24","14",12885,13627
"2106",157757,"SPALDING UNIVERSITY                                         ","2003-2004",2,"Basketball",2000,42005,-40005,1000,20835,-19835,1000,21170,-20170,"12","15",20832,21165
"15046",196079,"SUNY AT BINGHAMTON                                          ","2003-2004",28,"Wrestling",133084,173091,-40007,133084,173091,-40007,0,0,0,"22",".",32201,0
"1519",160621,"SOUTHERN UNIVERSITY AND A &amp; M COLLEGE                       ","2003-2004",1,"Baseball",11886,51901,-40015,11886,51901,-40015,0,0,0,"58",".",1227,0
"6893",207971,"UNIVERSITY OF TULSA                                         ","2003-2004",13,"Rowing",548255,588284,-40029,0,0,0,548255,588284,-40029,".","43",0,110456
"7026",198808,"LEES-MCRAE COLLEGE                                          ","2003-2004",14,"Skiing",14600,54652,-40052,7300,29652,-22352,7300,25000,-17700,"8","4",9652,5000
"12631",199698,"ST ANDREWS PRESBYTERIAN COLLEGE                             ","2003-2004",25,"Track and Field, X-Country",46421,86481,-40060,24711,45770,-21059,21710,40711,-19001,"7","7",5211,5210
"16872",160621,"SOUTHERN UNIVERSITY AND A &amp; M COLLEGE                       ","2003-2004",39,"Total Participants",319927,360002,-40075,101959,141974,-40015,217968,218028,-60,"205","104",14180,22672
"15064",197027,"UNITED STATES MERCHANT MARINE ACADEMY                       ","2003-2004",29,"Other Sports",17800,57876,-40076,8900,28938,-20038,8900,28938,-20038,"10","2",3966,3966
"15466",171535,"OAKLAND COMMUNITY COLLEGE                                   ","2003-2004",39,"Total Participants",85517,125605,-40088,17899,33364,-15465,67618,92241,-24623,"33","55",49470,96947
"4244",165936,"GORDON COLLEGE                                              ","2003-2004",6,"Field hocky",4760,44855,-40095,0,0,0,4760,44855,-40095,".","18",0,18921
"16119",131520,"HOWARD UNIVERSITY                                           ","2003-2004",39,"Total Participants",2971071,3011200,-40129,903369,928528,-25159,2067702,2082672,-14970,"240","190",435184,414958
"5089",237011,"WESTERN WASHINGTON UNIVERSITY                               ","2003-2004",7,"Football",1040602,1080773,-40171,1040602,1080773,-40171,0,0,0,"104",".",195005,0
"10513",110556,"CALIFORNIA STATE UNIVERSITY-FRESNO                          ","2003-2004",19,"Swimming",277808,317990,-40182,0,0,0,277808,317990,-40182,".","16",0,60410
"7194",154059,"NORTH IOWA AREA COMMUNITY COLLEGE                           ","2003-2004",15,"Soccer",1194,41398,-40204,772,22947,-22175,422,18451,-18029,"24","10",12089,8750
"8926",234979,"COLUMBIA BASIN COLLEGE                                      ","2003-2004",16,"Softball",30322,70532,-40210,0,0,0,30322,70532,-40210,".","13",0,28605
"14027",200341,"WILLISTON STATE COLLEGE                                     ","2003-2004",26,"Volleyball",9506,49743,-40237,0,0,0,9506,49743,-40237,".","12",0,19050
"15375",164924,"BOSTON COLLEGE                                              ","2003-2004",36,"Sailing",61224,101488,-40264,30612,50744,-20132,30612,50744,-20132,"15","17",29943,29943
"605",153737,"KIRKWOOD COMMUNITY COLLEGE                                  ","2003-2004",1,"Baseball",7700,47975,-40275,7700,47975,-40275,0,0,0,"30",".",14300,0
"15988",230047,"BRIGHAM YOUNG UNIVERSITY-HAWAII CAMPUS                      ","2003-2004",39,"Total Participants",303500,343790,-40290,98300,123138,-24838,205200,220652,-15452,"47","47",212600,205200
"2034",156286,"BELLARMINE UNIVERSITY                                       ","2003-2004",2,"Basketball",854098,894417,-40319,428546,447831,-19285,425552,446586,-21034,"13","13",45182,55711
"690",196006,"SUNY COLLEGE OF TECHNOLOGY AT ALFRED                        ","2003-2004",1,"Baseball",41030,81357,-40327,41030,81357,-40327,0,0,0,"23",".",38226,0
"8921",198613,"GUILFORD COLLEGE                                            ","2003-2004",16,"Softball",22981,63318,-40337,0,0,0,22981,63318,-40337,".","15",0,10569
"15969",150145,"BETHEL COLLEGE                                              ","2003-2004",39,"Total Participants",199645,240031,-40386,97825,128725,-30900,101820,111306,-9486,"122","93",136475,122275
"13013",194161,"NYACK COLLEGE                                               ","2003-2004",26,"Volleyball",19709,60100,-40391,0,0,0,19709,60100,-40391,".","11",0,11500
"7139",175078,"SOUTHWEST MINNESOTA STATE UNIVERSITY                        ","2003-2004",15,"Soccer",100,40619,-40519,0,0,0,100,40619,-40519,".","21",0,24809
"8102",237181,"BETHANY COLLEGE                                             ","2003-2004",15,"Soccer",60114,100679,-40565,37352,59103,-21751,22762,41576,-18814,"26","21",17004,18375
"8356",115755,"HUMBOLDT STATE UNIVERSITY                                   ","2003-2004",15,"Soccer",237363,277982,-40619,123620,141600,-17980,113743,136382,-22639,"27","26",44200,50949
"10820",217402,"PROVIDENCE COLLEGE                                          ","2003-2004",22,"Tennis",1,40631,-40630,0,0,0,1,40631,-40630,".","12",0,24287
"3164",209074,"LINN-BENTON COMMUNITY COLLEGE                               ","2003-2004",2,"Basketball",7505,48139,-40634,3901,25975,-22074,3604,22164,-18560,"11","12",17358,13547
"977",220057,"DYERSBURG STATE COMMUNITY COLLEGE                           ","2003-2004",1,"Baseball",12364,53053,-40689,12364,53053,-40689,0,0,0,"27",".",28254,0
"9097",175078,"SOUTHWEST MINNESOTA STATE UNIVERSITY                        ","2003-2004",16,"Softball",100,40796,-40696,0,0,0,100,40796,-40696,".","20",0,28765
"5538",173647,"GUSTAVUS ADOLPHUS COLLEGE                                   ","2003-2004",8,"Golf",103131,143852,-40721,61261,98579,-37318,41870,45273,-3403,"16","11",76938,21389
"8300",155627,"OTTAWA UNIVERSITY                                           ","2003-2004",15,"Soccer",34789,75625,-40836,16715,38078,-21363,18074,37547,-19473,"30","27",17737,16380
"11258",194958,"ROBERTS WESLEYAN COLLEGE                                    ","2003-2004",22,"Tennis",17142,58065,-40923,8571,33936,-25365,8571,24129,-15558,"10","6",3996,6369
"15173",106412,"UNIVERSITY OF ARKANSAS AT PINE BLUFF                        ","2003-2004",33,"Bowling",400,41328,-40928,0,0,0,400,41328,-40928,".","6",0,4225
"3148",232089,"FERRUM COLLEGE                                              ","2003-2004",2,"Basketball",106147,147101,-40954,41647,67254,-25607,64500,79847,-15347,"17","16",30181,27696
"7913",175272,"WINONA STATE UNIVERSITY                                     ","2003-2004",15,"Soccer",60432,101402,-40970,0,0,0,60432,101402,-40970,".","25",0,35422
"15355",131496,"GEORGETOWN UNIVERSITY                                       ","2003-2004",36,"Sailing",101838,142824,-40986,0,0,0,101838,142824,-40986,".","50",0,64112
"69",213613,"LOCK HAVEN UNIVERSITY OF PENNSYLVANIA                       ","2003-2004",1,"Baseball",90205,131222,-41017,90205,131222,-41017,0,0,0,"29",".",49173,0
"6969",162928,"JOHNS HOPKINS UNIVERSITY                                    ","2003-2004",13,"Rowing",90330,131406,-41076,60676,92339,-31663,29654,39067,-9413,"26","11",37501,15867
"8147",153384,"GRINNELL COLLEGE                                            ","2003-2004",15,"Soccer",36607,77689,-41082,17350,38038,-20688,19257,39651,-20394,"29","25",19896,18251
"393",154527,"WARTBURG COLLEGE                                            ","2003-2004",1,"Baseball",28872,69962,-41090,28872,69962,-41090,0,0,0,"43",".",26282,0
"12746",219806,"CARSON-NEWMAN COLLEGE                                       ","2003-2004",25,"Track and Field, X-Country",100,41196,-41096,50,16146,-16096,50,25050,-25000,"12","8",3996,4000
"15245",234207,"WASHINGTON AND LEE UNIVERSITY                               ","2003-2004",34,"Equestrian",425,41523,-41098,0,0,0,425,41523,-41098,".","16",0,7545
"10988",117645,"LONG BEACH CITY COLLEGE                                     ","2003-2004",22,"Tennis",6902,48057,-41155,2984,22397,-19413,3918,25660,-21742,"11","6",3539,3251
"11509",117627,"LA SIERRA UNIVERSITY                                        ","2003-2004",22,"Tennis",5000,46235,-41235,2500,20200,-17700,2500,26035,-23535,"10","10",2800,2800
"12284",240480,"UNIVERSITY OF WISCONSIN-STEVENS POINT                       ","2003-2004",25,"Track and Field, X-Country",149335,190577,-41242,79414,99627,-20213,69921,90950,-21029,"127","142",35936,36610
"6031",117645,"LONG BEACH CITY COLLEGE                                     ","2003-2004",8,"Golf",4360,45604,-41244,2180,21034,-18854,2180,24570,-22390,"8","5",2176,2161
"5148",175935,"MERIDIAN COMMUNITY COLLEGE                                  ","2003-2004",8,"Golf",17550,58804,-41254,17550,58804,-41254,0,0,0,"10",".",19125,0
"12169",170790,"MACOMB COMMUNITY COLLEGE                                    ","2003-2004",25,"Track and Field, X-Country",45122,86426,-41304,22561,43213,-20652,22561,43213,-20652,"10","12",21674,21674
"6766",213613,"LOCK HAVEN UNIVERSITY OF PENNSYLVANIA                       ","2003-2004",11,"Lacrosse",95598,136904,-41306,0,0,0,95598,136904,-41306,".","27",0,47461
"11314",232681,"MARY WASHINGTON COLLEGE                                     ","2003-2004",22,"Tennis",49488,90813,-41325,27700,46045,-18345,21788,44768,-22980,"12","12",11567,10791
"7523",154527,"WARTBURG COLLEGE                                            ","2003-2004",15,"Soccer",37781,79178,-41397,21512,39750,-18238,16269,39428,-23159,"36","30",15416,15094
"15381",197027,"UNITED STATES MERCHANT MARINE ACADEMY                       ","2003-2004",36,"Sailing",17400,58808,-41408,8700,29404,-20704,8700,29404,-20704,"28","15",4706,4706
"14368",181011,"DANA COLLEGE                                                ","2003-2004",26,"Volleyball",10000,51500,-41500,0,0,0,10000,51500,-41500,".","9",0,10499
"10525",216807,"WESTMINSTER COLLEGE                                         ","2003-2004",19,"Swimming",119348,160884,-41536,59674,80442,-20768,59674,80442,-20768,"17","18",8495,8495
"1003",198899,"MARS HILL COLLEGE                                           ","2003-2004",1,"Baseball",96687,138224,-41537,96687,138224,-41537,0,0,0,"34",".",53181,0
"16701",198066,"BREVARD COLLEGE                                             ","2003-2004",39,"Total Participants",373700,415266,-41566,205400,234593,-29193,168300,180673,-12373,"80","59",106886,76357
"10754",224226,"DALLAS BAPTIST UNIVERSITY                                   ","2003-2004",22,"Tennis",31740,73320,-41580,11626,27804,-16178,20114,45516,-25402,"10","10",6852,5371
"5753",181215,"UNIVERSITY OF NEBRASKA AT KEARNEY                           ","2003-2004",8,"Golf",18771,60371,-41600,15349,35396,-20047,3422,24975,-21553,"19","8",21807,9646
"16018",154776,"THE BROWN MACKIE COLLEGE                                    ","2003-2004",39,"Total Participants",400,42000,-41600,100,27000,-26900,300,15000,-14700,"53","38",2525,2470
"1604",112075,"CONCORDIA UNIVERSITY                                        ","2003-2004",2,"Basketball",179459,221084,-41625,125584,154996,-29412,53875,66088,-12213,"15","15",49150,24428
"11105",152530,"TAYLOR UNIVERSITY-UPLAND                                    ","2003-2004",22,"Tennis",6805,48454,-41649,5723,27684,-21961,1082,20770,-19688,"8","9",9038,8008
"16891",240125,"WAUKESHA COUNTY TECHNICAL COLLEGE                           ","2003-2004",39,"Total Participants",3236,44948,-41712,2936,32740,-29804,300,12208,-11908,"32","32",25390,14417
"10367",168421,"WORCESTER POLYTECHNIC INSTITUTE                             ","2003-2004",18,"Swimming and Diving",18896,60619,-41723,9448,30896,-21448,9448,29723,-20275,"15","19",12276,11098
"14926",213613,"LOCK HAVEN UNIVERSITY OF PENNSYLVANIA                       ","2003-2004",28,"Wrestling",651094,692864,-41770,651094,692864,-41770,0,0,0,"35",".",49144,0
"13479",198613,"GUILFORD COLLEGE                                            ","2003-2004",26,"Volleyball",22159,64016,-41857,0,0,0,22159,64016,-41857,".","11",0,8109
"2929",240189,"UNIVERSITY OF WISCONSIN-WHITEWATER                          ","2003-2004",2,"Basketball",133403,175291,-41888,75523,116663,-41140,57880,58628,-748,"17","19",31101,27052
"239",216357,"THIEL COLLEGE                                               ","2003-2004",1,"Baseball",14793,56697,-41904,14793,56697,-41904,0,0,0,"24",".",22108,0
"1542",216010,"SHIPPENSBURG UNIVERSITY OF PENNSYLVANIA                     ","2003-2004",1,"Baseball",120236,162435,-42199,120236,162435,-42199,0,0,0,"30",".",48591,0
"8870",221971,"UNION UNIVERSITY                                            ","2003-2004",16,"Softball",197301,239533,-42232,0,0,0,197301,239533,-42232,".","13",0,33254
"8986",138293,"WEBBER INTERNATIONAL UNIVERSITY                             ","2003-2004",16,"Softball",84853,127102,-42249,0,0,0,84853,127102,-42249,".","17",0,18974
"13209",155566,"NEOSHO COUNTY COMMUNITY COLLEGE                             ","2003-2004",26,"Volleyball",100,42354,-42254,0,0,0,100,42354,-42254,".","12",0,12250
"2623",232681,"MARY WASHINGTON COLLEGE                                     ","2003-2004",2,"Basketball",65840,108138,-42298,33040,54997,-21957,32800,53141,-20341,"17","14",19947,22580
"5885",204936,"OTTERBEIN COLLEGE                                           ","2003-2004",8,"Golf",42487,84787,-42300,22714,26714,-4000,19773,58073,-38300,"14","13",17931,14426
"9411",110547,"CALIFORNIA STATE UNIVERSITY-DOMINGUEZ HILLS                 ","2003-2004",16,"Softball",21464,63765,-42301,0,0,0,21464,63765,-42301,".","27",0,39995
"1681",196167,"SUNY COLLEGE AT GENESEO                                     ","2003-2004",2,"Basketball",88562,130878,-42316,47933,70499,-22566,40629,60379,-19750,"16","13",25349,25453
"6292",164076,"TOWSON UNIVERSITY                                           ","2003-2004",8,"Golf",32289,74624,-42335,32289,74624,-42335,0,0,0,"11",".",23012,0
"14809",240462,"UNIVERSITY OF WISCONSIN-PLATTEVILLE                         ","2003-2004",28,"Wrestling",6570,48940,-42370,6570,48940,-42370,0,0,0,"30",".",21569,0
"4275",111948,"CHAPMAN UNIVERSITY                                          ","2003-2004",7,"Football",164600,207000,-42400,164600,207000,-42400,0,0,0,"84",".",56000,0
"15301",228316,"SOUTHWEST TEXAS JUNIOR COLLEGE                              ","2003-2004",35,"Rodeo",10000,52500,-42500,5000,32025,-27025,5000,20475,-15475,"18","10",30985,17214
"15580",228316,"SOUTHWEST TEXAS JUNIOR COLLEGE                              ","2003-2004",39,"Total Participants",10000,52500,-42500,5000,32025,-27025,5000,20475,-15475,"18","10",30985,17214
"14140",136330,"PALM BEACH ATLANTIC UNIVERSITY-WEST PALM BEACH              ","2003-2004",26,"Volleyball",18892,61435,-42543,787,18017,-17230,18105,43418,-25313,"13","14",12358,34763
"14284",155937,"STERLING COLLEGE                                            ","2003-2004",26,"Volleyball",335,42893,-42558,0,0,0,335,42893,-42558,"0","25",0,42892
"11065",227526,"PRAIRIE VIEW A &amp; M UNIVERSITY                               ","2003-2004",22,"Tennis",31594,74160,-42566,15797,22332,-6535,15797,51828,-36031,"9","7",15797,15797
"14859",240727,"UNIVERSITY OF WYOMING                                       ","2003-2004",28,"Wrestling",302419,344991,-42572,302419,344991,-42572,0,0,0,"29",".",66492,0
"1185",153214,"DES MOINES AREA COMMUNITY COLLEGE                           ","2003-2004",1,"Baseball",5184,47790,-42606,5184,47790,-42606,0,0,0,"25",".",21540,0
"14905",147660,"NORTH CENTRAL COLLEGE                                       ","2003-2004",28,"Wrestling",21745,64392,-42647,21745,64392,-42647,0,0,0,"36",".",12000,0
"13890",200305,"NORTH DAKOTA STATE COLLEGE OF SCIENCE                       ","2003-2004",26,"Volleyball",815,43513,-42698,0,0,0,815,43513,-42698,"0","15",0,31302
"15801",200305,"NORTH DAKOTA STATE COLLEGE OF SCIENCE                       ","2003-2004",39,"Total Participants",815,43513,-42698,0,0,0,815,43513,-42698,"82","26",80010,62584
"9608",148937,"SOUTHEASTERN ILLINOIS COLLEGE                               ","2003-2004",16,"Softball",6796,49537,-42741,0,0,0,6796,49537,-42741,".","17",0,9720
"13038",203599,"LAKELAND COMMUNITY COLLEGE                                  ","2003-2004",26,"Volleyball",2850,45654,-42804,0,0,0,2850,45654,-42804,".","11",0,21242
"1784",224323,"UNIVERSITY OF DALLAS                                        ","2003-2004",2,"Basketball",116890,159727,-42837,67290,96613,-29323,49600,63114,-13514,"14","14",45520,41446
"8631",211361,"CALIFORNIA UNIVERSITY OF PENNSYLVANIA                       ","2003-2004",16,"Softball",203111,245985,-42874,0,0,0,203111,245985,-42874,".","20",0,36540
"6991",182670,"DARTMOUTH COLLEGE                                           ","2003-2004",13,"Rowing",543003,585918,-42915,328496,373061,-44565,214507,212857,1650,"45","72",142731,84737
"8489",227526,"PRAIRIE VIEW A &amp; M UNIVERSITY                               ","2003-2004",15,"Soccer",41636,84570,-42934,0,0,0,41636,84570,-42934,".","20",0,41636
"13504",238430,"CARDINAL STRITCH UNIVERSITY                                 ","2003-2004",26,"Volleyball",17039,59986,-42947,8488,29764,-21276,8551,30222,-21671,"10","11",7466,7890
"11983",139719,"FORT VALLEY STATE UNIVERSITY                                ","2003-2004",24,"Track and Field, Outdoor",10500,53487,-42987,3500,24803,-21303,7000,28684,-21684,"30","25",2249,5000
"12272",139719,"FORT VALLEY STATE UNIVERSITY                                ","2003-2004",25,"Track and Field, X-Country",10500,53487,-42987,3500,24803,-21303,7000,28684,-21684,"8","10",2249,5000
"16354",189839,"CAYUGA COUNTY COMMUNITY COLLEGE                             ","2003-2004",39,"Total Participants",52370,95370,-43000,28570,50070,-21500,23800,45300,-21500,"66","58",49745,41825
"1957",191676,"HOUGHTON COLLEGE                                            ","2003-2004",2,"Basketball",270853,313930,-43077,154660,179883,-25223,116193,134047,-17854,"14","15",39956,32694
"16822",195058,"ROCKLAND COMMUNITY COLLEGE                                  ","2003-2004",39,"Total Participants",1200,44300,-43100,800,25900,-25100,400,18400,-18000,"58","33",800,575
"3494",178341,"MISSOURI SOUTHERN STATE UNIVERSITY                          ","2003-2004",3,"All Track Combined",320056,363167,-43111,139211,164396,-25185,180845,198771,-17926,"29","29",29365,46417
"9583",218229,"LANDER UNIVERSITY                                           ","2003-2004",16,"Softball",92716,135828,-43112,0,0,0,92716,135828,-43112,".","19",0,25831
"9869",122931,"SANTA CLARA UNIVERSITY                                      ","2003-2004",16,"Softball",176929,220053,-43124,0,0,0,176929,220053,-43124,".","16",0,41252
"9834",149231,"SOUTHERN ILLINOIS UNIVERSITY-EDWARDSVILLE                   ","2003-2004",16,"Softball",151477,194607,-43130,0,0,0,151477,194607,-43130,".","17",0,67333
"4223",234207,"WASHINGTON AND LEE UNIVERSITY                               ","2003-2004",6,"Field hocky",3600,46797,-43197,0,0,0,3600,46797,-43197,".","19",0,8114
"15352",232265,"HAMPTON UNIVERSITY                                          ","2003-2004",36,"Sailing",53484,96686,-43202,53484,96686,-43202,0,0,0,"16",".",29544,0
"2976",126678,"COLORADO COLLEGE                                            ","2003-2004",2,"Basketball",131084,174297,-43213,54432,71749,-17317,76652,102548,-25896,"13","11",23329,32739
"4168",184348,"DREW UNIVERSITY                                             ","2003-2004",6,"Field hocky",15780,59014,-43234,0,0,0,15780,59014,-43234,".","23",0,11833
"10992",199698,"ST ANDREWS PRESBYTERIAN COLLEGE                             ","2003-2004",22,"Tennis",34072,77312,-43240,14791,39991,-25200,19281,37321,-18040,"5","6",4791,10281
"10789",208822,"GEORGE FOX UNIVERSITY                                       ","2003-2004",22,"Tennis",3177,46452,-43275,3176,24174,-20998,1,22278,-22277,"6","13",12489,13396
"1782",173993,"MESABI RANGE COMMUNITY AND TECHNICAL COLLEGE                ","2003-2004",2,"Basketball",2472,45774,-43302,1168,26641,-25473,1304,19133,-17829,"17","11",10462,10705
"298",199032,"MONTREAT COLLEGE                                            ","2003-2004",1,"Baseball",50982,94290,-43308,50982,94290,-43308,0,0,0,"32",".",34951,0
"4629",238476,"CARTHAGE COLLEGE                                            ","2003-2004",7,"Football",295692,339049,-43357,295692,339049,-43357,0,0,0,"120",".",73000,0
"15339",154934,"COLBY COMMUNITY COLLEGE                                     ","2003-2004",35,"Rodeo",57507,100930,-43423,31629,55512,-23883,25878,45418,-19540,"14","12",49370,40393
"10847",130943,"UNIVERSITY OF DELAWARE                                      ","2003-2004",22,"Tennis",77146,120575,-43429,30403,49854,-19451,46743,70721,-23978,"10","10",13878,19688
"1186",232937,"NORFOLK STATE UNIVERSITY                                    ","2003-2004",1,"Baseball",250242,293677,-43435,250242,293677,-43435,0,0,0,"24",".",204493,0
"3165",241739,"UNIVERSIDAD METROPOLITANA                                   ","2003-2004",2,"Basketball",2,43446,-43444,1,20949,-20948,1,22497,-22496,"12","12",8725,8725
"4297",237181,"BETHANY COLLEGE                                             ","2003-2004",7,"Football",142017,185471,-43454,142017,185471,-43454,0,0,0,"70",".",63070,0
"11844",200280,"UNIVERSITY OF NORTH DAKOTA-MAIN CAMPUS                      ","2003-2004",23,"Track and Field, Indoor",62271,105732,-43461,26943,44964,-18021,35328,60768,-25440,"37","49",16371,18476
"9304",174844,"SAINT OLAF COLLEGE                                          ","2003-2004",16,"Softball",2834,46301,-43467,0,0,0,2834,46301,-43467,".","16",0,21289
"5238",238476,"CARTHAGE COLLEGE                                            ","2003-2004",8,"Golf",46628,90104,-43476,23189,46975,-23786,23439,43129,-19690,"15","8",8750,8750
"9153",208822,"GEORGE FOX UNIVERSITY                                       ","2003-2004",16,"Softball",2210,45719,-43509,0,0,0,2210,45719,-43509,".","17",0,21906
"11995",200280,"UNIVERSITY OF NORTH DAKOTA-MAIN CAMPUS                      ","2003-2004",24,"Track and Field, Outdoor",62171,105732,-43561,26843,44964,-18121,35328,60768,-25440,"36","49",16371,18476
"12553",200280,"UNIVERSITY OF NORTH DAKOTA-MAIN CAMPUS                      ","2003-2004",25,"Track and Field, X-Country",62171,105732,-43561,26843,44964,-18121,35328,60768,-25440,"18","19",16371,18476
"4376",228325,"SOUTHWESTERN ASSEMBLIES OF GOD UNIVERSITY                   ","2003-2004",7,"Football",120311,163875,-43564,120311,163875,-43564,0,0,0,"49",".",45038,0
"14760",174844,"SAINT OLAF COLLEGE                                          ","2003-2004",28,"Wrestling",1915,45547,-43632,1915,45547,-43632,0,0,0,"16",".",13246,0
"11896",234207,"WASHINGTON AND LEE UNIVERSITY                               ","2003-2004",23,"Track and Field, Indoor",7028,50662,-43634,2840,26011,-23171,4188,24651,-20463,"18","20",7396,7610
"12056",234207,"WASHINGTON AND LEE UNIVERSITY                               ","2003-2004",24,"Track and Field, Outdoor",7028,50662,-43634,2840,26011,-23171,4188,24651,-20463,"19","22",7396,7610
"5743",229160,"TEXAS WESLEYAN UNIVERSITY                                   ","2003-2004",8,"Golf",23245,66895,-43650,23245,66895,-43650,0,0,0,"16",".",22245,0
"14406",205470,"SINCLAIR COMMUNITY COLLEGE                                  ","2003-2004",26,"Volleyball",5710,49429,-43719,0,0,0,5710,49429,-43719,".","11",0,28077
"10760",218229,"LANDER UNIVERSITY                                           ","2003-2004",22,"Tennis",50410,94149,-43739,50410,94149,-43739,0,0,0,"9",".",29122,0
"13786",131399,"UNIVERSITY OF THE DISTRICT OF COLUMBIA                      ","2003-2004",26,"Volleyball",30000,73740,-43740,0,0,0,30000,73740,-43740,".","9",0,9217
"4097",233295,"RANDOLPH-MACON COLLEGE                                      ","2003-2004",6,"Field hocky",1080,44826,-43746,0,0,0,1080,44826,-43746,".","19",0,10050
"525",168342,"WILLIAMS COLLEGE                                            ","2003-2004",1,"Baseball",31869,75637,-43768,31869,75637,-43768,0,0,0,"27",".",25031,0
"11770",238476,"CARTHAGE COLLEGE                                            ","2003-2004",22,"Tennis",53700,97470,-43770,27115,49000,-21885,26585,48470,-21885,"15","20",10500,10500
"16574",230898,"GREEN MOUNTAIN COLLEGE                                      ","2003-2004",39,"Total Participants",411656,455463,-43807,227489,277507,-50018,184167,177956,6211,"74","70",73178,73001
"14580",221838,"TENNESSEE STATE UNIVERSITY                                  ","2003-2004",26,"Volleyball",98896,142705,-43809,0,0,0,98896,142705,-43809,".","12",0,34669
"6869",200800,"UNIVERSITY OF AKRON MAIN CAMPUS                             ","2003-2004",12,"Rifle",350,44175,-43825,88,11044,-10956,262,33131,-32869,".","8",3352,10056
"7675",173142,"BETHANY LUTHERAN COLLEGE                                    ","2003-2004",15,"Soccer",73542,117376,-43834,37051,58263,-21212,36491,59113,-22622,"25","21",16728,18900
"15347",229832,"WESTERN TEXAS COLLEGE                                       ","2003-2004",35,"Rodeo",70026,113902,-43876,48437,74504,-26067,21589,39398,-17809,"22","11",56012,28007
"7187",203128,"HIRAM COLLEGE                                               ","2003-2004",15,"Soccer",51566,95446,-43880,22456,44212,-21756,29110,51234,-22124,"21","16",14560,15150
"3415",223773,"CEDAR VALLEY COLLEGE                                        ","2003-2004",2,"Basketball",28651,72540,-43889,28651,72540,-43889,0,0,0,"12",".",12896,0
"5923",221351,"RHODES COLLEGE                                              ","2003-2004",8,"Golf",27100,71036,-43936,15300,35518,-20218,11800,35518,-23718,"16","7",14880,10600
"3800",176947,"CENTRAL METHODIST COLLEGE                                   ","2003-2004",3,"All Track Combined",18728,62728,-44000,9364,31364,-22000,9364,31364,-22000,"25","17",9364,9364
"9143",222567,"ALVIN COMMUNITY COLLEGE                                     ","2003-2004",16,"Softball",20254,64254,-44000,0,0,0,20254,64254,-44000,".","17",0,20254
"15058",169798,"EASTERN MICHIGAN UNIVERSITY                                 ","2003-2004",28,"Wrestling",200580,244583,-44003,200580,244583,-44003,0,0,0,"22",".",40023,0
"12663",240426,"UNIVERSITY OF WISCONSIN-SUPERIOR                            ","2003-2004",25,"Track and Field, X-Country",24670,68770,-44100,10876,32926,-22050,13794,35844,-22050,"24","32",11426,14344
"2666",226833,"MIDWESTERN STATE UNIVERSITY                                 ","2003-2004",2,"Basketball",76664,120768,-44104,62153,74900,-12747,14511,45868,-31357,"12","13",54000,45500
"10200",196149,"SUNY COLLEGE AT CORTLAND                                    ","2003-2004",18,"Swimming and Diving",36084,80307,-44223,18042,39510,-21468,18042,40797,-22755,"18","32",19765,20807
"12289",175272,"WINONA STATE UNIVERSITY                                     ","2003-2004",25,"Track and Field, X-Country",86325,130550,-44225,11834,10432,1402,74491,120118,-45627,"8","102",5597,44127
"8470",366401,"LAS POSITAS COLLEGE                                         ","2003-2004",15,"Soccer",42126,86407,-44281,21063,45548,-24485,21063,40859,-19796,"27","21",26648,21959
"8501",197027,"UNITED STATES MERCHANT MARINE ACADEMY                       ","2003-2004",15,"Soccer",9008,53333,-44325,9008,53333,-44325,0,0,0,"26",".",9411,0
"7211",207458,"OKLAHOMA CITY UNIVERSITY                                    ","2003-2004",15,"Soccer",5153,49507,-44354,3147,29008,-25861,2006,20499,-18493,"22","20",19500,12200
"1739",179955,"WILLIAM JEWELL COLLEGE                                      ","2003-2004",2,"Basketball",119266,163634,-44368,90700,104913,-14213,28566,58721,-30155,"28","11",45158,25859
"123",165802,"FISHER COLLEGE                                              ","2003-2004",1,"Baseball",6000,50500,-44500,6000,50500,-44500,0,0,0,"24",".",38500,0
"480",147660,"NORTH CENTRAL COLLEGE                                       ","2003-2004",1,"Baseball",21278,65778,-44500,21278,65778,-44500,0,0,0,"38",".",11942,0
"9197",165802,"FISHER COLLEGE                                              ","2003-2004",16,"Softball",4000,48500,-44500,0,0,0,4000,48500,-44500,".","15",0,36500
"6666",197027,"UNITED STATES MERCHANT MARINE ACADEMY                       ","2003-2004",11,"Lacrosse",8889,53411,-44522,8889,53411,-44522,0,0,0,"38",".",13311,0
"2627",156189,"ALICE LLOYD COLLEGE                                         ","2003-2004",2,"Basketball",51501,96091,-44590,28589,37164,-8575,22912,58927,-36015,"15","13",18700,16225
"3696",161554,"UNIVERSITY OF SOUTHERN MAINE                                ","2003-2004",3,"All Track Combined",146825,191489,-44664,54198,74559,-20361,92627,116930,-24303,"40","46",28408,66675
"10715",206589,"COLLEGE OF WOOSTER                                          ","2003-2004",22,"Tennis",1080,45759,-44679,800,21800,-21000,280,23959,-23679,"15","15",12151,12010
"8420",142285,"UNIVERSITY OF IDAHO                                         ","2003-2004",15,"Soccer",368751,413466,-44715,0,0,0,368751,413466,-44715,".","29",0,94420
"14717",216597,"VILLANOVA UNIVERSITY                                        ","2003-2004",27,"Water Polo",2641,47373,-44732,0,0,0,2641,47373,-44732,".","18",0,19630
"6780",195030,"UNIVERSITY OF ROCHESTER                                     ","2003-2004",11,"Lacrosse",30475,75245,-44770,0,0,0,30475,75245,-44770,".","23",0,27664
"15222",159009,"GRAMBLING STATE UNIVERSITY                                  ","2003-2004",33,"Bowling",100,44883,-44783,0,0,0,100,44883,-44783,".","8",0,28996
"10821",154697,"BARTON COUNTY COMMUNITY COLLEGE                             ","2003-2004",22,"Tennis",16180,60965,-44785,10200,37939,-27739,5980,23026,-17046,"11","6",15357,7891
"7368",199412,"QUEENS UNIVERSITY OF CHARLOTTE                              ","2003-2004",15,"Soccer",230660,275450,-44790,126745,147792,-21047,103915,127658,-23743,"23","22",11100,13171
"10629",129215,"EASTERN CONNECTICUT STATE UNIVERSITY                        ","2003-2004",19,"Swimming",5450,50271,-44821,0,0,0,5450,50271,-44821,".","15",0,15125
"15489",162690,"HAGERSTOWN COMMUNITY COLLEGE                                ","2003-2004",39,"Total Participants",58913,103746,-44833,29004,54956,-25952,29909,48790,-18881,"105","35",51183,45220
"7453",203599,"LAKELAND COMMUNITY COLLEGE                                  ","2003-2004",15,"Soccer",2241,47091,-44850,2241,47091,-44850,0,0,0,"21",".",24188,0
"2950",213020,"INDIANA UNIVERSITY OF PENNSYLVANIA-MAIN CAMPUS              ","2003-2004",2,"Basketball",630746,675601,-44855,420136,358549,61587,210610,317052,-106442,"15","17",36434,28724
"898",171571,"OAKLAND UNIVERSITY                                          ","2003-2004",1,"Baseball",165267,210124,-44857,165267,210124,-44857,0,0,0,"41",".",73370,0
"10920",156408,"CENTRE COLLEGE                                              ","2003-2004",22,"Tennis",400,45284,-44884,200,22642,-22442,200,22642,-22442,"12","9",11176,11176
"10451",113634,"DIABLO VALLEY COLLEGE                                       ","2003-2004",18,"Swimming and Diving",1804,46690,-44886,902,23345,-22443,902,23345,-22443,"31","27",3441,3024
"9110",198899,"MARS HILL COLLEGE                                           ","2003-2004",16,"Softball",51349,96277,-44928,0,0,0,51349,96277,-44928,".","26",0,24392
"17240",139968,"GORDON COLLEGE                                              ","2003-2004",39,"Total Participants",152630,197571,-44941,81459,107348,-25889,71171,90223,-19052,"71","52",55000,55000
"12214",102270,"STILLMAN COLLEGE                                            ","2003-2004",25,"Track and Field, X-Country",27650,72600,-44950,13825,26600,-12775,13825,46000,-32175,"16","18",11000,11000
"7506",218070,"FURMAN UNIVERSITY                                           ","2003-2004",15,"Soccer",797570,842530,-44960,351998,393575,-41577,445572,448955,-3383,"21","19",44044,61573
"14688",122205,"SADDLEBACK COLLEGE                                          ","2003-2004",27,"Water Polo",11016,56000,-44984,5508,28000,-22492,5508,28000,-22492,"12","15",5508,5160
"3724",229027,"THE UNIVERSITY OF TEXAS AT SAN ANTONIO                      ","2003-2004",3,"All Track Combined",655467,700462,-44995,304694,335609,-30915,350773,364853,-14080,"69","84",73920,52452
"13217",229018,"THE UNIVERSITY OF TEXAS OF THE PERMIAN BASIN                ","2003-2004",26,"Volleyball",3000,48010,-45010,0,0,0,3000,48010,-45010,".","14",0,30978
"6422",204024,"MIAMI UNIVERSITY-OXFORD                                     ","2003-2004",10,"Ice Hockey",1088259,1133337,-45078,1088259,1133337,-45078,0,0,0,"28",".",174184,0
"8062",236328,"UNIVERSITY OF PUGET SOUND                                   ","2003-2004",15,"Soccer",22132,67304,-45172,16519,44636,-28117,5613,22668,-17055,"25","19",44558,22160
"13259",196246,"SUNY COLLEGE AT PLATTSBURGH                                 ","2003-2004",26,"Volleyball",3699,48921,-45222,0,0,0,3699,48921,-45222,".","13",0,20488
"6163",234207,"WASHINGTON AND LEE UNIVERSITY                               ","2003-2004",8,"Golf",14041,59309,-45268,14041,59309,-45268,0,0,0,"8",".",20699,0
"10609",243197,"UNIVERSITY OF PUERTO RICO-MAYAGUEZ                          ","2003-2004",19,"Swimming",5942,51218,-45276,2971,31217,-28246,2971,20001,-17030,"14","7",5557,5383
"6808",192323,"LE MOYNE COLLEGE                                            ","2003-2004",11,"Lacrosse",66425,111706,-45281,38500,57531,-19031,27925,54175,-26250,"43","27",38500,27925
"11707",152099,"OAKLAND CITY UNIVERSITY                                     ","2003-2004",22,"Tennis",20000,65299,-45299,10000,29959,-19959,10000,35340,-25340,"5","8",3281,2719
"16207",149019,"SPRINGFIELD COLLEGE IN ILLINOIS                             ","2003-2004",39,"Total Participants",130076,175440,-45364,97049,128396,-31347,33027,47044,-14017,"54","37",56372,23004
"15512",173647,"GUSTAVUS ADOLPHUS COLLEGE                                   ","2003-2004",39,"Total Participants",1679036,1724423,-45387,804554,842544,-37990,874482,881879,-7397,"453","324",405946,330649
"5510",232186,"GEORGE MASON UNIVERSITY                                     ","2003-2004",8,"Golf",45093,90492,-45399,45093,90492,-45399,0,0,0,"10",".",29670,0
"15638",204194,"MOUNT VERNON NAZARENE UNIVERSITY                            ","2003-2004",39,"Total Participants",130055,175485,-45430,64553,95548,-30995,65502,79937,-14435,"78","64",94057,90952
"8771",155566,"NEOSHO COUNTY COMMUNITY COLLEGE                             ","2003-2004",16,"Softball",100,45537,-45437,0,0,0,100,45537,-45437,".","17",0,16500
"7778",136516,"POLK COMMUNITY COLLEGE                                      ","2003-2004",15,"Soccer",47312,92798,-45486,0,0,0,47312,92798,-45486,".","15",0,24990
"2882",123457,"SIMPSON COLLEGE                                             ","2003-2004",2,"Basketball",12563,58065,-45502,5664,28362,-22698,6899,29703,-22804,"10","9",22986,22303
"14816",196149,"SUNY COLLEGE AT CORTLAND                                    ","2003-2004",28,"Wrestling",29474,75020,-45546,29474,75020,-45546,0,0,0,"36",".",42650,0
"10399",192323,"LE MOYNE COLLEGE                                            ","2003-2004",18,"Swimming and Diving",26400,72028,-45628,13200,36014,-22814,13200,36014,-22814,"18","24",13200,13200
"6878",219602,"AUSTIN PEAY STATE UNIVERSITY                                ","2003-2004",12,"Rifle",0,45640,-45640,0,0,0,0,45640,-45640,".","7",0,6552
"6764",168254,"WESTERN NEW ENGLAND COLLEGE                                 ","2003-2004",11,"Lacrosse",31962,77640,-45678,17292,38062,-20770,14670,39578,-24908,"31","22",14000,13160
"6372",230603,"SOUTHERN UTAH UNIVERSITY                                    ","2003-2004",9,"Gymnastics",202924,248606,-45682,0,0,0,202924,248606,-45682,".","16",0,58229
"3744",219082,"DAKOTA STATE UNIVERSITY                                     ","2003-2004",3,"All Track Combined",63891,109633,-45742,32693,64719,-32026,31198,44914,-13716,"49","45",17441,16331
"24",100706,"UNIVERSITY OF ALABAMA IN HUNTSVILLE                         ","2003-2004",1,"Baseball",189940,235696,-45756,189940,235696,-45756,0,0,0,"32",".",59353,0
"13851",177065,"COLUMBIA COLLEGE                                            ","2003-2004",26,"Volleyball",2337,48102,-45765,0,0,0,2337,48102,-45765,".","13",0,17205
"4170",164580,"BABSON COLLEGE                                              ","2003-2004",6,"Field hocky",10050,55860,-45810,0,0,0,10050,55860,-45810,".","21",0,10050
"5425",155317,"UNIVERSITY OF KANSAS MAIN CAMPUS                            ","2003-2004",8,"Golf",515036,560898,-45862,489774,240413,249361,25262,320485,-295223,"12","15",86475,91356
"8873",168342,"WILLIAMS COLLEGE                                            ","2003-2004",16,"Softball",27337,73216,-45879,0,0,0,27337,73216,-45879,".","16",0,20539
"11092",230603,"SOUTHERN UTAH UNIVERSITY                                    ","2003-2004",22,"Tennis",57256,103199,-45943,0,0,0,57256,103199,-45943,".","8",0,26517
"9071",183062,"KEENE STATE COLLEGE                                         ","2003-2004",16,"Softball",23892,69863,-45971,0,0,0,23892,69863,-45971,".","16",0,28563
"14745",122931,"SANTA CLARA UNIVERSITY                                      ","2003-2004",27,"Water Polo",93819,139838,-46019,55070,73478,-18408,38749,66360,-27611,"22","15",15725,24803
"10119",126678,"COLORADO COLLEGE                                            ","2003-2004",18,"Swimming and Diving",108497,154613,-46116,53473,70763,-17290,55024,83850,-28826,"17","31",31474,48141
"3033",212054,"DREXEL UNIVERSITY                                           ","2003-2004",2,"Basketball",2588917,2635066,-46149,1574863,1602335,-27472,1014054,1032731,-18677,"14","14",246208,122248
"2754",172200,"SCHOOLCRAFT COLLEGE                                         ","2003-2004",2,"Basketball",127467,173622,-46155,70023,95320,-25297,57444,78302,-20858,"15","13",21799,30258
"15591",176479,"WILLIAM CAREY COLLEGE                                       ","2003-2004",39,"Total Participants",786785,832980,-46195,467070,507552,-40482,319715,325428,-5713,"82","49",124426,70164
"2289",130989,"GOLDEY-BEACOM COLLEGE                                       ","2003-2004",2,"Basketball",88129,134461,-46332,44482,66994,-22512,43647,67467,-23820,"16","13",20594,18367
"6512",161554,"UNIVERSITY OF SOUTHERN MAINE                                ","2003-2004",10,"Ice Hockey",52734,99076,-46342,22018,45083,-23065,30716,53993,-23277,"27","26",33483,34470
"272",117052,"REEDLEY COLLEGE                                             ","2003-2004",1,"Baseball",22334,68685,-46351,22334,68685,-46351,0,0,0,"36",".",14014,0
"9708",110510,"CALIFORNIA STATE UNIVERSITY-SAN BERNARDINO                  ","2003-2004",16,"Softball",34866,81236,-46370,0,0,0,34866,81236,-46370,".","16",0,24740
"5830",142285,"UNIVERSITY OF IDAHO                                         ","2003-2004",8,"Golf",256485,302871,-46386,101065,131130,-30065,155420,171741,-16321,"10","8",39791,38167
"13794",126580,"UNIVERSITY OF COLORADO AT COLORADO SPRINGS                  ","2003-2004",26,"Volleyball",65110,111518,-46408,0,0,0,65110,111518,-46408,".","12",0,53688
"14331",230171,"DIXIE STATE COLLEGE OF UTAH                                 ","2003-2004",26,"Volleyball",600,47028,-46428,0,0,0,600,47028,-46428,".","15",0,26698
"13215",110510,"CALIFORNIA STATE UNIVERSITY-SAN BERNARDINO                  ","2003-2004",26,"Volleyball",134972,181402,-46430,0,0,0,134972,181402,-46430,".","17",0,35290
"10134",153825,"LORAS COLLEGE                                               ","2003-2004",18,"Swimming and Diving",20750,67215,-46465,10375,31657,-21282,10375,35558,-25183,"13","17",8922,11039
"2361",227401,"PARIS JUNIOR COLLEGE                                        ","2003-2004",2,"Basketball",2192,48668,-46476,1096,26190,-25094,1096,22478,-21382,"15","13",12960,10086
"10761",170541,"KALAMAZOO VALLEY COMMUNITY COLLEGE                          ","2003-2004",22,"Tennis",2,46517,-46515,1,21036,-21035,1,25481,-25480,"7","8",14360,15961
"15351",164216,"WASHINGTON COLLEGE                                          ","2003-2004",36,"Sailing",1981,48512,-46531,0,0,0,1981,48512,-46531,".","8",0,15500
"16100",222178,"ABILENE CHRISTIAN UNIVERSITY                                ","2003-2004",39,"Total Participants",2188958,2235520,-46562,1080637,1134786,-54149,1108321,1100734,7587,"229","119",359819,216521
"5896",217633,"ANDERSON COLLEGE                                            ","2003-2004",8,"Golf",82216,128781,-46565,42255,55886,-13631,39961,72895,-32934,"11","10",15345,17120
"12635",122205,"SADDLEBACK COLLEGE                                          ","2003-2004",25,"Track and Field, X-Country",9414,56000,-46586,4707,28000,-23293,4707,28000,-23293,"7","9",4403,4401
"12400",175616,"DELTA STATE UNIVERSITY                                      ","2003-2004",25,"Track and Field, X-Country",0,46599,-46599,0,0,0,0,46599,-46599,".","8",0,5184
"14984",178615,"TRUMAN STATE UNIVERSITY                                     ","2003-2004",28,"Wrestling",6566,53234,-46668,6566,53234,-46668,0,0,0,"18",".",12931,0
"6037",154004,"MORNINGSIDE COLLEGE                                         ","2003-2004",8,"Golf",8000,54692,-46692,4000,27346,-23346,4000,27346,-23346,"9","8",3010,3010
"7148",213613,"LOCK HAVEN UNIVERSITY OF PENNSYLVANIA                       ","2003-2004",15,"Soccer",432824,479589,-46765,177309,201495,-24186,255515,278094,-22579,"26","24",19978,29180
"9693",153825,"LORAS COLLEGE                                               ","2003-2004",16,"Softball",5030,51840,-46810,0,0,0,5030,51840,-46810,".","24",0,16767
"6868",204796,"OHIO STATE UNIVERSITY-MAIN CAMPUS                           ","2003-2004",12,"Rifle",2,46864,-46862,1,28002,-28001,1,18862,-18861,"8","3",14960,5819
"16659",110413,"CALIFORNIA LUTHERAN UNIVERSITY                              ","2003-2004",39,"Total Participants",686030,732904,-46874,359337,365627,-6290,326693,367277,-40584,"208","99",301300,191228
"15400",243197,"UNIVERSITY OF PUERTO RICO-MAYAGUEZ                          ","2003-2004",38,"Weight Lifting",5660,52622,-46962,2830,27371,-24541,2830,25251,-22421,"12","14",5335,3635
"3612",197027,"UNITED STATES MERCHANT MARINE ACADEMY                       ","2003-2004",3,"All Track Combined",8460,55426,-46966,4230,27713,-23483,4230,27713,-23483,"37","8",9534,9534
"7451",174783,"SAINT CLOUD STATE UNIVERSITY                                ","2003-2004",15,"Soccer",63985,110984,-46999,0,0,0,63985,110984,-46999,".","22",0,36146
"12278",156286,"BELLARMINE UNIVERSITY                                       ","2003-2004",25,"Track and Field, X-Country",248916,295930,-47014,125012,148189,-23177,123904,147741,-23837,"64","55",15125,15125
"8422",232681,"MARY WASHINGTON COLLEGE                                     ","2003-2004",15,"Soccer",59841,106959,-47118,30430,54442,-24012,29411,52517,-23106,"26","24",19101,23192
"16592",167251,"NEWBURY COLLEGE-BROOKLINE                                   ","2003-2004",39,"Total Participants",7048,54215,-47167,3743,29892,-26149,3305,24323,-21018,"74","58",20738,16438
"12834",218742,"UNIVERSITY OF SOUTH CAROLINA-SPARTANBURG                    ","2003-2004",25,"Track and Field, X-Country",734,47904,-47170,367,28139,-27772,367,19765,-19398,"8","7",3551,1454
"15607",191986,"JAMESTOWN COMMUNITY COLLEGE                                 ","2003-2004",39,"Total Participants",65518,112737,-47219,39991,69914,-29923,25527,42823,-17296,"87","62",49609,37497
"2822",220206,"FREE WILL BAPTIST BIBLE COLLEGE                             ","2003-2004",2,"Basketball",21355,68585,-47230,10640,34273,-23633,10715,34312,-23597,"12","10",1182,1271
"3573",232937,"NORFOLK STATE UNIVERSITY                                    ","2003-2004",3,"All Track Combined",640267,687524,-47257,346846,356424,-9578,293421,331100,-37679,"52","60",271264,281287
"13499",174844,"SAINT OLAF COLLEGE                                          ","2003-2004",26,"Volleyball",1184,48475,-47291,0,0,0,1184,48475,-47291,".","19",0,10069
"12555",197984,"BELMONT ABBEY COLLEGE                                       ","2003-2004",25,"Track and Field, X-Country",3124,50441,-47317,1562,22390,-20828,1562,28051,-26489,"9","10",1762,1762
"1283",200059,"DICKINSON STATE UNIVERSITY                                  ","2003-2004",1,"Baseball",23303,70667,-47364,23303,70667,-47364,0,0,0,"29",".",20525,0
"5582",141264,"VALDOSTA STATE UNIVERSITY                                   ","2003-2004",8,"Golf",48644,96030,-47386,48644,96030,-47386,0,0,0,"11",".",31558,0
"564",200156,"JAMESTOWN COLLEGE                                           ","2003-2004",1,"Baseball",43138,90538,-47400,43138,90538,-47400,0,0,0,"24",".",14405,0
"10823",126580,"UNIVERSITY OF COLORADO AT COLORADO SPRINGS                  ","2003-2004",22,"Tennis",68220,115644,-47424,34110,57822,-23712,34110,57822,-23712,"8","10",27024,27024
"13188",215132,"UNIVERSITY OF THE SCIENCES IN PHILADELPHIA                  ","2003-2004",26,"Volleyball",1,47432,-47431,0,0,0,1,47432,-47431,".","9",0,9100
"13043",173920,"MINNESOTA STATE UNVERSITY-MANKATO                           ","2003-2004",26,"Volleyball",196121,243598,-47477,0,0,0,196121,243598,-47477,".","13",0,69291
"7275",183211,"RIVIER COLLEGE                                              ","2003-2004",15,"Soccer",1045,48546,-47501,495,23331,-22836,550,25215,-24665,"18","15",13500,12525
"2012",213613,"LOCK HAVEN UNIVERSITY OF PENNSYLVANIA                       ","2003-2004",2,"Basketball",362868,410441,-47573,173085,195368,-22283,189783,215073,-25290,"18","17",36521,31836
"11917",153384,"GRINNELL COLLEGE                                            ","2003-2004",23,"Track and Field, Indoor",12843,60450,-47607,6468,36889,-30421,6375,23561,-17186,"36","29",7243,6027
"12041",153384,"GRINNELL COLLEGE                                            ","2003-2004",24,"Track and Field, Outdoor",12843,60450,-47607,6468,36889,-30421,6375,23561,-17186,"50","32",7243,6027
"5752",221838,"TENNESSEE STATE UNIVERSITY                                  ","2003-2004",8,"Golf",119065,166730,-47665,73629,101166,-27537,45436,65564,-20128,"6","6",24522,16048
"6867",221847,"TENNESSEE TECHNOLOGICAL UNIVERSITY                          ","2003-2004",12,"Rifle",11630,59331,-47701,9304,35195,-25891,2326,24136,-21810,"4","1",8685,2171
"16285",139366,"COLUMBUS STATE UNIVERSITY                                   ","2003-2004",39,"Total Participants",701964,749694,-47730,407362,412340,-4978,294602,337354,-42752,"78","39",156180,119418
"5745",157386,"MOREHEAD STATE UNIVERSITY                                   ","2003-2004",8,"Golf",37089,84826,-47737,37089,84826,-47737,0,0,0,"15","0",34798,0
"7188",175935,"MERIDIAN COMMUNITY COLLEGE                                  ","2003-2004",15,"Soccer",54800,102615,-47815,27400,42578,-15178,27400,60037,-32637,"22","22",20578,22717
"10143",144892,"EASTERN ILLINOIS UNIVERSITY                                 ","2003-2004",18,"Swimming and Diving",125617,173620,-48003,43117,65170,-22053,82500,108450,-25950,"24","28",22620,26518
"3526",154749,"BETHEL COLLEGE                                              ","2003-2004",3,"All Track Combined",11019,59057,-48038,5558,42714,-37156,5461,16343,-10882,"15","11",7086,7085
"17042",174437,"NORTH CENTRAL UNIVERSITY                                    ","2003-2004",39,"Total Participants",25750,73790,-48040,11700,31065,-19365,14050,42725,-28675,"62","71",37860,45335
"6297",216807,"WESTMINSTER COLLEGE                                         ","2003-2004",8,"Golf",25007,73098,-48091,12844,42432,-29588,12163,30666,-18503,"9","8",4968,4010
"10427",183062,"KEENE STATE COLLEGE                                         ","2003-2004",18,"Swimming and Diving",21395,69486,-48091,11374,36691,-25317,10021,32795,-22774,"22","17",27675,23897
"2102",225885,"JARVIS CHRISTIAN COLLEGE                                    ","2003-2004",2,"Basketball",11320,59423,-48103,8798,31532,-22734,2522,27891,-25369,"16","14",22734,20202
"15026",168342,"WILLIAMS COLLEGE                                            ","2003-2004",28,"Wrestling",32248,80417,-48169,32248,80417,-48169,0,0,0,"23",".",16322,0
"14422",239248,"MILWAUKEE AREA TECHNICAL COLLEGE                            ","2003-2004",26,"Volleyball",2,48200,-48198,1,29500,-29499,1,18700,-18699,"10","13",10900,9400
"3394",113634,"DIABLO VALLEY COLLEGE                                       ","2003-2004",2,"Basketball",1804,50037,-48233,902,28741,-27839,902,21296,-20394,"12","13",7956,7046
"13841",190761,"DOMINICAN COLLEGE OF BLAUVELT                               ","2003-2004",26,"Volleyball",950,49225,-48275,0,0,0,950,49225,-48275,".","11",0,6225
"3637",219347,"SOUTH DAKOTA SCHOOL OF MINES AND TECHNOLOGY                 ","2003-2004",3,"All Track Combined",15500,63810,-48310,12100,36247,-24147,3400,27563,-24163,"20","4",12095,3411
"256",207236,"MURRAY STATE COLLEGE                                        ","2003-2004",1,"Baseball",17471,65795,-48324,17471,65795,-48324,0,0,0,"29",".",16944,0
"3184",141565,"UNIVERSITY OF HAWAII AT HILO                                ","2003-2004",2,"Basketball",192807,241225,-48418,192807,241225,-48418,0,0,0,"15",".",14963,0
"5835",203599,"LAKELAND COMMUNITY COLLEGE                                  ","2003-2004",8,"Golf",4568,53007,-48439,4568,53007,-48439,0,0,0,"6",".",24609,0
"5340",156365,"CAMPBELLSVILLE UNIVERSITY                                   ","2003-2004",8,"Golf",16401,64901,-48500,11126,42626,-31500,5275,22275,-17000,"12","5",6561,4641
"8493",229160,"TEXAS WESLEYAN UNIVERSITY                                   ","2003-2004",15,"Soccer",46971,95487,-48516,22082,39522,-17440,24889,55965,-31076,"34","25",20183,22990
"12785",227243,"NORTHWOOD UNIVERSITY                                        ","2003-2004",25,"Track and Field, X-Country",179446,227969,-48523,93503,114782,-21279,85943,113187,-27244,"9","7",16814,15888
"5964",236452,"SAINT MARTINS COLLEGE                                       ","2003-2004",8,"Golf",15310,63837,-48527,10310,52350,-42040,5000,11487,-6487,"9","2",19033,2235
"3213",201654,"CEDARVILLE UNIVERSITY                                       ","2003-2004",2,"Basketball",450258,498792,-48534,251351,276909,-25558,198907,221883,-22976,"15","12",40599,44090
"12117",182670,"DARTMOUTH COLLEGE                                           ","2003-2004",24,"Track and Field, Outdoor",193588,242151,-48563,93735,121006,-27271,99853,121145,-21292,"59","55",40138,43234
"16446",196866,"UNION COLLEGE                                               ","2003-2004",39,"Total Participants",1404980,1453646,-48666,669087,674714,-5627,735893,778932,-43039,"328","227",254877,173692
"3242",178217,"MINERAL AREA COLLEGE                                        ","2003-2004",2,"Basketball",327830,376516,-48686,203009,273856,-70847,124821,102660,22161,"16","13",29461,21007
"11897",182670,"DARTMOUTH COLLEGE                                           ","2003-2004",23,"Track and Field, Indoor",193571,242257,-48686,95359,123103,-27744,98212,119154,-20942,"60","54",40833,42524
"2879",155511,"MCPHERSON COLLEGE                                           ","2003-2004",2,"Basketball",41044,89754,-48710,21272,44684,-23412,19772,45070,-25298,"21","16",19381,18881
"11976",241377,"CARIBBEAN UNIVERSITY-BAYAMON                                ","2003-2004",24,"Track and Field, Outdoor",4000,52727,-48727,4000,52727,-48727,0,0,0,"9",".",10540,0
"16198",177940,"LINCOLN UNIVERSITY                                          ","2003-2004",39,"Total Participants",533731,582597,-48866,233587,239938,-6351,300144,342659,-42515,"165","88",233299,145282
"13282",153825,"LORAS COLLEGE                                               ","2003-2004",26,"Volleyball",4942,53901,-48959,0,0,0,4942,53901,-48959,".","19",0,20913
"5795",154590,"WILLIAM PENN UNIVERSITY                                     ","2003-2004",8,"Golf",10299,59271,-48972,10299,59271,-48972,0,0,0,"10",".",8340,0
"2241",208390,"CHEMEKETA COMMUNITY COLLEGE                                 ","2003-2004",2,"Basketball",1100,50075,-48975,600,25996,-25396,500,24079,-23579,"12","12",25995,24078
"8050",219471,"UNIVERSITY OF SOUTH DAKOTA                                  ","2003-2004",15,"Soccer",67167,116155,-48988,0,0,0,67167,116155,-48988,".","27",0,24429
"1851",131399,"UNIVERSITY OF THE DISTRICT OF COLUMBIA                      ","2003-2004",2,"Basketball",175000,224016,-49016,90000,109082,-19082,85000,114934,-29934,"12","11",9916,10448
"412",118684,"MENDOCINO COLLEGE                                           ","2003-2004",1,"Baseball",6665,55716,-49051,6665,55716,-49051,0,0,0,"21",".",29760,0
"11479",138293,"WEBBER INTERNATIONAL UNIVERSITY                             ","2003-2004",22,"Tennis",111511,160620,-49109,59115,102182,-43067,52396,58438,-6042,"10","10",12800,12455
"7219",206589,"COLLEGE OF WOOSTER                                          ","2003-2004",15,"Soccer",1220,50376,-49156,640,22867,-22227,580,27509,-26929,"32","34",20595,18588
"806",156189,"ALICE LLOYD COLLEGE                                         ","2003-2004",1,"Baseball",32246,81422,-49176,32246,81422,-49176,0,0,0,"33",".",18200,0
"17356",156189,"ALICE LLOYD COLLEGE                                         ","2003-2004",39,"Total Participants",43246,92422,-49176,34496,83672,-49176,8750,8750,0,"54","31",38400,23225
"9168",215655,"ROBERT MORRIS UNIVERSITY                                    ","2003-2004",16,"Softball",169942,219141,-49199,0,0,0,169942,219141,-49199,".","20",0,32940
"17081",204024,"MIAMI UNIVERSITY-OXFORD                                     ","2003-2004",39,"Total Participants",6596095,6645314,-49219,2689139,2734217,-45078,3906956,3911097,-4141,"282","307",1424598,871626
"483",196149,"SUNY COLLEGE AT CORTLAND                                    ","2003-2004",1,"Baseball",57590,106942,-49352,57590,106942,-49352,0,0,0,"31",".",61273,0
"16857",190558,"CUNY COLLEGE OF STATEN ISLAND                               ","2003-2004",39,"Total Participants",99028,148384,-49356,56868,80723,-23855,42160,67661,-25501,"82","69",78918,62916
"12132",105525,"PIMA COMMUNITY COLLEGE                                      ","2003-2004",24,"Track and Field, Outdoor",31616,81051,-49435,15808,49745,-33937,15808,31306,-15498,"29","10",8474,8474
"13089",188182,"COLLEGE OF THE SOUTHWEST                                    ","2003-2004",26,"Volleyball",1,49450,-49449,0,0,0,1,49450,-49449,".","12",0,31450
"14710",123572,"SONOMA STATE UNIVERSITY                                     ","2003-2004",27,"Water Polo",3020,52478,-49458,0,0,0,3020,52478,-49458,".","27",0,27319
"8238",136330,"PALM BEACH ATLANTIC UNIVERSITY-WEST PALM BEACH              ","2003-2004",15,"Soccer",16359,65924,-49565,12363,30761,-18398,3996,35163,-31167,"25","17",22573,29193
"6589",238078,"WHEELING JESUIT UNIVERSITY                                  ","2003-2004",11,"Lacrosse",500,50067,-49567,500,50067,-49567,0,0,0,"26","0",17861,0
"5532",224147,"TEXAS A &amp; M UNIVERSITY-CORPUS CHRISTI                       ","2003-2004",8,"Golf",36790,86360,-49570,0,0,0,36790,86360,-49570,".","7",0,18511
"11163",217165,"BRYANT COLLEGE                                              ","2003-2004",22,"Tennis",46810,96405,-49595,15708,37827,-22119,31102,58578,-27476,"9","8",26820,22896
"3131",224004,"CONCORDIA UNIVERSITY AT AUSTIN                              ","2003-2004",2,"Basketball",66890,116490,-49600,33500,60532,-27032,33390,55958,-22568,"16","16",32982,31232
"12469",162654,"GOUCHER COLLEGE                                             ","2003-2004",25,"Track and Field, X-Country",6988,56766,-49778,3339,27453,-24114,3649,29313,-25664,"15","23",5658,7518
"3334",239628,"RIPON COLLEGE                                               ","2003-2004",2,"Basketball",71564,121471,-49907,33871,63352,-29481,37693,58119,-20426,"19","19",29500,29500
"7897",164465,"AMHERST COLLEGE                                             ","2003-2004",15,"Soccer",170365,220300,-49935,93714,117665,-23951,76651,102635,-25984,"35","27",27368,25658
"5910",219806,"CARSON-NEWMAN COLLEGE                                       ","2003-2004",8,"Golf",471,50415,-49944,471,50415,-49944,0,0,0,"11",".",9900,0
"10987",107071,"HENDERSON STATE UNIVERSITY                                  ","2003-2004",22,"Tennis",30678,80623,-49945,0,0,0,30678,80623,-49945,".","9",0,6003
"1263",155025,"EMPORIA STATE UNIVERSITY                                    ","2003-2004",1,"Baseball",99668,149678,-50010,99668,149678,-50010,0,0,0,"39",".",44879,0
"14065",117627,"LA SIERRA UNIVERSITY                                        ","2003-2004",26,"Volleyball",7684,57700,-50016,0,0,0,7684,57700,-50016,".","11",0,9000
"3927",227757,"RICE UNIVERSITY                                             ","2003-2004",3,"All Track Combined",1698242,1748265,-50023,680479,716486,-36007,1017763,1031779,-14016,"76","101",121137,152646
"11930",144892,"EASTERN ILLINOIS UNIVERSITY                                 ","2003-2004",24,"Track and Field, Outdoor",162480,212512,-50032,71487,96910,-25423,90993,115602,-24609,"43","37",35952,36654
"14344",142443,"NORTH IDAHO COLLEGE                                         ","2003-2004",26,"Volleyball",66602,116680,-50078,0,0,0,66602,116680,-50078,".","15",0,42726
"7020",228246,"SOUTHERN METHODIST UNIVERSITY                               ","2003-2004",13,"Rowing",822239,872341,-50102,0,0,0,822239,872341,-50102,".","41",0,110178
"10800",177968,"LINDENWOOD UNIVERSITY                                       ","2003-2004",22,"Tennis",21620,71736,-50116,10810,40359,-29549,10810,31377,-20567,"13","12",29549,20567
"6851",220862,"UNIVERSITY OF MEMPHIS                                       ","2003-2004",12,"Rifle",1395,51532,-50137,797,29447,-28650,598,22085,-21487,"4","3",7642,5732
"6576",164580,"BABSON COLLEGE                                              ","2003-2004",11,"Lacrosse",16113,66261,-50148,5897,22545,-16648,10216,43716,-33500,"23","20",5897,10216
"6693",190761,"DOMINICAN COLLEGE OF BLAUVELT                               ","2003-2004",11,"Lacrosse",23331,73499,-50168,23331,73499,-50168,0,0,0,"17",".",8999,0
"13101",117645,"LONG BEACH CITY COLLEGE                                     ","2003-2004",26,"Volleyball",26554,76740,-50186,15565,38287,-22722,10989,38453,-27464,"16","11",13648,10263
"14032",102270,"STILLMAN COLLEGE                                            ","2003-2004",26,"Volleyball",13000,63250,-50250,0,0,0,13000,63250,-50250,".","12",0,13000
"9031",164580,"BABSON COLLEGE                                              ","2003-2004",16,"Softball",12609,62879,-50270,0,0,0,12609,62879,-50270,".","16",0,12609
"10730",196176,"SUNY COLLEGE AT NEW PALTZ                                   ","2003-2004",22,"Tennis",400,50683,-50283,350,22489,-22139,50,28194,-28144,"8","11",3099,9014
"299",195720,"SAINT JOHN FISHER COLLEGE                                   ","2003-2004",1,"Baseball",14200,64583,-50383,14200,64583,-50383,0,0,0,"27",".",17362,0
"16182",141565,"UNIVERSITY OF HAWAII AT HILO                                ","2003-2004",39,"Total Participants",674818,725236,-50418,301298,326089,-24791,373520,399147,-25627,"71","44",161489,140996
"14643",175272,"WINONA STATE UNIVERSITY                                     ","2003-2004",26,"Volleyball",118320,168774,-50454,0,0,0,118320,168774,-50454,".","13",0,40476
"2967",191339,"GENESEE COMMUNITY COLLEGE                                   ","2003-2004",2,"Basketball",38000,88463,-50463,19000,55640,-36640,19000,32823,-13823,"12","13",15484,1138
"4009",110565,"CALIFORNIA STATE UNIVERSITY-FULLERTON                       ","2003-2004",5,"Fencing",122655,173118,-50463,60310,80331,-20021,62345,92787,-30442,"11","12",17536,17534
"13467",193292,"MOLLOY COLLEGE                                              ","2003-2004",26,"Volleyball",11500,62000,-50500,0,0,0,11500,62000,-50500,".","10",0,8500
"11295",204617,"OHIO DOMINICAN UNIVERSITY                                   ","2003-2004",22,"Tennis",726,51248,-50522,363,22049,-21686,363,29199,-28836,"7","10",577,2713
"1116",218964,"WINTHROP UNIVERSITY                                         ","2003-2004",1,"Baseball",365188,415721,-50533,365188,415721,-50533,0,0,0,"34",".",110275,0
"16088",120290,"OHLONE COLLEGE                                              ","2003-2004",39,"Total Participants",135962,186528,-50566,82058,91914,-9856,53904,94614,-40710,"82","71",55942,46730
"5934",204617,"OHIO DOMINICAN UNIVERSITY                                   ","2003-2004",8,"Golf",1770,52373,-50603,1770,52373,-50603,0,0,0,"8",".",13968,0
"11754",205470,"SINCLAIR COMMUNITY COLLEGE                                  ","2003-2004",22,"Tennis",589,51236,-50647,389,28179,-27790,200,23057,-22857,"7","6",20426,12322
"13141",221971,"UNION UNIVERSITY                                            ","2003-2004",26,"Volleyball",124105,174796,-50691,0,0,0,124105,174796,-50691,".","11",0,26916
"14970",154518,"WALDORF COLLEGE                                             ","2003-2004",28,"Wrestling",15000,65741,-50741,15000,65741,-50741,0,0,0,"10",".",15000,0
"10365",185590,"MONTCLAIR STATE UNIVERSITY                                  ","2003-2004",18,"Swimming and Diving",39236,90000,-50764,19618,45000,-25382,19618,45000,-25382,"16","13",22324,22324
"4159",161253,"UNIVERSITY OF MAINE                                         ","2003-2004",6,"Field hocky",355396,406162,-50766,0,0,0,355396,406162,-50766,".","26",0,58266
"13234",238078,"WHEELING JESUIT UNIVERSITY                                  ","2003-2004",26,"Volleyball",500,51274,-50774,0,0,0,500,51274,-50774,"0","14",0,24754
"3964",180948,"CHADRON STATE COLLEGE                                       ","2003-2004",3,"All Track Combined",45532,96341,-50809,22021,50737,-28716,23511,45604,-22093,"64","38",7852,7857
"7472",141167,"THOMAS UNIVERSITY                                           ","2003-2004",15,"Soccer",69642,120471,-50829,45341,67890,-22549,24301,52581,-28280,"33","21",27122,20584
"4667",204936,"OTTERBEIN COLLEGE                                           ","2003-2004",7,"Football",95826,146675,-50849,95826,146675,-50849,0,0,0,"97",".",43444,0
"7355",155566,"NEOSHO COUNTY COMMUNITY COLLEGE                             ","2003-2004",15,"Soccer",200,51118,-50918,100,25559,-25459,100,25559,-25459,"18","15",10098,8415
"15134",177968,"LINDENWOOD UNIVERSITY                                       ","2003-2004",29,"Other Sports",26220,77155,-50935,26220,77155,-50935,0,0,0,"34",".",50935,0
"4104",164216,"WASHINGTON COLLEGE                                          ","2003-2004",6,"Field hocky",4906,55876,-50970,0,0,0,4906,55876,-50970,".","23",0,13331
"9368",216667,"WASHINGTON &amp; JEFFERSON COLLEGE                              ","2003-2004",16,"Softball",77117,128119,-51002,0,0,0,77117,128119,-51002,".","19",0,30608
"127",156408,"CENTRE COLLEGE                                              ","2003-2004",1,"Baseball",810,51822,-51012,810,51822,-51012,0,0,0,"22",".",18434,0
"10181",122205,"SADDLEBACK COLLEGE                                          ","2003-2004",18,"Swimming and Diving",26981,78000,-51019,12258,38000,-25742,14723,40000,-25277,"17","14",10115,11284
"17101",155104,"GARDEN CITY COMMUNITY COLLEGE                               ","2003-2004",39,"Total Participants",126911,178017,-51106,70858,97822,-26964,56053,80195,-24142,"176","65",130054,69031
"15099",204796,"OHIO STATE UNIVERSITY-MAIN CAMPUS                           ","2003-2004",29,"Other Sports",500,51655,-51155,250,31865,-31615,250,19790,-19540,"10","3",17326,5472
"16095",233611,"SOUTHERN VIRGINIA UNIVERSITY                                ","2003-2004",39,"Total Participants",58044,109202,-51158,25448,49485,-24037,32596,59717,-27121,"187","110",133892,51464
"10929",200004,"WESTERN CAROLINA UNIVERSITY                                 ","2003-2004",22,"Tennis",1108,52536,-51428,0,0,0,1108,52536,-51428,".","6",0,14891
"15141",105297,"DINE COLLEGE                                                ","2003-2004",30,"Archery",9770,61223,-51453,4885,40123,-35238,4885,21100,-16215,"9","4",25268,11230
"9445",232186,"GEORGE MASON UNIVERSITY                                     ","2003-2004",16,"Softball",108674,160135,-51461,0,0,0,108674,160135,-51461,".","17",0,47134
"13782",217633,"ANDERSON COLLEGE                                            ","2003-2004",26,"Volleyball",48099,99596,-51497,0,0,0,48099,99596,-51497,".","16",0,22720
"437",231712,"CHRISTOPHER NEWPORT UNIVERSITY                              ","2003-2004",1,"Baseball",26100,77702,-51602,26100,77702,-51602,0,0,0,"29",".",18566,0
"2364",128106,"COLORADO STATE UNIVERSITY-PUEBLO                            ","2003-2004",2,"Basketball",441790,493435,-51645,152781,265999,-113218,289009,227436,61573,"15","16",57200,53386
"10618",234827,"CENTRAL WASHINGTON UNIVERSITY                               ","2003-2004",19,"Swimming",5758,57424,-51666,2879,24658,-21779,2879,32766,-29887,"19","30",9671,15255
"3649",206589,"COLLEGE OF WOOSTER                                          ","2003-2004",3,"All Track Combined",1360,53061,-51701,707,26631,-25924,653,26430,-25777,"84","85",14754,14613
"6546",164465,"AMHERST COLLEGE                                             ","2003-2004",11,"Lacrosse",148241,199979,-51738,71932,95549,-23617,76309,104430,-28121,"33","25",26830,28998
"10897",237969,"WEST VIRGINIA WESLEYAN COLLEGE                              ","2003-2004",22,"Tennis",45209,96959,-51750,22496,61496,-39000,22713,35463,-12750,"12","7",11435,11648
"14518",133650,"FLORIDA AGRICULTURAL AND MECHANICAL UNIVERSITY              ","2003-2004",26,"Volleyball",1,51828,-51827,0,0,0,1,51828,-51827,".","11",0,50253
"12396",230898,"GREEN MOUNTAIN COLLEGE                                      ","2003-2004",25,"Track and Field, X-Country",26589,78425,-51836,7051,59969,-52918,19538,18456,1082,"4","6",692,692
"13859",226587,"MCMURRY UNIVERSITY                                          ","2003-2004",26,"Volleyball",30162,82047,-51885,0,0,0,30162,82047,-51885,".","14",0,33363
"1674",234979,"COLUMBIA BASIN COLLEGE                                      ","2003-2004",2,"Basketball",43625,95537,-51912,21410,48458,-27048,22215,47079,-24864,"12","10",17017,16819
"856",147679,"NORTH PARK UNIVERSITY                                       ","2003-2004",1,"Baseball",31988,83913,-51925,31988,83913,-51925,0,0,0,"25",".",48808,0
"15864",209825,"UNIVERSITY OF PORTLAND                                      ","2003-2004",39,"Total Participants",3144679,3196625,-51946,1522733,1566113,-43380,1621946,1630512,-8566,"198","144",578172,460090
"12144",219806,"CARSON-NEWMAN COLLEGE                                       ","2003-2004",24,"Track and Field, Outdoor",100,52047,-51947,50,23307,-23257,50,28740,-28690,"31","19",3007,3002
"751",162584,"FROSTBURG STATE UNIVERSITY                                  ","2003-2004",1,"Baseball",46603,98565,-51962,46603,98565,-51962,0,0,0,"42",".",75756,0
"2205",218919,"VOORHEES COLLEGE                                            ","2003-2004",2,"Basketball",28000,80000,-52000,16000,38000,-22000,12000,42000,-30000,"15","15",33000,30000
"5677",153384,"GRINNELL COLLEGE                                            ","2003-2004",8,"Golf",17100,69151,-52051,11550,37954,-26404,5550,31197,-25647,"18","7",10221,4832
"17012",237181,"BETHANY COLLEGE                                             ","2003-2004",39,"Total Participants",234478,286531,-52053,121585,146095,-24510,112893,140436,-27543,"196","123",124127,82782
"7493",216357,"THIEL COLLEGE                                               ","2003-2004",15,"Soccer",15663,67733,-52070,7377,32452,-25075,8286,35281,-26995,"22","12",13599,16987
"10620",110097,"BIOLA UNIVERSITY                                            ","2003-2004",19,"Swimming",28350,80456,-52106,11340,32182,-20842,17010,48274,-31264,"10","15",3778,11334
"7047",166629,"UNIVERSITY OF MASSACHUSETTS-AMHERST                         ","2003-2004",14,"Skiing",17818,70016,-52198,5778,35045,-29267,12040,34971,-22931,"12","12",9322,9433
"11112",156365,"CAMPBELLSVILLE UNIVERSITY                                   ","2003-2004",22,"Tennis",11489,63689,-52200,6803,46803,-40000,4686,16886,-12200,"8","6",6061,3982
"6797",185590,"MONTCLAIR STATE UNIVERSITY                                  ","2003-2004",11,"Lacrosse",24768,76970,-52202,8975,25947,-16972,15793,51023,-35230,"28","17",16026,23577
"14194",135188,"LAKE-SUMTER COMMUNITY COLLEGE                               ","2003-2004",26,"Volleyball",870,53106,-52236,0,0,0,870,53106,-52236,".","14",0,42606
"669",154059,"NORTH IOWA AREA COMMUNITY COLLEGE                           ","2003-2004",1,"Baseball",21305,73555,-52250,21305,73555,-52250,0,0,0,"44",".",48598,0
"12525",102553,"UNIVERSITY OF ALASKA ANCHORAGE                              ","2003-2004",25,"Track and Field, X-Country",228993,281250,-52257,113054,123673,-10619,115939,157577,-41638,"27","26",25515,62088
"13903",183211,"RIVIER COLLEGE                                              ","2003-2004",26,"Volleyball",6070,58348,-52278,3075,29174,-26099,2995,29174,-26179,"14","9",14798,10008
"8784",196176,"SUNY COLLEGE AT NEW PALTZ                                   ","2003-2004",16,"Softball",4930,57210,-52280,0,0,0,4930,57210,-52280,".","19",0,18910
"13664",228246,"SOUTHERN METHODIST UNIVERSITY                               ","2003-2004",26,"Volleyball",900064,952361,-52297,0,0,0,900064,952361,-52297,".","12",0,131045
"5828",221731,"TENNESSEE WESLEYAN COLLEGE                                  ","2003-2004",8,"Golf",8550,60850,-52300,8550,60850,-52300,0,0,0,"7",".",6950,0
"16231",175421,"BELHAVEN COLLEGE                                            ","2003-2004",39,"Total Participants",780828,833241,-52413,437563,462807,-25244,343265,370434,-27169,"191","76",202137,100341
"1918",240374,"UNIVERSITY OF WISCONSIN-PARKSIDE                            ","2003-2004",2,"Basketball",443880,496299,-52419,214176,235460,-21284,229704,260839,-31135,"14","12",23068,41649
"2901",207041,"EAST CENTRAL UNIVERSITY                                     ","2003-2004",2,"Basketball",102523,155013,-52490,59127,85822,-26695,43396,69191,-25795,"21","15",49295,32391
"192",222567,"ALVIN COMMUNITY COLLEGE                                     ","2003-2004",1,"Baseball",24560,77060,-52500,24560,77060,-52500,0,0,0,"42",".",24560,0
"12403",152099,"OAKLAND CITY UNIVERSITY                                     ","2003-2004",25,"Track and Field, X-Country",6000,58501,-52501,3000,27906,-24906,3000,30595,-27595,"7","6",1393,1393
"9880",221838,"TENNESSEE STATE UNIVERSITY                                  ","2003-2004",16,"Softball",154537,207050,-52513,0,0,0,154537,207050,-52513,".","18",0,56506
"11246",101295,"GEORGE C WALLACE STATE COMMUNITY COLL-HANCEVILLE            ","2003-2004",22,"Tennis",11600,64143,-52543,5800,26935,-21135,5800,37208,-31408,"7","7",5796,5796
"16162",151379,"INDIANA UNIVERSITY-SOUTHEAST                                ","2003-2004",39,"Total Participants",152846,205400,-52554,73538,130591,-57053,79308,74809,4499,"54","36",123130,78536
"9757",173328,"CONCORDIA UNIVERSITY-ST PAUL                                ","2003-2004",16,"Softball",87650,140214,-52564,0,0,0,87650,140214,-52564,".","19",0,48885
"6229",187903,"NEW MEXICO JUNIOR COLLEGE                                   ","2003-2004",8,"Golf",100,52724,-52624,100,52724,-52624,0,0,0,"8",".",17618,0
"1197",172334,"SPRING ARBOR UNIVERSITY                                     ","2003-2004",1,"Baseball",21190,73906,-52716,21190,73906,-52716,0,0,0,"19",".",21190,0
"1203",229160,"TEXAS WESLEYAN UNIVERSITY                                   ","2003-2004",1,"Baseball",31991,84763,-52772,31991,84763,-52772,0,0,0,"54",".",29435,0
"9113",184782,"ROWAN UNIVERSITY                                            ","2003-2004",16,"Softball",24870,77661,-52791,0,0,0,24870,77661,-52791,".","18",0,21202
"7932",117645,"LONG BEACH CITY COLLEGE                                     ","2003-2004",15,"Soccer",24889,77698,-52809,5559,29435,-23876,19330,48263,-28933,"23","23",6288,18424
"702",228608,"TEMPLE COLLEGE                                              ","2003-2004",1,"Baseball",85015,137948,-52933,85015,137948,-52933,0,0,0,"36",".",42804,0
"8391",201928,"CINCINNATI STATE TECHNICAL AND COMMUNITY COLLEGE            ","2003-2004",15,"Soccer",23000,76000,-53000,13000,39000,-26000,10000,37000,-27000,"21","21",10000,20000
"5928",216667,"WASHINGTON &amp; JEFFERSON COLLEGE                              ","2003-2004",8,"Golf",32517,85540,-53023,17817,48015,-30198,14700,37525,-22825,"9","5",16147,4948
"6989",215655,"ROBERT MORRIS UNIVERSITY                                    ","2003-2004",13,"Rowing",104218,157250,-53032,0,0,0,104218,157250,-53032,".","24",0,25545
"12830",152336,"UNIVERSITY OF SAINT FRANCIS-FT WAYNE                        ","2003-2004",25,"Track and Field, X-Country",20000,73056,-53056,10000,36744,-26744,10000,36312,-26312,"22","18",9239,9239
"11308",133650,"FLORIDA AGRICULTURAL AND MECHANICAL UNIVERSITY              ","2003-2004",22,"Tennis",600,53760,-53160,300,26460,-26160,300,27300,-27000,"7","8",24045,24675
"5658",218964,"WINTHROP UNIVERSITY                                         ","2003-2004",8,"Golf",148627,201810,-53183,74102,89853,-15751,74525,111957,-37432,"10","8",22770,24276
"8883",171571,"OAKLAND UNIVERSITY                                          ","2003-2004",16,"Softball",136677,189897,-53220,0,0,0,136677,189897,-53220,".","23",0,53569
"16427",174358,"MINNESOTA STATE UNIVERSITY-MOORHEAD                         ","2003-2004",39,"Total Participants",610602,663827,-53225,173461,176263,-2802,437141,487564,-50423,"184","152",174312,212915
"9444",199157,"NORTH CAROLINA CENTRAL UNIVERSITY                           ","2003-2004",16,"Softball",2696,55956,-53260,0,0,0,2696,55956,-53260,".","11",0,22829
"16926",201928,"CINCINNATI STATE TECHNICAL AND COMMUNITY COLLEGE            ","2003-2004",39,"Total Participants",30700,84000,-53300,19500,46000,-26500,11200,38000,-26800,"42","34",35250,60750
"6864",221768,"THE UNIVERSITY OF TENNESSEE-MARTIN                          ","2003-2004",12,"Rifle",2455,55797,-53342,1350,35960,-34610,1105,19837,-18732,"9","6",4020,2954
"8346",220710,"MARYVILLE COLLEGE                                           ","2003-2004",15,"Soccer",39744,93157,-53413,21643,46897,-25254,18101,46260,-28159,"25","18",22257,21620
"4486",153144,"COE COLLEGE                                                 ","2003-2004",7,"Football",230734,284151,-53417,230734,284151,-53417,0,0,0,"103",".",55627,0
"4392",155520,"MIDAMERICA NAZARENE UNIVERSITY                              ","2003-2004",7,"Football",486045,539510,-53465,486045,539510,-53465,0,0,0,"121",".",109300,0
"441",168005,"SUFFOLK UNIVERSITY                                          ","2003-2004",1,"Baseball",15800,69320,-53520,15800,69320,-53520,0,0,0,"30",".",15800,0
"16317",150066,"ANDERSON UNIVERSITY                                         ","2003-2004",39,"Total Participants",433218,486753,-53535,240560,266697,-26137,192658,220056,-27398,"302","140",268946,133758
"16806",230834,"CASTLETON STATE COLLEGE                                     ","2003-2004",39,"Total Participants",166988,220548,-53560,96571,126571,-30000,70417,93977,-23560,"121","100",124241,100903
"7821",230171,"DIXIE STATE COLLEGE OF UTAH                                 ","2003-2004",15,"Soccer",610,54337,-53727,0,0,0,610,54337,-53727,".","21",0,36075
"5048",228529,"TARLETON STATE UNIVERSITY                                   ","2003-2004",7,"Football",515936,569761,-53825,515936,569761,-53825,0,0,0,"113",".",102096,0
"6092",122931,"SANTA CLARA UNIVERSITY                                      ","2003-2004",8,"Golf",345543,399385,-53842,219695,238030,-18335,125848,161355,-35507,"10","8",40396,23750
"10829",215132,"UNIVERSITY OF THE SCIENCES IN PHILADELPHIA                  ","2003-2004",22,"Tennis",2,53859,-53857,1,25976,-25975,1,27883,-27882,"9","14",2400,2100
"10985",191630,"HOBART WILLIAM SMITH COLLEGES                               ","2003-2004",22,"Tennis",18855,72760,-53905,13500,42365,-28865,5355,30395,-25040,"10","10",6283,2520
"7831",227766,"RICHLAND COLLEGE                                            ","2003-2004",15,"Soccer",2000,56075,-54075,1000,37920,-36920,1000,18155,-17155,"27","13",15420,12415
"7015",168342,"WILLIAMS COLLEGE                                            ","2003-2004",13,"Rowing",78487,132584,-54097,0,0,0,78487,132584,-54097,"0","25",0,47304
"14914",154934,"COLBY COMMUNITY COLLEGE                                     ","2003-2004",28,"Wrestling",1500,55643,-54143,1500,55643,-54143,0,0,0,"16",".",24863,0
"362",215062,"UNIVERSITY OF PENNSYLVANIA                                  ","2003-2004",1,"Baseball",126988,181136,-54148,126988,181136,-54148,0,0,0,"36",".",81504,0
"684",155450,"LABETTE COMMUNITY COLLEGE                                   ","2003-2004",1,"Baseball",5475,59658,-54183,5475,59658,-54183,0,0,0,"27",".",22448,0
"6786",177968,"LINDENWOOD UNIVERSITY                                       ","2003-2004",11,"Lacrosse",30326,84532,-54206,16514,48108,-31594,13812,36424,-22612,"32","16",31594,22612
"5371",221768,"THE UNIVERSITY OF TENNESSEE-MARTIN                          ","2003-2004",8,"Golf",15020,69239,-54219,15020,69239,-54219,0,0,0,"8",".",20987,0
"13675",219602,"AUSTIN PEAY STATE UNIVERSITY                                ","2003-2004",26,"Volleyball",0,54252,-54252,0,0,0,0,54252,-54252,".","12",0,23764
"6949",213543,"LEHIGH UNIVERSITY                                           ","2003-2004",13,"Rowing",118608,172883,-54275,0,0,0,118608,172883,-54275,".","74",0,120083
"2156",238476,"CARTHAGE COLLEGE                                            ","2003-2004",2,"Basketball",231983,286281,-54298,146868,192106,-45238,85115,94175,-9060,"21","20",23000,23000
"4145",168342,"WILLIAMS COLLEGE                                            ","2003-2004",6,"Field hocky",27390,81711,-54321,0,0,0,27390,81711,-54321,".","22",0,20333
"650",224323,"UNIVERSITY OF DALLAS                                        ","2003-2004",1,"Baseball",69290,123632,-54342,69290,123632,-54342,0,0,0,"26",".",53648,0
"8076",110583,"CALIFORNIA STATE UNIVERSITY-LONG BEACH                      ","2003-2004",15,"Soccer",346860,401289,-54429,0,0,0,346860,401289,-54429,".","38",0,52322
"15035",155450,"LABETTE COMMUNITY COLLEGE                                   ","2003-2004",28,"Wrestling",10883,65339,-54456,10883,65339,-54456,0,0,0,"29","0",34372,0
"15178",175342,"ALCORN STATE UNIVERSITY                                     ","2003-2004",33,"Bowling",1488,55996,-54508,0,0,0,1488,55996,-54508,".","6",0,8282
"8641",207351,"OKLAHOMA PANHANDLE STATE UNIVERSITY                         ","2003-2004",16,"Softball",29942,84490,-54548,0,0,0,29942,84490,-54548,".","18",0,28151
"12197",238476,"CARTHAGE COLLEGE                                            ","2003-2004",25,"Track and Field, X-Country",200576,255136,-54560,105381,143633,-38252,95195,111503,-16308,"131","120",23000,23000
"9921",161253,"UNIVERSITY OF MAINE                                         ","2003-2004",16,"Softball",306649,361225,-54576,0,0,0,306649,361225,-54576,".","22",0,79391
"11493",227757,"RICE UNIVERSITY                                             ","2003-2004",22,"Tennis",828502,883110,-54608,383556,424330,-40774,444946,458780,-13834,"12","11",116569,50053
"17268",178341,"MISSOURI SOUTHERN STATE UNIVERSITY                          ","2003-2004",39,"Total Participants",1093194,1147825,-54631,438709,470575,-31866,654485,677250,-22765,"201","102",214004,168114
"11024",228246,"SOUTHERN METHODIST UNIVERSITY                               ","2003-2004",22,"Tennis",808056,862691,-54635,419399,449761,-30362,388657,412930,-24273,"12","11",32423,29451
"16411",165820,"FITCHBURG STATE COLLEGE                                     ","2003-2004",39,"Total Participants",165223,219860,-54637,100046,133527,-33481,65177,86333,-21156,"217","95",143659,63282
"7655",229814,"WEST TEXAS A &amp; M UNIVERSITY                                 ","2003-2004",15,"Soccer",123812,178480,-54668,69512,88341,-18829,54300,90139,-35839,"28","24",29731,30892
"13767",144892,"EASTERN ILLINOIS UNIVERSITY                                 ","2003-2004",26,"Volleyball",168073,222762,-54689,0,0,0,168073,222762,-54689,".","14",0,55310
"9685",101295,"GEORGE C WALLACE STATE COMMUNITY COLL-HANCEVILLE            ","2003-2004",16,"Softball",15542,70238,-54696,0,0,0,15542,70238,-54696,".","16",0,13488
"415",185129,"NEW JERSEY CITY UNIVERSITY                                  ","2003-2004",1,"Baseball",22500,77197,-54697,22500,77197,-54697,0,0,0,"24",".",4948,0
"6957",203845,"MARIETTA COLLEGE                                            ","2003-2004",13,"Rowing",160006,214706,-54700,93408,149081,-55673,66598,65625,973,"40","16",29739,10592
"11824",198136,"CAMPBELL UNIVERSITY INC                                     ","2003-2004",23,"Track and Field, Indoor",88276,142981,-54705,44730,72051,-27321,43546,70930,-27384,"19","17",12053,11899
"12048",198136,"CAMPBELL UNIVERSITY INC                                     ","2003-2004",24,"Track and Field, Outdoor",88275,142981,-54706,44730,72051,-27321,43545,70930,-27385,"19","17",12053,11899
"12263",198136,"CAMPBELL UNIVERSITY INC                                     ","2003-2004",25,"Track and Field, X-Country",88274,142981,-54707,44729,72051,-27322,43545,70930,-27385,"8","9",12053,11899
"2820",183211,"RIVIER COLLEGE                                              ","2003-2004",2,"Basketball",8075,62791,-54716,6420,39201,-32781,1655,23590,-21935,"15","12",12600,10236
"13435",195030,"UNIVERSITY OF ROCHESTER                                     ","2003-2004",26,"Volleyball",30856,85579,-54723,0,0,0,30856,85579,-54723,".","13",0,26155
"15019",221740,"THE UNIVERSITY OF TENNESSEE-CHATTANOOGA                     ","2003-2004",28,"Wrestling",21692,76492,-54800,21692,76492,-54800,0,0,0,"40",".",32232,0
"4188",216667,"WASHINGTON &amp; JEFFERSON COLLEGE                              ","2003-2004",6,"Field hocky",55835,110639,-54804,0,0,0,55835,110639,-54804,".","17",0,12156
"10174",171571,"OAKLAND UNIVERSITY                                          ","2003-2004",18,"Swimming and Diving",404951,459792,-54841,155745,183425,-27680,249206,276367,-27161,"27","25",29164,28768
"4820",123800,"SOUTHWESTERN COLLEGE                                        ","2003-2004",7,"Football",56693,111552,-54859,56693,111552,-54859,0,0,0,"76",".",29905,0
"8930",219888,"COLUMBIA STATE COMMUNITY COLLEGE                            ","2003-2004",16,"Softball",2116,57033,-54917,0,0,0,2116,57033,-54917,".","14",0,24267
"4599",224554,"TEXAS A &amp; M UNIVERSITY-COMMERCE                             ","2003-2004",7,"Football",122000,177000,-55000,122000,177000,-55000,0,0,0,"111",".",107443,0
"6074",207403,"OKLAHOMA BAPTIST UNIVERSITY                                 ","2003-2004",8,"Golf",21545,76553,-55008,12620,41368,-28748,8925,35185,-26260,"5","5",11215,6124
"3663",228158,"SOUTH PLAINS COLLEGE                                        ","2003-2004",3,"All Track Combined",2000,57036,-55036,1000,29468,-28468,1000,27568,-26568,"31","21",16368,16368
"10230",206589,"COLLEGE OF WOOSTER                                          ","2003-2004",18,"Swimming and Diving",1883,56975,-55092,734,22208,-21474,1149,34767,-33618,"20","31",14769,23100
"329",193326,"MONROE COMMUNITY COLLEGE                                    ","2003-2004",1,"Baseball",93762,148899,-55137,93762,148899,-55137,0,0,0,"30",".",39555,0
"11781",221740,"THE UNIVERSITY OF TENNESSEE-CHATTANOOGA                     ","2003-2004",22,"Tennis",43025,98277,-55252,39943,39943,0,3082,58334,-55252,"14","12",18670,34538
"16109",203580,"LAKE ERIE COLLEGE                                           ","2003-2004",39,"Total Participants",99686,154940,-55254,52076,74099,-22023,47610,80841,-33231,"59","51",59512,52758
"4289",213783,"MANSFIELD UNIVERSITY OF PENNSYLVANIA                        ","2003-2004",7,"Football",333052,388338,-55286,333052,388338,-55286,0,0,0,"99",".",60572,0
"10947",181394,"UNIVERSITY OF NEBRASKA AT OMAHA                             ","2003-2004",22,"Tennis",2205,57512,-55307,0,0,0,2205,57512,-55307,".","12",0,8127
"5227",143358,"BRADLEY UNIVERSITY                                          ","2003-2004",8,"Golf",184294,239641,-55347,66722,99740,-33018,117572,139901,-22329,"11","6",32462,25548
"11397",198899,"MARS HILL COLLEGE                                           ","2003-2004",22,"Tennis",39412,94863,-55451,19706,44287,-24581,19706,50576,-30870,"9","10",5751,5751
"17316",155186,"HIGHLAND COMMUNITY COLLEGE                                  ","2003-2004",39,"Total Participants",332542,388026,-55484,172196,199938,-27742,160346,188088,-27742,"148","59",207066,106982
"4355",187912,"NEW MEXICO MILITARY INSTITUTE                               ","2003-2004",7,"Football",369874,425363,-55489,369874,425363,-55489,0,0,0,"70",".",85000,0
"10978",174844,"SAINT OLAF COLLEGE                                          ","2003-2004",22,"Tennis",1000,56510,-55510,500,29662,-29162,500,26848,-26348,"8","9",10663,8721
"15487",161341,"UNIVERSITY OF MAINE AT PRESQUE ISLE                         ","2003-2004",39,"Total Participants",10845,66355,-55510,7731,38686,-30955,3114,27669,-24555,"69","57",42428,33850
"9843",154998,"DODGE CITY COMMUNITY COLLEGE                                ","2003-2004",16,"Softball",32873,88440,-55567,0,0,0,32873,88440,-55567,".","22",0,21130
"8642",102429,"BEVILL STATE COMMUNITY COLLEGE                              ","2003-2004",16,"Softball",30601,86169,-55568,0,0,0,30601,86169,-55568,".","15",0,15461
"1755",237385,"GLENVILLE STATE COLLEGE                                     ","2003-2004",2,"Basketball",231046,286732,-55686,132066,138861,-6795,98980,147871,-48891,"13","13",18183,35047
"12650",113573,"COLLEGE OF THE DESERT                                       ","2003-2004",25,"Track and Field, X-Country",1230,57017,-55787,615,28543,-27928,615,28474,-27859,"11","14",7535,7462
"2747",120421,"OXNARD COLLEGE                                              ","2003-2004",2,"Basketball",20246,76100,-55854,9684,35600,-25916,10562,40500,-29938,"10","11",9684,10562
"4871",150400,"DEPAUW UNIVERSITY                                           ","2003-2004",7,"Football",380191,436057,-55866,380191,436057,-55866,0,0,0,"124",".",133309,0
"15921",117788,"LOS ANGELES CITY COLLEGE                                    ","2003-2004",39,"Total Participants",51021,107027,-56006,36381,56676,-20295,14640,50351,-35711,"41","41",47987,34196
"7322",224226,"DALLAS BAPTIST UNIVERSITY                                   ","2003-2004",15,"Soccer",169447,225485,-56038,53094,58812,-5718,116353,166673,-50320,"22","23",27242,43668
"10228",168342,"WILLIAMS COLLEGE                                            ","2003-2004",18,"Swimming and Diving",56540,112641,-56101,27773,55820,-28047,28767,56821,-28054,"32","40",23611,24656
"976",151379,"INDIANA UNIVERSITY-SOUTHEAST                                ","2003-2004",1,"Baseball",53407,109523,-56116,53407,109523,-56116,0,0,0,"31",".",82597,0
"3889",221740,"THE UNIVERSITY OF TENNESSEE-CHATTANOOGA                     ","2003-2004",3,"All Track Combined",71017,127139,-56122,970,57092,-56122,70047,70047,0,"20","22",26745,26501
"15740",122597,"SAN FRANCISCO STATE UNIVERSITY                              ","2003-2004",39,"Total Participants",1360733,1416915,-56182,637552,635454,2098,723181,781461,-58280,"131","201",182895,212960
"8251",162584,"FROSTBURG STATE UNIVERSITY                                  ","2003-2004",15,"Soccer",147731,203919,-56188,82234,114879,-32645,65497,89040,-23543,"26","23",32570,18340
"12398",113333,"DE ANZA COLLEGE                                             ","2003-2004",25,"Track and Field, X-Country",13490,69721,-56231,6745,66715,-59970,6745,3006,3739,"4","3",2330,1321
"16215",237385,"GLENVILLE STATE COLLEGE                                     ","2003-2004",39,"Total Participants",116066,172391,-56325,30703,46081,-15378,85363,126310,-40947,"121","65",100132,74932
"1862",192925,"MEDAILLE COLLEGE                                            ","2003-2004",2,"Basketball",501,56848,-56347,500,24836,-24336,1,32012,-32011,"15","13",16936,16912
"3218",239248,"MILWAUKEE AREA TECHNICAL COLLEGE                            ","2003-2004",2,"Basketball",2,56400,-56398,1,29400,-29399,1,27000,-26999,"15","14",16400,14700
"8146",153108,"CENTRAL COLLEGE                                             ","2003-2004",15,"Soccer",33515,89983,-56468,17625,45716,-28091,15890,44267,-28377,"40","28",15899,13468
"11398",216597,"VILLANOVA UNIVERSITY                                        ","2003-2004",22,"Tennis",16661,73129,-56468,11750,30328,-18578,4911,42801,-37890,"11","14",8203,28456
"15675",199999,"WINSTON-SALEM STATE UNIVERSITY                              ","2003-2004",39,"Total Participants",111542,168011,-56469,14520,21823,-7303,97022,146188,-49166,"147","59",132057,74432
"6212",218733,"SOUTH CAROLINA STATE UNIVERSITY                             ","2003-2004",8,"Golf",125000,181529,-56529,83597,92181,-8584,41403,89348,-47945,"5","7",17499,19116
"8185",179955,"WILLIAM JEWELL COLLEGE                                      ","2003-2004",15,"Soccer",46069,102600,-56531,22500,51300,-28800,23569,51300,-27731,"25","22",18000,18000
"10330",149772,"WESTERN ILLINOIS UNIVERSITY                                 ","2003-2004",18,"Swimming and Diving",105908,162496,-56588,52954,81248,-28294,52954,81248,-28294,"23","24",17619,17619
"14723",113634,"DIABLO VALLEY COLLEGE                                       ","2003-2004",27,"Water Polo",1804,58455,-56651,902,29167,-28265,902,29288,-28386,"17","19",3213,3990
"390",225627,"UNIVERSITY OF THE INCARNATE WORD                            ","2003-2004",1,"Baseball",274344,331035,-56691,274344,331035,-56691,0,0,0,"27",".",16034,0
"2186",159391,"LOUISIANA STATE UNIV &amp; AG &amp; MECH &amp; HEBERT LAWS CTR          ","2003-2004",2,"Basketball",4437122,4493832,-56710,4146978,2597113,1549865,290144,1896719,-1606575,"15","13",411838,513421
"4048",213507,"LEBANON VALLEY COLLEGE                                      ","2003-2004",6,"Field hocky",28821,85537,-56716,0,0,0,28821,85537,-56716,".","29",0,2011
"12237",198516,"ELON UNIVERSITY                                             ","2003-2004",25,"Track and Field, X-Country",5630,62351,-56721,4664,31620,-26956,966,30731,-29765,"14","77",4664,19981
"17251",212106,"DUQUESNE UNIVERSITY                                         ","2003-2004",39,"Total Participants",4072291,4129069,-56778,1672188,1703908,-31720,2400103,2425161,-25058,"262","276",782045,556000
"2589",189088,"BARD COLLEGE                                                ","2003-2004",2,"Basketball",704,57609,-56905,703,33104,-32401,1,24505,-24504,"12","12",20985,9457
"327",152336,"UNIVERSITY OF SAINT FRANCIS-FT WAYNE                        ","2003-2004",1,"Baseball",20650,77584,-56934,20650,77584,-56934,0,0,0,"29",".",21521,0
"4995",196006,"SUNY COLLEGE OF TECHNOLOGY AT ALFRED                        ","2003-2004",7,"Football",84083,141045,-56962,84083,141045,-56962,0,0,0,"63",".",44410,0
"3413",231712,"CHRISTOPHER NEWPORT UNIVERSITY                              ","2003-2004",2,"Basketball",64470,121450,-56980,40945,59859,-18914,23525,61591,-38066,"13","13",10213,12305
"11419",159966,"NICHOLLS STATE UNIVERSITY                                   ","2003-2004",22,"Tennis",1787,58928,-57141,0,0,0,1787,58928,-57141,".","8",0,6162
"8648",227225,"NORTHEAST TEXAS COMMUNITY COLLEGE                           ","2003-2004",16,"Softball",601,57757,-57156,0,0,0,601,57757,-57156,".","23",0,49656
"7952",151306,"UNIVERSITY OF SOUTHERN INDIANA                              ","2003-2004",15,"Soccer",176414,233619,-57205,103983,138768,-34785,72431,94851,-22420,"25","18",37354,23130
"8514",163462,"MOUNT SAINT MARYS COLLEGE                                   ","2003-2004",15,"Soccer",399450,456724,-57274,212533,229989,-17456,186917,226735,-39818,"29","26",44294,35244
"11371",198969,"METHODIST COLLEGE                                           ","2003-2004",22,"Tennis",4092,61497,-57405,591,38666,-38075,3501,22831,-19330,"12","8",5491,4331
"1990",118684,"MENDOCINO COLLEGE                                           ","2003-2004",2,"Basketball",8375,65790,-57415,4585,36387,-31802,3790,29403,-25613,"13","12",20205,18600
"11633",127741,"UNIVERSITY OF NORTHERN COLORADO                             ","2003-2004",22,"Tennis",51377,108793,-57416,18780,25253,-6473,32597,83540,-50943,"8","11",5347,14689
"3548",155566,"NEOSHO COUNTY COMMUNITY COLLEGE                             ","2003-2004",3,"All Track Combined",200,57618,-57418,100,28809,-28709,100,28809,-28709,"23","15",16160,10530
"17019",188438,"ADIRONDACK COMMUNITY COLLEGE                                ","2003-2004",39,"Total Participants",7576,64999,-57423,1864,29831,-27967,5712,35168,-29456,"58","50",28868,29473
"7420",204936,"OTTERBEIN COLLEGE                                           ","2003-2004",15,"Soccer",39611,97111,-57500,20385,40385,-20000,19226,56726,-37500,"26","24",17289,16106
"13293",138275,"WARNER SOUTHERN COLLEGE                                     ","2003-2004",26,"Volleyball",1623,59136,-57513,0,0,0,1623,59136,-57513,"0","10",0,11172
"6344",230038,"BRIGHAM YOUNG UNIVERSITY                                    ","2003-2004",9,"Gymnastics",451589,509130,-57541,0,0,0,451589,509130,-57541,".","19",0,42518
"10465",231174,"UNIVERSITY OF VERMONT AND STATE AGRICULTURAL COLL           ","2003-2004",18,"Swimming and Diving",99252,156862,-57610,44549,37964,6585,54703,118898,-64195,"17","24",18376,55132
"857",206589,"COLLEGE OF WOOSTER                                          ","2003-2004",1,"Baseball",800,58439,-57639,800,58439,-57639,0,0,0,"40",".",49096,0
"16708",113193,"CUESTA COLLEGE                                              ","2003-2004",39,"Total Participants",126327,183983,-57656,54119,85215,-31096,72208,98768,-26560,"162","119",52415,51641
"11254",106412,"UNIVERSITY OF ARKANSAS AT PINE BLUFF                        ","2003-2004",22,"Tennis",2,57731,-57729,1,22047,-22046,1,35684,-35683,"7","6",12594,19830
"1804",151342,"INDIANA UNIVERSITY-SOUTH BEND                               ","2003-2004",2,"Basketball",6580,64367,-57787,4386,32165,-27779,2194,32202,-30008,"16","10",30500,30500
"12456",240462,"UNIVERSITY OF WISCONSIN-PLATTEVILLE                         ","2003-2004",25,"Track and Field, X-Country",123540,181384,-57844,63232,94168,-30936,60308,87216,-26908,"132","112",45906,39580
"11078",195030,"UNIVERSITY OF ROCHESTER                                     ","2003-2004",22,"Tennis",25738,83620,-57882,14827,43212,-28385,10911,40408,-29497,"12","12",18038,15209
"1963",140483,"MIDDLE GEORGIA COLLEGE                                      ","2003-2004",2,"Basketball",12745,70703,-57958,7902,44909,-37007,4843,25794,-20951,"17","15",27764,16780
"10068",191630,"HOBART WILLIAM SMITH COLLEGES                               ","2003-2004",17,"Squash",23437,81403,-57966,14460,43706,-29246,8977,37697,-28720,"18","12",11303,3576
"1814",226329,"LON MORRIS COLLEGE                                          ","2003-2004",2,"Basketball",60325,118300,-57975,34820,72567,-37747,25505,45733,-20228,"13","15",32375,12733
"4738",211644,"CLARION UNIVERSITY OF PENNSYLVANIA                          ","2003-2004",7,"Football",395423,453463,-58040,395423,453463,-58040,0,0,0,"82",".",68545,0
"9888",207458,"OKLAHOMA CITY UNIVERSITY                                    ","2003-2004",16,"Softball",3025,61142,-58117,0,0,0,3025,61142,-58117,".","13",0,32000
"10377",153384,"GRINNELL COLLEGE                                            ","2003-2004",18,"Swimming and Diving",37900,96093,-58193,17700,48755,-31055,20200,47338,-27138,"36","51",19766,18349
"9931",230171,"DIXIE STATE COLLEGE OF UTAH                                 ","2003-2004",16,"Softball",318,58544,-58226,0,0,0,318,58544,-58226,".","19",0,35292
"5868",198808,"LEES-MCRAE COLLEGE                                          ","2003-2004",8,"Golf",13000,71228,-58228,13000,71228,-58228,0,0,0,"7",".",15078,0
"15328",240657,"NORTHWEST COMMUNITY COLLEGE                                 ","2003-2004",35,"Rodeo",13104,71334,-58230,6552,35667,-29115,6552,35667,-29115,"6","4",25164,25164
"9937",206923,"CARL ALBERT STATE COLLEGE                                   ","2003-2004",16,"Softball",1705,59943,-58238,0,0,0,1705,59943,-58238,".","18",0,38237
"8584",211158,"BLOOMSBURG UNIVERSITY OF PENNSYLVANIA                       ","2003-2004",16,"Softball",146909,205156,-58247,0,0,0,146909,205156,-58247,".","19",0,17882
"4724",233611,"SOUTHERN VIRGINIA UNIVERSITY                                ","2003-2004",7,"Football",97336,155591,-58255,97336,155591,-58255,0,0,0,"62",".",95736,0
"7709",110547,"CALIFORNIA STATE UNIVERSITY-DOMINGUEZ HILLS                 ","2003-2004",15,"Soccer",26248,84506,-58258,11513,39063,-27550,14735,45443,-30708,"21","22",28577,36179
"7737",217998,"ERSKINE COLLEGE AND SEMINARY                                ","2003-2004",15,"Soccer",32000,90261,-58261,16000,40255,-24255,16000,50006,-34006,"18","21",12888,18006
"17281",149727,"WAUBONSEE COMMUNITY COLLEGE                                 ","2003-2004",39,"Total Participants",83500,141815,-58315,41475,75558,-34083,42025,66257,-24232,"94","57",56175,43426
"14930",168421,"WORCESTER POLYTECHNIC INSTITUTE                             ","2003-2004",28,"Wrestling",22787,81135,-58348,22787,81135,-58348,0,0,0,"33","0",24303,0
"1531",185828,"NEW JERSEY INSTITUTE OF TECHNOLOGY                          ","2003-2004",1,"Baseball",24634,83021,-58387,24634,83021,-58387,0,0,0,"27",".",24634,0
"15743",157951,"WESTERN KENTUCKY UNIVERSITY                                 ","2003-2004",39,"Total Participants",3178265,3236667,-58402,1386582,1433942,-47360,1791683,1802725,-11042,"326","168",918936,598490
"16634",184348,"DREW UNIVERSITY                                             ","2003-2004",39,"Total Participants",647905,706322,-58417,322162,349756,-27594,325743,356566,-30823,"144","160",82369,90009
"7109",118693,"MENLO COLLEGE                                               ","2003-2004",15,"Soccer",3000,61481,-58481,2700,28370,-25670,300,33111,-32811,"23","16",14972,16650
"11431",140960,"SAVANNAH STATE UNIVERSITY                                   ","2003-2004",22,"Tennis",0,58517,-58517,0,0,0,0,58517,-58517,"0","5",0,46613
"5893",106412,"UNIVERSITY OF ARKANSAS AT PINE BLUFF                        ","2003-2004",8,"Golf",2,58551,-58549,1,25387,-25386,1,33164,-33163,"6","5",14109,11335
"12397",234207,"WASHINGTON AND LEE UNIVERSITY                               ","2003-2004",25,"Track and Field, X-Country",6181,64736,-58555,4537,37576,-33039,1644,27160,-25516,"11","14",5103,3652
"488",144892,"EASTERN ILLINOIS UNIVERSITY                                 ","2003-2004",1,"Baseball",212679,271273,-58594,212679,271273,-58594,0,0,0,"36",".",91420,0
"4659",125763,"WHITTIER COLLEGE                                            ","2003-2004",7,"Football",122400,181000,-58600,122400,181000,-58600,0,0,0,"50",".",114670,0
"7335",185129,"NEW JERSEY CITY UNIVERSITY                                  ","2003-2004",15,"Soccer",25000,83681,-58681,14000,56115,-42115,11000,27566,-16566,"31","15",8329,4863
"3255",159407,"LOUISIANA STATE UNIVERSITY-EUNICE                           ","2003-2004",2,"Basketball",1852,60575,-58723,0,0,0,1852,60575,-58723,".","22",0,42075
"5216",181394,"UNIVERSITY OF NEBRASKA AT OMAHA                             ","2003-2004",8,"Golf",12285,71008,-58723,0,0,0,12285,71008,-58723,".","11",0,22830
"9580",231174,"UNIVERSITY OF VERMONT AND STATE AGRICULTURAL COLL           ","2003-2004",16,"Softball",215373,274106,-58733,0,0,0,215373,274106,-58733,".","19",0,74745
"4060",233426,"ROANOKE COLLEGE                                             ","2003-2004",6,"Field hocky",315,59091,-58776,0,0,0,315,59091,-58776,".","21",0,24091
"9465",218964,"WINTHROP UNIVERSITY                                         ","2003-2004",16,"Softball",111528,170391,-58863,0,0,0,111528,170391,-58863,".","22",0,39230
"11742",219383,"UNIVERSITY OF SIOUX FALLS                                   ","2003-2004",22,"Tennis",8712,67594,-58882,4538,35922,-31384,4174,31672,-27498,"8","10",9088,9088
"14408",156365,"CAMPBELLSVILLE UNIVERSITY                                   ","2003-2004",26,"Volleyball",13876,72775,-58899,0,0,0,13876,72775,-58899,".","12",0,13261
"2073",206589,"COLLEGE OF WOOSTER                                          ","2003-2004",2,"Basketball",11874,70779,-58905,11143,34882,-23739,731,35897,-35166,"18","22",32759,21744
"7161",173920,"MINNESOTA STATE UNVERSITY-MANKATO                           ","2003-2004",15,"Soccer",136039,194981,-58942,0,0,0,136039,194981,-58942,".","26",0,41871
"4268",213613,"LOCK HAVEN UNIVERSITY OF PENNSYLVANIA                       ","2003-2004",7,"Football",507841,566850,-59009,507841,566850,-59009,0,0,0,"101",".",86310,0
"894",217721,"BENEDICT COLLEGE                                            ","2003-2004",1,"Baseball",1,59062,-59061,1,59062,-59061,0,0,0,"17",".",14062,0
"7801",206835,"OKLAHOMA WESLEYAN UNIVERSITY                                ","2003-2004",15,"Soccer",26437,85550,-59113,14627,55512,-40885,11810,30038,-18228,"19","18",11705,10928
"9013",228981,"TEXAS LUTHERAN UNIVERSITY                                   ","2003-2004",16,"Softball",4344,63467,-59123,0,0,0,4344,63467,-59123,".","19",0,20717
"1691",228158,"SOUTH PLAINS COLLEGE                                        ","2003-2004",2,"Basketball",60000,119133,-59133,30000,63240,-33240,30000,55893,-25893,"20","15",42501,38781
"9386",133650,"FLORIDA AGRICULTURAL AND MECHANICAL UNIVERSITY              ","2003-2004",16,"Softball",1,59136,-59135,0,0,0,1,59136,-59135,".","15",0,56569
"15664",145619,"BENEDICTINE UNIVERSITY                                      ","2003-2004",39,"Total Participants",480570,539714,-59144,263156,291584,-28428,217414,248130,-30716,"208","103",134354,76448
"13357",234207,"WASHINGTON AND LEE UNIVERSITY                               ","2003-2004",26,"Volleyball",2295,61459,-59164,0,0,0,2295,61459,-59164,".","14",0,12626
"16206",195562,"SAINT JOSEPHS COLLEGE-SUFFOLK CAMPUS                        ","2003-2004",39,"Total Participants",234420,293621,-59201,112446,134887,-22441,121974,158734,-36760,"83","102",86963,116719
"1803",212009,"DICKINSON COLLEGE                                           ","2003-2004",2,"Basketball",37684,96896,-59212,19890,51919,-32029,17794,44977,-27183,"18","11",22890,19794
"11725",176044,"MISSISSIPPI VALLEY STATE UNIVERSITY                         ","2003-2004",22,"Tennis",14300,73535,-59235,7150,32892,-25742,7150,40643,-33493,"5","5",25392,25393
"14925",200059,"DICKINSON STATE UNIVERSITY                                  ","2003-2004",28,"Wrestling",31895,91168,-59273,31895,91168,-59273,0,0,0,"33",".",31073,0
"7425",155025,"EMPORIA STATE UNIVERSITY                                    ","2003-2004",15,"Soccer",35609,94884,-59275,0,0,0,35609,94884,-59275,".","22",0,26796
"5131",220516,"KING COLLEGE                                                ","2003-2004",8,"Golf",3460,62781,-59321,3460,62781,-59321,0,0,0,"8",".",3460,0
"1350",207351,"OKLAHOMA PANHANDLE STATE UNIVERSITY                         ","2003-2004",1,"Baseball",10327,69658,-59331,10327,69658,-59331,0,0,0,"17",".",18827,0
"12587",215132,"UNIVERSITY OF THE SCIENCES IN PHILADELPHIA                  ","2003-2004",25,"Track and Field, X-Country",2,59419,-59417,1,28522,-28521,1,30897,-30896,"11","11",2200,2200
"11953",228486,"SOUTHWESTERN CHRISTIAN COLLEGE                              ","2003-2004",24,"Track and Field, Outdoor",450,59930,-59480,250,37430,-37180,200,22500,-22300,"20","15",4806,4550
"4236",196149,"SUNY COLLEGE AT CORTLAND                                    ","2003-2004",6,"Field hocky",37018,96512,-59494,0,0,0,37018,96512,-59494,".","21",0,53027
"12736",227845,"SAINT EDWARD'S UNIVERSITY                                   ","2003-2004",25,"Track and Field, X-Country",2,59500,-59498,1,29750,-29749,1,29750,-29749,"8","4",2050,2050
"2891",123484,"COLLEGE OF THE SISKIYOUS                                    ","2003-2004",2,"Basketball",38421,97948,-59527,20688,43000,-22312,17733,54948,-37215,"15","12",18885,16296
"11880",228486,"SOUTHWESTERN CHRISTIAN COLLEGE                              ","2003-2004",23,"Track and Field, Indoor",350,59930,-59580,200,37430,-37230,150,22500,-22350,"20","15",1500,1300
"9242",238078,"WHEELING JESUIT UNIVERSITY                                  ","2003-2004",16,"Softball",500,60083,-59583,0,0,0,500,60083,-59583,".","11",0,24113
"13323",216667,"WASHINGTON &amp; JEFFERSON COLLEGE                              ","2003-2004",26,"Volleyball",59923,119608,-59685,0,0,0,59923,119608,-59685,"0","15",0,13167
"9868",148654,"UNIVERSITY OF ILLINOIS AT SPRINGFIELD                       ","2003-2004",16,"Softball",103000,162748,-59748,0,0,0,103000,162748,-59748,".","14",0,53210
"9743",109819,"BAKERSFIELD COLLEGE                                         ","2003-2004",16,"Softball",35700,95522,-59822,0,0,0,35700,95522,-59822,".","18",0,5432
"8738",152530,"TAYLOR UNIVERSITY-UPLAND                                    ","2003-2004",16,"Softball",390,60244,-59854,0,0,0,390,60244,-59854,".","13",0,17964
"15100",190150,"COLUMBIA UNIVERSITY IN THE CITY OF NEW YORK                 ","2003-2004",29,"Other Sports",41624,101529,-59905,41624,101529,-59905,0,0,0,"19",".",53619,0
"782",110495,"CALIFORNIA STATE UNIVERSITY-STANISLAUS                      ","2003-2004",1,"Baseball",40692,100709,-60017,40692,100709,-60017,0,0,0,"25",".",50484,0
"16097",173805,"ITASCA COMMUNITY COLLEGE                                    ","2003-2004",39,"Total Participants",37288,97320,-60032,22089,47884,-25795,15199,49436,-34237,"87","34",21821,12197
"9688",144892,"EASTERN ILLINOIS UNIVERSITY                                 ","2003-2004",16,"Softball",173598,233695,-60097,0,0,0,173598,233695,-60097,".","20",0,67621
"16783",171304,"MUSKEGON COMMUNITY COLLEGE                                  ","2003-2004",39,"Total Participants",123546,183648,-60102,67059,98424,-31365,56487,85224,-28737,"83","41",54437,41377
"10093",191241,"FORDHAM UNIVERSITY                                          ","2003-2004",18,"Swimming and Diving",527361,587583,-60222,212795,220755,-7960,314566,366828,-52262,"32","28",20570,19455
"1679",237215,"BLUEFIELD STATE COLLEGE                                     ","2003-2004",2,"Basketball",59350,119587,-60237,28750,66833,-38083,30600,52754,-22154,"18","13",28750,28750
"16730",240365,"UNIVERSITY OF WISCONSIN-OSHKOSH                             ","2003-2004",39,"Total Participants",569206,629479,-60273,272766,312263,-39497,296440,317216,-20776,"337","234",281084,240675
"2503",117645,"LONG BEACH CITY COLLEGE                                     ","2003-2004",2,"Basketball",20362,80662,-60300,9893,39534,-29641,10469,41128,-30659,"13","13",8993,9894
"2061",200280,"UNIVERSITY OF NORTH DAKOTA-MAIN CAMPUS                      ","2003-2004",2,"Basketball",985992,1046366,-60374,448571,533278,-84707,537421,513088,24333,"18","16",39210,73427
"14704",110583,"CALIFORNIA STATE UNIVERSITY-LONG BEACH                      ","2003-2004",27,"Water Polo",358700,419082,-60382,155401,162876,-7475,203299,256206,-52907,"30","41",44758,67351
"7782",219000,"AUGUSTANA COLLEGE                                           ","2003-2004",15,"Soccer",45682,106157,-60475,0,0,0,45682,106157,-60475,".","30",0,18582
"12461",213507,"LEBANON VALLEY COLLEGE                                      ","2003-2004",25,"Track and Field, X-Country",24288,84774,-60486,12545,42788,-30243,11743,41986,-30243,"53","46",12545,11743
"13968",236452,"SAINT MARTINS COLLEGE                                       ","2003-2004",26,"Volleyball",34631,95209,-60578,0,0,0,34631,95209,-60578,".","10",0,25832
"11287",221351,"RHODES COLLEGE                                              ","2003-2004",22,"Tennis",30200,90928,-60728,15100,45399,-30299,15100,45529,-30429,"12","12",10260,10260
"11489",180461,"MONTANA STATE UNIVERSITY-BOZEMAN                            ","2003-2004",22,"Tennis",369649,430381,-60732,142339,178942,-36603,227310,251439,-24129,"8","8",40287,23989
"16250",243188,"UNIVERSITY OF PUERTO RICO-UTUADO                            ","2003-2004",39,"Total Participants",19000,79802,-60802,10600,47256,-36656,8400,32546,-24146,"83","60",15974,12092
"11367",139366,"COLUMBUS STATE UNIVERSITY                                   ","2003-2004",22,"Tennis",147760,208568,-60808,68600,89295,-20695,79160,119273,-40113,"8","8",11700,16353
"823",176071,"MISSISSIPPI GULF COAST COMMUNITY COLLEGE                    ","2003-2004",1,"Baseball",1,60893,-60892,1,60893,-60892,0,0,0,"30",".",12871,0
"16530",157401,"MURRAY STATE UNIVERSITY                                     ","2003-2004",39,"Total Participants",1925777,1986696,-60919,757475,774203,-16728,1168302,1212493,-44191,"212","158",521850,312588
"11723",197984,"BELMONT ABBEY COLLEGE                                       ","2003-2004",22,"Tennis",1305,62235,-60930,652,36411,-35759,653,25824,-25171,"9","9",3717,3717
"12679",139366,"COLUMBUS STATE UNIVERSITY                                   ","2003-2004",25,"Track and Field, X-Country",92150,153100,-60950,42150,70531,-28381,50000,82569,-32569,"9","7",11400,17800
"5612",144740,"DEPAUL UNIVERSITY                                           ","2003-2004",8,"Golf",103024,163998,-60974,103024,163998,-60974,0,0,0,"5",".",42186,0
"6620",216667,"WASHINGTON &amp; JEFFERSON COLLEGE                              ","2003-2004",11,"Lacrosse",62216,123200,-60984,62216,123200,-60984,0,0,0,"17","0",14436,0
"3278",220710,"MARYVILLE COLLEGE                                           ","2003-2004",2,"Basketball",76318,137325,-61007,46606,88606,-42000,29712,48719,-19007,"25","14",38086,30359
"13065",140960,"SAVANNAH STATE UNIVERSITY                                   ","2003-2004",26,"Volleyball",0,61047,-61047,0,0,0,0,61047,-61047,".","15",0,39846
"9277",203599,"LAKELAND COMMUNITY COLLEGE                                  ","2003-2004",16,"Softball",1135,62202,-61067,0,0,0,1135,62202,-61067,".","10",0,34146
"4702",153384,"GRINNELL COLLEGE                                            ","2003-2004",7,"Football",55300,116388,-61088,55300,116388,-61088,0,0,0,"49",".",43840,0
"13211",148654,"UNIVERSITY OF ILLINOIS AT SPRINGFIELD                       ","2003-2004",26,"Volleyball",90500,151674,-61174,0,0,0,90500,151674,-61174,".","11",0,36801
"220",174844,"SAINT OLAF COLLEGE                                          ","2003-2004",1,"Baseball",7620,68891,-61271,7620,68891,-61271,0,0,0,"35",".",31802,0
"8392",155937,"STERLING COLLEGE                                            ","2003-2004",15,"Soccer",71,61391,-61320,1,30497,-30496,70,30894,-30824,"16","17",30496,30893
"347",152530,"TAYLOR UNIVERSITY-UPLAND                                    ","2003-2004",1,"Baseball",16852,78190,-61338,16852,78190,-61338,0,0,0,"22",".",32018,0
"847",200280,"UNIVERSITY OF NORTH DAKOTA-MAIN CAMPUS                      ","2003-2004",1,"Baseball",76982,138364,-61382,76982,138364,-61382,0,0,0,"45",".",59558,0
"9759",234827,"CENTRAL WASHINGTON UNIVERSITY                               ","2003-2004",16,"Softball",23448,84876,-61428,0,0,0,23448,84876,-61428,".","41",0,43248
"10387",168591,"ALMA COLLEGE                                                ","2003-2004",18,"Swimming and Diving",48576,110082,-61506,22862,55172,-32310,25714,54910,-29196,"15","22",19335,19405
"2235",153108,"CENTRAL COLLEGE                                             ","2003-2004",2,"Basketball",79016,140664,-61648,41767,71658,-29891,37249,69006,-31757,"24","23",24258,19920
"721",173328,"CONCORDIA UNIVERSITY-ST PAUL                                ","2003-2004",1,"Baseball",116805,178535,-61730,116805,178535,-61730,0,0,0,"29",".",62672,0
"8901",229018,"THE UNIVERSITY OF TEXAS OF THE PERMIAN BASIN                ","2003-2004",16,"Softball",1,61762,-61761,0,0,0,1,61762,-61761,".","19",0,27082
"17276",123457,"SIMPSON COLLEGE                                             ","2003-2004",39,"Total Participants",15150,76963,-61813,1415,38273,-36858,13735,38690,-24955,"41","31",51155,47947
"4087",216764,"WEST CHESTER UNIVERSITY OF PENNSYLVANIA                     ","2003-2004",6,"Field hocky",44865,106726,-61861,0,0,0,44865,106726,-61861,".","35",0,35784
"5616",113573,"COLLEGE OF THE DESERT                                       ","2003-2004",8,"Golf",2354,64300,-61946,1280,33470,-32190,1074,30830,-29756,"13","7",6578,6944
"7588",193326,"MONROE COMMUNITY COLLEGE                                    ","2003-2004",15,"Soccer",79041,140997,-61956,42448,63397,-20949,36593,77600,-41007,"24","22",19786,21712
"5902",159647,"LOUISIANA TECH UNIVERSITY                                   ","2003-2004",8,"Golf",14800,76798,-61998,14800,76798,-61998,0,0,0,"11",".",39407,0
"3031",240426,"UNIVERSITY OF WISCONSIN-SUPERIOR                            ","2003-2004",2,"Basketball",75434,137446,-62012,43750,83829,-40079,31684,53617,-21933,"14","15",45564,31617
"16587",183859,"BROOKDALE COMMUNITY COLLEGE                                 ","2003-2004",39,"Total Participants",64000,126019,-62019,32000,61705,-29705,32000,64314,-32314,"72","59",61782,62506
"9302",228705,"TEXAS A &amp; M UNIVERSITY-KINGSVILLE                           ","2003-2004",16,"Softball",34090,96136,-62046,0,0,0,34090,96136,-62046,".","15",0,65451
"10400",164465,"AMHERST COLLEGE                                             ","2003-2004",18,"Swimming and Diving",86084,148270,-62186,43042,73511,-30469,43042,74759,-31717,"24","22",15055,16263
"15877",130776,"WESTERN CONNECTICUT STATE UNIVERSITY                        ","2003-2004",39,"Total Participants",679156,741387,-62231,295510,291957,3553,383646,449430,-65784,"195","110",146957,144673
"7169",115728,"HOLY NAMES UNIVERSITY                                       ","2003-2004",15,"Soccer",200,62443,-62243,100,28890,-28790,100,33553,-33453,"18","14",16690,27214
"16074",118347,"COLLEGE OF MARIN                                            ","2003-2004",39,"Total Participants",800,63071,-62271,450,46760,-46310,350,16311,-15961,"137","30",66539,24485
"12384",117645,"LONG BEACH CITY COLLEGE                                     ","2003-2004",25,"Track and Field, X-Country",21100,83376,-62276,12665,44942,-32277,8435,38434,-29999,"38","26",12619,7289
"9567",152600,"VALPARAISO UNIVERSITY                                       ","2003-2004",16,"Softball",298881,361159,-62278,0,0,0,298881,361159,-62278,".","29",0,15637
"10300",157951,"WESTERN KENTUCKY UNIVERSITY                                 ","2003-2004",18,"Swimming and Diving",510935,573230,-62295,201881,252999,-51118,309054,320231,-11177,"37","26",42072,54333
"2087",240462,"UNIVERSITY OF WISCONSIN-PLATTEVILLE                         ","2003-2004",2,"Basketball",259322,321697,-62375,225275,246083,-20808,34047,75614,-41567,"20","13",45645,28944
"5481",175616,"DELTA STATE UNIVERSITY                                      ","2003-2004",8,"Golf",1680,64083,-62403,1680,64083,-62403,0,0,0,"8",".",22952,0
"16075",366401,"LAS POSITAS COLLEGE                                         ","2003-2004",39,"Total Participants",63188,125683,-62495,31594,65186,-33592,31594,60497,-28903,"35","29",36836,32147
"15379",137351,"UNIVERSITY OF SOUTH FLORIDA                                 ","2003-2004",36,"Sailing",7077,69591,-62514,0,0,0,7077,69591,-62514,".","16",0,22558
"15636",237215,"BLUEFIELD STATE COLLEGE                                     ","2003-2004",39,"Total Participants",109687,172204,-62517,64744,108632,-43888,44943,63572,-18629,"71","47",79710,61440
"1723",140669,"NORTH GEORGIA COLLEGE AND STATE UNIVERSITY                  ","2003-2004",2,"Basketball",261144,323682,-62538,126128,155328,-29200,135016,168354,-33338,"16","11",66582,69382
"11962",196246,"SUNY COLLEGE AT PLATTSBURGH                                 ","2003-2004",24,"Track and Field, Outdoor",1540,64094,-62554,305,32047,-31742,1235,32047,-30812,"27","21",16639,16639
"13528",154925,"COFFEYVILLE COMMUNITY COLLEGE &amp; AREA TECH SCHOOL            ","2003-2004",26,"Volleyball",4880,67457,-62577,0,0,0,4880,67457,-62577,".","13",0,7616
"428",110510,"CALIFORNIA STATE UNIVERSITY-SAN BERNARDINO                  ","2003-2004",1,"Baseball",113615,176252,-62637,113615,176252,-62637,0,0,0,"30",".",43963,0
"8478",195720,"SAINT JOHN FISHER COLLEGE                                   ","2003-2004",15,"Soccer",22226,84942,-62716,11525,29388,-17863,10701,55554,-44853,"28","26",12454,12669
"3880",157951,"WESTERN KENTUCKY UNIVERSITY                                 ","2003-2004",3,"All Track Combined",509724,572559,-62835,221494,279097,-57603,288230,293462,-5232,"92","55",72852,74440
"15005",177968,"LINDENWOOD UNIVERSITY                                       ","2003-2004",28,"Wrestling",33638,96480,-62842,33638,96480,-62842,0,0,0,"53",".",62842,0
"1879",199306,"PFEIFFER UNIVERSITY                                         ","2003-2004",2,"Basketball",24482,87397,-62915,24481,65710,-41229,1,21687,-21686,"23","11",53885,19149
"16786",235343,"GREEN RIVER COMMUNITY COLLEGE                               ","2003-2004",39,"Total Participants",88216,151207,-62991,40980,68320,-27340,47236,82887,-35651,"71","64",48479,53035
"1901",219134,"SI TANKA UNIVERSITY-HURON CAMPUS                            ","2003-2004",2,"Basketball",69842,132847,-63005,33989,63989,-30000,35853,68858,-33005,"16","10",33989,35858
"10295",191630,"HOBART WILLIAM SMITH COLLEGES                               ","2003-2004",18,"Swimming and Diving",28964,92054,-63090,0,0,0,28964,92054,-63090,".","23",0,8238
"12283",196246,"SUNY COLLEGE AT PLATTSBURGH                                 ","2003-2004",25,"Track and Field, X-Country",2090,65226,-63136,580,32613,-32033,1510,32613,-31103,"15","10",16455,16455
"5458",120184,"NOTRE DAME DE NAMUR UNIVERSITY                              ","2003-2004",8,"Golf",47233,110410,-63177,24839,70716,-45877,22394,39694,-17300,"7","7",18904,16682
"7812",238430,"CARDINAL STRITCH UNIVERSITY                                 ","2003-2004",15,"Soccer",31462,94814,-63352,15840,47820,-31980,15622,46994,-31372,"30","18",11414,11321
"1340",153825,"LORAS COLLEGE                                               ","2003-2004",1,"Baseball",27104,90492,-63388,27104,90492,-63388,0,0,0,"36",".",21337,0
"7915",199032,"MONTREAT COLLEGE                                            ","2003-2004",15,"Soccer",42725,106201,-63476,21271,58950,-37679,21454,47251,-25797,"18","14",23674,20251
"12455",217633,"ANDERSON COLLEGE                                            ","2003-2004",25,"Track and Field, X-Country",85441,148921,-63480,44547,71583,-27036,40894,77338,-36444,"41","33",62976,44748
"14960",155566,"NEOSHO COUNTY COMMUNITY COLLEGE                             ","2003-2004",28,"Wrestling",100,63618,-63518,100,63618,-63518,0,0,0,"34",".",26500,0
"1512",118693,"MENLO COLLEGE                                               ","2003-2004",1,"Baseball",4200,67727,-63527,4200,67727,-63527,0,0,0,"43",".",62082,0
"14466",154518,"WALDORF COLLEGE                                             ","2003-2004",26,"Volleyball",14000,77568,-63568,0,0,0,14000,77568,-63568,".","14",0,14000
"5754",133951,"FLORIDA INTERNATIONAL UNIVERSITY                            ","2003-2004",8,"Golf",143329,207029,-63700,0,0,0,143329,207029,-63700,".","10",0,34778
"11075",160038,"NORTHWESTERN STATE UNIVERSITY OF LOUISIANA                  ","2003-2004",22,"Tennis",52793,116561,-63768,0,0,0,52793,116561,-63768,".","7",0,15120
"6849",199193,"NORTH CAROLINA STATE UNIVERSITY AT RALEIGH                  ","2003-2004",12,"Rifle",200,63999,-63799,100,25599,-25499,100,38400,-38300,".","12",6400,9600
"5435",155973,"TABOR COLLEGE                                               ","2003-2004",8,"Golf",4907,68709,-63802,4362,61075,-56713,545,7634,-7089,"8","1",17928,2241
"15966",191339,"GENESEE COMMUNITY COLLEGE                                   ","2003-2004",39,"Total Participants",114896,178716,-63820,54443,92631,-38188,60453,86085,-25632,"67","79",63606,4800
"7454",172200,"SCHOOLCRAFT COLLEGE                                         ","2003-2004",15,"Soccer",148244,212065,-63821,98602,108947,-10345,49642,103118,-53476,"20","20",24013,46227
"3358",154934,"COLBY COMMUNITY COLLEGE                                     ","2003-2004",2,"Basketball",42917,106769,-63852,18998,61425,-42427,23919,45344,-21425,"12","12",24405,20889
"2513",196006,"SUNY COLLEGE OF TECHNOLOGY AT ALFRED                        ","2003-2004",2,"Basketball",36702,100591,-63889,17318,48058,-30740,19384,52533,-33149,"12","10",13185,9894
"10964",164076,"TOWSON UNIVERSITY                                           ","2003-2004",22,"Tennis",8043,71933,-63890,4258,36171,-31913,3785,35762,-31977,"12","12",9094,8513
"1898",199412,"QUEENS UNIVERSITY OF CHARLOTTE                              ","2003-2004",2,"Basketball",431149,495072,-63923,230612,265998,-35386,200537,229074,-28537,"16","15",23922,20948
"8119",106412,"UNIVERSITY OF ARKANSAS AT PINE BLUFF                        ","2003-2004",15,"Soccer",1,63975,-63974,0,0,0,1,63975,-63974,".","17",0,20000
"4079",185262,"KEAN UNIVERSITY                                             ","2003-2004",6,"Field hocky",1,64061,-64060,0,0,0,1,64061,-64060,".","27",0,29149
"12626",181002,"CREIGHTON UNIVERSITY                                        ","2003-2004",25,"Track and Field, X-Country",16810,80975,-64165,8405,42738,-34333,8405,38237,-29832,"8","9",9149,9149
"13462",227526,"PRAIRIE VIEW A &amp; M UNIVERSITY                               ","2003-2004",26,"Volleyball",62204,126382,-64178,0,0,0,62204,126382,-64178,".","12",0,60990
"7005",232186,"GEORGE MASON UNIVERSITY                                     ","2003-2004",13,"Rowing",179071,243469,-64398,0,0,0,179071,243469,-64398,".","46",0,94131
"10048",155937,"STERLING COLLEGE                                            ","2003-2004",16,"Softball",430,64840,-64410,0,0,0,430,64840,-64410,".","20",0,64839
"8884",155025,"EMPORIA STATE UNIVERSITY                                    ","2003-2004",16,"Softball",59790,124271,-64481,0,0,0,59790,124271,-64481,".","20",0,47379
"678",216764,"WEST CHESTER UNIVERSITY OF PENNSYLVANIA                     ","2003-2004",1,"Baseball",45035,109620,-64585,45035,109620,-64585,0,0,0,"30",".",33346,0
"8324",235097,"EASTERN WASHINGTON UNIVERSITY                               ","2003-2004",15,"Soccer",210303,275006,-64703,0,0,0,210303,275006,-64703,".","39",0,68710
"16203",154013,"MOUNT MERCY COLLEGE                                         ","2003-2004",39,"Total Participants",99731,164472,-64741,43780,43781,-1,55951,120691,-64740,"114","80",58414,69362
"15252",190415,"CORNELL UNIVERSITY-ENDOWED COLLEGES                         ","2003-2004",34,"Equestrian",65046,129832,-64786,0,0,0,65046,129832,-64786,".","28",0,24004
"7983",196149,"SUNY COLLEGE AT CORTLAND                                    ","2003-2004",15,"Soccer",69159,134025,-64866,37143,75506,-38363,32016,58519,-26503,"25","24",33247,20919
"201",230092,"COLLEGE OF EASTERN UTAH                                     ","2003-2004",1,"Baseball",1500,66400,-64900,1500,66400,-64900,0,0,0,"25",".",25000,0
"880",121345,"POMONA COLLEGE                                              ","2003-2004",1,"Baseball",19620,84539,-64919,19620,84539,-64919,0,0,0,"23",".",26960,0
"6489",177968,"LINDENWOOD UNIVERSITY                                       ","2003-2004",10,"Ice Hockey",33925,98855,-64930,16962,53918,-36956,16963,44937,-27974,"31","16",36956,27974
"5826",159993,"UNIVERSITY OF LOUISIANA AT MONROE                           ","2003-2004",8,"Golf",41970,106954,-64984,41970,106954,-64984,0,0,0,"9",".",36620,0
"12727",220516,"KING COLLEGE                                                ","2003-2004",25,"Track and Field, X-Country",10000,75087,-65087,5000,45570,-40570,5000,29517,-24517,"7","7",5000,5000
"12634",216807,"WESTMINSTER COLLEGE                                         ","2003-2004",25,"Track and Field, X-Country",30252,95372,-65120,16846,48453,-31607,13406,46919,-33513,"31","29",12367,11859
"12678",154013,"MOUNT MERCY COLLEGE                                         ","2003-2004",25,"Track and Field, X-Country",13805,78930,-65125,6480,6480,0,7325,72450,-65125,"23","26",6156,6888
"14679",216667,"WASHINGTON &amp; JEFFERSON COLLEGE                              ","2003-2004",27,"Water Polo",42730,107929,-65199,21365,53965,-32600,21365,53964,-32599,"19","21",16977,16976
"8868",200280,"UNIVERSITY OF NORTH DAKOTA-MAIN CAMPUS                      ","2003-2004",16,"Softball",116155,181426,-65271,0,0,0,116155,181426,-65271,".","18",0,62592
"13692",180948,"CHADRON STATE COLLEGE                                       ","2003-2004",26,"Volleyball",30803,96093,-65290,0,0,0,30803,96093,-65290,"0","14",0,13895
"128",127556,"MESA STATE COLLEGE                                          ","2003-2004",1,"Baseball",117248,182619,-65371,117248,182619,-65371,0,0,0,"33",".",154464,0
"9268",107071,"HENDERSON STATE UNIVERSITY                                  ","2003-2004",16,"Softball",49289,114723,-65434,0,0,0,49289,114723,-65434,".","18",0,23291
"1138",219000,"AUGUSTANA COLLEGE                                           ","2003-2004",1,"Baseball",71734,137169,-65435,71734,137169,-65435,0,0,0,"42",".",40776,0
"375",175829,"ITAWAMBA COMMUNITY COLLEGE                                  ","2003-2004",1,"Baseball",1043,66479,-65436,1043,66479,-65436,0,0,0,"21",".",32043,0
"1727",175078,"SOUTHWEST MINNESOTA STATE UNIVERSITY                        ","2003-2004",2,"Basketball",70456,135997,-65541,45042,76851,-31809,25414,59146,-33732,"17","16",46447,39734
"16385",164173,"VILLA JULIE COLLEGE                                         ","2003-2004",39,"Total Participants",195153,260696,-65543,90055,125269,-35214,105098,135427,-30329,"100","130",91161,90724
"8310",216807,"WESTMINSTER COLLEGE                                         ","2003-2004",15,"Soccer",91707,157291,-65584,47305,72177,-24872,44402,85114,-40712,"24","24",16265,18316
"11531",102094,"UNIVERSITY OF SOUTH ALABAMA                                 ","2003-2004",22,"Tennis",412912,478500,-65588,206012,238136,-32124,206900,240364,-33464,"8","7",68478,65795
"429",147013,"MCKENDREE COLLEGE                                           ","2003-2004",1,"Baseball",163521,229143,-65622,163521,229143,-65622,0,0,0,"37",".",36892,0
"12460",154527,"WARTBURG COLLEGE                                            ","2003-2004",25,"Track and Field, X-Country",111902,177615,-65713,47750,86799,-39049,64152,90816,-26664,"83","82",32540,48810
"8555",127556,"MESA STATE COLLEGE                                          ","2003-2004",16,"Softball",63962,129713,-65751,0,0,0,63962,129713,-65751,".","26",0,102309
"12255",102614,"UNIVERSITY OF ALASKA FAIRBANKS                              ","2003-2004",25,"Track and Field, X-Country",10277,76079,-65802,5101,38298,-33197,5176,37781,-32605,"8","6",8213,8972
"15696",150048,"ANCILLA COLLEGE                                             ","2003-2004",39,"Total Participants",40000,106000,-66000,24000,58000,-34000,16000,48000,-32000,"56","40",69000,64000
"10434",197027,"UNITED STATES MERCHANT MARINE ACADEMY                       ","2003-2004",18,"Swimming and Diving",7000,73044,-66044,3500,36522,-33022,3500,36522,-33022,"27","19",12530,12530
"12424",157386,"MOREHEAD STATE UNIVERSITY                                   ","2003-2004",25,"Track and Field, X-Country",120795,186928,-66133,52005,83553,-31548,68790,103375,-34585,"86","72",17112,17112
"10622",164216,"WASHINGTON COLLEGE                                          ","2003-2004",19,"Swimming",8174,74352,-66178,4087,37176,-33089,4087,37176,-33089,"11","17",8753,8753
"11583",113573,"COLLEGE OF THE DESERT                                       ","2003-2004",22,"Tennis",1190,67385,-66195,595,35404,-34809,595,31981,-31386,"7","8",11515,8088
"9910",154518,"WALDORF COLLEGE                                             ","2003-2004",16,"Softball",19500,85721,-66221,0,0,0,19500,85721,-66221,".","18",0,19500
"2647",153214,"DES MOINES AREA COMMUNITY COLLEGE                           ","2003-2004",2,"Basketball",17451,83790,-66339,9608,49550,-39942,7843,34240,-26397,"14","15",23300,15740
"302",109819,"BAKERSFIELD COLLEGE                                         ","2003-2004",1,"Baseball",36471,102821,-66350,36471,102821,-66350,0,0,0,"31",".",11085,0
"15736",101675,"MILES COLLEGE                                               ","2003-2004",39,"Total Participants",85113,151479,-66366,40402,77046,-36644,44711,74433,-29722,"138","59",23352,19480
"689",110097,"BIOLA UNIVERSITY                                            ","2003-2004",1,"Baseball",90606,156979,-66373,90606,156979,-66373,0,0,0,"27",".",22604,0
"14762",154527,"WARTBURG COLLEGE                                            ","2003-2004",28,"Wrestling",63393,129891,-66498,63393,129891,-66498,0,0,0,"46",".",32569,0
"5136",121309,"POINT LOMA NAZARENE UNIVERSITY                              ","2003-2004",8,"Golf",25215,91779,-66564,25215,91779,-66564,0,0,0,"11",".",37276,0
"14156",165936,"GORDON COLLEGE                                              ","2003-2004",26,"Volleyball",10000,76596,-66596,0,0,0,10000,76596,-66596,".","11",0,34273
"9752",233897,"THE UNIVERSITY OF VIRGINIA'S COLLEGE AT WISE                ","2003-2004",16,"Softball",40943,107568,-66625,0,0,0,40943,107568,-66625,".","42",0,51237
"6860",182290,"UNIVERSITY OF NEVADA-RENO                                   ","2003-2004",12,"Rifle",510,67140,-66630,255,18790,-18535,255,48350,-48095,"4","12",7060,15965
"8404",179894,"WEBSTER UNIVERSITY                                          ","2003-2004",15,"Soccer",14566,81218,-66652,300,23358,-23058,14266,57860,-43594,"24","24",10073,31697
"8659",121345,"POMONA COLLEGE                                              ","2003-2004",16,"Softball",12834,79507,-66673,0,0,0,12834,79507,-66673,".","12",0,15190
"1942",196149,"SUNY COLLEGE AT CORTLAND                                    ","2003-2004",2,"Basketball",99549,166243,-66694,58553,88437,-29884,40996,77806,-36810,"14","13",31597,29777
"13822",228981,"TEXAS LUTHERAN UNIVERSITY                                   ","2003-2004",26,"Volleyball",7339,74101,-66762,0,0,0,7339,74101,-66762,".","12",0,27249
"5390",122205,"SADDLEBACK COLLEGE                                          ","2003-2004",8,"Golf",17182,84000,-66818,9378,42000,-32622,7804,42000,-34196,"13","6",5577,6048
"8250",109819,"BAKERSFIELD COLLEGE                                         ","2003-2004",15,"Soccer",10500,77400,-66900,0,0,0,10500,77400,-66900,"0","17",0,4030
"16512",241377,"CARIBBEAN UNIVERSITY-BAYAMON                                ","2003-2004",39,"Total Participants",8500,75433,-66933,7750,72677,-64927,750,2756,-2006,"36","3",19841,630
"1275",206835,"OKLAHOMA WESLEYAN UNIVERSITY                                ","2003-2004",1,"Baseball",22615,89590,-66975,22615,89590,-66975,0,0,0,"21",".",13433,0
"16969",224961,"GALVESTON COLLEGE                                           ","2003-2004",39,"Total Participants",8500,75487,-66987,4000,36358,-32358,4500,39129,-34629,"28","27",20860,20335
"7363",213507,"LEBANON VALLEY COLLEGE                                      ","2003-2004",15,"Soccer",36336,103333,-66997,16002,46581,-30579,20334,56752,-36418,"21","19",10956,15288
"2230",153384,"GRINNELL COLLEGE                                            ","2003-2004",2,"Basketball",44520,111561,-67041,23670,56971,-33301,20850,54590,-33740,"21","17",30606,30923
"281",220312,"HIWASSEE COLLEGE                                            ","2003-2004",1,"Baseball",17700,84749,-67049,17700,84749,-67049,0,0,0,"23",".",13504,0
"1077",155566,"NEOSHO COUNTY COMMUNITY COLLEGE                             ","2003-2004",1,"Baseball",100,67152,-67052,100,67152,-67052,0,0,0,"35",".",29500,0
"15297",227225,"NORTHEAST TEXAS COMMUNITY COLLEGE                           ","2003-2004",35,"Rodeo",12599,79903,-67304,12599,79903,-67304,0,0,0,"48",".",68696,0
"11173",226204,"LEE COLLEGE                                                 ","2003-2004",22,"Tennis",25535,92858,-67323,0,0,0,25535,92858,-67323,".","8",0,25535
"7475",127060,"UNIVERSITY OF DENVER                                        ","2003-2004",15,"Soccer",999673,1067150,-67477,447467,479447,-31980,552206,587703,-35497,"22","20",83962,131996
"14388",152099,"OAKLAND CITY UNIVERSITY                                     ","2003-2004",26,"Volleyball",10500,78122,-67622,0,0,0,10500,78122,-67622,"0","10",0,8891
"1713",177065,"COLUMBIA COLLEGE                                            ","2003-2004",2,"Basketball",9727,77405,-67678,6569,45294,-38725,3158,32111,-28953,"12","11",30646,24294
"15524",224110,"NORTH CENTRAL TEXAS COLLEGE                                 ","2003-2004",39,"Total Participants",412100,479800,-67700,152300,172500,-20200,259800,307300,-47500,"28","39",24436,38182
"16535",224004,"CONCORDIA UNIVERSITY AT AUSTIN                              ","2003-2004",39,"Total Participants",155940,223695,-67755,97065,132654,-35589,58875,91041,-32166,"102","49",112985,78261
"8382",173328,"CONCORDIA UNIVERSITY-ST PAUL                                ","2003-2004",15,"Soccer",57009,124777,-67768,0,0,0,57009,124777,-67768,".","18",0,32721
"12593",196176,"SUNY COLLEGE AT NEW PALTZ                                   ","2003-2004",25,"Track and Field, X-Country",100,67878,-67778,50,33939,-33889,50,33939,-33889,"19","25",14111,14111
"481",199698,"ST ANDREWS PRESBYTERIAN COLLEGE                             ","2003-2004",1,"Baseball",94678,162503,-67825,94678,162503,-67825,0,0,0,"47",".",47678,0
"8003",225627,"UNIVERSITY OF THE INCARNATE WORD                            ","2003-2004",15,"Soccer",555429,623258,-67829,276378,305491,-29113,279051,317767,-38716,"31","18",27102,17605
"9846",229832,"WESTERN TEXAS COLLEGE                                       ","2003-2004",16,"Softball",53700,121576,-67876,0,0,0,53700,121576,-67876,".","21",0,106055
"7820",142294,"ALBERTSON COLLEGE OF IDAHO                                  ","2003-2004",15,"Soccer",12920,80875,-67955,9778,49135,-39357,3142,31740,-28598,"24","17",23340,20430
"4719",219082,"DAKOTA STATE UNIVERSITY                                     ","2003-2004",7,"Football",129828,197852,-68024,129828,197852,-68024,0,0,0,"64",".",54680,0
"6671",195720,"SAINT JOHN FISHER COLLEGE                                   ","2003-2004",11,"Lacrosse",31950,100029,-68079,18750,37769,-19019,13200,62260,-49060,"45","17",20974,17513
"12100",139931,"GEORGIA SOUTHERN UNIVERSITY                                 ","2003-2004",24,"Track and Field, Outdoor",14758,82851,-68093,0,0,0,14758,82851,-68093,".","28",0,22236
"11913",139931,"GEORGIA SOUTHERN UNIVERSITY                                 ","2003-2004",23,"Track and Field, Indoor",14758,82852,-68094,0,0,0,14758,82852,-68094,".","28",0,22236
"16330",208390,"CHEMEKETA COMMUNITY COLLEGE                                 ","2003-2004",39,"Total Participants",1400,69502,-68102,300,19953,-19653,1100,49549,-48449,"36","38",45947,73625
"7474",172334,"SPRING ARBOR UNIVERSITY                                     ","2003-2004",15,"Soccer",29550,97670,-68120,14910,49232,-34322,14640,48438,-33798,"23","22",14910,14640
"8085",113573,"COLLEGE OF THE DESERT                                       ","2003-2004",15,"Soccer",875,68996,-68121,375,35042,-34667,500,33954,-33454,"24","16",8184,7088
"15428",191612,"HERKIMER COUNTY COMMUNITY COLLEGE                           ","2003-2004",39,"Total Participants",95585,163740,-68155,49350,79100,-29750,46235,84640,-38405,"118","132",64350,60235
"9676",195243,"SAINT THOMAS AQUINAS COLLEGE                                ","2003-2004",16,"Softball",14644,82954,-68310,0,0,0,14644,82954,-68310,".","21",0,14032
"1802",240417,"UNIVERSITY OF WISCONSIN-STOUT                               ","2003-2004",2,"Basketball",287857,356172,-68315,138178,172522,-34344,149679,183650,-33971,"15","30",43365,56250
"16871",171456,"NORTHERN MICHIGAN UNIVERSITY                                ","2003-2004",39,"Total Participants",3198648,3266991,-68343,1488090,1528839,-40749,1710558,1738152,-27594,"163","152",524795,376378
"8846",209409,"NORTHWEST CHRISTIAN COLLEGE                                 ","2003-2004",16,"Softball",2700,71049,-68349,0,0,0,2700,71049,-68349,".","12",0,71048
"15683",209409,"NORTHWEST CHRISTIAN COLLEGE                                 ","2003-2004",39,"Total Participants",2700,71049,-68349,0,0,0,2700,71049,-68349,"15","23",76123,87392
"7299",127556,"MESA STATE COLLEGE                                          ","2003-2004",15,"Soccer",49562,117924,-68362,0,0,0,49562,117924,-68362,".","26",0,90520
"9650",236452,"SAINT MARTINS COLLEGE                                       ","2003-2004",16,"Softball",22106,90527,-68421,0,0,0,22106,90527,-68421,".","14",0,27540
"14630",121345,"POMONA COLLEGE                                              ","2003-2004",26,"Volleyball",15091,83547,-68456,0,0,0,15091,83547,-68456,".","14",0,14063
"770",205470,"SINCLAIR COMMUNITY COLLEGE                                  ","2003-2004",1,"Baseball",5630,74139,-68509,5630,74139,-68509,0,0,0,"29",".",42916,0
"13677",229832,"WESTERN TEXAS COLLEGE                                       ","2003-2004",26,"Volleyball",34859,103455,-68596,0,0,0,34859,103455,-68596,"0","10",0,82360
"6396",191630,"HOBART WILLIAM SMITH COLLEGES                               ","2003-2004",10,"Ice Hockey",78673,147278,-68605,78673,147278,-68605,0,0,0,"30",".",32058,0
"15124",199102,"NORTH CAROLINA  A &amp;T STATE UNIVERSITY                       ","2003-2004",29,"Other Sports",14800,83447,-68647,0,0,0,14800,83447,-68647,".","7",0,17177
"9732",197984,"BELMONT ABBEY COLLEGE                                       ","2003-2004",16,"Softball",1715,70473,-68758,0,0,0,1715,70473,-68758,".","15",0,10845
"1495",216667,"WASHINGTON &amp; JEFFERSON COLLEGE                              ","2003-2004",1,"Baseball",78503,147271,-68768,78503,147271,-68768,0,0,0,"32",".",50273,0
"3409",173665,"HAMLINE UNIVERSITY                                          ","2003-2004",2,"Basketball",130215,199005,-68790,68660,137642,-68982,61555,61363,192,"25","22",29739,19569
"8201",230603,"SOUTHERN UTAH UNIVERSITY                                    ","2003-2004",15,"Soccer",72454,141252,-68798,0,0,0,72454,141252,-68798,".","20",0,57330
"10899",217633,"ANDERSON COLLEGE                                            ","2003-2004",22,"Tennis",60125,128925,-68800,27355,66611,-39256,32770,62314,-29544,"7","9",7854,7353
"4689",117052,"REEDLEY COLLEGE                                             ","2003-2004",7,"Football",50621,119429,-68808,50621,119429,-68808,0,0,0,"103",".",26175,0
"2483",207351,"OKLAHOMA PANHANDLE STATE UNIVERSITY                         ","2003-2004",2,"Basketball",106765,175585,-68820,53002,75547,-22545,53763,100038,-46275,"11","15",22057,17037
"995",218229,"LANDER UNIVERSITY                                           ","2003-2004",1,"Baseball",118800,187637,-68837,118800,187637,-68837,0,0,0,"28",".",39801,0
"1338",233295,"RANDOLPH-MACON COLLEGE                                      ","2003-2004",1,"Baseball",4157,73000,-68843,4157,73000,-68843,0,0,0,"21",".",19000,0
"9604",220400,"JACKSON STATE COMMUNITY COLLEGE                             ","2003-2004",16,"Softball",529,69463,-68934,0,0,0,529,69463,-68934,".","14",0,8381
"11066",131496,"GEORGETOWN UNIVERSITY                                       ","2003-2004",22,"Tennis",41920,110938,-69018,20960,45341,-24381,20960,65597,-44637,"10","8",15604,16847
"2060",216357,"THIEL COLLEGE                                               ","2003-2004",2,"Basketball",23699,92742,-69043,14536,52074,-37538,9163,40668,-31505,"24","19",18244,16817
"10039",174233,"UNIVERSITY OF MINNESOTA-DULUTH                              ","2003-2004",16,"Softball",13947,83023,-69076,0,0,0,13947,83023,-69076,".","25",0,37370
"13958",174783,"SAINT CLOUD STATE UNIVERSITY                                ","2003-2004",26,"Volleyball",128786,197882,-69096,0,0,0,128786,197882,-69096,".","19",0,48356
"8106",144892,"EASTERN ILLINOIS UNIVERSITY                                 ","2003-2004",15,"Soccer",257904,327026,-69122,92683,122135,-29452,165221,204891,-39670,"27","22",30445,42353
"5058",113634,"DIABLO VALLEY COLLEGE                                       ","2003-2004",7,"Football",902,70115,-69213,902,70115,-69213,0,0,0,"57",".",13680,0
"11147",159647,"LOUISIANA TECH UNIVERSITY                                   ","2003-2004",22,"Tennis",47405,116676,-69271,0,0,0,47405,116676,-69271,".","10",0,23883
"1117",155858,"SEWARD COUNTY COMMUNITY COLLEGE                             ","2003-2004",1,"Baseball",96182,165555,-69373,96182,165555,-69373,0,0,0,"27",".",34573,0
"1718",174251,"UNIVERSITY OF MINNESOTA-MORRIS                              ","2003-2004",2,"Basketball",91308,160722,-69414,62290,77684,-15394,29018,83038,-54020,"15","18",24533,22952
"4488",164465,"AMHERST COLLEGE                                             ","2003-2004",7,"Football",234435,304088,-69653,234435,304088,-69653,0,0,0,"73",".",67242,0
"266",141565,"UNIVERSITY OF HAWAII AT HILO                                ","2003-2004",1,"Baseball",81998,151689,-69691,81998,151689,-69691,0,0,0,"30",".",87606,0
"4533",147660,"NORTH CENTRAL COLLEGE                                       ","2003-2004",7,"Football",131123,200823,-69700,131123,200823,-69700,0,0,0,"95",".",58123,0
"1304",236452,"SAINT MARTINS COLLEGE                                       ","2003-2004",1,"Baseball",70127,139903,-69776,70127,139903,-69776,0,0,0,"27",".",35730,0
"9562",213376,"LACKAWANNA COLLEGE                                          ","2003-2004",16,"Softball",1731,71691,-69960,0,0,0,1731,71691,-69960,".","12",0,55264
"3508",173920,"MINNESOTA STATE UNVERSITY-MANKATO                           ","2003-2004",3,"All Track Combined",227623,297599,-69976,124041,162409,-38368,103582,135190,-31608,"103","85",35222,36236
"1848",150048,"ANCILLA COLLEGE                                             ","2003-2004",2,"Basketball",7000,77000,-70000,2000,38000,-36000,5000,39000,-34000,"16","15",29000,29000
"7223",176071,"MISSISSIPPI GULF COAST COMMUNITY COLLEGE                    ","2003-2004",15,"Soccer",1320,71342,-70022,660,35671,-35011,660,35671,-35011,"23","14",6505,6505
"14525",176044,"MISSISSIPPI VALLEY STATE UNIVERSITY                         ","2003-2004",26,"Volleyball",16150,86176,-70026,0,0,0,16150,86176,-70026,".","13",0,50297
"7136",168591,"ALMA COLLEGE                                                ","2003-2004",15,"Soccer",42323,112391,-70068,23332,60337,-37005,18991,52054,-33063,"24","20",34552,25323
"16974",228529,"TARLETON STATE UNIVERSITY                                   ","2003-2004",39,"Total Participants",570511,640619,-70108,177400,194779,-17379,393111,445840,-52729,"194","91",226273,176152
"12812",110495,"CALIFORNIA STATE UNIVERSITY-STANISLAUS                      ","2003-2004",25,"Track and Field, X-Country",13654,83910,-70256,4566,26063,-21497,9088,57847,-48759,"9","48",5145,11700
"5087",155511,"MCPHERSON COLLEGE                                           ","2003-2004",7,"Football",26860,97199,-70339,26860,97199,-70339,0,0,0,"70",".",39266,0
"5935",228981,"TEXAS LUTHERAN UNIVERSITY                                   ","2003-2004",8,"Golf",29130,99609,-70479,14565,67874,-53309,14565,31735,-17170,"10","6",45183,9044
"17327",240417,"UNIVERSITY OF WISCONSIN-STOUT                               ","2003-2004",39,"Total Participants",520928,591436,-70508,208565,241223,-32658,312363,350213,-37850,"291","228",265010,222001
"12805",147679,"NORTH PARK UNIVERSITY                                       ","2003-2004",25,"Track and Field, X-Country",61274,131789,-70515,30010,67556,-37546,31264,64233,-32969,"38","36",21809,18486
"10202",174844,"SAINT OLAF COLLEGE                                          ","2003-2004",18,"Swimming and Diving",7734,78477,-70743,3867,29888,-26021,3867,48589,-44722,"24","24",16154,16154
"10583",162654,"GOUCHER COLLEGE                                             ","2003-2004",19,"Swimming",994,71768,-70774,472,35884,-35412,522,35884,-35362,"8","16",8515,8515
"16034",235167,"EVERGREEN STATE COLLEGE                                     ","2003-2004",39,"Total Participants",10285,81084,-70799,4615,32207,-27592,5670,48877,-43207,"38","47",35965,47235
"396",184782,"ROWAN UNIVERSITY                                            ","2003-2004",1,"Baseball",21263,92085,-70822,21263,92085,-70822,0,0,0,"29",".",31368,0
"7195",175342,"ALCORN STATE UNIVERSITY                                     ","2003-2004",15,"Soccer",2976,73828,-70852,0,0,0,2976,73828,-70852,".","12",0,12067
"3043",173452,"MARTIN LUTHER COLLEGE                                       ","2003-2004",2,"Basketball",20000,91000,-71000,11000,8000,3000,9000,83000,-74000,"13","16",5500,6000
"9264",200059,"DICKINSON STATE UNIVERSITY                                  ","2003-2004",16,"Softball",13463,84487,-71024,0,0,0,13463,84487,-71024,".","17",0,13827
"11558",207403,"OKLAHOMA BAPTIST UNIVERSITY                                 ","2003-2004",22,"Tennis",18826,89898,-71072,8888,45224,-36336,9938,44674,-34736,"10","8",8264,9341
"15144",190150,"COLUMBIA UNIVERSITY IN THE CITY OF NEW YORK                 ","2003-2004",30,"Archery",25,71185,-71160,0,0,0,25,71185,-71160,".","12",0,34765
"15946",210571,"ALBRIGHT COLLEGE                                            ","2003-2004",39,"Total Participants",163655,234950,-71295,71476,105190,-33714,92179,129760,-37581,"296","195",221935,107894
"7711",130943,"UNIVERSITY OF DELAWARE                                      ","2003-2004",15,"Soccer",579023,650320,-71297,214033,274461,-60428,364990,375859,-10869,"29","27",41627,50395
"6403",100706,"UNIVERSITY OF ALABAMA IN HUNTSVILLE                         ","2003-2004",10,"Ice Hockey",469120,540438,-71318,469120,540438,-71318,0,0,0,"25",".",177479,0
"1815",206525,"WITTENBERG UNIVERSITY                                       ","2003-2004",2,"Basketball",98391,169711,-71320,89922,82421,7501,8469,87290,-78821,"25","30",24604,23772
"11937",152530,"TAYLOR UNIVERSITY-UPLAND                                    ","2003-2004",24,"Track and Field, Outdoor",4365,75694,-71329,3519,43265,-39746,846,32429,-31583,"26","19",22457,21442
"8683",130943,"UNIVERSITY OF DELAWARE                                      ","2003-2004",16,"Softball",358449,429784,-71335,0,0,0,358449,429784,-71335,".","17",0,47613
"8950",156365,"CAMPBELLSVILLE UNIVERSITY                                   ","2003-2004",16,"Softball",20383,91744,-71361,0,0,0,20383,91744,-71361,".","15",0,18601
"12231",156408,"CENTRE COLLEGE                                              ","2003-2004",25,"Track and Field, X-Country",1104,72606,-71502,552,36303,-35751,552,36303,-35751,"47","29",29057,29057
"3732",196079,"SUNY AT BINGHAMTON                                          ","2003-2004",3,"All Track Combined",283427,354959,-71532,150013,183596,-33583,133414,171363,-37949,"85","77",32431,32883
"907",155061,"FORT HAYS STATE UNIVERSITY                                  ","2003-2004",1,"Baseball",92425,163964,-71539,92425,163964,-71539,0,0,0,"40",".",26526,0
"6577",213321,"KINGS COLLEGE                                               ","2003-2004",11,"Lacrosse",43605,115157,-71552,25779,60377,-34598,17826,54780,-36954,"28","22",23941,17372
"2533",142461,"NORTHWEST NAZARENE UNIVERSITY                               ","2003-2004",2,"Basketball",656170,727746,-71576,388307,438880,-50573,267863,288866,-21003,"15","12",84813,48419
"9295",203845,"MARIETTA COLLEGE                                            ","2003-2004",16,"Softball",42452,114063,-71611,0,0,0,42452,114063,-71611,".","20",0,26390
"16807",146719,"LOYOLA UNIVERSITY CHICAGO                                   ","2003-2004",39,"Total Participants",2629177,2700847,-71670,995606,1006690,-11084,1633571,1694157,-60586,"93","100",269722,330008
"14919",240657,"NORTHWEST COMMUNITY COLLEGE                                 ","2003-2004",28,"Wrestling",9886,81581,-71695,9886,81581,-71695,0,0,0,"19",".",25016,0
"862",154925,"COFFEYVILLE COMMUNITY COLLEGE &amp; AREA TECH SCHOOL            ","2003-2004",1,"Baseball",7000,78719,-71719,7000,78719,-71719,0,0,0,"30",".",16914,0
"4904",219347,"SOUTH DAKOTA SCHOOL OF MINES AND TECHNOLOGY                 ","2003-2004",7,"Football",69995,141714,-71719,69995,141714,-71719,0,0,0,"73",".",59776,0
"5684",207324,"OKLAHOMA CHRISTIAN UNIVERSITY                               ","2003-2004",8,"Golf",15202,87135,-71933,15202,87135,-71933,0,0,0,"13",".",25573,0
"12570",178402,"UNIVERSITY OF MISSOURI-KANSAS CITY                          ","2003-2004",25,"Track and Field, X-Country",434457,506409,-71952,191814,276023,-84209,242643,230386,12257,"40","45",37504,37504
"10339",107071,"HENDERSON STATE UNIVERSITY                                  ","2003-2004",18,"Swimming and Diving",52278,124249,-71971,35038,85510,-50472,17240,38739,-21499,"22","19",10036,10036
"5336",208488,"CONCORDIA UNIVERSITY                                        ","2003-2004",8,"Golf",15512,87512,-72000,8863,46613,-37750,6649,40899,-34250,"8","5",8863,6649
"17128",235149,"EVERETT COMMUNITY COLLEGE                                   ","2003-2004",39,"Total Participants",3600,75600,-72000,1600,33400,-31800,2000,42200,-40200,"64","65",5000,6800
"7097",147013,"MCKENDREE COLLEGE                                           ","2003-2004",15,"Soccer",292526,364556,-72030,149132,186349,-37217,143394,178207,-34813,"22","24",24887,18046
"5584",191931,"IONA COLLEGE                                                ","2003-2004",8,"Golf",6000,78049,-72049,6000,78049,-72049,0,0,0,"10",".",30723,0
"7079",162654,"GOUCHER COLLEGE                                             ","2003-2004",15,"Soccer",13055,85104,-72049,4426,46386,-41960,8629,38718,-30089,"20","20",12370,17987
"10088",110422,"CALIFORNIA POLYTECHNIC STATE UNIV-SAN LUIS OBISPO           ","2003-2004",18,"Swimming and Diving",3730,75794,-72064,1865,37796,-35931,1865,37998,-36133,"22","24",6887,7439
"8220",164216,"WASHINGTON COLLEGE                                          ","2003-2004",15,"Soccer",3728,75853,-72125,2703,41585,-38882,1025,34268,-33243,"23","17",12857,7218
"6136",232265,"HAMPTON UNIVERSITY                                          ","2003-2004",8,"Golf",86366,158495,-72129,41331,80312,-38981,45035,78183,-33148,"6","6",10828,12379
"8371",186371,"RUTGERS UNIVERSITY-CAMDEN                                   ","2003-2004",15,"Soccer",2808,74978,-72170,2039,39293,-37254,769,35685,-34916,"26","21",24564,21641
"12014",204936,"OTTERBEIN COLLEGE                                           ","2003-2004",24,"Track and Field, Outdoor",48269,120444,-72175,27031,62253,-35222,21238,58191,-36953,"50","22",26801,21058
"9271",137209,"SEMINOLE COMMUNITY COLLEGE                                  ","2003-2004",16,"Softball",89484,161766,-72282,0,0,0,89484,161766,-72282,".","23",0,43112
"13138",240657,"NORTHWEST COMMUNITY COLLEGE                                 ","2003-2004",26,"Volleyball",4604,76896,-72292,0,0,0,4604,76896,-72292,".","10",0,17037
"17235",209250,"MT HOOD COMMUNITY COLLEGE                                   ","2003-2004",39,"Total Participants",34454,106768,-72314,15449,44369,-28920,19005,62399,-43394,"60","60",61507,77816
"2425",217998,"ERSKINE COLLEGE AND SEMINARY                                ","2003-2004",2,"Basketball",40500,112842,-72342,22000,72532,-50532,18500,40310,-21810,"19","14",24032,18800
"2565",152637,"VINCENNES UNIVERSITY                                        ","2003-2004",2,"Basketball",123315,195699,-72384,79038,128367,-49329,44277,67332,-23055,"11","11",76593,43862
"12035",155973,"TABOR COLLEGE                                               ","2003-2004",24,"Track and Field, Outdoor",5200,77690,-72490,3100,43530,-40430,2100,34160,-32060,"22","16",3696,2688
"11242",152600,"VALPARAISO UNIVERSITY                                       ","2003-2004",22,"Tennis",95351,167868,-72517,49536,96609,-47073,45815,71259,-25444,"8","8",8125,5735
"1754",102429,"BEVILL STATE COMMUNITY COLLEGE                              ","2003-2004",2,"Basketball",227372,299931,-72559,193791,226334,-32543,33581,73597,-40016,"28","14",32886,18136
"1506",130943,"UNIVERSITY OF DELAWARE                                      ","2003-2004",1,"Baseball",480125,552732,-72607,480125,552732,-72607,0,0,0,"29",".",131477,0
"1299",206923,"CARL ALBERT STATE COLLEGE                                   ","2003-2004",1,"Baseball",695,73315,-72620,695,73315,-72620,0,0,0,"28",".",30634,0
"726",122205,"SADDLEBACK COLLEGE                                          ","2003-2004",1,"Baseball",45371,118000,-72629,45371,118000,-72629,0,0,0,"33",".",16137,0
"16751",213783,"MANSFIELD UNIVERSITY OF PENNSYLVANIA                        ","2003-2004",39,"Total Participants",629370,702382,-73012,239742,285347,-45605,389628,417035,-27407,"258","180",184222,142486
"861",110583,"CALIFORNIA STATE UNIVERSITY-LONG BEACH                      ","2003-2004",1,"Baseball",758719,831798,-73079,758719,831798,-73079,0,0,0,"36",".",164262,0
"7311",154518,"WALDORF COLLEGE                                             ","2003-2004",15,"Soccer",14500,87600,-73100,8000,49600,-41600,6500,38000,-31500,"16","17",8000,6500
"12900",187897,"NEW MEXICO HIGHLANDS UNIVERSITY                             ","2003-2004",25,"Track and Field, X-Country",1090,74320,-73230,545,38335,-37790,545,35985,-35440,"9","7",7340,7340
"777",155973,"TABOR COLLEGE                                               ","2003-2004",1,"Baseball",11276,84527,-73251,11276,84527,-73251,0,0,0,"27",".",17145,0
"16344",219082,"DAKOTA STATE UNIVERSITY                                     ","2003-2004",39,"Total Participants",248927,322227,-73300,110045,155712,-45667,138882,166515,-27633,"167","88",121300,70588
"7375",147679,"NORTH PARK UNIVERSITY                                       ","2003-2004",15,"Soccer",31595,104926,-73331,15611,60238,-44627,15984,44688,-28704,"24","20",15361,11722
"6676",185262,"KEAN UNIVERSITY                                             ","2003-2004",11,"Lacrosse",2,73417,-73415,1,25480,-25479,1,47937,-47936,"34","20",17239,17175
"3862",201654,"CEDARVILLE UNIVERSITY                                       ","2003-2004",3,"All Track Combined",267607,341023,-73416,118107,160318,-42211,149500,180705,-31205,"33","32",47945,40652
"497",106412,"UNIVERSITY OF ARKANSAS AT PINE BLUFF                        ","2003-2004",1,"Baseball",1,73484,-73483,1,73484,-73483,0,0,0,"21",".",31831,0
"7103",156408,"CENTRE COLLEGE                                              ","2003-2004",15,"Soccer",10914,84398,-73484,10714,46827,-36113,200,37571,-37371,"29","21",35994,22258
"1039",133650,"FLORIDA AGRICULTURAL AND MECHANICAL UNIVERSITY              ","2003-2004",1,"Baseball",2000,75516,-73516,2000,75516,-73516,0,0,0,"35",".",71316,0
"9269",135188,"LAKE-SUMTER COMMUNITY COLLEGE                               ","2003-2004",16,"Softball",738,74379,-73641,0,0,0,738,74379,-73641,".","19",0,63879
"13103",154004,"MORNINGSIDE COLLEGE                                         ","2003-2004",26,"Volleyball",22054,95729,-73675,0,0,0,22054,95729,-73675,".","16",0,20315
"16452",227401,"PARIS JUNIOR COLLEGE                                        ","2003-2004",39,"Total Participants",3,73735,-73732,2,41920,-41918,1,31815,-31814,"52","31",34186,20218
"9941",106412,"UNIVERSITY OF ARKANSAS AT PINE BLUFF                        ","2003-2004",16,"Softball",1,73833,-73832,0,0,0,1,73833,-73832,".","15",0,25503
"10217",184782,"ROWAN UNIVERSITY                                            ","2003-2004",18,"Swimming and Diving",36384,110250,-73866,18192,55125,-36933,18192,55125,-36933,"28","32",16255,16255
"140",140483,"MIDDLE GEORGIA COLLEGE                                      ","2003-2004",1,"Baseball",32213,106098,-73885,32213,106098,-73885,0,0,0,"26",".",65128,0
"9053",230603,"SOUTHERN UTAH UNIVERSITY                                    ","2003-2004",16,"Softball",120184,194157,-73973,0,0,0,120184,194157,-73973,".","15",0,68665
"4110",129215,"EASTERN CONNECTICUT STATE UNIVERSITY                        ","2003-2004",6,"Field hocky",1140,75152,-74012,0,0,0,1140,75152,-74012,".","18",0,13909
"13415",237969,"WEST VIRGINIA WESLEYAN COLLEGE                              ","2003-2004",26,"Volleyball",53664,127764,-74100,0,0,0,53664,127764,-74100,".","13",0,21007
"7486",226833,"MIDWESTERN STATE UNIVERSITY                                 ","2003-2004",15,"Soccer",7121,81471,-74350,2997,34361,-31364,4124,47110,-42986,"30","24",34000,34000
"2427",153737,"KIRKWOOD COMMUNITY COLLEGE                                  ","2003-2004",2,"Basketball",25200,99560,-74360,11500,52110,-40610,13700,47450,-33750,"14","14",16260,16840
"2286",226587,"MCMURRY UNIVERSITY                                          ","2003-2004",2,"Basketball",134276,208637,-74361,72597,103278,-30681,61679,105359,-43680,"17","20",33333,41160
"2077",228149,"ST MARYS UNIVERSITY                                         ","2003-2004",2,"Basketball",118835,193222,-74387,71559,122596,-51037,47276,70626,-23350,"20","13",83496,41489
"928",203599,"LAKELAND COMMUNITY COLLEGE                                  ","2003-2004",1,"Baseball",8978,83382,-74404,8978,83382,-74404,0,0,0,"25",".",43325,0
"1570",233897,"THE UNIVERSITY OF VIRGINIA'S COLLEGE AT WISE                ","2003-2004",1,"Baseball",47147,121554,-74407,47147,121554,-74407,0,0,0,"66",".",41701,0
"14429",155061,"FORT HAYS STATE UNIVERSITY                                  ","2003-2004",26,"Volleyball",68497,142942,-74445,0,0,0,68497,142942,-74445,".","14",0,25745
"14033",220215,"FREED-HARDEMAN UNIVERSITY                                   ","2003-2004",26,"Volleyball",10000,84471,-74471,0,0,0,10000,84471,-74471,".","13",0,9194
"13143",230092,"COLLEGE OF EASTERN UTAH                                     ","2003-2004",26,"Volleyball",1000,75503,-74503,0,0,0,1000,75503,-74503,"0","14",0,21000
"12973",212009,"DICKINSON COLLEGE                                           ","2003-2004",25,"Track and Field, X-Country",24224,98736,-74512,12112,49368,-37256,12112,49368,-37256,"41","33",15112,15112
"1414",135188,"LAKE-SUMTER COMMUNITY COLLEGE                               ","2003-2004",1,"Baseball",738,75465,-74727,738,75465,-74727,0,0,0,"20",".",64965,0
"6607",183062,"KEENE STATE COLLEGE                                         ","2003-2004",11,"Lacrosse",52964,127836,-74872,29300,73761,-44461,23664,54075,-30411,"32","20",47062,30465
"11994",122205,"SADDLEBACK COLLEGE                                          ","2003-2004",24,"Track and Field, Outdoor",31115,106000,-74885,17139,55000,-37861,13976,51000,-37024,"26","16",14222,11520
"14586",163453,"MORGAN STATE UNIVERSITY                                     ","2003-2004",26,"Volleyball",238564,313528,-74964,0,0,0,238564,313528,-74964,".","12",0,52769
"1392",186371,"RUTGERS UNIVERSITY-CAMDEN                                   ","2003-2004",1,"Baseball",48008,123057,-75049,48008,123057,-75049,0,0,0,"40",".",77431,0
"7173",126580,"UNIVERSITY OF COLORADO AT COLORADO SPRINGS                  ","2003-2004",15,"Soccer",51985,127076,-75091,51985,127076,-75091,0,0,0,"26",".",41216,0
"9977",181011,"DANA COLLEGE                                                ","2003-2004",16,"Softball",13000,88100,-75100,0,0,0,13000,88100,-75100,".","23",0,23345
"1321",188182,"COLLEGE OF THE SOUTHWEST                                    ","2003-2004",1,"Baseball",1,75125,-75124,1,75125,-75124,0,0,0,"24",".",41115,0
"1381",220400,"JACKSON STATE COMMUNITY COLLEGE                             ","2003-2004",1,"Baseball",8759,83965,-75206,8759,83965,-75206,0,0,0,"25",".",11922,0
"9439",181215,"UNIVERSITY OF NEBRASKA AT KEARNEY                           ","2003-2004",16,"Softball",13057,88450,-75393,0,0,0,13057,88450,-75393,".","17",0,36750
"11828",196246,"SUNY COLLEGE AT PLATTSBURGH                                 ","2003-2004",23,"Track and Field, Indoor",1540,76988,-75448,305,38494,-38189,1235,38494,-37259,"67","51",22336,22336
"5159",138983,"AUGUSTA STATE UNIVERSITY                                    ","2003-2004",8,"Golf",201591,277194,-75603,51170,141667,-90497,150421,135527,14894,"10","9",30800,25458
"531",229832,"WESTERN TEXAS COLLEGE                                       ","2003-2004",1,"Baseball",76812,152442,-75630,76812,152442,-75630,0,0,0,"46",".",114347,0
"10251",231624,"COLLEGE OF WILLIAM AND MARY                                 ","2003-2004",18,"Swimming and Diving",93294,168924,-75630,46647,84462,-37815,46647,84462,-37815,"25","30",41700,41700
"849",174233,"UNIVERSITY OF MINNESOTA-DULUTH                              ","2003-2004",1,"Baseball",37905,113578,-75673,37905,113578,-75673,0,0,0,"35",".",32501,0
"8619",198808,"LEES-MCRAE COLLEGE                                          ","2003-2004",16,"Softball",19915,95659,-75744,0,0,0,19915,95659,-75744,".","15",0,18944
"15679",153214,"DES MOINES AREA COMMUNITY COLLEGE                           ","2003-2004",39,"Total Participants",8279,84085,-75806,5184,47790,-42606,3095,36295,-33200,"39","25",44840,33535
"1845",143279,"BLACK HAWK COLLEGE                                          ","2003-2004",2,"Basketball",106817,182671,-75854,65420,104438,-39018,41397,78233,-36836,"24","21",39874,37691
"9483",217721,"BENEDICT COLLEGE                                            ","2003-2004",16,"Softball",1,75880,-75879,0,0,0,1,75880,-75879,".","18",0,11335
"12831",207403,"OKLAHOMA BAPTIST UNIVERSITY                                 ","2003-2004",25,"Track and Field, X-Country",8810,84742,-75932,4744,45721,-40977,4066,39021,-34955,"15","14",6764,6162
"10649",131399,"UNIVERSITY OF THE DISTRICT OF COLUMBIA                      ","2003-2004",22,"Tennis",40000,116033,-76033,20000,58888,-38888,20000,57145,-37145,"8","7",8412,8163
"13800",197984,"BELMONT ABBEY COLLEGE                                       ","2003-2004",26,"Volleyball",140,76196,-76056,0,0,0,140,76196,-76056,".","12",0,11685
"17000",122180,"SACRAMENTO CITY COLLEGE                                     ","2003-2004",39,"Total Participants",5999,82082,-76083,3392,41743,-38351,2607,40339,-37732,"202","150",40520,27179
"12902",141264,"VALDOSTA STATE UNIVERSITY                                   ","2003-2004",25,"Track and Field, X-Country",7636,83723,-76087,6636,43761,-37125,1000,39962,-38962,"11","9",6387,6850
"1527",213376,"LACKAWANNA COLLEGE                                          ","2003-2004",1,"Baseball",170,76258,-76088,170,76258,-76088,0,0,0,"18",".",59821,0
"3878",163453,"MORGAN STATE UNIVERSITY                                     ","2003-2004",3,"All Track Combined",578062,654164,-76102,247195,317421,-70226,330867,336743,-5876,"26","24",53902,53902
"2125",179894,"WEBSTER UNIVERSITY                                          ","2003-2004",2,"Basketball",16637,92934,-76297,7007,44426,-37419,9630,48508,-38878,"23","17",24652,21204
"1075",228705,"TEXAS A &amp; M UNIVERSITY-KINGSVILLE                           ","2003-2004",1,"Baseball",44308,120671,-76363,44308,120671,-76363,0,0,0,"28",".",71209,0
"8247",148654,"UNIVERSITY OF ILLINOIS AT SPRINGFIELD                       ","2003-2004",15,"Soccer",159099,235477,-76378,159099,235477,-76378,0,0,0,"22",".",41188,0
"15030",181394,"UNIVERSITY OF NEBRASKA AT OMAHA                             ","2003-2004",28,"Wrestling",95646,172139,-76493,95646,172139,-76493,0,0,0,"33",".",57322,0
"4503",153108,"CENTRAL COLLEGE                                             ","2003-2004",7,"Football",171590,248096,-76506,171590,248096,-76506,0,0,0,"128",".",82753,0
"3132",200305,"NORTH DAKOTA STATE COLLEGE OF SCIENCE                       ","2003-2004",2,"Basketball",12973,89502,-76529,6528,44018,-37490,6445,45484,-39039,"16","11",32983,31282
"15238",232265,"HAMPTON UNIVERSITY                                          ","2003-2004",33,"Bowling",43943,120514,-76571,0,0,0,43943,120514,-76571,".","8",0,23875
"10562",154004,"MORNINGSIDE COLLEGE                                         ","2003-2004",19,"Swimming",20512,97094,-76582,10256,48547,-38291,10256,48547,-38291,"3","11",14342,14342
"6771",199412,"QUEENS UNIVERSITY OF CHARLOTTE                              ","2003-2004",11,"Lacrosse",247754,324378,-76624,124380,173198,-48818,123374,151180,-27806,"29","17",15656,12530
"10755",232186,"GEORGE MASON UNIVERSITY                                     ","2003-2004",22,"Tennis",58479,135178,-76699,30220,66332,-36112,28259,68846,-40587,"8","11",14693,16311
"17224",232937,"NORFOLK STATE UNIVERSITY                                    ","2003-2004",39,"Total Participants",1533887,1610636,-76749,692715,770807,-78092,841172,839829,1343,"164","115",1814743,950861
"17196",240693,"WESTERN WYOMING COMMUNITY COLLEGE                           ","2003-2004",39,"Total Participants",1094,77993,-76899,313,39518,-39205,781,38475,-37694,"39","27",74913,58492
"6579",184782,"ROWAN UNIVERSITY                                            ","2003-2004",11,"Lacrosse",5250,82160,-76910,0,0,0,5250,82160,-76910,"0","22",0,18262
"14858",232186,"GEORGE MASON UNIVERSITY                                     ","2003-2004",28,"Wrestling",117328,194310,-76982,117328,194310,-76982,0,0,0,"23",".",57492,0
"14238",110565,"CALIFORNIA STATE UNIVERSITY-FULLERTON                       ","2003-2004",26,"Volleyball",271524,348507,-76983,0,0,0,271524,348507,-76983,".","12",0,62463
"4335",112172,"CITRUS COLLEGE                                              ","2003-2004",7,"Football",96916,173941,-77025,96916,173941,-77025,0,0,0,"77",".",26624,0
"14378",180461,"MONTANA STATE UNIVERSITY-BOZEMAN                            ","2003-2004",26,"Volleyball",462532,539684,-77152,0,0,0,462532,539684,-77152,".","12",0,89823
"13201",155025,"EMPORIA STATE UNIVERSITY                                    ","2003-2004",26,"Volleyball",77296,154503,-77207,0,0,0,77296,154503,-77207,".","13",0,24157
"598",195243,"SAINT THOMAS AQUINAS COLLEGE                                ","2003-2004",1,"Baseball",33046,110305,-77259,33046,110305,-77259,0,0,0,"35",".",38825,0
"14740",191931,"IONA COLLEGE                                                ","2003-2004",27,"Water Polo",16357,93691,-77334,9136,43665,-34529,7221,50026,-42805,"20","15",27246,28859
"3661",155140,"HASKELL INDIAN NATIONS UNIVERSITY                           ","2003-2004",3,"All Track Combined",13900,91266,-77366,6950,38610,-31660,6950,52656,-45706,"18","24",6950,6950
"16012",199582,"SAINT AUGUSTINES COLLEGE                                    ","2003-2004",39,"Total Participants",747252,824632,-77380,341403,418170,-76767,405849,406462,-613,"164","88",244846,127100
"4108",184782,"ROWAN UNIVERSITY                                            ","2003-2004",6,"Field hocky",1180,78618,-77438,0,0,0,1180,78618,-77438,".","28",0,22532
"5285",219383,"UNIVERSITY OF SIOUX FALLS                                   ","2003-2004",8,"Golf",1110,78566,-77456,555,43095,-42540,555,35471,-34916,"14","11",4655,4281
"3155",207689,"SAINT GREGORYS UNIVERSITY                                   ","2003-2004",2,"Basketball",330120,407581,-77461,188640,200540,-11900,141480,207041,-65561,"16","12",18740,23700
"4259",110635,"UNIVERSITY OF CALIFORNIA-BERKELEY                           ","2003-2004",6,"Field hocky",301124,378607,-77483,0,0,0,301124,378607,-77483,".","26",0,112209
"9712",219471,"UNIVERSITY OF SOUTH DAKOTA                                  ","2003-2004",16,"Softball",73659,151225,-77566,0,0,0,73659,151225,-77566,".","17",0,50160
"12230",217721,"BENEDICT COLLEGE                                            ","2003-2004",25,"Track and Field, X-Country",2,77624,-77622,1,38812,-38811,1,38812,-38811,"9","11",3787,3787
"5767",230764,"UNIVERSITY OF UTAH                                          ","2003-2004",8,"Golf",46972,124628,-77656,46972,124628,-77656,0,0,0,"10",".",48269,0
"1620",219471,"UNIVERSITY OF SOUTH DAKOTA                                  ","2003-2004",2,"Basketball",511949,589628,-77679,269737,305119,-35382,242212,284509,-42297,"18","16",39816,57756
"8038",215275,"UNIVERSITY OF PITTSBURGH-GREENSBURG                         ","2003-2004",15,"Soccer",616,78347,-77731,591,40507,-39916,25,37840,-37815,"33","20",22011,21200
"6663",206589,"COLLEGE OF WOOSTER                                          ","2003-2004",11,"Lacrosse",1320,79090,-77770,860,43660,-42800,460,35430,-34970,"41","21",34496,25360
"3275",155627,"OTTAWA UNIVERSITY                                           ","2003-2004",2,"Basketball",88334,166123,-77789,42723,88191,-45468,45611,77932,-32321,"17","15",29815,28348
"11300",190512,"CUNY BERNARD M BARUCH COLLEGE                               ","2003-2004",22,"Tennis",13000,90800,-77800,6500,82500,-76000,6500,8300,-1800,"9","11",4300,3300
"9586",185262,"KEAN UNIVERSITY                                             ","2003-2004",16,"Softball",1,77826,-77825,0,0,0,1,77826,-77825,".","16",0,31050
"14334",142328,"LEWIS-CLARK STATE COLLEGE                                   ","2003-2004",26,"Volleyball",84136,161994,-77858,0,0,0,84136,161994,-77858,".","14",0,35651
"4319",175078,"SOUTHWEST MINNESOTA STATE UNIVERSITY                        ","2003-2004",7,"Football",17663,95573,-77910,17663,95573,-77910,0,0,0,"91",".",68525,0
"4248",196176,"SUNY COLLEGE AT NEW PALTZ                                   ","2003-2004",6,"Field hocky",45,77977,-77932,0,0,0,45,77977,-77932,".","14",0,19747
"12839",208822,"GEORGE FOX UNIVERSITY                                       ","2003-2004",25,"Track and Field, X-Country",5038,82980,-77942,4888,44707,-39819,150,38273,-38123,"13","14",23055,18393
"12121",208822,"GEORGE FOX UNIVERSITY                                       ","2003-2004",24,"Track and Field, Outdoor",5038,82982,-77944,4888,44708,-39820,150,38274,-38124,"39","28",23056,18394
"6243",120883,"UNIVERSITY OF THE PACIFIC                                   ","2003-2004",8,"Golf",142431,220410,-77979,142431,220410,-77979,0,0,0,"9",".",43484,0
"4683",131283,"CATHOLIC UNIVERSITY OF AMERICA                              ","2003-2004",7,"Football",11000,89000,-78000,11000,89000,-78000,0,0,0,"58",".",59000,0
"8335",228246,"SOUTHERN METHODIST UNIVERSITY                               ","2003-2004",15,"Soccer",1489951,1567976,-78025,817296,858093,-40797,672655,709883,-37228,"26","23",100920,65250
"14008",102094,"UNIVERSITY OF SOUTH ALABAMA                                 ","2003-2004",26,"Volleyball",210547,288573,-78026,0,0,0,210547,288573,-78026,".","10",0,36761
"12393",221351,"RHODES COLLEGE                                              ","2003-2004",25,"Track and Field, X-Country",54650,132723,-78073,27325,66699,-39374,27325,66024,-38699,"85","58",24150,15850
"5864",180179,"MONTANA STATE UNIVERSITY-BILLINGS                           ","2003-2004",8,"Golf",5232,83325,-78093,2512,48156,-45644,2720,35169,-32449,"9","6",18549,16803
"3971",154925,"COFFEYVILLE COMMUNITY COLLEGE &amp; AREA TECH SCHOOL            ","2003-2004",3,"All Track Combined",2120,80222,-78102,1696,64178,-62482,424,16044,-15620,"20","5",13741,3434
"16167",115755,"HUMBOLDT STATE UNIVERSITY                                   ","2003-2004",39,"Total Participants",898813,976932,-78119,216260,232901,-16641,682553,744031,-61478,"151","155",289945,308624
"16490",434672,"THE COMMUNITY COLLEGE OF BALTIMORE COUNTY                   ","2003-2004",39,"Total Participants",219250,297433,-78183,123390,161918,-38528,95860,135515,-39655,"198","111",165610,137870
"885",196176,"SUNY COLLEGE AT NEW PALTZ                                   ","2003-2004",1,"Baseball",9187,87385,-78198,9187,87385,-78198,0,0,0,"24",".",24402,0
"12853",179159,"SAINT LOUIS UNIVERSITY-MAIN CAMPUS                          ","2003-2004",25,"Track and Field, X-Country",7134,85442,-78308,3567,38878,-35311,3567,46564,-42997,"9","18",9529,9529
"7644",131399,"UNIVERSITY OF THE DISTRICT OF COLUMBIA                      ","2003-2004",15,"Soccer",30000,108380,-78380,30000,108380,-78380,0,0,0,"15",".",9031,0
"14225",227845,"SAINT EDWARD'S UNIVERSITY                                   ","2003-2004",26,"Volleyball",1702,80103,-78401,0,0,0,1702,80103,-78401,".","9",0,31203
"10896",179557,"SOUTHEAST MISSOURI STATE UNIVERSITY                         ","2003-2004",22,"Tennis",1,78429,-78428,0,0,0,1,78429,-78428,".","7",0,14889
"10877",226134,"LAREDO COMMUNITY COLLEGE                                    ","2003-2004",22,"Tennis",9000,87568,-78568,4500,43784,-39284,4500,43784,-39284,"8","8",22855,22854
"16773",210401,"WILLAMETTE UNIVERSITY                                       ","2003-2004",39,"Total Participants",554561,633161,-78600,229653,268074,-38421,324908,365087,-40179,"306","262",272386,186926
"5819",175342,"ALCORN STATE UNIVERSITY                                     ","2003-2004",8,"Golf",2728,81516,-78788,1302,39803,-38501,1426,41713,-40287,"5","6",7231,7231
"3265",210571,"ALBRIGHT COLLEGE                                            ","2003-2004",2,"Basketball",59858,138697,-78839,44143,83876,-39733,15715,54821,-39106,"25","13",35430,15715
"3484",162928,"JOHNS HOPKINS UNIVERSITY                                    ","2003-2004",2,"Basketball",292960,371935,-78975,144732,187509,-42777,148228,184426,-36198,"14","15",54972,51263
"1501",182670,"DARTMOUTH COLLEGE                                           ","2003-2004",1,"Baseball",201687,280717,-79030,201687,280717,-79030,0,0,0,"29",".",82376,0
"114",101240,"GADSDEN STATE COMMUNITY COLLEGE                             ","2003-2004",1,"Baseball",88291,167413,-79122,88291,167413,-79122,0,0,0,"26",".",51914,0
"1546",177968,"LINDENWOOD UNIVERSITY                                       ","2003-2004",1,"Baseball",31257,110379,-79122,31257,110379,-79122,0,0,0,"66",".",79122,0
"8662",175935,"MERIDIAN COMMUNITY COLLEGE                                  ","2003-2004",16,"Softball",37039,116170,-79131,0,0,0,37039,116170,-79131,".","16",0,43130
"8693",237118,"ALDERSON BROADDUS COLLEGE                                   ","2003-2004",16,"Softball",20633,99809,-79176,0,0,0,20633,99809,-79176,".","16",0,16630
"6656",216597,"VILLANOVA UNIVERSITY                                        ","2003-2004",11,"Lacrosse",48929,128120,-79191,45194,61933,-16739,3735,66187,-62452,"46","32",43230,34564
"2720",157809,"THOMAS MORE COLLEGE                                         ","2003-2004",2,"Basketball",93111,172365,-79254,45922,100912,-54990,47189,71453,-24264,"25","17",17075,14093
"7270",174844,"SAINT OLAF COLLEGE                                          ","2003-2004",15,"Soccer",5718,85026,-79308,5263,48282,-43019,455,36744,-36289,"45","46",17127,11762
"4672",200305,"NORTH DAKOTA STATE COLLEGE OF SCIENCE                       ","2003-2004",7,"Football",3415,82751,-79336,3415,82751,-79336,0,0,0,"66",".",47027,0
"14506",204617,"OHIO DOMINICAN UNIVERSITY                                   ","2003-2004",26,"Volleyball",550,79888,-79338,0,0,0,550,79888,-79338,".","12",0,14203
"1125",229799,"WEATHERFORD COLLEGE                                         ","2003-2004",1,"Baseball",30735,110116,-79381,30735,110116,-79381,0,0,0,"26",".",62331,0
"6479",164465,"AMHERST COLLEGE                                             ","2003-2004",10,"Ice Hockey",204539,283954,-79415,108873,148479,-39606,95666,135475,-39809,"24","22",40208,37398
"12146",217721,"BENEDICT COLLEGE                                            ","2003-2004",24,"Track and Field, Outdoor",2,79526,-79524,1,39763,-39762,1,39763,-39762,"15","30",7574,7574
"12428",156365,"CAMPBELLSVILLE UNIVERSITY                                   ","2003-2004",25,"Track and Field, X-Country",19134,98784,-79650,9358,54158,-44800,9776,44626,-34850,"22","9",7243,7483
"286",198969,"METHODIST COLLEGE                                           ","2003-2004",1,"Baseball",34904,114602,-79698,34904,114602,-79698,0,0,0,"47",".",38157,0
"3380",113573,"COLLEGE OF THE DESERT                                       ","2003-2004",2,"Basketball",14027,93734,-79707,7207,47127,-39920,6820,46607,-39787,"14","13",15806,15301
"10814",213543,"LEHIGH UNIVERSITY                                           ","2003-2004",22,"Tennis",93150,172950,-79800,43180,81936,-38756,49970,91014,-41044,"12","12",18626,18234
"17136",112172,"CITRUS COLLEGE                                              ","2003-2004",39,"Total Participants",173707,253549,-79842,98567,126804,-28237,75140,126745,-51605,"195","92",81306,54048
"4903",210146,"SOUTHERN OREGON UNIVERSITY                                  ","2003-2004",7,"Football",194000,274000,-80000,194000,274000,-80000,0,0,0,"110",".",175245,0
"9454",154925,"COFFEYVILLE COMMUNITY COLLEGE &amp; AREA TECH SCHOOL            ","2003-2004",16,"Softball",9000,89009,-80009,0,0,0,9000,89009,-80009,".","14",0,14804
"15793",220057,"DYERSBURG STATE COMMUNITY COLLEGE                           ","2003-2004",39,"Total Participants",23493,103511,-80018,12364,53053,-40689,11129,50458,-39329,"41","27",43326,29059
"13704",230038,"BRIGHAM YOUNG UNIVERSITY                                    ","2003-2004",26,"Volleyball",1043985,1124034,-80049,499506,513821,-14315,544479,610213,-65734,"27","22",131550,119321
"16423",206604,"WRIGHT STATE UNIVERSITY-MAIN CAMPUS                         ","2003-2004",39,"Total Participants",3065854,3145943,-80089,1340188,1415141,-74953,1725666,1730802,-5136,"128","181",619533,438903
"14777",153825,"LORAS COLLEGE                                               ","2003-2004",28,"Wrestling",9814,89955,-80141,9814,89955,-80141,0,0,0,"31",".",16181,0
"17167",202356,"CUYAHOGA COMMUNITY COLLEGE DISTRICT                         ","2003-2004",39,"Total Participants",247989,328166,-80177,97057,132830,-35773,150932,195336,-44404,"66","45",124075,120887
"8055",234827,"CENTRAL WASHINGTON UNIVERSITY                               ","2003-2004",15,"Soccer",10851,91054,-80203,0,0,0,10851,91054,-80203,".","30",0,40618
"17209",164720,"BECKER COLLEGE                                              ","2003-2004",39,"Total Participants",53913,134195,-80282,31015,67281,-36266,22898,66914,-44016,"67","101",52276,56119
"11795",217721,"BENEDICT COLLEGE                                            ","2003-2004",22,"Tennis",2,80324,-80322,1,40162,-40161,1,40162,-40161,"8","8",5162,5162
"6592",126678,"COLORADO COLLEGE                                            ","2003-2004",11,"Lacrosse",195048,275391,-80343,112319,150632,-38313,82729,124759,-42030,"31","20",72009,49084
"560",107071,"HENDERSON STATE UNIVERSITY                                  ","2003-2004",1,"Baseball",53732,134166,-80434,53732,134166,-80434,0,0,0,"42",".",35161,0
"13052",228705,"TEXAS A &amp; M UNIVERSITY-KINGSVILLE                           ","2003-2004",26,"Volleyball",12918,93380,-80462,0,0,0,12918,93380,-80462,".","12",0,72196
"9895",130776,"WESTERN CONNECTICUT STATE UNIVERSITY                        ","2003-2004",16,"Softball",87744,168219,-80475,0,0,0,87744,168219,-80475,".","21",0,33474
"1246",138293,"WEBBER INTERNATIONAL UNIVERSITY                             ","2003-2004",1,"Baseball",117997,198510,-80513,117997,198510,-80513,0,0,0,"32",".",25531,0
"13496",101161,"JAMES H FAULKNER STATE COMMUNITY COLLEGE                    ","2003-2004",26,"Volleyball",16865,97384,-80519,0,0,0,16865,97384,-80519,"0","18",0,20184
"10533",229018,"THE UNIVERSITY OF TEXAS OF THE PERMIAN BASIN                ","2003-2004",19,"Swimming",2,80564,-80562,1,40282,-40281,1,40282,-40281,"10","11",20800,20800
"10630",198215,"CATAWBA COLLEGE                                             ","2003-2004",19,"Swimming",14310,94876,-80566,0,0,0,14310,94876,-80566,".","7",0,13210
"15321",225520,"HOWARD COUNTY JUNIOR COLLEGE DISTRICT                       ","2003-2004",35,"Rodeo",26297,107146,-80849,20249,82502,-62253,6048,24644,-18596,"28","8",33669,10057
"12737",213598,"LINCOLN UNIVERSITY                                          ","2003-2004",25,"Track and Field, X-Country",39000,119884,-80884,20000,62192,-42192,19000,57692,-38692,"12","12",3200,27500
"15469",200341,"WILLISTON STATE COLLEGE                                     ","2003-2004",39,"Total Participants",30203,111133,-80930,20697,61390,-40693,9506,49743,-40237,"38","23",49394,43003
"15114",168342,"WILLIAMS COLLEGE                                            ","2003-2004",29,"Other Sports",101445,182389,-80944,101445,182389,-80944,0,0,0,"32",".",115004,0
"13394",168342,"WILLIAMS COLLEGE                                            ","2003-2004",26,"Volleyball",21900,102868,-80968,0,0,0,21900,102868,-80968,".","12",0,23087
"5043",123484,"COLLEGE OF THE SISKIYOUS                                    ","2003-2004",7,"Football",71508,152508,-81000,71508,152508,-81000,0,0,0,"86",".",64500,0
"5898",179557,"SOUTHEAST MISSOURI STATE UNIVERSITY                         ","2003-2004",8,"Golf",1235,82321,-81086,1235,82321,-81086,0,0,0,"12",".",26191,0
"17339",120971,"PALOMAR COLLEGE                                             ","2003-2004",39,"Total Participants",107696,188810,-81114,68838,111592,-42754,38858,77218,-38360,"230","105",93445,47315
"1778",200156,"JAMESTOWN COLLEGE                                           ","2003-2004",2,"Basketball",157116,238239,-81123,105307,151275,-45968,51809,86964,-35155,"15","15",26617,21264
"14882",128391,"WESTERN STATE COLLEGE OF COLORADO                           ","2003-2004",28,"Wrestling",319115,400257,-81142,319115,400257,-81142,0,0,0,"43",".",42338,0
"10348",240453,"UNIVERSITY OF WISCONSIN-MILWAUKEE                           ","2003-2004",18,"Swimming and Diving",498649,579849,-81200,203761,243891,-40130,294888,335958,-41070,"26","39",78240,79414
"4939",232089,"FERRUM COLLEGE                                              ","2003-2004",7,"Football",126778,207997,-81219,126778,207997,-81219,0,0,0,"104",".",71062,0
"12206",162584,"FROSTBURG STATE UNIVERSITY                                  ","2003-2004",25,"Track and Field, X-Country",116273,197551,-81278,58780,116165,-57385,57493,81386,-23893,"47","25",32280,20582
"6429",213507,"LEBANON VALLEY COLLEGE                                      ","2003-2004",10,"Ice Hockey",86002,167312,-81310,86002,167312,-81310,0,0,0,"29",".",86002,0
"16595",130183,"TEIKYO POST UNIVERSITY                                      ","2003-2004",39,"Total Participants",56092,137407,-81315,37589,81273,-43684,18503,56134,-37631,"120","91",93597,67306
"1432",203845,"MARIETTA COLLEGE                                            ","2003-2004",1,"Baseball",65733,147054,-81321,65733,147054,-81321,0,0,0,"32",".",29601,0
"15804",207236,"MURRAY STATE COLLEGE                                        ","2003-2004",39,"Total Participants",34428,115758,-81330,17471,65795,-48324,16957,49963,-33006,"43","25",36096,34077
"10029",240277,"UNIVERSITY OF WISCONSIN-GREEN BAY                           ","2003-2004",16,"Softball",98841,180195,-81354,0,0,0,98841,180195,-81354,".","20",0,55701
"1447",161253,"UNIVERSITY OF MAINE                                         ","2003-2004",1,"Baseball",415008,496367,-81359,415008,496367,-81359,0,0,0,"28",".",94188,0
"3756",110565,"CALIFORNIA STATE UNIVERSITY-FULLERTON                       ","2003-2004",3,"All Track Combined",347323,428701,-81378,157565,202799,-45234,189758,225902,-36144,"36","63",45130,58060
"3628",222178,"ABILENE CHRISTIAN UNIVERSITY                                ","2003-2004",3,"All Track Combined",734939,816394,-81455,367546,414260,-46714,367393,402134,-34741,"60","65",57554,66980
"3279",122205,"SADDLEBACK COLLEGE                                          ","2003-2004",2,"Basketball",32487,114000,-81513,16264,83000,-66736,16223,31000,-14777,"16","14",15712,15666
"772",178615,"TRUMAN STATE UNIVERSITY                                     ","2003-2004",1,"Baseball",3885,85544,-81659,3885,85544,-81659,0,0,0,"29",".",29469,0
"8323",226587,"MCMURRY UNIVERSITY                                          ","2003-2004",15,"Soccer",75224,156915,-81691,41731,85221,-43490,33493,71694,-38201,"25","20",35719,28188
"13544",219471,"UNIVERSITY OF SOUTH DAKOTA                                  ","2003-2004",26,"Volleyball",71833,153534,-81701,0,0,0,71833,153534,-81701,".","12",0,24037
"9060",181817,"WESTERN NEBRASKA COMMUNITY COLLEGE                          ","2003-2004",16,"Softball",7971,89760,-81789,0,0,0,7971,89760,-81789,".","19",0,38516
"11811",204936,"OTTERBEIN COLLEGE                                           ","2003-2004",23,"Track and Field, Indoor",16089,97880,-81791,9010,49617,-40607,7079,48263,-41184,"52","39",8933,7019
"464",226587,"MCMURRY UNIVERSITY                                          ","2003-2004",1,"Baseball",120165,202023,-81858,120165,202023,-81858,0,0,0,"54",".",63543,0
"4010",190415,"CORNELL UNIVERSITY-ENDOWED COLLEGES                         ","2003-2004",5,"Fencing",17225,99084,-81859,0,0,0,17225,99084,-81859,".","18",0,30886
"12083",238078,"WHEELING JESUIT UNIVERSITY                                  ","2003-2004",24,"Track and Field, Outdoor",1000,82922,-81922,500,42646,-42146,500,40276,-39776,"18","17",21614,20413
"9624",169716,"UNIVERSITY OF DETROIT MERCY                                 ","2003-2004",16,"Softball",381263,463186,-81923,0,0,0,381263,463186,-81923,".","17",0,58487
"2338",117052,"REEDLEY COLLEGE                                             ","2003-2004",2,"Basketball",38713,120700,-81987,14487,63301,-48814,24226,57399,-33173,"13","14",8630,18710
"252",102094,"UNIVERSITY OF SOUTH ALABAMA                                 ","2003-2004",1,"Baseball",561647,643740,-82093,561647,643740,-82093,0,0,0,"40",".",113524,0
"11130",213385,"LAFAYETTE COLLEGE                                           ","2003-2004",22,"Tennis",54882,136984,-82102,30668,42288,-11620,24214,94696,-70482,"10","9",8332,7354
"12563",163338,"UNIVERSITY OF MARYLAND-EASTERN SHORE                        ","2003-2004",25,"Track and Field, X-Country",384424,466561,-82137,219250,219067,183,165174,247494,-82320,"47","52",38508,50745
"16123",216287,"SWARTHMORE COLLEGE                                          ","2003-2004",39,"Total Participants",201230,283453,-82223,86380,123548,-37168,114850,159905,-45055,"211","253",141394,183970
"6816",128771,"CENTRAL CONNECTICUT STATE UNIVERSITY                        ","2003-2004",11,"Lacrosse",2370,84832,-82462,0,0,0,2370,84832,-82462,".","18",0,15823
"11081",240277,"UNIVERSITY OF WISCONSIN-GREEN BAY                           ","2003-2004",22,"Tennis",99579,182080,-82501,61609,99928,-38319,37970,82152,-44182,"7","6",22664,28322
"6662",198613,"GUILFORD COLLEGE                                            ","2003-2004",11,"Lacrosse",59308,141876,-82568,40600,81485,-40885,18708,60391,-41683,"19","16",16244,7505
"4147",213543,"LEHIGH UNIVERSITY                                           ","2003-2004",6,"Field hocky",159585,242177,-82592,0,0,0,159585,242177,-82592,".","26",0,36507
"11165",178615,"TRUMAN STATE UNIVERSITY                                     ","2003-2004",22,"Tennis",3725,86456,-82731,2782,36245,-33463,943,50211,-49268,"10","10",9071,10284
"16006",162007,"BOWIE STATE UNIVERSITY                                      ","2003-2004",39,"Total Participants",172720,255477,-82757,46076,78296,-32220,126644,177181,-50537,"97","62",207562,150395
"1737",168254,"WESTERN NEW ENGLAND COLLEGE                                 ","2003-2004",2,"Basketball",19601,102380,-82779,10559,53186,-42627,9042,49194,-40152,"13","13",15890,14390
"8344",176947,"CENTRAL METHODIST COLLEGE                                   ","2003-2004",15,"Soccer",17927,100777,-82850,7584,47784,-40200,10343,52993,-42650,"22","20",7584,10343
"11858",213598,"LINCOLN UNIVERSITY                                          ","2003-2004",23,"Track and Field, Indoor",37000,119884,-82884,19000,62192,-43192,18000,57692,-39692,"35","20",3200,27500
"12122",213598,"LINCOLN UNIVERSITY                                          ","2003-2004",24,"Track and Field, Outdoor",37000,119884,-82884,19000,62192,-43192,18000,57692,-39692,"35","20",3200,27500
"14463",130943,"UNIVERSITY OF DELAWARE                                      ","2003-2004",26,"Volleyball",462719,545712,-82993,0,0,0,462719,545712,-82993,".","17",0,66025
"3538",102429,"BEVILL STATE COMMUNITY COLLEGE                              ","2003-2004",3,"All Track Combined",29996,112993,-82997,0,0,0,29996,112993,-82997,".","60",0,14826
"7894",198899,"MARS HILL COLLEGE                                           ","2003-2004",15,"Soccer",94389,177390,-83001,46391,99540,-53149,47998,77850,-29852,"20","15",19997,17239
"16638",240107,"VITERBO UNIVERSITY                                          ","2003-2004",39,"Total Participants",164588,247630,-83042,81562,116200,-34638,83026,131430,-48404,"65","61",93847,82411
"14357",161253,"UNIVERSITY OF MAINE                                         ","2003-2004",26,"Volleyball",278255,361303,-83048,0,0,0,278255,361303,-83048,".","13",0,60219
"6966",237011,"WESTERN WASHINGTON UNIVERSITY                               ","2003-2004",13,"Rowing",39983,123063,-83080,0,0,0,39983,123063,-83080,".","71",0,38729
"1847",155858,"SEWARD COUNTY COMMUNITY COLLEGE                             ","2003-2004",2,"Basketball",208538,291642,-83104,99843,144645,-44802,108695,146997,-38302,"15","12",20525,13431
"146",219471,"UNIVERSITY OF SOUTH DAKOTA                                  ","2003-2004",1,"Baseball",58547,141731,-83184,58547,141731,-83184,0,0,0,"31",".",56812,0
"5230",217721,"BENEDICT COLLEGE                                            ","2003-2004",8,"Golf",2,83186,-83184,1,41593,-41592,1,41593,-41592,"7","5",6593,6593
"13020",185262,"KEAN UNIVERSITY                                             ","2003-2004",26,"Volleyball",1,83299,-83298,0,0,0,1,83299,-83298,".","15",0,19275
"2625",211644,"CLARION UNIVERSITY OF PENNSYLVANIA                          ","2003-2004",2,"Basketball",396963,480414,-83451,206632,247402,-40770,190331,233012,-42681,"16","11",28588,28616
"1236",200332,"NORTH DAKOTA STATE UNIVERSITY-MAIN CAMPUS                   ","2003-2004",1,"Baseball",64304,147784,-83480,64304,147784,-83480,0,0,0,"30",".",75095,0
"14854",181215,"UNIVERSITY OF NEBRASKA AT KEARNEY                           ","2003-2004",28,"Wrestling",77867,161358,-83491,77867,161358,-83491,0,0,0,"36",".",19656,0
"3910",187903,"NEW MEXICO JUNIOR COLLEGE                                   ","2003-2004",3,"All Track Combined",100,83596,-83496,0,0,0,100,83596,-83496,".","12",0,21825
"14673",163286,"UNIVERSITY OF MARYLAND-COLLEGE PARK                         ","2003-2004",27,"Water Polo",0,83511,-83511,0,0,0,0,83511,-83511,".","41",0,44392
"14276",224226,"DALLAS BAPTIST UNIVERSITY                                   ","2003-2004",26,"Volleyball",87879,171433,-83554,20012,58096,-38084,67867,113337,-45470,"14","11",17128,16110
"4257",130943,"UNIVERSITY OF DELAWARE                                      ","2003-2004",6,"Field hocky",422282,505879,-83597,0,0,0,422282,505879,-83597,".","26",0,70043
"9576",110583,"CALIFORNIA STATE UNIVERSITY-LONG BEACH                      ","2003-2004",16,"Softball",323779,407478,-83699,0,0,0,323779,407478,-83699,".","16",0,81684
"3712",218964,"WINTHROP UNIVERSITY                                         ","2003-2004",3,"All Track Combined",172112,255877,-83765,84441,110955,-26514,87671,144922,-57251,"24","32",36693,44022
"771",234207,"WASHINGTON AND LEE UNIVERSITY                               ","2003-2004",1,"Baseball",3210,87135,-83925,3210,87135,-83925,0,0,0,"27",".",23600,0
"2284",154749,"BETHEL COLLEGE                                              ","2003-2004",2,"Basketball",62863,146803,-83940,27519,73998,-46479,35344,72805,-37461,"17","17",25198,34374
"14483",173328,"CONCORDIA UNIVERSITY-ST PAUL                                ","2003-2004",26,"Volleyball",95627,179643,-84016,0,0,0,95627,179643,-84016,".","15",0,52508
"13028",154697,"BARTON COUNTY COMMUNITY COLLEGE                             ","2003-2004",26,"Volleyball",27250,111309,-84059,0,0,0,27250,111309,-84059,".","12",0,27487
"12292",185590,"MONTCLAIR STATE UNIVERSITY                                  ","2003-2004",25,"Track and Field, X-Country",3530,87637,-84107,2275,44071,-41796,1255,43566,-42311,"33","20",12287,12287
"16914",143279,"BLACK HAWK COLLEGE                                          ","2003-2004",39,"Total Participants",120276,204402,-84126,60080,96515,-36435,60196,107887,-47691,"53","56",76309,85846
"12671",154004,"MORNINGSIDE COLLEGE                                         ","2003-2004",25,"Track and Field, X-Country",20000,104192,-84192,10000,52096,-42096,10000,52096,-42096,"10","6",9326,9326
"6365",110565,"CALIFORNIA STATE UNIVERSITY-FULLERTON                       ","2003-2004",9,"Gymnastics",291492,375687,-84195,0,0,0,291492,375687,-84195,".","16",0,51787
"595",137546,"STETSON UNIVERSITY                                          ","2003-2004",1,"Baseball",904669,988967,-84298,904669,988967,-84298,0,0,0,"35",".",129299,0
"11569",198215,"CATAWBA COLLEGE                                             ","2003-2004",22,"Tennis",27946,112306,-84360,13391,63943,-50552,14555,48363,-33808,"6","8",11041,12205
"2344",229814,"WEST TEXAS A &amp; M UNIVERSITY                                 ","2003-2004",2,"Basketball",257416,341949,-84533,138811,169274,-30463,118605,172675,-54070,"10","11",55641,70135
"9794",101240,"GADSDEN STATE COMMUNITY COLLEGE                             ","2003-2004",16,"Softball",46265,130853,-84588,0,0,0,46265,130853,-84588,".","23",0,32216
"13465",107071,"HENDERSON STATE UNIVERSITY                                  ","2003-2004",26,"Volleyball",56554,141191,-84637,0,0,0,56554,141191,-84637,".","10",0,21958
"5124",144005,"CHICAGO STATE UNIVERSITY                                    ","2003-2004",8,"Golf",78356,163015,-84659,31374,66204,-34830,46982,96811,-49829,"7","5",15834,13982
"14328",143358,"BRADLEY UNIVERSITY                                          ","2003-2004",26,"Volleyball",352798,437705,-84907,0,0,0,352798,437705,-84907,"0","16",0,71140
"14486",163338,"UNIVERSITY OF MARYLAND-EASTERN SHORE                        ","2003-2004",26,"Volleyball",111413,196322,-84909,0,0,0,111413,196322,-84909,".","15",0,25914
"5630",200280,"UNIVERSITY OF NORTH DAKOTA-MAIN CAMPUS                      ","2003-2004",8,"Golf",30749,115742,-84993,16138,87334,-71196,14611,28408,-13797,"17","11",26715,15282
"15671",154998,"DODGE CITY COMMUNITY COLLEGE                                ","2003-2004",39,"Total Participants",270360,355377,-85017,152128,158738,-6610,118232,196639,-78407,"232","86",135233,97170
"14139",122931,"SANTA CLARA UNIVERSITY                                      ","2003-2004",26,"Volleyball",648248,733278,-85030,0,0,0,648248,733278,-85030,".","15",0,53830
"16794",229799,"WEATHERFORD COLLEGE                                         ","2003-2004",39,"Total Participants",43966,129102,-85136,39335,122457,-83122,4631,6645,-2014,"66","14",118739,57520
"9986",227845,"SAINT EDWARD'S UNIVERSITY                                   ","2003-2004",16,"Softball",100,85248,-85148,0,0,0,100,85248,-85148,".","18",0,26248
"1950",156408,"CENTRE COLLEGE                                              ","2003-2004",2,"Basketball",9203,94418,-85215,7268,53057,-45789,1935,41361,-39426,"19","9",38652,30019
"4246",198215,"CATAWBA COLLEGE                                             ","2003-2004",6,"Field hocky",23013,108257,-85244,0,0,0,23013,108257,-85244,".","18",0,21663
"10236",177968,"LINDENWOOD UNIVERSITY                                       ","2003-2004",18,"Swimming and Diving",27025,112313,-85288,13512,60647,-47135,13513,51666,-38153,"42","39",47135,38153
"15771",156295,"BEREA COLLEGE                                               ","2003-2004",39,"Total Participants",94740,180070,-85330,49548,96037,-46489,45192,84033,-38841,"114","117",75348,68484
"1279",230038,"BRIGHAM YOUNG UNIVERSITY                                    ","2003-2004",1,"Baseball",520689,606034,-85345,520689,606034,-85345,0,0,0,"34",".",164733,0
"16462",236230,"PACIFIC LUTHERAN UNIVERSITY                                 ","2003-2004",39,"Total Participants",158100,243452,-85352,73300,115001,-41701,84800,128451,-43651,"270","185",135000,99200
"8204",185590,"MONTCLAIR STATE UNIVERSITY                                  ","2003-2004",15,"Soccer",46931,132298,-85367,32170,87659,-55489,14761,44639,-29878,"28","25",30998,31426
"7884",218964,"WINTHROP UNIVERSITY                                         ","2003-2004",15,"Soccer",285220,370601,-85381,141399,195588,-54189,143821,175013,-31192,"31","25",50951,54218
"13573",138716,"ALBANY STATE UNIVERSITY                                     ","2003-2004",26,"Volleyball",51810,137276,-85466,0,0,0,51810,137276,-85466,".","13",0,45635
"10132",228246,"SOUTHERN METHODIST UNIVERSITY                               ","2003-2004",18,"Swimming and Diving",1628721,1714218,-85497,781997,821539,-39542,846724,892679,-45955,"29","25",64501,52744
"16907",102553,"UNIVERSITY OF ALASKA ANCHORAGE                              ","2003-2004",39,"Total Participants",2148006,2233552,-85546,1400203,1372184,28019,747803,861368,-113565,"86","76",605575,360148
"14916",234207,"WASHINGTON AND LEE UNIVERSITY                               ","2003-2004",28,"Wrestling",3384,88975,-85591,3384,88975,-85591,0,0,0,"8",".",6139,0
"4461",206589,"COLLEGE OF WOOSTER                                          ","2003-2004",7,"Football",5313,90920,-85607,5313,90920,-85607,0,0,0,"109",".",66247,0
"5903",127741,"UNIVERSITY OF NORTHERN COLORADO                             ","2003-2004",8,"Golf",46432,132118,-85686,16000,55907,-39907,30432,76211,-45779,"9","9",21274,17157
"11666",122931,"SANTA CLARA UNIVERSITY                                      ","2003-2004",22,"Tennis",360909,446745,-85836,209323,254926,-45603,151586,191819,-40233,"10","9",49400,21900
"10905",201885,"UNIVERSITY OF CINCINNATI-MAIN CAMPUS                        ","2003-2004",22,"Tennis",205186,291106,-85920,0,0,0,205186,291106,-85920,".","8",0,31432
"11059",175342,"ALCORN STATE UNIVERSITY                                     ","2003-2004",22,"Tennis",3720,89680,-85960,1798,43885,-42087,1922,45795,-43873,"7","8",7475,8697
"3477",215275,"UNIVERSITY OF PITTSBURGH-GREENSBURG                         ","2003-2004",2,"Basketball",7899,94070,-86171,3813,45554,-41741,4086,48516,-44430,"19","11",19703,22660
"16397",219347,"SOUTH DAKOTA SCHOOL OF MINES AND TECHNOLOGY                 ","2003-2004",39,"Total Participants",36500,122880,-86380,15100,40305,-25205,21400,82575,-61175,"113","26",102468,51208
"12024",127741,"UNIVERSITY OF NORTHERN COLORADO                             ","2003-2004",24,"Track and Field, Outdoor",61447,147833,-86386,25528,56836,-31308,35919,90997,-55078,"27","28",18437,18000
"8216",149772,"WESTERN ILLINOIS UNIVERSITY                                 ","2003-2004",15,"Soccer",164975,251369,-86394,98982,148464,-49482,65993,102905,-36912,"31","24",34722,28878
"14006",207740,"SEMINOLE STATE COLLEGE                                      ","2003-2004",26,"Volleyball",26287,112816,-86529,0,0,0,26287,112816,-86529,".","13",0,15724
"4943",220710,"MARYVILLE COLLEGE                                           ","2003-2004",7,"Football",97293,183848,-86555,97293,183848,-86555,0,0,0,"93",".",85343,0
"7851",185828,"NEW JERSEY INSTITUTE OF TECHNOLOGY                          ","2003-2004",15,"Soccer",38761,125345,-86584,21851,68835,-46984,16910,56510,-39600,"23","14",21851,16910
"15662",218733,"SOUTH CAROLINA STATE UNIVERSITY                             ","2003-2004",39,"Total Participants",1485320,1571925,-86605,359810,385999,-26189,1125510,1185926,-60416,"162","106",397412,395425
"4407",207971,"UNIVERSITY OF TULSA                                         ","2003-2004",7,"Football",5027052,5113700,-86648,5027052,5113700,-86648,0,0,0,"91",".",828153,0
"15606",228158,"SOUTH PLAINS COLLEGE                                        ","2003-2004",39,"Total Participants",3000,89676,-86676,1500,46553,-45053,1500,43123,-41623,"69","41",69399,64149
"10188",232186,"GEORGE MASON UNIVERSITY                                     ","2003-2004",18,"Swimming and Diving",262236,348934,-86698,130918,172852,-41934,131318,176082,-44764,"25","28",42161,42506
"1633",165802,"FISHER COLLEGE                                              ","2003-2004",2,"Basketball",1800,88500,-86700,1400,43500,-42100,400,45000,-44600,"11","9",31500,33000
"4046",153658,"UNIVERSITY OF IOWA                                          ","2003-2004",6,"Field hocky",162225,248933,-86708,0,0,0,162225,248933,-86708,".","19",0,85967
"9951",222062,"WALTERS STATE COMMUNITY COLLEGE                             ","2003-2004",16,"Softball",9000,95717,-86717,0,0,0,9000,95717,-86717,".","14",0,25257
"8046",110510,"CALIFORNIA STATE UNIVERSITY-SAN BERNARDINO                  ","2003-2004",15,"Soccer",115050,201802,-86752,57525,100346,-42821,57525,101456,-43931,"29","29",22685,23585
"14975",201104,"ASHLAND UNIVERSITY                                          ","2003-2004",28,"Wrestling",334311,421170,-86859,334311,421170,-86859,0,0,0,"39",".",22800,0
"11557",159993,"UNIVERSITY OF LOUISIANA AT MONROE                           ","2003-2004",22,"Tennis",582,87544,-86962,0,0,0,582,87544,-86962,".","8",0,14699
"3826",194091,"NEW YORK INSTITUTE OF TECHNOLOGY-OLD WESTBURY               ","2003-2004",3,"All Track Combined",447156,534122,-86966,248463,315702,-67239,198693,218420,-19727,"22","20",26998,26998
"8938",196246,"SUNY COLLEGE AT PLATTSBURGH                                 ","2003-2004",16,"Softball",2123,89092,-86969,0,0,0,2123,89092,-86969,".","16",0,33312
"6945",202480,"UNIVERSITY OF DAYTON                                        ","2003-2004",13,"Rowing",1716,88752,-87036,0,0,0,1716,88752,-87036,".","81",0,55037
"11767",197197,"WAGNER COLLEGE                                              ","2003-2004",22,"Tennis",16790,103841,-87051,7430,52881,-45451,9360,50960,-41600,"8","8",4694,6073
"7192",174075,"UNIVERSITY OF MINNESOTA-CROOKSTON                           ","2003-2004",15,"Soccer",8878,96002,-87124,0,0,0,8878,96002,-87124,".","18",0,38174
"5369",138275,"WARNER SOUTHERN COLLEGE                                     ","2003-2004",8,"Golf",741,87969,-87228,516,62964,-62448,225,25005,-24780,"10","4",8248,5305
"3565",161253,"UNIVERSITY OF MAINE                                         ","2003-2004",3,"All Track Combined",453261,540578,-87317,180782,194108,-13326,272479,346470,-73991,"91","108",62456,77567
"13000",218964,"WINTHROP UNIVERSITY                                         ","2003-2004",26,"Volleyball",159206,246675,-87469,0,0,0,159206,246675,-87469,".","11",0,46208
"5062",230171,"DIXIE STATE COLLEGE OF UTAH                                 ","2003-2004",7,"Football",41200,128672,-87472,41200,128672,-87472,0,0,0,"88",".",51930,0
"9807",225520,"HOWARD COUNTY JUNIOR COLLEGE DISTRICT                       ","2003-2004",16,"Softball",2195,89836,-87641,0,0,0,2195,89836,-87641,".","20",0,24117
"14952",142443,"NORTH IDAHO COLLEGE                                         ","2003-2004",28,"Wrestling",94980,182635,-87655,94980,182635,-87655,0,0,0,"34",".",51830,0
"4377",122205,"SADDLEBACK COLLEGE                                          ","2003-2004",7,"Football",27328,115000,-87672,27328,115000,-87672,0,0,0,"94",".",25192,0
"2019",176947,"CENTRAL METHODIST COLLEGE                                   ","2003-2004",2,"Basketball",46350,134142,-87792,22952,72213,-49261,23398,61929,-38531,"26","23",20763,21209
"2390",240693,"WESTERN WYOMING COMMUNITY COLLEGE                           ","2003-2004",2,"Basketball",1944,89760,-87816,1213,53945,-52732,731,35815,-35084,"15","12",42256,27158
"2473",198969,"METHODIST COLLEGE                                           ","2003-2004",2,"Basketball",31405,119240,-87835,14640,65288,-50648,16765,53952,-37187,"25","23",25953,19717
"968",181215,"UNIVERSITY OF NEBRASKA AT KEARNEY                           ","2003-2004",1,"Baseball",20274,108155,-87881,20274,108155,-87881,0,0,0,"38",".",45849,0
"9984",204617,"OHIO DOMINICAN UNIVERSITY                                   ","2003-2004",16,"Softball",16850,104880,-88030,0,0,0,16850,104880,-88030,".","20",0,15202
"15081",243197,"UNIVERSITY OF PUERTO RICO-MAYAGUEZ                          ","2003-2004",29,"Other Sports",9836,97882,-88046,6369,68086,-61717,3467,29796,-26329,"14","39",7074,4565
"2847",185129,"NEW JERSEY CITY UNIVERSITY                                  ","2003-2004",2,"Basketball",34972,123200,-88228,18472,73702,-55230,16500,49498,-32998,"15","13",12675,8391
"6094",110583,"CALIFORNIA STATE UNIVERSITY-LONG BEACH                      ","2003-2004",8,"Golf",271573,359811,-88238,131567,184264,-52697,140006,175547,-35541,"9","10",51908,40549
"4536",179955,"WILLIAM JEWELL COLLEGE                                      ","2003-2004",7,"Football",79719,167999,-88280,79719,167999,-88280,0,0,0,"114",".",59190,0
"12262",228981,"TEXAS LUTHERAN UNIVERSITY                                   ","2003-2004",25,"Track and Field, X-Country",7645,96046,-88401,0,0,0,7645,96046,-88401,".","57",0,49561
"14040",196176,"SUNY COLLEGE AT NEW PALTZ                                   ","2003-2004",26,"Volleyball",4369,92804,-88435,1940,41794,-39854,2429,51010,-48581,"12","14",10000,15939
"1954",175829,"ITAWAMBA COMMUNITY COLLEGE                                  ","2003-2004",2,"Basketball",4284,92740,-88456,2142,52815,-50673,2142,39925,-37783,"15","13",25849,16585
"2831",220312,"HIWASSEE COLLEGE                                            ","2003-2004",2,"Basketball",29400,117879,-88479,14700,61837,-47137,14700,56042,-41342,"15","10",13924,27975
"6596",183044,"UNIVERSITY OF NEW HAMPSHIRE-MAIN CAMPUS                     ","2003-2004",11,"Lacrosse",236817,325362,-88545,0,0,0,236817,325362,-88545,".","30",0,64213
"3895",152600,"VALPARAISO UNIVERSITY                                       ","2003-2004",3,"All Track Combined",222256,310814,-88558,112595,153650,-41055,109661,157164,-47503,"75","49",1299,1299
"8779",154697,"BARTON COUNTY COMMUNITY COLLEGE                             ","2003-2004",16,"Softball",200,88780,-88580,0,0,0,200,88780,-88580,".","19",0,14057
"3790",228246,"SOUTHERN METHODIST UNIVERSITY                               ","2003-2004",3,"All Track Combined",1511313,1599920,-88607,714615,732537,-17922,796698,867383,-70685,"49","47",53154,164275
"5824",220215,"FREED-HARDEMAN UNIVERSITY                                   ","2003-2004",8,"Golf",20000,108865,-88865,10000,53976,-43976,10000,54889,-44889,"8","4",9928,9928
"2924",220057,"DYERSBURG STATE COMMUNITY COLLEGE                           ","2003-2004",2,"Basketball",3648,92530,-88882,2194,53370,-51176,1454,39160,-37706,"14","13",15072,11910
"2131",237011,"WESTERN WASHINGTON UNIVERSITY                               ","2003-2004",2,"Basketball",828631,917530,-88899,494426,586901,-92475,334205,330629,3576,"16","13",85506,76395
"2166",243197,"UNIVERSITY OF PUERTO RICO-MAYAGUEZ                          ","2003-2004",2,"Basketball",17794,106732,-88938,11612,54122,-42510,6182,52610,-46428,"18","20",34663,19035
"16400",165802,"FISHER COLLEGE                                              ","2003-2004",39,"Total Participants",10000,99000,-89000,6000,50500,-44500,4000,48500,-44500,"35","24",70000,69500
"11582",101161,"JAMES H FAULKNER STATE COMMUNITY COLLEGE                    ","2003-2004",22,"Tennis",6020,95063,-89043,3010,43264,-40254,3010,51799,-48789,"7","8",4255,4864
"10739",227881,"SAM HOUSTON STATE UNIVERSITY                                ","2003-2004",22,"Tennis",16448,105497,-89049,0,0,0,16448,105497,-89049,".","10",0,11706
"2566",220941,"CRICHTON COLLEGE                                            ","2003-2004",2,"Basketball",1179,90310,-89131,1179,90310,-89131,0,0,0,"12",".",52652,0
"14823",197197,"WAGNER COLLEGE                                              ","2003-2004",28,"Wrestling",29166,118366,-89200,29166,118366,-89200,0,0,0,"18",".",21993,0
"12722",216667,"WASHINGTON &amp; JEFFERSON COLLEGE                              ","2003-2004",25,"Track and Field, X-Country",54914,144146,-89232,27457,72073,-44616,27457,72073,-44616,"32","26",15119,15119
"11380",148654,"UNIVERSITY OF ILLINOIS AT SPRINGFIELD                       ","2003-2004",22,"Tennis",89679,178933,-89254,43847,80681,-36834,45832,98252,-52420,"6","9",8551,17106
"4996",154059,"NORTH IOWA AREA COMMUNITY COLLEGE                           ","2003-2004",7,"Football",6734,96054,-89320,6734,96054,-89320,0,0,0,"62",".",51355,0
"4854",236328,"UNIVERSITY OF PUGET SOUND                                   ","2003-2004",7,"Football",26658,116035,-89377,26658,116035,-89377,0,0,0,"69",".",84360,0
"6853",228796,"THE UNIVERSITY OF TEXAS AT EL PASO                          ","2003-2004",12,"Rifle",60922,150323,-89401,0,0,0,60922,150323,-89401,".","5",0,28667
"17323",177065,"COLUMBIA COLLEGE                                            ","2003-2004",39,"Total Participants",4824,94304,-89480,1519,17190,-15671,3305,77114,-73809,"33","36",44511,59758
"3600",200156,"JAMESTOWN COLLEGE                                           ","2003-2004",3,"All Track Combined",102373,192023,-89650,46635,102085,-55450,55738,89938,-34200,"40","35",16873,16081
"9225",163453,"MORGAN STATE UNIVERSITY                                     ","2003-2004",16,"Softball",99235,188960,-89725,0,0,0,99235,188960,-89725,".","16",0,19060
"2490",154059,"NORTH IOWA AREA COMMUNITY COLLEGE                           ","2003-2004",2,"Basketball",9427,99165,-89738,5029,50052,-45023,4398,49113,-44715,"17","9",23468,21237
"4208",191630,"HOBART WILLIAM SMITH COLLEGES                               ","2003-2004",6,"Field hocky",27968,117864,-89896,0,0,0,27968,117864,-89896,".","23",0,20021
"13270",218742,"UNIVERSITY OF SOUTH CAROLINA-SPARTANBURG                    ","2003-2004",26,"Volleyball",6659,96693,-90034,0,0,0,6659,96693,-90034,"0","12",0,20300
"16487",212601,"GANNON UNIVERSITY                                           ","2003-2004",39,"Total Participants",1564298,1654402,-90104,714589,768850,-54261,849709,885552,-35843,"233","150",315431,230082
"8134",127741,"UNIVERSITY OF NORTHERN COLORADO                             ","2003-2004",15,"Soccer",70778,160980,-90202,0,0,0,70778,160980,-90202,".","31",0,38718
"5080",219134,"SI TANKA UNIVERSITY-HURON CAMPUS                            ","2003-2004",7,"Football",71237,161487,-90250,71237,161487,-90250,0,0,0,"53",".",71237,0
"13374",243197,"UNIVERSITY OF PUERTO RICO-MAYAGUEZ                          ","2003-2004",26,"Volleyball",7797,98075,-90278,4338,56954,-52616,3459,41121,-37662,"19","15",16697,12647
"2478",177968,"LINDENWOOD UNIVERSITY                                       ","2003-2004",2,"Basketball",89941,180285,-90344,43021,92684,-49663,46920,87601,-40681,"39","20",49663,40681
"953",196246,"SUNY COLLEGE AT PLATTSBURGH                                 ","2003-2004",1,"Baseball",1965,92392,-90427,1965,92392,-90427,0,0,0,"26",".",45522,0
"17200",112075,"CONCORDIA UNIVERSITY                                        ","2003-2004",39,"Total Participants",358158,448633,-90475,162574,199223,-36649,195584,249410,-53826,"77","86",130606,135559
"10263",195030,"UNIVERSITY OF ROCHESTER                                     ","2003-2004",18,"Swimming and Diving",87423,177920,-90497,57458,80327,-22869,29965,97593,-67628,"20","25",33819,51045
"876",227225,"NORTHEAST TEXAS COMMUNITY COLLEGE                           ","2003-2004",1,"Baseball",21894,112585,-90691,21894,112585,-90691,0,0,0,"29",".",96794,0
"11875",237525,"MARSHALL UNIVERSITY                                         ","2003-2004",23,"Track and Field, Indoor",31479,122378,-90899,0,0,0,31479,122378,-90899,".","28",0,22288
"11965",237525,"MARSHALL UNIVERSITY                                         ","2003-2004",24,"Track and Field, Outdoor",31479,122379,-90900,0,0,0,31479,122379,-90900,".","29",0,23084
"11695",188304,"WESTERN NEW MEXICO UNIVERSITY                               ","2003-2004",22,"Tennis",2,91147,-91145,1,60307,-60306,1,30840,-30839,"8","7",11623,11631
"16227",117627,"LA SIERRA UNIVERSITY                                        ","2003-2004",39,"Total Participants",12684,103935,-91251,2500,20200,-17700,10184,83735,-73551,"26","36",8050,17050
"11477",164216,"WASHINGTON COLLEGE                                          ","2003-2004",22,"Tennis",14573,105838,-91265,8213,52919,-44706,6360,52919,-46559,"10","11",21871,15662
"376",159407,"LOUISIANA STATE UNIVERSITY-EUNICE                           ","2003-2004",1,"Baseball",3832,95330,-91498,3832,95330,-91498,0,0,0,"35",".",76330,0
"15923",159407,"LOUISIANA STATE UNIVERSITY-EUNICE                           ","2003-2004",39,"Total Participants",3832,95330,-91498,3832,95330,-91498,0,0,0,"35","22",76330,42075
"7174",200332,"NORTH DAKOTA STATE UNIVERSITY-MAIN CAMPUS                   ","2003-2004",15,"Soccer",119202,210730,-91528,0,0,0,119202,210730,-91528,".","20",0,57411
"9770",190761,"DOMINICAN COLLEGE OF BLAUVELT                               ","2003-2004",16,"Softball",4930,96495,-91565,0,0,0,4930,96495,-91565,".","16",0,19095
"1163",187903,"NEW MEXICO JUNIOR COLLEGE                                   ","2003-2004",1,"Baseball",100,91741,-91641,100,91741,-91641,0,0,0,"24",".",29827,0
"2220",100724,"ALABAMA STATE UNIVERSITY                                    ","2003-2004",2,"Basketball",1035692,1127382,-91690,598439,680151,-81712,437253,447231,-9978,"15","15",437543,285649
"10786",195164,"SAINT BONAVENTURE UNIVERSITY                                ","2003-2004",22,"Tennis",80809,172567,-91758,47709,97358,-49649,33100,75209,-42109,"8","10",18432,9901
"13580",178697,"COLLEGE OF THE OZARKS                                       ","2003-2004",26,"Volleyball",707,92477,-91770,0,0,0,707,92477,-91770,".","11",0,51140
"1086",149772,"WESTERN ILLINOIS UNIVERSITY                                 ","2003-2004",1,"Baseball",171185,263052,-91867,171185,263052,-91867,0,0,0,"41",".",126770,0
"6132",110495,"CALIFORNIA STATE UNIVERSITY-STANISLAUS                      ","2003-2004",8,"Golf",13884,105832,-91948,13884,105832,-91948,0,0,0,"10",".",37681,0
"15376",217819,"COLLEGE OF CHARLESTON                                       ","2003-2004",36,"Sailing",35168,127120,-91952,0,0,0,35168,127120,-91952,".","15",0,54854
"17142",221856,"TENNESSEE TEMPLE UNIVERSITY                                 ","2003-2004",39,"Total Participants",46039,138007,-91968,34940,93971,-59031,11099,44036,-32937,"53","24",47995,25888
"15011",219806,"CARSON-NEWMAN COLLEGE                                       ","2003-2004",28,"Wrestling",27,92024,-91997,27,92024,-91997,0,0,0,"41",".",18819,0
"5837",202480,"UNIVERSITY OF DAYTON                                        ","2003-2004",8,"Golf",2020,94036,-92016,1020,57229,-56209,1000,36807,-35807,"11","9",18963,17536
"5553",198969,"METHODIST COLLEGE                                           ","2003-2004",8,"Golf",14554,106630,-92076,7493,54385,-46892,7061,52245,-45184,"18","14",15150,18040
"9230",220215,"FREED-HARDEMAN UNIVERSITY                                   ","2003-2004",16,"Softball",17000,109132,-92132,0,0,0,17000,109132,-92132,".","15",0,16935
"13287",129215,"EASTERN CONNECTICUT STATE UNIVERSITY                        ","2003-2004",26,"Volleyball",3878,96056,-92178,0,0,0,3878,96056,-92178,".","14",0,15268
"7870",102094,"UNIVERSITY OF SOUTH ALABAMA                                 ","2003-2004",15,"Soccer",256201,348441,-92240,0,0,0,256201,348441,-92240,".","24",0,71757
"16681",105297,"DINE COLLEGE                                                ","2003-2004",39,"Total Participants",29310,121550,-92240,14655,72319,-57664,14655,49231,-34576,"21","12",37724,19621
"13640",200280,"UNIVERSITY OF NORTH DAKOTA-MAIN CAMPUS                      ","2003-2004",26,"Volleyball",207994,300245,-92251,0,0,0,207994,300245,-92251,".","17",0,42841
"2691",209409,"NORTHWEST CHRISTIAN COLLEGE                                 ","2003-2004",2,"Basketball",150,92469,-92319,100,76124,-76024,50,16345,-16295,"15","11",76123,16344
"12266",196149,"SUNY COLLEGE AT CORTLAND                                    ","2003-2004",25,"Track and Field, X-Country",105652,198115,-92463,49722,96425,-46703,55930,101690,-45760,"57","51",39519,41137
"12548",174233,"UNIVERSITY OF MINNESOTA-DULUTH                              ","2003-2004",25,"Track and Field, X-Country",41042,133529,-92487,17934,56742,-38808,23108,76787,-53679,"104","182",32134,28112
"10695",196060,"SUNY AT ALBANY                                              ","2003-2004",22,"Tennis",2896,95391,-92495,0,0,0,2896,95391,-92495,".","10",0,16348
"13928",226134,"LAREDO COMMUNITY COLLEGE                                    ","2003-2004",26,"Volleyball",8000,100500,-92500,0,0,0,8000,100500,-92500,".","14",0,57091
"15303",187903,"NEW MEXICO JUNIOR COLLEGE                                   ","2003-2004",35,"Rodeo",1000,93510,-92510,500,65883,-65383,500,27627,-27127,"8","3",31791,11759
"3957",101295,"GEORGE C WALLACE STATE COMMUNITY COLL-HANCEVILLE            ","2003-2004",3,"All Track Combined",12100,104726,-92626,6050,77825,-71775,6050,26901,-20851,"23","8",6049,6048
"7990",152600,"VALPARAISO UNIVERSITY                                       ","2003-2004",15,"Soccer",601365,694248,-92883,307048,347613,-40565,294317,346635,-52318,"30","43",21500,13369
"16173",228149,"ST MARYS UNIVERSITY                                         ","2003-2004",39,"Total Participants",277747,370663,-92916,119633,151352,-31719,158114,219311,-61197,"106","98",192156,207148
"6892",216597,"VILLANOVA UNIVERSITY                                        ","2003-2004",13,"Rowing",51505,144441,-92936,0,0,0,51505,144441,-92936,".","77",0,75049
"10005",193292,"MOLLOY COLLEGE                                              ","2003-2004",16,"Softball",30000,123000,-93000,0,0,0,30000,123000,-93000,".","17",0,25000
"14109",152530,"TAYLOR UNIVERSITY-UPLAND                                    ","2003-2004",26,"Volleyball",34529,127542,-93013,0,0,0,34529,127542,-93013,".","10",0,32252
"6008",110705,"UNIVERSITY OF CALIFORNIA-SANTA BARBARA                      ","2003-2004",8,"Golf",37763,130790,-93027,37763,130790,-93027,0,0,0,"13",".",36322,0
"12745",110361,"CALIFORNIA BAPTIST UNIVERSITY                               ","2003-2004",25,"Track and Field, X-Country",2,93084,-93082,1,31176,-31175,1,61908,-61907,"6","11",2872,3903
"15070",217819,"COLLEGE OF CHARLESTON                                       ","2003-2004",29,"Other Sports",35168,128287,-93119,0,0,0,35168,128287,-93119,".","34",0,53750
"16078",109208,"AMERICAN RIVER COLLEGE                                      ","2003-2004",39,"Total Participants",76236,169557,-93321,33760,74373,-40613,42476,95184,-52708,"233","128",98666,79125
"3905",110583,"CALIFORNIA STATE UNIVERSITY-LONG BEACH                      ","2003-2004",3,"All Track Combined",609088,702516,-93428,284565,312751,-28186,324523,389765,-65242,"67","97",64751,69913
"5946",197036,"UNITED STATES MILITARY ACADEMY                              ","2003-2004",8,"Golf",69072,162547,-93475,69072,162547,-93475,0,0,0,"10",".",60717,0
"8397",137847,"THE UNIVERSITY OF TAMPA                                     ","2003-2004",15,"Soccer",395594,489104,-93510,189465,204398,-14933,206129,284706,-78577,"32","26",37824,77086
"17153",152637,"VINCENNES UNIVERSITY                                        ","2003-2004",39,"Total Participants",137852,231420,-93568,87581,148634,-61053,50271,82786,-32515,"122","34",164174,94133
"10014",110097,"BIOLA UNIVERSITY                                            ","2003-2004",16,"Softball",39004,132585,-93581,0,0,0,39004,132585,-93581,".","15",0,14985
"2951",134130,"UNIVERSITY OF FLORIDA                                       ","2003-2004",2,"Basketball",7584035,7677668,-93633,6774986,5154305,1620681,809049,2523363,-1714314,"14","16",1023452,776284
"8252",230782,"WEBER STATE UNIVERSITY                                      ","2003-2004",15,"Soccer",100808,194463,-93655,0,0,0,100808,194463,-93655,".","28",0,58722
"1015",148937,"SOUTHEASTERN ILLINOIS COLLEGE                               ","2003-2004",1,"Baseball",4054,97741,-93687,4054,97741,-93687,0,0,0,"24",".",19958,0
"6805",196149,"SUNY COLLEGE AT CORTLAND                                    ","2003-2004",11,"Lacrosse",97619,191399,-93780,68861,106675,-37814,28758,84724,-55966,"45","25",64728,47079
"15236",132602,"BETHUNE COOKMAN COLLEGE                                     ","2003-2004",33,"Bowling",52211,146142,-93931,0,0,0,52211,146142,-93931,".","11",0,49179
"9944",219383,"UNIVERSITY OF SIOUX FALLS                                   ","2003-2004",16,"Softball",721,94696,-93975,0,0,0,721,94696,-93975,".","23",0,16364
"9335",129215,"EASTERN CONNECTICUT STATE UNIVERSITY                        ","2003-2004",16,"Softball",16302,110278,-93976,0,0,0,16302,110278,-93976,".","20",0,31689
"16096",208406,"CLACKAMAS COMMUNITY COLLEGE                                 ","2003-2004",39,"Total Participants",52352,146329,-93977,15158,56544,-41386,37194,89785,-52591,"74","71",38833,52781
"13733",138983,"AUGUSTA STATE UNIVERSITY                                    ","2003-2004",26,"Volleyball",17316,111455,-94139,0,0,0,17316,111455,-94139,".","12",0,11415
"16426",140669,"NORTH GEORGIA COLLEGE AND STATE UNIVERSITY                  ","2003-2004",39,"Total Participants",435112,529320,-94208,252006,299714,-47708,183106,229606,-46500,"97","70",241974,187057
"9228",127741,"UNIVERSITY OF NORTHERN COLORADO                             ","2003-2004",16,"Softball",51696,145941,-94245,0,0,0,51696,145941,-94245,".","31",0,34082
"14170",180814,"BELLEVUE UNIVERSITY                                         ","2003-2004",26,"Volleyball",1000,95250,-94250,0,0,0,1000,95250,-94250,".","13",0,40250
"4728",162584,"FROSTBURG STATE UNIVERSITY                                  ","2003-2004",7,"Football",292880,387144,-94264,292880,387144,-94264,0,0,0,"111",".",98285,0
"10998",168342,"WILLIAMS COLLEGE                                            ","2003-2004",22,"Tennis",29403,123706,-94303,21378,72732,-51354,8025,50974,-42949,"22","8",10536,9865
"16314",130697,"WESLEYAN UNIVERSITY                                         ","2003-2004",39,"Total Participants",1514866,1609173,-94307,730639,789646,-59007,784227,819527,-35300,"403","263",376132,249865
"17347",223773,"CEDAR VALLEY COLLEGE                                        ","2003-2004",39,"Total Participants",126142,220506,-94364,40934,76195,-35261,85208,144311,-59103,"40","31",22151,41210
"8390",221351,"RHODES COLLEGE                                              ","2003-2004",15,"Soccer",65420,159855,-94435,35820,92057,-56237,29600,67798,-38198,"22","20",26200,26840
"15929",194824,"RENSSELAER POLYTECHNIC INSTITUTE                            ","2003-2004",39,"Total Participants",1063079,1157679,-94600,659897,710547,-50650,403182,447132,-43950,"414","218",296049,177859
"16483",179955,"WILLIAM JEWELL COLLEGE                                      ","2003-2004",39,"Total Participants",228131,322847,-94716,100609,148983,-48374,127522,173864,-46342,"258","102",173859,109509
"14436",200059,"DICKINSON STATE UNIVERSITY                                  ","2003-2004",26,"Volleyball",34541,129283,-94742,0,0,0,34541,129283,-94742,".","17",0,30904
"3013",230603,"SOUTHERN UTAH UNIVERSITY                                    ","2003-2004",2,"Basketball",689261,784261,-95000,507765,475407,32358,181496,308854,-127358,"15","14",173904,120691
"3518",218733,"SOUTH CAROLINA STATE UNIVERSITY                             ","2003-2004",3,"All Track Combined",402285,497330,-95045,176428,197417,-20989,225857,299913,-74056,"27","21",49398,52260
"8698",110671,"UNIVERSITY OF CALIFORNIA-RIVERSIDE                          ","2003-2004",16,"Softball",499325,594493,-95168,0,0,0,499325,594493,-95168,".","24",0,8520
"9922",237154,"MOUNTAIN STATE UNIVERSITY                                   ","2003-2004",16,"Softball",13910,109087,-95177,0,0,0,13910,109087,-95177,".","12",0,23159
"9543",101161,"JAMES H FAULKNER STATE COMMUNITY COLLEGE                    ","2003-2004",16,"Softball",15492,110693,-95201,0,0,0,15492,110693,-95201,".","23",0,18810
"10499",237969,"WEST VIRGINIA WESLEYAN COLLEGE                              ","2003-2004",19,"Swimming",64714,159964,-95250,32357,78357,-46000,32357,81607,-49250,"11","11",12360,12360
"7513",129215,"EASTERN CONNECTICUT STATE UNIVERSITY                        ","2003-2004",15,"Soccer",12066,107325,-95259,7136,55502,-48366,4930,51823,-46893,"24","28",19964,17797
"15619",170790,"MACOMB COMMUNITY COLLEGE                                    ","2003-2004",39,"Total Participants",166977,262278,-95301,79304,131139,-51835,87673,131139,-43466,"95","75",127084,118926
"10759",151102,"INDIANA UNIVERSITY-PURDUE UNIVERSITY-FORT WAYNE             ","2003-2004",22,"Tennis",8152,103593,-95441,5307,47392,-42085,2845,56201,-53356,"10","10",14407,18434
"1313",230603,"SOUTHERN UTAH UNIVERSITY                                    ","2003-2004",1,"Baseball",111607,207080,-95473,111607,207080,-95473,0,0,0,"30",".",108668,0
"2868",142285,"UNIVERSITY OF IDAHO                                         ","2003-2004",2,"Basketball",1622116,1717610,-95494,921136,1057438,-136302,700980,660172,40808,"14","11",214259,148704
"16825",169716,"UNIVERSITY OF DETROIT MERCY                                 ","2003-2004",39,"Total Participants",2042930,2138475,-95545,924929,934073,-9144,1118001,1204402,-86401,"103","98",334682,251393
"1196",185590,"MONTCLAIR STATE UNIVERSITY                                  ","2003-2004",1,"Baseball",50310,145882,-95572,50310,145882,-95572,0,0,0,"33",".",62278,0
"8528",200332,"NORTH DAKOTA STATE UNIVERSITY-MAIN CAMPUS                   ","2003-2004",16,"Softball",91537,187117,-95580,0,0,0,91537,187117,-95580,".","16",0,62270
"13456",175342,"ALCORN STATE UNIVERSITY                                     ","2003-2004",26,"Volleyball",3224,98879,-95655,0,0,0,3224,98879,-95655,".","13",0,23301
"1916",176071,"MISSISSIPPI GULF COAST COMMUNITY COLLEGE                    ","2003-2004",2,"Basketball",2241,97909,-95668,1100,47562,-46462,1141,50347,-49206,"15","15",8905,7254
"12534",226587,"MCMURRY UNIVERSITY                                          ","2003-2004",25,"Track and Field, X-Country",124769,220496,-95727,67915,116658,-48743,56854,103838,-46984,"113","59",52885,40359
"8712",102076,"SNEAD STATE COMMUNITY COLLEGE                               ","2003-2004",16,"Softball",547,96331,-95784,0,0,0,547,96331,-95784,".","21",0,22831
"6680",163268,"UNIVERSITY OF MARYLAND-BALTIMORE COUNTY                     ","2003-2004",11,"Lacrosse",186080,281944,-95864,111025,190627,-79602,75055,91317,-16262,"39","29",69824,41549
"4096",120883,"UNIVERSITY OF THE PACIFIC                                   ","2003-2004",6,"Field hocky",143756,239636,-95880,0,0,0,143756,239636,-95880,".","24",0,50432
"6459",168342,"WILLIAMS COLLEGE                                            ","2003-2004",10,"Ice Hockey",94978,191015,-96037,55957,106532,-50575,39021,84483,-45462,"24","23",56326,37891
"17036",174075,"UNIVERSITY OF MINNESOTA-CROOKSTON                           ","2003-2004",39,"Total Participants",403742,499867,-96125,197369,200121,-2752,206373,299746,-93373,"170","93",232316,146300
"1813",164216,"WASHINGTON COLLEGE                                          ","2003-2004",2,"Basketball",31749,128008,-96259,18432,67801,-49369,13317,60207,-46890,"18","12",13796,27306
"10880",187648,"EASTERN NEW MEXICO UNIVERSITY-MAIN CAMPUS                   ","2003-2004",22,"Tennis",1225,97491,-96266,0,0,0,1225,97491,-96266,".","10",0,21666
"7374",153825,"LORAS COLLEGE                                               ","2003-2004",15,"Soccer",6866,103201,-96335,6226,55689,-49463,640,47512,-46872,"39","25",19423,15478
"2602",175272,"WINONA STATE UNIVERSITY                                     ","2003-2004",2,"Basketball",279592,375943,-96351,145256,199023,-53767,134336,176920,-42584,"16","15",55742,43459
"7455",168342,"WILLIAMS COLLEGE                                            ","2003-2004",15,"Soccer",64584,160941,-96357,38287,97414,-59127,26297,63527,-37230,"22","24",21600,20136
"1284",178697,"COLLEGE OF THE OZARKS                                       ","2003-2004",1,"Baseball",1060,97436,-96376,1060,97436,-96376,0,0,0,"30",".",54241,0
"3798",234827,"CENTRAL WASHINGTON UNIVERSITY                               ","2003-2004",3,"All Track Combined",2808,99228,-96420,1404,31816,-30412,1404,67412,-66008,"40","53",12974,21623
"2013",194161,"NYACK COLLEGE                                               ","2003-2004",2,"Basketball",158588,255183,-96595,85861,189683,-103822,72727,65500,7227,"17","10",31000,27650
"9135",230038,"BRIGHAM YOUNG UNIVERSITY                                    ","2003-2004",16,"Softball",427321,523951,-96630,0,0,0,427321,523951,-96630,".","19",0,155512
"7816",231712,"CHRISTOPHER NEWPORT UNIVERSITY                              ","2003-2004",15,"Soccer",36224,132895,-96671,14297,80935,-66638,21927,51960,-30033,"23","26",9722,17678
"3454",186371,"RUTGERS UNIVERSITY-CAMDEN                                   ","2003-2004",2,"Basketball",10730,107430,-96700,1068,39645,-38577,9662,67785,-58123,"12","11",24695,44386
"5063",182670,"DARTMOUTH COLLEGE                                           ","2003-2004",7,"Football",978364,1075079,-96715,978364,1075079,-96715,0,0,0,"102",".",156102,0
"15588",157757,"SPALDING UNIVERSITY                                         ","2003-2004",39,"Total Participants",1350,98418,-97068,750,42490,-41740,600,55928,-55328,"59","67",63310,77090
"14409",110097,"BIOLA UNIVERSITY                                            ","2003-2004",26,"Volleyball",23282,120398,-97116,0,0,0,23282,120398,-97116,".","11",0,11357
"9362",219000,"AUGUSTANA COLLEGE                                           ","2003-2004",16,"Softball",70979,168103,-97124,0,0,0,70979,168103,-97124,".","21",0,44542
"8463",240727,"UNIVERSITY OF WYOMING                                       ","2003-2004",15,"Soccer",397072,494199,-97127,0,0,0,397072,494199,-97127,".","31",0,129542
"7176",155973,"TABOR COLLEGE                                               ","2003-2004",15,"Soccer",1810,98963,-97153,942,54298,-53356,868,44665,-43797,"17","17",6443,8908
"7367",200280,"UNIVERSITY OF NORTH DAKOTA-MAIN CAMPUS                      ","2003-2004",15,"Soccer",70610,167815,-97205,0,0,0,70610,167815,-97205,".","27",0,33472
"2875",207458,"OKLAHOMA CITY UNIVERSITY                                    ","2003-2004",2,"Basketball",25161,122371,-97210,11432,56092,-44660,13729,66279,-52550,"13","13",39300,38000
"7166",220312,"HIWASSEE COLLEGE                                            ","2003-2004",15,"Soccer",18000,115213,-97213,9000,60120,-51120,9000,55093,-46093,"18","12",11624,7423
"4900",155627,"OTTAWA UNIVERSITY                                           ","2003-2004",7,"Football",73066,170325,-97259,73066,170325,-97259,0,0,0,"99",".",51156,0
"14102",219259,"NORTHERN STATE UNIVERSITY                                   ","2003-2004",26,"Volleyball",53121,150380,-97259,0,0,0,53121,150380,-97259,".","22",0,23194
"2817",148654,"UNIVERSITY OF ILLINOIS AT SPRINGFIELD                       ","2003-2004",2,"Basketball",242000,339401,-97401,122000,159978,-37978,120000,179423,-59423,"15","15",49448,42822
"7441",154697,"BARTON COUNTY COMMUNITY COLLEGE                             ","2003-2004",15,"Soccer",35200,132718,-97518,18900,76005,-57105,16300,56713,-40413,"30","16",17759,16169
"16755",179292,"SAINT LOUIS COMMUNITY COLLEGE-FLORISSANT VALLEY             ","2003-2004",39,"Total Participants",41774,139303,-97529,16402,72211,-55809,25372,67092,-41720,"82","59",74746,63650
"447",208822,"GEORGE FOX UNIVERSITY                                       ","2003-2004",1,"Baseball",34672,132311,-97639,34672,132311,-97639,0,0,0,"34",".",68909,0
"4442",210571,"ALBRIGHT COLLEGE                                            ","2003-2004",7,"Football",129011,226810,-97799,129011,226810,-97799,0,0,0,"97",".",115029,0
"10689",220516,"KING COLLEGE                                                ","2003-2004",22,"Tennis",5735,103606,-97871,2870,72616,-69746,2865,30990,-28125,"7","8",2870,2865
"6629",233295,"RANDOLPH-MACON COLLEGE                                      ","2003-2004",11,"Lacrosse",2600,100784,-98184,1487,49571,-48084,1113,51213,-50100,"25","22",16950,11900
"9517",176044,"MISSISSIPPI VALLEY STATE UNIVERSITY                         ","2003-2004",16,"Softball",22500,120720,-98220,0,0,0,22500,120720,-98220,".","16",0,87850
"3737",236452,"SAINT MARTINS COLLEGE                                       ","2003-2004",3,"All Track Combined",15444,113700,-98256,7722,66425,-58703,7722,47275,-39553,"17","16",15546,15546
"14819",219000,"AUGUSTANA COLLEGE                                           ","2003-2004",28,"Wrestling",61578,160003,-98425,61578,160003,-98425,0,0,0,"26",".",29944,0
"8023",238078,"WHEELING JESUIT UNIVERSITY                                  ","2003-2004",15,"Soccer",1000,99558,-98558,500,56910,-56410,500,42648,-42148,"28","20",15557,15858
"16405",185873,"OCEAN COUNTY COLLEGE                                        ","2003-2004",39,"Total Participants",12200,110800,-98600,5850,58350,-52500,6350,52450,-46100,"64","57",43600,41500
"7064",174844,"SAINT OLAF COLLEGE                                          ","2003-2004",14,"Skiing",20610,119218,-98608,10305,59609,-49304,10305,59609,-49304,"18","16",39069,39069
"7936",176044,"MISSISSIPPI VALLEY STATE UNIVERSITY                         ","2003-2004",15,"Soccer",36600,135308,-98708,0,0,0,36600,135308,-98708,".","18",0,56258
"14256",179539,"STATE FAIR COMMUNITY COLLEGE                                ","2003-2004",26,"Volleyball",988,99728,-98740,0,0,0,988,99728,-98740,".","12",0,11260
"17330",179539,"STATE FAIR COMMUNITY COLLEGE                                ","2003-2004",39,"Total Participants",988,99728,-98740,0,0,0,988,99728,-98740,"12","24",19982,30242
"14120",213376,"LACKAWANNA COLLEGE                                          ","2003-2004",26,"Volleyball",85,98989,-98904,0,0,0,85,98989,-98904,".","6",0,10871
"1936",101240,"GADSDEN STATE COMMUNITY COLLEGE                             ","2003-2004",2,"Basketball",117100,216034,-98934,46703,101977,-55274,70397,114057,-43660,"11","13",22805,46185
"17297",133881,"FLORIDA INSTITUTE OF TECHNOLOGY-MELBOURNE                   ","2003-2004",39,"Total Participants",1687461,1786435,-98974,769674,817215,-47541,917787,969220,-51433,"106","141",128878,148572
"11975",213303,"KEYSTONE COLLEGE                                            ","2003-2004",24,"Track and Field, Outdoor",10950,109950,-99000,5475,54975,-49500,5475,54975,-49500,"4","5",5475,5475
"12701",213303,"KEYSTONE COLLEGE                                            ","2003-2004",25,"Track and Field, X-Country",6432,105432,-99000,3216,52716,-49500,3216,52716,-49500,"5","4",3216,3216
"7574",208822,"GEORGE FOX UNIVERSITY                                       ","2003-2004",15,"Soccer",390,99412,-99022,240,57895,-57655,150,41517,-41367,"26","20",29419,21756
"853",190150,"COLUMBIA UNIVERSITY IN THE CITY OF NEW YORK                 ","2003-2004",1,"Baseball",69723,168763,-99040,69723,168763,-99040,0,0,0,"28",".",105791,0
"3522",184782,"ROWAN UNIVERSITY                                            ","2003-2004",3,"All Track Combined",445,99488,-99043,220,49744,-49524,225,49744,-49519,"32","23",12195,12195
"4040",232566,"LONGWOOD UNIVERSITY                                         ","2003-2004",6,"Field hocky",14046,113127,-99081,0,0,0,14046,113127,-99081,".","19",0,26209
"2958",205470,"SINCLAIR COMMUNITY COLLEGE                                  ","2003-2004",2,"Basketball",2851,101980,-99129,1295,51097,-49802,1556,50883,-49327,"13","12",27969,28550
"3636",126580,"UNIVERSITY OF COLORADO AT COLORADO SPRINGS                  ","2003-2004",3,"All Track Combined",76436,175674,-99238,38218,87837,-49619,38218,87837,-49619,"20","21",26675,26675
"9178",185590,"MONTCLAIR STATE UNIVERSITY                                  ","2003-2004",16,"Softball",11767,111081,-99314,0,0,0,11767,111081,-99314,".","17",0,31601
"1330",183062,"KEENE STATE COLLEGE                                         ","2003-2004",1,"Baseball",50086,149409,-99323,50086,149409,-99323,0,0,0,"28",".",68275,0
"13171",237118,"ALDERSON BROADDUS COLLEGE                                   ","2003-2004",26,"Volleyball",18717,118085,-99368,0,0,0,18717,118085,-99368,".","14",0,1321
"15174",177968,"LINDENWOOD UNIVERSITY                                       ","2003-2004",33,"Bowling",5750,105120,-99370,2875,57051,-54176,2875,48069,-45194,"29","14",54176,45194
"9004",180814,"BELLEVUE UNIVERSITY                                         ","2003-2004",16,"Softball",1500,100897,-99397,0,0,0,1500,100897,-99397,".","15",0,50897
"5312",131159,"AMERICAN UNIVERSITY                                         ","2003-2004",8,"Golf",375,100070,-99695,375,100070,-99695,0,0,0,"9",".",28652,0
"3271",229160,"TEXAS WESLEYAN UNIVERSITY                                   ","2003-2004",2,"Basketball",63920,163672,-99752,34905,81651,-46746,29015,82021,-53006,"32","25",30846,26763
"14524",178402,"UNIVERSITY OF MISSOURI-KANSAS CITY                          ","2003-2004",26,"Volleyball",301594,401433,-99839,0,0,0,301594,401433,-99839,".","15",0,58586
"13762",199157,"NORTH CAROLINA CENTRAL UNIVERSITY                           ","2003-2004",26,"Volleyball",32444,132341,-99897,0,0,0,32444,132341,-99897,".","13",0,15229
"1876",199032,"MONTREAT COLLEGE                                            ","2003-2004",2,"Basketball",56417,156395,-99978,31590,98025,-66435,24827,58370,-33543,"12","16",23125,17009
"1443",237118,"ALDERSON BROADDUS COLLEGE                                   ","2003-2004",1,"Baseball",17765,117865,-100100,17765,117865,-100100,0,0,0,"26",".",15730,0
"12053",228705,"TEXAS A &amp; M UNIVERSITY-KINGSVILLE                           ","2003-2004",24,"Track and Field, Outdoor",2900,103000,-100100,1000,51000,-50000,1900,52000,-50100,"24","22",30000,30000
"14789",198419,"DUKE UNIVERSITY                                             ","2003-2004",28,"Wrestling",12225,112344,-100119,12225,112344,-100119,0,0,0,"35",".",40193,0
"8084",130989,"GOLDEY-BEACOM COLLEGE                                       ","2003-2004",15,"Soccer",70409,170553,-100144,35701,90058,-54357,34708,80495,-45787,"21","19",29878,14095
"1300",230171,"DIXIE STATE COLLEGE OF UTAH                                 ","2003-2004",1,"Baseball",6626,106950,-100324,6626,106950,-100324,0,0,0,"25",".",64494,0
"7010",153269,"DRAKE UNIVERSITY                                            ","2003-2004",13,"Rowing",66223,166713,-100490,0,0,0,66223,166713,-100490,".","29",0,102501
"2500",216764,"WEST CHESTER UNIVERSITY OF PENNSYLVANIA                     ","2003-2004",2,"Basketball",146257,246773,-100516,80478,104635,-24157,65779,142138,-76359,"18","16",31636,36963
"8973",123572,"SONOMA STATE UNIVERSITY                                     ","2003-2004",16,"Softball",25721,126289,-100568,0,0,0,25721,126289,-100568,".","20",0,33198
"10049",142443,"NORTH IDAHO COLLEGE                                         ","2003-2004",16,"Softball",65402,166326,-100924,0,0,0,65402,166326,-100924,".","24",0,39353
"17123",194541,"POLYTECHNIC UNIVERSITY                                      ","2003-2004",39,"Total Participants",65056,166073,-101017,39461,112881,-73420,25595,53192,-27597,"87","61",64451,21502
"248",102076,"SNEAD STATE COMMUNITY COLLEGE                               ","2003-2004",1,"Baseball",997,102295,-101298,997,102295,-101298,0,0,0,"21",".",28795,0
"3929",149772,"WESTERN ILLINOIS UNIVERSITY                                 ","2003-2004",3,"All Track Combined",213362,314712,-101350,106681,157356,-50675,106681,157356,-50675,"98","89",49740,49740
"2151",192323,"LE MOYNE COLLEGE                                            ","2003-2004",2,"Basketball",96521,197948,-101427,49228,99049,-49821,47293,98899,-51606,"13","12",49228,47293
"16938",157809,"THOMAS MORE COLLEGE                                         ","2003-2004",39,"Total Participants",147029,248698,-101669,76224,113823,-37599,70805,134875,-64070,"255","82",95785,60959
"4803",240462,"UNIVERSITY OF WISCONSIN-PLATTEVILLE                         ","2003-2004",7,"Football",194786,296481,-101695,194786,296481,-101695,0,0,0,"100",".",105978,0
"9729",143358,"BRADLEY UNIVERSITY                                          ","2003-2004",16,"Softball",298292,400047,-101755,0,0,0,298292,400047,-101755,".","22",0,77722
"10144",219471,"UNIVERSITY OF SOUTH DAKOTA                                  ","2003-2004",18,"Swimming and Diving",145293,247061,-101768,74734,125561,-50827,70559,121500,-50941,"27","15",44437,43953
"14544",110495,"CALIFORNIA STATE UNIVERSITY-STANISLAUS                      ","2003-2004",26,"Volleyball",58157,159969,-101812,0,0,0,58157,159969,-101812,".","12",0,40692
"11336",132602,"BETHUNE COOKMAN COLLEGE                                     ","2003-2004",22,"Tennis",160949,262889,-101940,97465,132517,-35052,63484,130372,-66888,"7","6",31554,18327
"11775",240727,"UNIVERSITY OF WYOMING                                       ","2003-2004",22,"Tennis",197409,299378,-101969,0,0,0,197409,299378,-101969,".","8",0,56340
"10214",127741,"UNIVERSITY OF NORTHERN COLORADO                             ","2003-2004",18,"Swimming and Diving",60267,162288,-102021,0,0,0,60267,162288,-102021,".","32",0,32647
"13081",177968,"LINDENWOOD UNIVERSITY                                       ","2003-2004",26,"Volleyball",21735,123841,-102106,10867,66411,-55544,10868,57430,-46562,"25","40",55544,46562
"1277",228981,"TEXAS LUTHERAN UNIVERSITY                                   ","2003-2004",1,"Baseball",15043,117190,-102147,15043,117190,-102147,0,0,0,"43",".",53107,0
"2337",102270,"STILLMAN COLLEGE                                            ","2003-2004",2,"Basketball",54593,156750,-102157,28100,69375,-41275,26493,87375,-60882,"15","15",25000,25000
"12721",202480,"UNIVERSITY OF DAYTON                                        ","2003-2004",25,"Track and Field, X-Country",1260,103444,-102184,1250,66056,-64806,10,37388,-37378,"14","31",15300,18515
"13897",106412,"UNIVERSITY OF ARKANSAS AT PINE BLUFF                        ","2003-2004",26,"Volleyball",1,102220,-102219,0,0,0,1,102220,-102219,".","10",0,21423
"8308",102067,"SHELTON STATE COMMUNITY COLLEGE                             ","2003-2004",15,"Soccer",5226,107461,-102235,0,0,0,5226,107461,-102235,".","20",0,20913
"5856",101161,"JAMES H FAULKNER STATE COMMUNITY COLLEGE                    ","2003-2004",8,"Golf",20907,123189,-102282,20907,123189,-102282,0,0,0,"10",".",24266,0
"15587",189088,"BARD COLLEGE                                                ","2003-2004",39,"Total Participants",1941,104235,-102294,971,54762,-53791,970,49473,-48503,"80","66",40625,27979
"2367",226204,"LEE COLLEGE                                                 ","2003-2004",2,"Basketball",32348,134644,-102296,32348,134644,-102296,0,0,0,"12",".",32348,0
"8807",138983,"AUGUSTA STATE UNIVERSITY                                    ","2003-2004",16,"Softball",37721,140027,-102306,0,0,0,37721,140027,-102306,".","17",0,29000
"16437",221971,"UNION UNIVERSITY                                            ","2003-2004",39,"Total Participants",958396,1060730,-102334,601167,595731,5436,357229,464999,-107770,"76","43",158435,107518
"6532",199698,"ST ANDREWS PRESBYTERIAN COLLEGE                             ","2003-2004",11,"Lacrosse",114874,217309,-102435,74576,172011,-97435,40298,45298,-5000,"36","17",29976,10298
"3525",227526,"PRAIRIE VIEW A &amp; M UNIVERSITY                               ","2003-2004",3,"All Track Combined",124730,227186,-102456,65365,101711,-36346,59365,125475,-66110,"19","18",63937,57937
"5133",217907,"COKER COLLEGE                                               ","2003-2004",8,"Golf",13890,116375,-102485,13890,116375,-102485,0,0,0,"11",".",20598,0
"14521",234827,"CENTRAL WASHINGTON UNIVERSITY                               ","2003-2004",26,"Volleyball",13758,116488,-102730,0,0,0,13758,116488,-102730,".","18",0,47687
"3947",133650,"FLORIDA AGRICULTURAL AND MECHANICAL UNIVERSITY              ","2003-2004",3,"All Track Combined",5000,107772,-102772,2500,54180,-51680,2500,53592,-51092,"50","29",50190,50757
"10243",106245,"UNIVERSITY OF ARKANSAS AT LITTLE ROCK                       ","2003-2004",18,"Swimming and Diving",29767,132550,-102783,0,0,0,29767,132550,-102783,".","14",0,19352
"14892",217633,"ANDERSON COLLEGE                                            ","2003-2004",28,"Wrestling",68162,170951,-102789,68162,170951,-102789,0,0,0,"26",".",22932,0
"14309",123572,"SONOMA STATE UNIVERSITY                                     ","2003-2004",26,"Volleyball",43418,146262,-102844,0,0,0,43418,146262,-102844,".","21",0,36312
"12986",217402,"PROVIDENCE COLLEGE                                          ","2003-2004",26,"Volleyball",3100,106105,-103005,0,0,0,3100,106105,-103005,".","10",0,40115
"2510",142294,"ALBERTSON COLLEGE OF IDAHO                                  ","2003-2004",2,"Basketball",56390,159560,-103170,49592,84660,-35068,6798,74900,-68102,"15","18",27900,26700
"13984",181817,"WESTERN NEBRASKA COMMUNITY COLLEGE                          ","2003-2004",26,"Volleyball",13075,116248,-103173,0,0,0,13075,116248,-103173,".","12",0,33997
"13761",152600,"VALPARAISO UNIVERSITY                                       ","2003-2004",26,"Volleyball",351155,454377,-103222,0,0,0,351155,454377,-103222,"0","14",0,11171
"10294",201104,"ASHLAND UNIVERSITY                                          ","2003-2004",18,"Swimming and Diving",332461,435745,-103284,205415,257057,-51642,127046,178688,-51642,"18","12",8755,8755
"14125",141264,"VALDOSTA STATE UNIVERSITY                                   ","2003-2004",26,"Volleyball",69801,173221,-103420,0,0,0,69801,173221,-103420,".","15",0,27387
"7115",187648,"EASTERN NEW MEXICO UNIVERSITY-MAIN CAMPUS                   ","2003-2004",15,"Soccer",5726,109189,-103463,0,0,0,5726,109189,-103463,".","25",0,33482
"1560",225520,"HOWARD COUNTY JUNIOR COLLEGE DISTRICT                       ","2003-2004",1,"Baseball",2652,106141,-103489,2652,106141,-103489,0,0,0,"27",".",31539,0
"12008",106412,"UNIVERSITY OF ARKANSAS AT PINE BLUFF                        ","2003-2004",24,"Track and Field, Outdoor",150,103701,-103551,75,41575,-41500,75,62126,-62051,"19","22",22500,28210
"125",101295,"GEORGE C WALLACE STATE COMMUNITY COLL-HANCEVILLE            ","2003-2004",1,"Baseball",23410,127030,-103620,23410,127030,-103620,0,0,0,"26",".",17992,0
"1808",213367,"LA SALLE UNIVERSITY                                         ","2003-2004",2,"Basketball",2237128,2340788,-103660,1504189,1561344,-57155,732939,779444,-46505,"13","12",273370,111811
"11886",106412,"UNIVERSITY OF ARKANSAS AT PINE BLUFF                        ","2003-2004",23,"Track and Field, Indoor",2,103701,-103699,1,41575,-41574,1,62126,-62125,"19","22",14877,19425
"12892",106412,"UNIVERSITY OF ARKANSAS AT PINE BLUFF                        ","2003-2004",25,"Track and Field, X-Country",2,103701,-103699,1,41575,-41574,1,62126,-62125,"7","10",7254,8417
"16728",237701,"POTOMAC STATE COLLEGE OF WEST VIRGINIA UNIVERSITY           ","2003-2004",39,"Total Participants",57000,160738,-103738,31000,84242,-53242,26000,76496,-50496,"80","54",48274,33904
"13475",221740,"THE UNIVERSITY OF TENNESSEE-CHATTANOOGA                     ","2003-2004",26,"Volleyball",2573,106344,-103771,0,0,0,2573,106344,-103771,".","13",0,30611
"2434",115755,"HUMBOLDT STATE UNIVERSITY                                   ","2003-2004",2,"Basketball",581458,685232,-103774,331246,402572,-71326,250212,282660,-32448,"16","16",107054,51152
"13638",241739,"UNIVERSIDAD METROPOLITANA                                   ","2003-2004",26,"Volleyball",2,103874,-103872,1,31820,-31819,1,72054,-72053,"12","12",9750,9750
"8145",198969,"METHODIST COLLEGE                                           ","2003-2004",15,"Soccer",9248,113158,-103910,3253,60298,-57045,5995,52860,-46865,"31","20",19238,14790
"13834",219806,"CARSON-NEWMAN COLLEGE                                       ","2003-2004",26,"Volleyball",3678,107670,-103992,0,0,0,3678,107670,-103992,".","12",0,14352
"10100",217402,"PROVIDENCE COLLEGE                                          ","2003-2004",18,"Swimming and Diving",426,104505,-104079,113,44481,-44368,313,60024,-59711,"17","26",25316,39598
"5014",212009,"DICKINSON COLLEGE                                           ","2003-2004",7,"Football",53363,157472,-104109,53363,157472,-104109,0,0,0,"68",".",58634,0
"16874",207041,"EAST CENTRAL UNIVERSITY                                     ","2003-2004",39,"Total Participants",110308,214431,-104123,46407,98669,-52262,63901,115762,-51861,"199","76",184306,90054
"14419",213543,"LEHIGH UNIVERSITY                                           ","2003-2004",26,"Volleyball",197548,301783,-104235,0,0,0,197548,301783,-104235,".","10",0,44653
"4380",156408,"CENTRE COLLEGE                                              ","2003-2004",7,"Football",21102,125358,-104256,21102,125358,-104256,0,0,0,"77",".",85816,0
"4460",174251,"UNIVERSITY OF MINNESOTA-MORRIS                              ","2003-2004",7,"Football",76795,181110,-104315,76795,181110,-104315,0,0,0,"50",".",44292,0
"15438",113218,"CUYAMACA COLLEGE                                            ","2003-2004",39,"Total Participants",84112,188478,-104366,37916,82736,-44820,46196,105742,-59546,"70","83",71614,88073
"11427",224147,"TEXAS A &amp; M UNIVERSITY-CORPUS CHRISTI                       ","2003-2004",22,"Tennis",90753,195179,-104426,47796,89910,-42114,42957,105269,-62312,"8","7",23368,16634
"8978",198871,"LOUISBURG COLLEGE                                           ","2003-2004",16,"Softball",1,104473,-104472,0,0,0,1,104473,-104472,".","19",0,23448
"3558",172334,"SPRING ARBOR UNIVERSITY                                     ","2003-2004",3,"All Track Combined",31105,135630,-104525,15530,67867,-52337,15575,67763,-52188,"12","15",15530,15575
"6149",110644,"UNIVERSITY OF CALIFORNIA-DAVIS                              ","2003-2004",8,"Golf",4258,108918,-104660,4258,108918,-104660,0,0,0,"10","0",24991,0
"14405",179645,"THREE RIVERS COMMUNITY COLLEGE                              ","2003-2004",26,"Volleyball",1168,105841,-104673,0,0,0,1168,105841,-104673,".","12",0,32488
"1397",185262,"KEAN UNIVERSITY                                             ","2003-2004",1,"Baseball",1,104691,-104690,1,104691,-104690,0,0,0,"31",".",47079,0
"12883",183062,"KEENE STATE COLLEGE                                         ","2003-2004",25,"Track and Field, X-Country",20800,125510,-104710,12674,66171,-53497,8126,59339,-51213,"27","28",26474,20405
"12857",221731,"TENNESSEE WESLEYAN COLLEGE                                  ","2003-2004",25,"Track and Field, X-Country",6400,111400,-105000,3200,55700,-52500,3200,55700,-52500,"7","7",2250,2250
"4956",157401,"MURRAY STATE UNIVERSITY                                     ","2003-2004",7,"Football",1619180,1724373,-105193,1619180,1724373,-105193,0,0,0,"79",".",111937,0
"5972",188030,"NEW MEXICO STATE UNIVERSITY-MAIN CAMPUS                     ","2003-2004",8,"Golf",148803,254008,-105205,60780,91358,-30578,88023,162650,-74627,"11","9",27257,33935
"1374",199218,"UNIVERSITY OF NORTH CAROLINA-WILMINGTON                     ","2003-2004",1,"Baseball",300491,405826,-105335,300491,405826,-105335,0,0,0,"30",".",110538,0
"2335",237330,"CONCORD COLLEGE                                             ","2003-2004",2,"Basketball",273401,378743,-105342,165712,215830,-50118,107689,162913,-55224,"16","17",30741,32068
"4721",138716,"ALBANY STATE UNIVERSITY                                     ","2003-2004",7,"Football",387526,492877,-105351,387526,492877,-105351,0,0,0,"90",".",238896,0
"15460",156286,"BELLARMINE UNIVERSITY                                       ","2003-2004",39,"Total Participants",1223982,1329336,-105354,599580,643198,-43618,624402,686138,-61736,"161","160",152750,162776
"4007",198419,"DUKE UNIVERSITY                                             ","2003-2004",5,"Fencing",7880,113365,-105485,3940,47682,-43742,3940,65683,-61743,"19","13",19635,32225
"15653",110334,"CABRILLO COLLEGE                                            ","2003-2004",39,"Total Participants",33102,138724,-105622,18625,72542,-53917,14477,66182,-51705,"144","70",53556,28788
"3869",235097,"EASTERN WASHINGTON UNIVERSITY                               ","2003-2004",3,"All Track Combined",410735,516406,-105671,111926,168680,-56754,298809,347726,-48917,"84","159",54606,54946
"1108",231174,"UNIVERSITY OF VERMONT AND STATE AGRICULTURAL COLL           ","2003-2004",1,"Baseball",209173,314977,-105804,209173,314977,-105804,0,0,0,"26",".",113749,0
"3965",170639,"LAKE SUPERIOR STATE UNIVERSITY                              ","2003-2004",3,"All Track Combined",8860,114675,-105815,4429,56631,-52202,4431,58044,-53613,"54","39",14018,14018
"2388",203599,"LAKELAND COMMUNITY COLLEGE                                  ","2003-2004",2,"Basketball",13192,119044,-105852,2540,51424,-48884,10652,67620,-56968,"12","13",25517,26778
"4514",225247,"HARDIN-SIMMONS UNIVERSITY                                   ","2003-2004",7,"Football",23000,129000,-106000,23000,129000,-106000,0,0,0,"100",".",124980,0
"9051",228699,"TEXARKANA COLLEGE                                           ","2003-2004",16,"Softball",1000,107000,-106000,0,0,0,1000,107000,-106000,".","19",0,76000
"14297",109785,"AZUSA PACIFIC UNIVERSITY                                    ","2003-2004",26,"Volleyball",33014,139014,-106000,0,0,0,33014,139014,-106000,".","13",0,23684
"6055",200004,"WESTERN CAROLINA UNIVERSITY                                 ","2003-2004",8,"Golf",28743,134848,-106105,18383,53458,-35075,10360,81390,-71030,"10","7",18454,26701
"11313",219806,"CARSON-NEWMAN COLLEGE                                       ","2003-2004",22,"Tennis",1102,107244,-106142,427,55252,-54825,675,51992,-51317,"7","8",7952,7952
"16671",207865,"SOUTHWESTERN OKLAHOMA STATE UNIVERSITY                      ","2003-2004",39,"Total Participants",110453,216619,-106166,42786,87312,-44526,67667,129307,-61640,"192","89",111851,91601
"4834",157809,"THOMAS MORE COLLEGE                                         ","2003-2004",7,"Football",120167,226438,-106271,120167,226438,-106271,0,0,0,"131",".",44147,0
"947",227845,"SAINT EDWARD'S UNIVERSITY                                   ","2003-2004",1,"Baseball",100,106387,-106287,100,106387,-106287,0,0,0,"32",".",34787,0
"15374",243744,"STANFORD UNIVERSITY                                         ","2003-2004",36,"Sailing",112402,218773,-106371,56201,109386,-53185,56201,109387,-53186,"0","33",16914,16915
"6142",159966,"NICHOLLS STATE UNIVERSITY                                   ","2003-2004",8,"Golf",17390,123847,-106457,8695,57327,-48632,8695,66520,-57825,"9","6",17910,19299
"10145",181394,"UNIVERSITY OF NEBRASKA AT OMAHA                             ","2003-2004",18,"Swimming and Diving",69810,176355,-106545,0,0,0,69810,176355,-106545,".","24",0,68291
"865",122931,"SANTA CLARA UNIVERSITY                                      ","2003-2004",1,"Baseball",799843,906455,-106612,799843,906455,-106612,0,0,0,"33",".",157112,0
"4877",175829,"ITAWAMBA COMMUNITY COLLEGE                                  ","2003-2004",7,"Football",15861,122509,-106648,15861,122509,-106648,0,0,0,"54",".",39283,0
"12435",217165,"BRYANT COLLEGE                                              ","2003-2004",25,"Track and Field, X-Country",40472,147202,-106730,20524,79265,-58741,19948,67937,-47989,"27","20",7668,8320
"7944",221740,"THE UNIVERSITY OF TENNESSEE-CHATTANOOGA                     ","2003-2004",15,"Soccer",2395,109137,-106742,0,0,0,2395,109137,-106742,".","20",0,59683
"10676",170639,"LAKE SUPERIOR STATE UNIVERSITY                              ","2003-2004",22,"Tennis",10208,116951,-106743,5803,61902,-56099,4405,55049,-50644,"8","9",9708,10707
"892",227368,"THE UNIVERSITY OF TEXAS-PAN AMERICAN                        ","2003-2004",1,"Baseball",244082,350878,-106796,244082,350878,-106796,0,0,0,"33",".",92815,0
"16861",123484,"COLLEGE OF THE SISKIYOUS                                    ","2003-2004",39,"Total Participants",108633,215451,-106818,63185,109704,-46519,45448,105747,-60299,"146","44",144505,60272
"16135",153630,"IOWA WESTERN COMMUNITY COLLEGE                              ","2003-2004",39,"Total Participants",297156,403981,-106825,132296,164258,-31962,164860,239723,-74863,"40","34",53737,70901
"5341",160658,"UNIVERSITY OF LOUISIANA AT LAFAYETTE                        ","2003-2004",8,"Golf",1400,108259,-106859,1400,108259,-106859,0,0,0,"11",".",30812,0
"14814",198136,"CAMPBELL UNIVERSITY INC                                     ","2003-2004",28,"Wrestling",151367,258290,-106923,151367,258290,-106923,0,0,0,"18",".",42801,0
"1437",228699,"TEXARKANA COLLEGE                                           ","2003-2004",1,"Baseball",5000,112000,-107000,5000,112000,-107000,0,0,0,"26",".",76000,0
"223",219888,"COLUMBIA STATE COMMUNITY COLLEGE                            ","2003-2004",1,"Baseball",2460,109469,-107009,2460,109469,-107009,0,0,0,"25",".",35692,0
"12917",151102,"INDIANA UNIVERSITY-PURDUE UNIVERSITY-FORT WAYNE             ","2003-2004",25,"Track and Field, X-Country",9788,117085,-107297,2198,37936,-35738,7590,79149,-71559,"12","42",10361,36263
"16418",140483,"MIDDLE GEORGIA COLLEGE                                      ","2003-2004",39,"Total Participants",34217,141543,-107326,32213,106098,-73885,2004,35445,-33441,"43","32",92892,32888
"15732",157076,"KENTUCKY WESLEYAN COLLEGE                                   ","2003-2004",39,"Total Participants",437893,545254,-107361,237352,352315,-114963,200541,192939,7602,"161","66",188331,80639
"11036",129020,"UNIVERSITY OF CONNECTICUT                                   ","2003-2004",22,"Tennis",52500,159888,-107388,26250,79725,-53475,26250,80163,-53913,"10","7",36179,36618
"9382",201104,"ASHLAND UNIVERSITY                                          ","2003-2004",16,"Softball",207187,314609,-107422,0,0,0,207187,314609,-107422,".","22",0,23553
"7637",217633,"ANDERSON COLLEGE                                            ","2003-2004",15,"Soccer",132108,239589,-107481,76474,128005,-51531,55634,111584,-55950,"26","24",19136,19800
"2226",170541,"KALAMAZOO VALLEY COMMUNITY COLLEGE                          ","2003-2004",2,"Basketball",2,107562,-107560,1,51235,-51234,1,56327,-56326,"17","15",25272,41152
"15314",206996,"CONNORS STATE COLLEGE                                       ","2003-2004",35,"Rodeo",2,107687,-107685,1,83648,-83647,1,24039,-24038,"18",".",107694,0
"2171",155566,"NEOSHO COUNTY COMMUNITY COLLEGE                             ","2003-2004",2,"Basketball",400,108157,-107757,200,61185,-60985,200,46972,-46772,"30","17",21000,16000
"13236",127556,"MESA STATE COLLEGE                                          ","2003-2004",26,"Volleyball",65724,173861,-108137,0,0,0,65724,173861,-108137,".","14",0,132416
"4153",231174,"UNIVERSITY OF VERMONT AND STATE AGRICULTURAL COLL           ","2003-2004",6,"Field hocky",196656,304819,-108163,0,0,0,196656,304819,-108163,".","26",0,68413
"6364",145813,"ILLINOIS STATE UNIVERSITY                                   ","2003-2004",9,"Gymnastics",71198,179403,-108205,0,0,0,71198,179403,-108205,".","16",0,29333
"15247",162654,"GOUCHER COLLEGE                                             ","2003-2004",34,"Equestrian",26400,134763,-108363,0,0,0,26400,134763,-108363,".","22",0,57027
"12980",173328,"CONCORDIA UNIVERSITY-ST PAUL                                ","2003-2004",25,"Track and Field, X-Country",89376,197911,-108535,43878,95459,-51581,45498,102452,-56954,"44","36",18570,17872
"10158",139931,"GEORGIA SOUTHERN UNIVERSITY                                 ","2003-2004",18,"Swimming and Diving",36270,144907,-108637,0,0,0,36270,144907,-108637,".","26",0,41264
"1732",154527,"WARTBURG COLLEGE                                            ","2003-2004",2,"Basketball",54945,163643,-108698,30966,86886,-55920,23979,76757,-52778,"29","22",23145,20835
"5851",227845,"SAINT EDWARD'S UNIVERSITY                                   ","2003-2004",8,"Golf",200,108920,-108720,100,54000,-53900,100,54920,-54820,"12","5",11000,11920
"1156",201104,"ASHLAND UNIVERSITY                                          ","2003-2004",1,"Baseball",377028,485801,-108773,377028,485801,-108773,0,0,0,"38",".",34200,0
"9659",206996,"CONNORS STATE COLLEGE                                       ","2003-2004",16,"Softball",1,108826,-108825,0,0,0,1,108826,-108825,".","20",0,108820
"17002",155627,"OTTAWA UNIVERSITY                                           ","2003-2004",39,"Total Participants",147492,256492,-109000,80276,135158,-54882,67216,121334,-54118,"210","90",154701,89378
"4725",109819,"BAKERSFIELD COLLEGE                                         ","2003-2004",7,"Football",144321,253368,-109047,144321,253368,-109047,0,0,0,"90",".",29671,0
"3991",199120,"UNIVERSITY OF NORTH CAROLINA AT CHAPEL HILL                 ","2003-2004",5,"Fencing",2196,111344,-109148,1098,55672,-54574,1098,55672,-54574,"40","31",19788,19787
"6171",159009,"GRAMBLING STATE UNIVERSITY                                  ","2003-2004",8,"Golf",2,109183,-109181,1,49925,-49924,1,59258,-59257,"7","9",23773,23299
"1592",174844,"SAINT OLAF COLLEGE                                          ","2003-2004",2,"Basketball",3061,112303,-109242,2150,54891,-52741,911,57412,-56501,"18","14",16875,13021
"14020",121309,"POINT LOMA NAZARENE UNIVERSITY                              ","2003-2004",26,"Volleyball",58334,167595,-109261,0,0,0,58334,167595,-109261,".","11",0,66348
"39",155937,"STERLING COLLEGE                                            ","2003-2004",1,"Baseball",6503,115900,-109397,6503,115900,-109397,0,0,0,"25",".",115899,0
"15717",118684,"MENDOCINO COLLEGE                                           ","2003-2004",39,"Total Participants",12458,121889,-109431,6665,55716,-49051,5793,66173,-60380,"84","52",78260,66670
"238",141264,"VALDOSTA STATE UNIVERSITY                                   ","2003-2004",1,"Baseball",108997,218517,-109520,108997,218517,-109520,0,0,0,"34",".",54323,0
"7530",196176,"SUNY COLLEGE AT NEW PALTZ                                   ","2003-2004",15,"Soccer",2390,112068,-109678,1750,62087,-60337,640,49981,-49341,"21","19",21916,10542
"7517",218229,"LANDER UNIVERSITY                                           ","2003-2004",15,"Soccer",106171,215892,-109721,70217,133021,-62804,35954,82871,-46917,"27","21",18525,19868
"13648",213385,"LAFAYETTE COLLEGE                                           ","2003-2004",26,"Volleyball",31107,140933,-109826,0,0,0,31107,140933,-109826,".","13",0,28096
"6855",206622,"XAVIER UNIVERSITY                                           ","2003-2004",12,"Rifle",5214,115136,-109922,2607,57568,-54961,2607,57568,-54961,"6","0",21554,21554
"14031",123651,"VANGUARD UNIVERSITY OF SOUTHERN CALIFORNIA                  ","2003-2004",26,"Volleyball",56000,165932,-109932,0,0,0,56000,165932,-109932,"0","13",0,13315
"9610",217165,"BRYANT COLLEGE                                              ","2003-2004",16,"Softball",37596,147709,-110113,0,0,0,37596,147709,-110113,".","18",0,45432
"6936",168421,"WORCESTER POLYTECHNIC INSTITUTE                             ","2003-2004",13,"Rowing",61458,171681,-110223,32629,92882,-60253,28829,78799,-49970,"44","23",33755,31146
"10612",234207,"WASHINGTON AND LEE UNIVERSITY                               ","2003-2004",19,"Swimming",18520,128849,-110329,8001,57054,-49053,10519,71795,-61276,"14","15",18053,20218
"9203",230746,"SALT LAKE COMMUNITY COLLEGE                                 ","2003-2004",16,"Softball",30175,140509,-110334,0,0,0,30175,140509,-110334,".","15",0,39080
"11736",164988,"BOSTON UNIVERSITY                                           ","2003-2004",22,"Tennis",34801,145143,-110342,11206,43140,-31934,23595,102003,-78408,"14","9",22526,33227
"5342",181002,"CREIGHTON UNIVERSITY                                        ","2003-2004",8,"Golf",22700,133376,-110676,11350,64538,-53188,11350,68838,-57488,"9","9",15029,15029
"4489",196149,"SUNY COLLEGE AT CORTLAND                                    ","2003-2004",7,"Football",144622,255350,-110728,144622,255350,-110728,0,0,0,"96",".",69713,0
"2966",180814,"BELLEVUE UNIVERSITY                                         ","2003-2004",2,"Basketball",4000,114775,-110775,4000,114775,-110775,0,0,0,"15",".",45775,0
"866",219383,"UNIVERSITY OF SIOUX FALLS                                   ","2003-2004",1,"Baseball",3118,113981,-110863,3118,113981,-110863,0,0,0,"25",".",17842,0
"5583",179566,"SOUTHWEST MISSOURI STATE UNIVERSITY                         ","2003-2004",8,"Golf",173755,284905,-111150,85487,122015,-36528,88268,162890,-74622,"10","10",28225,30760
"2224",168342,"WILLIAMS COLLEGE                                            ","2003-2004",2,"Basketball",60046,171282,-111236,30519,89177,-58658,29527,82105,-52578,"19","19",36672,22115
"7919",228981,"TEXAS LUTHERAN UNIVERSITY                                   ","2003-2004",15,"Soccer",6008,117510,-111502,4148,66548,-62400,1860,50962,-49102,"25","23",18624,19241
"6697",234085,"VIRGINIA MILITARY INSTITUTE                                 ","2003-2004",11,"Lacrosse",28788,140302,-111514,28788,140302,-111514,0,0,0,"43",".",35069,0
"3655",130943,"UNIVERSITY OF DELAWARE                                      ","2003-2004",3,"All Track Combined",370977,482552,-111575,134180,177804,-43624,236797,304748,-67951,"105","138",49803,61217
"14531",154590,"WILLIAM PENN UNIVERSITY                                     ","2003-2004",26,"Volleyball",19366,131069,-111703,0,0,0,19366,131069,-111703,".","12",0,19368
"2979",206835,"OKLAHOMA WESLEYAN UNIVERSITY                                ","2003-2004",2,"Basketball",51511,163271,-111760,29842,93419,-63577,21669,69852,-48183,"13","12",14063,13066
"5490",180489,"THE UNIVERSITY OF MONTANA-MISSOULA                          ","2003-2004",8,"Golf",55550,167463,-111913,0,0,0,55550,167463,-111913,".","7",0,41023
"16833",173142,"BETHANY LUTHERAN COLLEGE                                    ","2003-2004",39,"Total Participants",256918,368907,-111989,113310,162907,-49597,143608,206000,-62392,"71","85",59686,68659
"4247",131496,"GEORGETOWN UNIVERSITY                                       ","2003-2004",6,"Field hocky",15380,127380,-112000,0,0,0,15380,127380,-112000,".","22",0,26613
"16501",141167,"THOMAS UNIVERSITY                                           ","2003-2004",39,"Total Participants",182841,294860,-112019,98748,157157,-58409,84093,137703,-53610,"61","44",67019,65386
"9844",179645,"THREE RIVERS COMMUNITY COLLEGE                              ","2003-2004",16,"Softball",584,112676,-112092,0,0,0,584,112676,-112092,".","12",0,44548
"10521",196176,"SUNY COLLEGE AT NEW PALTZ                                   ","2003-2004",19,"Swimming",1000,113096,-112096,500,55593,-55093,500,57503,-57003,"12","21",14764,16349
"2466",221971,"UNION UNIVERSITY                                            ","2003-2004",2,"Basketball",614402,726714,-112312,318432,371303,-52871,295970,355411,-59441,"14","11",54428,43450
"11091",138983,"AUGUSTA STATE UNIVERSITY                                    ","2003-2004",22,"Tennis",44191,156523,-112332,21983,74809,-52826,22208,81714,-59506,"7","6",16004,15450
"11192",154095,"UNIVERSITY OF NORTHERN IOWA                                 ","2003-2004",22,"Tennis",27821,140198,-112377,0,0,0,27821,140198,-112377,".","8",0,16636
"7886",233426,"ROANOKE COLLEGE                                             ","2003-2004",15,"Soccer",3646,116066,-112420,2200,58540,-56340,1446,57526,-56080,"23","24",23540,22526
"14622",221731,"TENNESSEE WESLEYAN COLLEGE                                  ","2003-2004",26,"Volleyball",22550,135050,-112500,0,0,0,22550,135050,-112500,".","15",0,8750
"4705",237367,"FAIRMONT STATE COLLEGE                                      ","2003-2004",7,"Football",261663,374227,-112564,261663,374227,-112564,0,0,0,"102",".",50117,0
"5546",218973,"WOFFORD COLLEGE                                             ","2003-2004",8,"Golf",128581,241174,-112593,102822,110757,-7935,25759,130417,-104658,"11","6",27460,18331
"17048",233499,"SAINT PAULS COLLEGE                                         ","2003-2004",39,"Total Participants",45038,157676,-112638,16744,69778,-53034,28294,87898,-59604,"70","73",79539,68957
"3145",110510,"CALIFORNIA STATE UNIVERSITY-SAN BERNARDINO                  ","2003-2004",2,"Basketball",379634,492339,-112705,208009,238767,-30758,171625,253572,-81947,"17","17",41377,40711
"1951",182290,"UNIVERSITY OF NEVADA-RENO                                   ","2003-2004",2,"Basketball",1974030,2087175,-113145,1955200,1278945,676255,18830,808230,-789400,"14","18",226260,179355
"12235",207500,"UNIVERSITY OF OKLAHOMA NORMAN CAMPUS                        ","2003-2004",25,"Track and Field, X-Country",8282,121492,-113210,5726,78347,-72621,2556,43145,-40589,"19","14",28204,16155
"5256",153658,"UNIVERSITY OF IOWA                                          ","2003-2004",8,"Golf",49588,162823,-113235,2188,63955,-61767,47400,98868,-51468,"16","10",39015,44619
"11404",190415,"CORNELL UNIVERSITY-ENDOWED COLLEGES                         ","2003-2004",22,"Tennis",52631,166013,-113382,36864,76861,-39997,15767,89152,-73385,"15","11",31095,35152
"2149",152336,"UNIVERSITY OF SAINT FRANCIS-FT WAYNE                        ","2003-2004",2,"Basketball",60000,173463,-113463,30000,86309,-56309,30000,87154,-57154,"19","17",29927,29470
"12473",105330,"NORTHERN ARIZONA UNIVERSITY                                 ","2003-2004",25,"Track and Field, X-Country",2650,116145,-113495,1325,45200,-43875,1325,70945,-69620,"8","12",11999,19492
"14261",108092,"UNIVERSITY OF ARKANSAS AT FT SMITH                          ","2003-2004",26,"Volleyball",5837,119340,-113503,0,0,0,5837,119340,-113503,".","10",0,19444
"4409",176947,"CENTRAL METHODIST COLLEGE                                   ","2003-2004",7,"Football",63151,176811,-113660,63151,176811,-113660,0,0,0,"124",".",54311,0
"4056",197869,"APPALACHIAN STATE UNIVERSITY                                ","2003-2004",6,"Field hocky",11120,124896,-113776,0,0,0,11120,124896,-113776,".","19",0,41046
"13033",200332,"NORTH DAKOTA STATE UNIVERSITY-MAIN CAMPUS                   ","2003-2004",26,"Volleyball",225839,339626,-113787,0,0,0,225839,339626,-113787,".","14",0,56891
"1099",213385,"LAFAYETTE COLLEGE                                           ","2003-2004",1,"Baseball",163021,276843,-113822,163021,276843,-113822,0,0,0,"31",".",63780,0
"1974",200341,"WILLISTON STATE COLLEGE                                     ","2003-2004",2,"Basketball",89869,203790,-113921,54461,119575,-65114,35408,84215,-48807,"15","11",28838,23953
"10864",228796,"THE UNIVERSITY OF TEXAS AT EL PASO                          ","2003-2004",22,"Tennis",144902,258858,-113956,0,0,0,144902,258858,-113956,".","8",0,66605
"11438",221731,"TENNESSEE WESLEYAN COLLEGE                                  ","2003-2004",22,"Tennis",9500,123500,-114000,4750,61750,-57000,4750,61750,-57000,"8","6",3850,3850
"2234",171571,"OAKLAND UNIVERSITY                                          ","2003-2004",2,"Basketball",1137362,1251390,-114028,727900,668179,59721,409462,583211,-173749,"17","15",170452,153436
"7489",157386,"MOREHEAD STATE UNIVERSITY                                   ","2003-2004",15,"Soccer",111955,226109,-114154,0,0,0,111955,226109,-114154,"0","23",0,47210
"17089",168005,"SUFFOLK UNIVERSITY                                          ","2003-2004",39,"Total Participants",87850,202010,-114160,64800,136271,-71471,23050,65739,-42689,"117","57",79800,38050
"10113",131496,"GEORGETOWN UNIVERSITY                                       ","2003-2004",18,"Swimming and Diving",37331,151514,-114183,18665,71366,-52701,18666,80148,-61482,"16","18",36206,36207
"7242",177968,"LINDENWOOD UNIVERSITY                                       ","2003-2004",15,"Soccer",55925,170137,-114212,26910,88507,-61597,29015,81630,-52615,"72","33",61597,52615
"6999",181002,"CREIGHTON UNIVERSITY                                        ","2003-2004",13,"Rowing",23478,137762,-114284,0,0,0,23478,137762,-114284,".","35",0,55652
"3305",230782,"WEBER STATE UNIVERSITY                                      ","2003-2004",2,"Basketball",1067182,1181513,-114331,780774,667305,113469,286408,514208,-227800,"16","15",137146,115168
"8526",170639,"LAKE SUPERIOR STATE UNIVERSITY                              ","2003-2004",16,"Softball",10654,124987,-114333,0,0,0,10654,124987,-114333,".","17",0,21870
"7371",156365,"CAMPBELLSVILLE UNIVERSITY                                   ","2003-2004",15,"Soccer",31042,145492,-114450,15936,72736,-56800,15106,72756,-57650,"21","17",12454,11521
"13846",198215,"CATAWBA COLLEGE                                             ","2003-2004",26,"Volleyball",25920,140392,-114472,0,0,0,25920,140392,-114472,".","16",0,21570
"10927",232566,"LONGWOOD UNIVERSITY                                         ","2003-2004",22,"Tennis",11212,125685,-114473,7955,63699,-55744,3257,61986,-58729,"7","12",7534,6738
"13530",219383,"UNIVERSITY OF SIOUX FALLS                                   ","2003-2004",26,"Volleyball",6430,121271,-114841,0,0,0,6430,121271,-114841,"0","20",0,17905
"432",154697,"BARTON COUNTY COMMUNITY COLLEGE                             ","2003-2004",1,"Baseball",33200,148074,-114874,33200,148074,-114874,0,0,0,"32",".",34011,0
"10438",128771,"CENTRAL CONNECTICUT STATE UNIVERSITY                        ","2003-2004",18,"Swimming and Diving",88550,203480,-114930,0,0,0,88550,203480,-114930,".","14",0,37350
"3321",201928,"CINCINNATI STATE TECHNICAL AND COMMUNITY COLLEGE            ","2003-2004",2,"Basketball",50000,165000,-115000,25000,63000,-38000,25000,102000,-77000,"13","13",20000,40000
"12953",198899,"MARS HILL COLLEGE                                           ","2003-2004",25,"Track and Field, X-Country",101590,216753,-115163,50795,139345,-88550,50795,77408,-26613,"29","21",23293,23293
"3038",115728,"HOLY NAMES UNIVERSITY                                       ","2003-2004",2,"Basketball",200,115420,-115220,100,34616,-34516,100,80804,-80704,"17","17",28225,68346
"6843",102614,"UNIVERSITY OF ALASKA FAIRBANKS                              ","2003-2004",12,"Rifle",23297,138618,-115321,10484,69983,-59499,12813,68635,-55822,"4","5",15742,19240
"9893",112826,"CONTRA COSTA COLLEGE                                        ","2003-2004",16,"Softball",3000,118350,-115350,0,0,0,3000,118350,-115350,".","14",0,8250
"14605",179566,"SOUTHWEST MISSOURI STATE UNIVERSITY                         ","2003-2004",26,"Volleyball",315926,431365,-115439,0,0,0,315926,431365,-115439,".","14",0,75761
"402",175935,"MERIDIAN COMMUNITY COLLEGE                                  ","2003-2004",1,"Baseball",52052,167569,-115517,52052,167569,-115517,0,0,0,"26",".",88569,0
"13086",208488,"CONCORDIA UNIVERSITY                                        ","2003-2004",26,"Volleyball",35989,151604,-115615,0,0,0,35989,151604,-115615,".","12",0,23960
"10440",200280,"UNIVERSITY OF NORTH DAKOTA-MAIN CAMPUS                      ","2003-2004",18,"Swimming and Diving",196745,312381,-115636,88934,146730,-57796,107811,165651,-57840,"27","39",47292,47293
"3406",172644,"WAYNE STATE UNIVERSITY                                      ","2003-2004",2,"Basketball",585144,700818,-115674,361404,384880,-23476,223740,315938,-92198,"15","11",55083,46329
"4966",168421,"WORCESTER POLYTECHNIC INSTITUTE                             ","2003-2004",7,"Football",56449,172192,-115743,56449,172192,-115743,0,0,0,"91",".",56689,0
"12772",123572,"SONOMA STATE UNIVERSITY                                     ","2003-2004",25,"Track and Field, X-Country",9345,125133,-115788,0,0,0,9345,125133,-115788,".","25",0,23092
"9030",197036,"UNITED STATES MILITARY ACADEMY                              ","2003-2004",16,"Softball",66875,183261,-116386,0,0,0,66875,183261,-116386,".","20",0,62325
"10454",154095,"UNIVERSITY OF NORTHERN IOWA                                 ","2003-2004",18,"Swimming and Diving",62600,179155,-116555,0,0,0,62600,179155,-116555,".","18",0,31289
"1574",197984,"BELMONT ABBEY COLLEGE                                       ","2003-2004",1,"Baseball",12677,129367,-116690,12677,129367,-116690,0,0,0,"34",".",22414,0
"5861",234030,"VIRGINIA COMMONWEALTH UNIVERSITY                            ","2003-2004",8,"Golf",35100,151793,-116693,35100,151793,-116693,0,0,0,"8",".",30862,0
"8292",159966,"NICHOLLS STATE UNIVERSITY                                   ","2003-2004",15,"Soccer",4187,120922,-116735,0,0,0,4187,120922,-116735,".","23",0,16741
"3559",219259,"NORTHERN STATE UNIVERSITY                                   ","2003-2004",3,"All Track Combined",36481,153232,-116751,19001,75687,-56686,17480,77545,-60065,"64","60",26935,23806
"13749",237154,"MOUNTAIN STATE UNIVERSITY                                   ","2003-2004",26,"Volleyball",4050,120801,-116751,0,0,0,4050,120801,-116751,".","11",0,40730
"11028",157386,"MOREHEAD STATE UNIVERSITY                                   ","2003-2004",22,"Tennis",68279,185080,-116801,36687,80470,-43783,31592,104610,-73018,"7","6",11145,11145
"1508",157076,"KENTUCKY WESLEYAN COLLEGE                                   ","2003-2004",1,"Baseball",125875,242717,-116842,125875,242717,-116842,0,0,0,"43",".",42577,0
"16008",234979,"COLUMBIA BASIN COLLEGE                                      ","2003-2004",39,"Total Participants",171704,288621,-116917,86192,134461,-48269,85512,154160,-68648,"73","54",76148,90349
"2873",155450,"LABETTE COMMUNITY COLLEGE                                   ","2003-2004",2,"Basketball",10477,127518,-117041,3648,64915,-61267,6829,62603,-55774,"13","12",22018,23671
"7360",152530,"TAYLOR UNIVERSITY-UPLAND                                    ","2003-2004",15,"Soccer",9060,126153,-117093,7110,65959,-58849,1950,60194,-58244,"15","18",20997,18346
"15738",134945,"JACKSONVILLE UNIVERSITY                                     ","2003-2004",39,"Total Participants",2439932,2557094,-117162,1090902,1063560,27342,1349030,1493534,-144504,"256","130",461144,287283
"7945",152336,"UNIVERSITY OF SAINT FRANCIS-FT WAYNE                        ","2003-2004",15,"Soccer",41600,158791,-117191,20800,84422,-63622,20800,74369,-53569,"34","24",21068,22782
"16085",216010,"SHIPPENSBURG UNIVERSITY OF PENNSYLVANIA                     ","2003-2004",39,"Total Participants",1207904,1325138,-117234,470640,526231,-55591,737264,798907,-61643,"332","263",282515,244633
"6334",197036,"UNITED STATES MILITARY ACADEMY                              ","2003-2004",9,"Gymnastics",122336,239645,-117309,122336,239645,-117309,0,0,0,"15",".",64853,0
"5248",131496,"GEORGETOWN UNIVERSITY                                       ","2003-2004",8,"Golf",178529,295844,-117315,116263,135050,-18787,62266,160794,-98528,"15","9",49214,67709
"7902",195030,"UNIVERSITY OF ROCHESTER                                     ","2003-2004",15,"Soccer",134470,251814,-117344,100359,135685,-35326,34111,116129,-82018,"24","26",38163,37810
"9358",154004,"MORNINGSIDE COLLEGE                                         ","2003-2004",16,"Softball",27000,144371,-117371,0,0,0,27000,144371,-117371,".","28",0,43787
"1069",138983,"AUGUSTA STATE UNIVERSITY                                    ","2003-2004",1,"Baseball",51150,168603,-117453,51150,168603,-117453,0,0,0,"33",".",44698,0
"9129",110495,"CALIFORNIA STATE UNIVERSITY-STANISLAUS                      ","2003-2004",16,"Softball",24387,141870,-117483,0,0,0,24387,141870,-117483,".","14",0,43473
"16646",115728,"HOLY NAMES UNIVERSITY                                       ","2003-2004",39,"Total Participants",600,118094,-117494,300,57425,-57125,300,60669,-60369,"49","48",64170,112214
"83",198215,"CATAWBA COLLEGE                                             ","2003-2004",1,"Baseball",49360,166870,-117510,49360,166870,-117510,0,0,0,"26",".",37860,0
"5105",139931,"GEORGIA SOUTHERN UNIVERSITY                                 ","2003-2004",8,"Golf",38267,155861,-117594,38267,155861,-117594,0,0,0,"14",".",40207,0
"17124",119137,"MOORPARK COLLEGE                                            ","2003-2004",39,"Total Participants",83946,201626,-117680,49621,111746,-62125,34325,89880,-55555,"241","92",77739,42732
"6582",232566,"LONGWOOD UNIVERSITY                                         ","2003-2004",11,"Lacrosse",8234,125950,-117716,0,0,0,8234,125950,-117716,".","23",0,43402
"13814",226204,"LEE COLLEGE                                                 ","2003-2004",26,"Volleyball",34056,151804,-117748,0,0,0,34056,151804,-117748,".","10",0,34056
"2211",207865,"SOUTHWESTERN OKLAHOMA STATE UNIVERSITY                      ","2003-2004",2,"Basketball",45342,163293,-117951,22671,86492,-63821,22671,76801,-54130,"18","13",20786,20786
"6279",179159,"SAINT LOUIS UNIVERSITY-MAIN CAMPUS                          ","2003-2004",8,"Golf",13243,131301,-118058,13243,131301,-118058,0,0,0,"10",".",26355,0
"8889",152099,"OAKLAND CITY UNIVERSITY                                     ","2003-2004",16,"Softball",11000,129105,-118105,0,0,0,11000,129105,-118105,".","18",0,13047
"4857",117645,"LONG BEACH CITY COLLEGE                                     ","2003-2004",7,"Football",47483,165593,-118110,47483,165593,-118110,0,0,0,"86",".",45211,0
"16205",224323,"UNIVERSITY OF DALLAS                                        ","2003-2004",39,"Total Participants",355392,473509,-118117,139647,233968,-94321,215745,239541,-23796,"106","130",153607,179959
"1559",204617,"OHIO DOMINICAN UNIVERSITY                                   ","2003-2004",1,"Baseball",27812,145977,-118165,27812,145977,-118165,0,0,0,"25",".",17570,0
"15584",153737,"KIRKWOOD COMMUNITY COLLEGE                                  ","2003-2004",39,"Total Participants",31350,149950,-118600,13800,65200,-51400,17550,84750,-67200,"52","42",36460,40670
"9637",219806,"CARSON-NEWMAN COLLEGE                                       ","2003-2004",16,"Softball",16786,135678,-118892,0,0,0,16786,135678,-118892,".","16",0,19600
"5213",209807,"PORTLAND STATE UNIVERSITY                                   ","2003-2004",8,"Golf",59133,178084,-118951,0,0,0,59133,178084,-118951,".","9",0,41347
"14230",136172,"UNIVERSITY OF NORTH FLORIDA                                 ","2003-2004",26,"Volleyball",52998,172026,-119028,0,0,0,52998,172026,-119028,"0","13",0,42967
"16224",228486,"SOUTHWESTERN CHRISTIAN COLLEGE                              ","2003-2004",39,"Total Participants",800,119860,-119060,450,74860,-74410,350,45000,-44650,"55","45",12716,12462
"7735",199698,"ST ANDREWS PRESBYTERIAN COLLEGE                             ","2003-2004",15,"Soccer",117866,236966,-119100,63905,111705,-47800,53961,125261,-71300,"30","27",18905,25961
"16477",211644,"CLARION UNIVERSITY OF PENNSYLVANIA                          ","2003-2004",39,"Total Participants",823222,942352,-119130,403304,439503,-36199,419918,502849,-82931,"226","183",166498,123397
"15075",172699,"WESTERN MICHIGAN UNIVERSITY                                 ","2003-2004",29,"Other Sports",53706,173038,-119332,0,0,0,53706,173038,-119332,".","52",0,117339
"16465",151111,"INDIANA UNIVERSITY-PURDUE UNIVERSITY-INDIANAPOLIS           ","2003-2004",39,"Total Participants",50471,169846,-119375,21385,77292,-55907,29086,92554,-63468,"96","122",57295,59276
"15472",237330,"CONCORD COLLEGE                                             ","2003-2004",39,"Total Participants",397839,517364,-119525,184677,263771,-79094,213162,253593,-40431,"182","81",155800,68705
"3465",233897,"THE UNIVERSITY OF VIRGINIA'S COLLEGE AT WISE                ","2003-2004",2,"Basketball",103860,223517,-119657,54552,118021,-63469,49308,105496,-56188,"44","30",35759,32287
"6433",172644,"WAYNE STATE UNIVERSITY                                      ","2003-2004",10,"Ice Hockey",1534062,1653742,-119680,790722,907194,-116472,743340,746548,-3208,"28","24",277367,233427
"5541",199139,"UNIVERSITY OF NORTH CAROLINA AT CHARLOTTE                   ","2003-2004",8,"Golf",6329,126092,-119763,6329,126092,-119763,0,0,0,"9",".",30553,0
"5439",239105,"MARQUETTE UNIVERSITY                                        ","2003-2004",8,"Golf",8406,128179,-119773,8406,128179,-119773,0,0,0,"7",".",50287,0
"16684",229814,"WEST TEXAS A &amp; M UNIVERSITY                                 ","2003-2004",39,"Total Participants",354702,474528,-119826,160327,199899,-39572,194375,274629,-80254,"196","84",262051,173962
"13345",197036,"UNITED STATES MILITARY ACADEMY                              ","2003-2004",26,"Volleyball",48423,168369,-119946,0,0,0,48423,168369,-119946,".","18",0,34342
"8031",143358,"BRADLEY UNIVERSITY                                          ","2003-2004",15,"Soccer",470374,590367,-119993,470374,590367,-119993,0,0,0,"32","0",65751,0
"17100",132471,"BARRY UNIVERSITY                                            ","2003-2004",39,"Total Participants",873985,994092,-120107,347761,394861,-47100,526224,599231,-73007,"89","126",264576,363579
"14918",213543,"LEHIGH UNIVERSITY                                           ","2003-2004",28,"Wrestling",475301,595441,-120140,475301,595441,-120140,0,0,0,"43",".",105751,0
"8343",161253,"UNIVERSITY OF MAINE                                         ","2003-2004",15,"Soccer",449078,569289,-120211,164968,184155,-19187,284110,385134,-101024,"23","25",38529,52746
"2925",204936,"OTTERBEIN COLLEGE                                           ","2003-2004",2,"Basketball",77005,197357,-120352,40298,118303,-78005,36707,79054,-42347,"19","22",22243,23310
"1136",112826,"CONTRA COSTA COLLEGE                                        ","2003-2004",1,"Baseball",3000,123360,-120360,3000,123360,-120360,0,0,0,"26",".",8650,0
"15817",203128,"HIRAM COLLEGE                                               ","2003-2004",39,"Total Participants",360041,480455,-120414,166576,218651,-52075,193465,261804,-68339,"170","114",133432,101136
"17304",227766,"RICHLAND COLLEGE                                            ","2003-2004",39,"Total Participants",6600,127065,-120465,5500,80210,-74710,1100,46855,-45755,"72","31",49995,18615
"17337",222567,"ALVIN COMMUNITY COLLEGE                                     ","2003-2004",39,"Total Participants",60633,181133,-120500,24560,77060,-52500,36073,104073,-68000,"42","28",24560,36073
"5172",201885,"UNIVERSITY OF CINCINNATI-MAIN CAMPUS                        ","2003-2004",8,"Golf",103022,223650,-120628,13362,68717,-55355,89660,154933,-65273,"10","9",27330,35945
"16838",169798,"EASTERN MICHIGAN UNIVERSITY                                 ","2003-2004",39,"Total Participants",4645364,4766060,-120696,1607031,1616454,-9423,3038333,3149606,-111273,"260","246",921799,634562
"8571",213543,"LEHIGH UNIVERSITY                                           ","2003-2004",16,"Softball",239565,360291,-120726,0,0,0,239565,360291,-120726,".","22",0,64195
"2406",142443,"NORTH IDAHO COLLEGE                                         ","2003-2004",2,"Basketball",209016,329764,-120748,113556,186926,-73370,95460,142838,-47378,"14","15",63175,47913
"9689",101286,"GEORGE C WALLACE COMMUNITY COLLEGE-DOTHAN                   ","2003-2004",16,"Softball",14844,135675,-120831,0,0,0,14844,135675,-120831,".","22",0,53526
"10372",164076,"TOWSON UNIVERSITY                                           ","2003-2004",18,"Swimming and Diving",37355,158395,-121040,19262,78697,-59435,18093,79698,-61605,"19","30",17473,17473
"14765",200332,"NORTH DAKOTA STATE UNIVERSITY-MAIN CAMPUS                   ","2003-2004",28,"Wrestling",141358,262436,-121078,141358,262436,-121078,0,0,0,"33",".",57165,0
"4825",199999,"WINSTON-SALEM STATE UNIVERSITY                              ","2003-2004",7,"Football",178676,299958,-121282,178676,299958,-121282,0,0,0,"110",".",96742,0
"3502",241100,"AMERICAN UNIVERSITY OF PUERTO RICO                          ","2003-2004",3,"All Track Combined",34794,156253,-121459,19157,140616,-121459,15637,15637,0,"8","4",16532,6567
"45",213543,"LEHIGH UNIVERSITY                                           ","2003-2004",1,"Baseball",369098,490709,-121611,369098,490709,-121611,0,0,0,"33",".",75889,0
"6485",240480,"UNIVERSITY OF WISCONSIN-STEVENS POINT                       ","2003-2004",10,"Ice Hockey",190357,312039,-121682,125588,182570,-56982,64769,129469,-64700,"28","24",54251,58414
"10142",237525,"MARSHALL UNIVERSITY                                         ","2003-2004",18,"Swimming and Diving",106934,228716,-121782,0,0,0,106934,228716,-121782,".","15",0,41790
"11474",159009,"GRAMBLING STATE UNIVERSITY                                  ","2003-2004",22,"Tennis",2,121884,-121882,1,50170,-50169,1,71714,-71713,"7","9",23918,25948
"6720",165936,"GORDON COLLEGE                                              ","2003-2004",11,"Lacrosse",13149,135079,-121930,9149,78286,-69137,4000,56793,-52793,"22","17",26922,31313
"12842",215655,"ROBERT MORRIS UNIVERSITY                                    ","2003-2004",25,"Track and Field, X-Country",349419,471461,-122042,143288,230792,-87504,206131,240669,-34538,"82","64",40449,41151
"5560",177968,"LINDENWOOD UNIVERSITY                                       ","2003-2004",8,"Golf",52542,174602,-122060,26271,91792,-65521,26271,82810,-56539,"38","18",65521,56539
"10455",159993,"UNIVERSITY OF LOUISIANA AT MONROE                           ","2003-2004",18,"Swimming and Diving",14394,136496,-122102,7197,76579,-69382,7197,59917,-52720,"14","13",5516,14034
"17231",211088,"ARCADIA UNIVERSITY                                          ","2003-2004",39,"Total Participants",61900,184042,-122142,26754,78215,-51461,35146,105827,-70681,"94","130",57565,67573
"7564",229018,"THE UNIVERSITY OF TEXAS OF THE PERMIAN BASIN                ","2003-2004",15,"Soccer",2,122222,-122220,1,62611,-62610,1,59611,-59610,"23","21",21300,18250
"5115",145813,"ILLINOIS STATE UNIVERSITY                                   ","2003-2004",8,"Golf",147065,269367,-122302,104907,137373,-32466,42158,131994,-89836,"11","9",31888,24381
"2053",168591,"ALMA COLLEGE                                                ","2003-2004",2,"Basketball",77439,199776,-122337,29402,95298,-65896,48037,104478,-56441,"22","20",22586,22949
"8635",232566,"LONGWOOD UNIVERSITY                                         ","2003-2004",16,"Softball",25345,147786,-122441,0,0,0,25345,147786,-122441,".","14",0,44248
"5959",179043,"ROCKHURST UNIVERSITY                                        ","2003-2004",8,"Golf",1636,124135,-122499,818,51312,-50494,818,72823,-72005,"12","11",51312,72820
"9438",218742,"UNIVERSITY OF SOUTH CAROLINA-SPARTANBURG                    ","2003-2004",16,"Softball",16852,139355,-122503,0,0,0,16852,139355,-122503,".","19",0,41214
"15027",243744,"STANFORD UNIVERSITY                                         ","2003-2004",28,"Wrestling",78366,200913,-122547,78366,200913,-122547,0,0,0,"35",".",50744,0
"11589",230782,"WEBER STATE UNIVERSITY                                      ","2003-2004",22,"Tennis",117196,239862,-122666,71665,109547,-37882,45531,130315,-84784,"11","11",14959,17772
"6470",196149,"SUNY COLLEGE AT CORTLAND                                    ","2003-2004",10,"Ice Hockey",34431,157200,-122769,31053,81326,-50273,3378,75874,-72496,"30","21",41797,34034
"12895",181011,"DANA COLLEGE                                                ","2003-2004",25,"Track and Field, X-Country",10150,132950,-122800,5075,72550,-67475,5075,60400,-55325,"29","17",8936,5026
"4405",168591,"ALMA COLLEGE                                                ","2003-2004",7,"Football",88551,211363,-122812,88551,211363,-122812,0,0,0,"105",".",59792,0
"10862",180179,"MONTANA STATE UNIVERSITY-BILLINGS                           ","2003-2004",22,"Tennis",6812,129933,-123121,3707,75818,-72111,3105,54115,-51010,"12","7",14786,15036
"6813",130943,"UNIVERSITY OF DELAWARE                                      ","2003-2004",11,"Lacrosse",751338,874667,-123329,294403,353739,-59336,456935,520928,-63993,"42","28",67291,65136
"9728",178615,"TRUMAN STATE UNIVERSITY                                     ","2003-2004",16,"Softball",11574,134967,-123393,0,0,0,11574,134967,-123393,".","19",0,37079
"6624",129215,"EASTERN CONNECTICUT STATE UNIVERSITY                        ","2003-2004",11,"Lacrosse",36550,160212,-123662,18275,79231,-60956,18275,80981,-62706,"36","32",45205,25726
"11853",206084,"UNIVERSITY OF TOLEDO                                        ","2003-2004",23,"Track and Field, Indoor",1253,125000,-123747,0,0,0,1253,125000,-123747,".","34",0,21590
"12046",206084,"UNIVERSITY OF TOLEDO                                        ","2003-2004",24,"Track and Field, Outdoor",1253,125000,-123747,0,0,0,1253,125000,-123747,".","36",0,22860
"769",217165,"BRYANT COLLEGE                                              ","2003-2004",1,"Baseball",95429,219586,-124157,95429,219586,-124157,0,0,0,"29",".",96048,0
"6597",196246,"SUNY COLLEGE AT PLATTSBURGH                                 ","2003-2004",11,"Lacrosse",150,124415,-124265,150,124415,-124265,0,0,0,"28",".",53139,0
"16476",120421,"OXNARD COLLEGE                                              ","2003-2004",39,"Total Participants",40225,164500,-124275,27949,100500,-72551,12276,64000,-51724,"70","51",38004,22467
"10321",145813,"ILLINOIS STATE UNIVERSITY                                   ","2003-2004",18,"Swimming and Diving",82725,207069,-124344,0,0,0,82725,207069,-124344,".","34",0,28704
"16497",241100,"AMERICAN UNIVERSITY OF PUERTO RICO                          ","2003-2004",39,"Total Participants",184403,308794,-124391,106329,227788,-121459,78074,81006,-2932,"44","31",66335,48225
"627",154518,"WALDORF COLLEGE                                             ","2003-2004",1,"Baseball",23000,147596,-124596,23000,147596,-124596,0,0,0,"25",".",23000,0
"17159",196024,"SUNY COLLEGE OF TECHNOLOGY AT DELHI                         ","2003-2004",39,"Total Participants",124307,249054,-124747,73151,157967,-84816,51156,91087,-39931,"148","103",98771,56196
"11724",199102,"NORTH CAROLINA  A &amp;T STATE UNIVERSITY                       ","2003-2004",22,"Tennis",21402,146211,-124809,10476,64454,-53978,10926,81757,-70831,"8","9",12572,10597
"12538",221768,"THE UNIVERSITY OF TENNESSEE-MARTIN                          ","2003-2004",25,"Track and Field, X-Country",558,125406,-124848,414,50116,-49702,144,75290,-75146,"9","6",8186,6992
"2028",206923,"CARL ALBERT STATE COLLEGE                                   ","2003-2004",2,"Basketball",2982,128074,-125092,1705,67119,-65414,1277,60955,-59678,"14","16",22539,21957
"11815",181394,"UNIVERSITY OF NEBRASKA AT OMAHA                             ","2003-2004",23,"Track and Field, Indoor",11705,136832,-125127,0,0,0,11705,136832,-125127,".","34",0,37233
"12257",181394,"UNIVERSITY OF NEBRASKA AT OMAHA                             ","2003-2004",25,"Track and Field, X-Country",11705,136832,-125127,0,0,0,11705,136832,-125127,".","34",0,37234
"9215",237969,"WEST VIRGINIA WESLEYAN COLLEGE                              ","2003-2004",16,"Softball",57445,182595,-125150,0,0,0,57445,182595,-125150,".","18",0,18858
"16464",190512,"CUNY BERNARD M BARUCH COLLEGE                               ","2003-2004",39,"Total Participants",91000,216350,-125350,42500,144400,-101900,48500,71950,-23450,"83","78",59300,50100
"10908",181002,"CREIGHTON UNIVERSITY                                        ","2003-2004",22,"Tennis",14597,140161,-125564,7298,71331,-64033,7299,68830,-61531,"9","9",13244,13244
"5485",135726,"UNIVERSITY OF MIAMI                                         ","2003-2004",8,"Golf",262636,388374,-125738,0,0,0,262636,388374,-125738,".","8",0,56766
"14798",197869,"APPALACHIAN STATE UNIVERSITY                                ","2003-2004",28,"Wrestling",36604,162376,-125772,36604,162376,-125772,0,0,0,"35",".",27573,0
"5055",200059,"DICKINSON STATE UNIVERSITY                                  ","2003-2004",7,"Football",73321,199141,-125820,73321,199141,-125820,0,0,0,"97",".",56379,0
"11445",202480,"UNIVERSITY OF DAYTON                                        ","2003-2004",22,"Tennis",446,126327,-125881,246,54562,-54316,200,71765,-71565,"9","9",12975,20649
"1892",229018,"THE UNIVERSITY OF TEXAS OF THE PERMIAN BASIN                ","2003-2004",2,"Basketball",17486,143468,-125982,14486,75247,-60761,3000,68221,-65221,"28","13",36500,31800
"1242",127741,"UNIVERSITY OF NORTHERN COLORADO                             ","2003-2004",1,"Baseball",84167,210236,-126069,84167,210236,-126069,0,0,0,"35",".",70221,0
"3457",153630,"IOWA WESTERN COMMUNITY COLLEGE                              ","2003-2004",2,"Basketball",181332,307422,-126090,100146,171331,-71185,81186,136091,-54905,"14","9",22846,19134
"15883",155511,"MCPHERSON COLLEGE                                           ","2003-2004",39,"Total Participants",85927,212071,-126144,28301,71551,-43250,57626,140520,-82894,"143","95",86948,75691
"12300",238032,"WEST VIRGINIA UNIVERSITY                                    ","2003-2004",25,"Track and Field, X-Country",100,126339,-126239,0,0,0,100,126339,-126239,".","16",0,24132
"13909",127741,"UNIVERSITY OF NORTHERN COLORADO                             ","2003-2004",26,"Volleyball",169763,296013,-126250,0,0,0,169763,296013,-126250,".","17",0,70123
"10925",109785,"AZUSA PACIFIC UNIVERSITY                                    ","2003-2004",22,"Tennis",64893,191233,-126340,33389,95409,-62020,31504,95824,-64320,"12","12",14788,15455
"13046",217907,"COKER COLLEGE                                               ","2003-2004",26,"Volleyball",14338,140790,-126452,0,0,0,14338,140790,-126452,".","14",0,15504
"7941",206330,"URBANA UNIVERSITY                                           ","2003-2004",15,"Soccer",8702,135195,-126493,4351,84365,-80014,4351,50830,-46479,"47","27",25734,26043
"7606",220215,"FREED-HARDEMAN UNIVERSITY                                   ","2003-2004",15,"Soccer",22800,149355,-126555,11400,74113,-62713,11400,75242,-63842,"22","14",11400,11400
"17028",154749,"BETHEL COLLEGE                                              ","2003-2004",39,"Total Participants",60412,186999,-126587,23163,94685,-71522,37249,92314,-55065,"104","65",97043,70041
"11063",237525,"MARSHALL UNIVERSITY                                         ","2003-2004",22,"Tennis",166357,292954,-126597,0,0,0,166357,292954,-126597,".","10",0,66880
"6549",162654,"GOUCHER COLLEGE                                             ","2003-2004",11,"Lacrosse",29104,155898,-126794,23805,85002,-61197,5299,70896,-65597,"31","19",23754,20176
"10663",198136,"CAMPBELL UNIVERSITY INC                                     ","2003-2004",22,"Tennis",174949,302049,-127100,84175,148698,-64523,90774,153351,-62577,"8","8",30521,29741
"7198",194161,"NYACK COLLEGE                                               ","2003-2004",15,"Soccer",173279,300498,-127219,109687,180973,-71286,63592,119525,-55933,"21","18",21650,19000
"5917",110617,"CALIFORNIA STATE UNIVERSITY-SACRAMENTO                      ","2003-2004",8,"Golf",61774,189086,-127312,22048,70164,-48116,39726,118922,-79196,"10","11",25016,26803
"5953",228796,"THE UNIVERSITY OF TEXAS AT EL PASO                          ","2003-2004",8,"Golf",253329,380733,-127404,149646,191438,-41792,103683,189295,-85612,"14","11",67307,44187
"9793",123651,"VANGUARD UNIVERSITY OF SOUTHERN CALIFORNIA                  ","2003-2004",16,"Softball",67224,194648,-127424,0,0,0,67224,194648,-127424,".","16",0,19000
"1856",126580,"UNIVERSITY OF COLORADO AT COLORADO SPRINGS                  ","2003-2004",2,"Basketball",269382,396900,-127518,136733,197551,-60818,132649,199349,-66700,"17","17",107739,102537
"11210",120883,"UNIVERSITY OF THE PACIFIC                                   ","2003-2004",22,"Tennis",356561,484133,-127572,157275,235962,-78687,199286,248171,-48885,"13","8",25658,17097
"303",175342,"ALCORN STATE UNIVERSITY                                     ","2003-2004",1,"Baseball",4799,132373,-127574,4799,132373,-127574,0,0,0,"27",".",29065,0
"7904",234207,"WASHINGTON AND LEE UNIVERSITY                               ","2003-2004",15,"Soccer",8942,136642,-127700,2908,71499,-68591,6034,65143,-59109,"25","22",19512,8490
"3370",217873,"CLAFLIN UNIVERSITY                                          ","2003-2004",2,"Basketball",39000,167000,-128000,23000,85000,-62000,16000,82000,-66000,"18","13",28000,23000
"3203",220400,"JACKSON STATE COMMUNITY COLLEGE                             ","2003-2004",2,"Basketball",2331,130526,-128195,1143,70673,-69530,1188,59853,-58665,"11","12",8796,7798
"5758",190150,"COLUMBIA UNIVERSITY IN THE CITY OF NEW YORK                 ","2003-2004",8,"Golf",18100,146548,-128448,9050,83715,-74665,9050,62833,-53783,"8","7",37360,30425
"3760",221838,"TENNESSEE STATE UNIVERSITY                                  ","2003-2004",3,"All Track Combined",312610,441131,-128521,99489,142313,-42824,213121,298818,-85697,"24","28",42513,69651
"6305",199120,"UNIVERSITY OF NORTH CAROLINA AT CHAPEL HILL                 ","2003-2004",9,"Gymnastics",170293,298818,-128525,0,0,0,170293,298818,-128525,".","16",0,40773
"243",102067,"SHELTON STATE COMMUNITY COLLEGE                             ","2003-2004",1,"Baseball",821,129474,-128653,821,129474,-128653,0,0,0,"30",".",40009,0
"13447",170639,"LAKE SUPERIOR STATE UNIVERSITY                              ","2003-2004",26,"Volleyball",10816,139554,-128738,0,0,0,10816,139554,-128738,".","16",0,20856
"13094",198136,"CAMPBELL UNIVERSITY INC                                     ","2003-2004",26,"Volleyball",153097,281880,-128783,0,0,0,153097,281880,-128783,".","12",0,53565
"11350",198808,"LEES-MCRAE COLLEGE                                          ","2003-2004",22,"Tennis",22000,150795,-128795,11000,75447,-64447,11000,75348,-64348,"7","6",10251,9974
"12691",194958,"ROBERTS WESLEYAN COLLEGE                                    ","2003-2004",25,"Track and Field, X-Country",69473,198349,-128876,34904,80870,-45966,34569,117479,-82910,"29","46",21300,14017
"3042",101295,"GEORGE C WALLACE STATE COMMUNITY COLL-HANCEVILLE            ","2003-2004",2,"Basketball",38212,167100,-128888,18277,93114,-74837,19935,73986,-54051,"20","16",14400,16592
"1993",155025,"EMPORIA STATE UNIVERSITY                                    ","2003-2004",2,"Basketball",408091,536993,-128902,218861,272426,-53565,189230,264567,-75337,"15","13",50927,47907
"3383",194958,"ROBERTS WESLEYAN COLLEGE                                    ","2003-2004",2,"Basketball",120573,249524,-128951,68754,134121,-65367,51819,115403,-63584,"12","12",21390,25490
"1905",208822,"GEORGE FOX UNIVERSITY                                       ","2003-2004",2,"Basketball",4147,133106,-128959,3797,66564,-62767,350,66542,-66192,"10","11",34586,33030
"2923",102076,"SNEAD STATE COMMUNITY COLLEGE                               ","2003-2004",2,"Basketball",22330,151586,-129256,12371,72503,-60132,9959,79083,-69124,"12","12",30503,37083
"11551",228459,"TEXAS STATE UNIVERSITY-SAN MARCOS                           ","2003-2004",22,"Tennis",6258,135650,-129392,0,0,0,6258,135650,-129392,".","9",0,16434
"14800",219356,"SOUTH DAKOTA STATE UNIVERSITY                               ","2003-2004",28,"Wrestling",6790,136208,-129418,6790,136208,-129418,0,0,0,"30",".",56940,0
"122",101286,"GEORGE C WALLACE COMMUNITY COLLEGE-DOTHAN                   ","2003-2004",1,"Baseball",53202,182658,-129456,53202,182658,-129456,0,0,0,"29",".",85473,0
"16220",187897,"NEW MEXICO HIGHLANDS UNIVERSITY                             ","2003-2004",39,"Total Participants",405973,535514,-129541,108567,164124,-55557,297406,371390,-73984,"160","77",122069,98362
"14631",149772,"WESTERN ILLINOIS UNIVERSITY                                 ","2003-2004",26,"Volleyball",120861,250449,-129588,0,0,0,120861,250449,-129588,".","15",0,43590
"8179",195243,"SAINT THOMAS AQUINAS COLLEGE                                ","2003-2004",15,"Soccer",25991,155615,-129624,11066,63690,-52624,14925,91925,-77000,"18","28",14440,14925
"11645",110617,"CALIFORNIA STATE UNIVERSITY-SACRAMENTO                      ","2003-2004",22,"Tennis",179903,309580,-129677,66390,121942,-55552,113513,187638,-74125,"11","11",26149,49522
"4311",161253,"UNIVERSITY OF MAINE                                         ","2003-2004",7,"Football",2021917,2151661,-129744,2021917,2151661,-129744,0,0,0,"84",".",217712,0
"11354",141264,"VALDOSTA STATE UNIVERSITY                                   ","2003-2004",22,"Tennis",98996,228797,-129801,56266,109659,-53393,42730,119138,-76408,"9","7",13240,10303
"8671",219356,"SOUTH DAKOTA STATE UNIVERSITY                               ","2003-2004",16,"Softball",559,130451,-129892,0,0,0,559,130451,-129892,".","15",0,50820
"314",193292,"MOLLOY COLLEGE                                              ","2003-2004",1,"Baseball",25000,155000,-130000,25000,155000,-130000,0,0,0,"27",".",26000,0
"13266",198808,"LEES-MCRAE COLLEGE                                          ","2003-2004",26,"Volleyball",48493,178622,-130129,23800,68903,-45103,24693,109719,-85026,"15","14",24523,24408
"17033",239248,"MILWAUKEE AREA TECHNICAL COLLEGE                            ","2003-2004",39,"Total Participants",9,130250,-130241,5,80050,-80045,4,50200,-50196,"73","51",52100,44350
"7332",160038,"NORTHWESTERN STATE UNIVERSITY OF LOUISIANA                  ","2003-2004",15,"Soccer",117134,247624,-130490,0,0,0,117134,247624,-130490,".","21",0,45222
"1859",175935,"MERIDIAN COMMUNITY COLLEGE                                  ","2003-2004",2,"Basketball",60210,190944,-130734,30105,98665,-68560,30105,92279,-62174,"14","15",38059,33342
"17255",206923,"CARL ALBERT STATE COLLEGE                                   ","2003-2004",39,"Total Participants",2400,133258,-130858,695,73315,-72620,1705,59943,-58238,"42","34",53173,60194
"1890",200059,"DICKINSON STATE UNIVERSITY                                  ","2003-2004",2,"Basketball",76129,207027,-130898,46798,130472,-83674,29331,76555,-47224,"19","18",38137,26226
"14938",234085,"VIRGINIA MILITARY INSTITUTE                                 ","2003-2004",28,"Wrestling",140398,271396,-130998,140398,271396,-130998,0,0,0,"31",".",18786,0
"6845",176017,"UNIVERSITY OF MISSISSIPPI MAIN CAMPUS                       ","2003-2004",12,"Rifle",0,131157,-131157,0,0,0,0,131157,-131157,".","8",0,37644
"6702",190150,"COLUMBIA UNIVERSITY IN THE CITY OF NEW YORK                 ","2003-2004",11,"Lacrosse",1900,133132,-131232,0,0,0,1900,133132,-131232,".","22",0,35227
"3860",176044,"MISSISSIPPI VALLEY STATE UNIVERSITY                         ","2003-2004",3,"All Track Combined",30930,162397,-131467,15465,79376,-63911,15465,83021,-67556,"32","26",43603,43604
"10824",121345,"POMONA COLLEGE                                              ","2003-2004",22,"Tennis",19303,150814,-131511,7645,37275,-29630,11658,113539,-101881,"17","8",10365,9073
"2592",221351,"RHODES COLLEGE                                              ","2003-2004",2,"Basketball",91100,222749,-131649,48300,135642,-87342,42800,87107,-44307,"15","14",36900,35600
"275",224226,"DALLAS BAPTIST UNIVERSITY                                   ","2003-2004",1,"Baseball",638587,770247,-131660,638587,770247,-131660,0,0,0,"39",".",269147,0
"2301",237154,"MOUNTAIN STATE UNIVERSITY                                   ","2003-2004",2,"Basketball",62274,193986,-131712,62274,193986,-131712,0,0,0,"11",".",66827,0
"1094",218742,"UNIVERSITY OF SOUTH CAROLINA-SPARTANBURG                    ","2003-2004",1,"Baseball",25235,157098,-131863,25235,157098,-131863,0,0,0,"36",".",54927,0
"2502",213321,"KINGS COLLEGE                                               ","2003-2004",2,"Basketball",54661,186553,-131892,24742,91968,-67226,29919,94585,-64666,"19","14",18408,26796
"4848",113573,"COLLEGE OF THE DESERT                                       ","2003-2004",7,"Football",7889,139825,-131936,7889,139825,-131936,0,0,0,"82",".",37146,0
"16253",225247,"HARDIN-SIMMONS UNIVERSITY                                   ","2003-2004",39,"Total Participants",40034,172000,-131966,21800,89000,-67200,18234,83000,-64766,"185","92",230476,93301
"5778",197869,"APPALACHIAN STATE UNIVERSITY                                ","2003-2004",8,"Golf",8239,140640,-132401,4150,59557,-55407,4089,81083,-76994,"11","8",25773,26299
"14056",220516,"KING COLLEGE                                                ","2003-2004",26,"Volleyball",34323,166778,-132455,0,0,0,34323,166778,-132455,".","15",0,11798
"9489",109785,"AZUSA PACIFIC UNIVERSITY                                    ","2003-2004",16,"Softball",34901,167357,-132456,0,0,0,34901,167357,-132456,".","18",0,23251
"12457",123651,"VANGUARD UNIVERSITY OF SOUTHERN CALIFORNIA                  ","2003-2004",25,"Track and Field, X-Country",42058,174526,-132468,21029,91927,-70898,21029,82599,-61570,"13","13",6150,6150
"3671",159966,"NICHOLLS STATE UNIVERSITY                                   ","2003-2004",3,"All Track Combined",3436,135945,-132509,1791,50912,-49121,1645,85033,-83388,"43","70",7696,14314
"9992",149772,"WESTERN ILLINOIS UNIVERSITY                                 ","2003-2004",16,"Softball",172900,305467,-132567,0,0,0,172900,305467,-132567,".","23",0,70515
"1464",219356,"SOUTH DAKOTA STATE UNIVERSITY                               ","2003-2004",1,"Baseball",878,133596,-132718,878,133596,-132718,0,0,0,"32",".",60385,0
"10105",183044,"UNIVERSITY OF NEW HAMPSHIRE-MAIN CAMPUS                     ","2003-2004",18,"Swimming and Diving",271974,404790,-132816,86239,82164,4075,185735,322626,-136891,"13","28",33213,71536
"15370",232982,"OLD DOMINION UNIVERSITY                                     ","2003-2004",36,"Sailing",6226,139338,-133112,3113,69669,-66556,3113,69669,-66556,"15","8",16572,16572
"74",176044,"MISSISSIPPI VALLEY STATE UNIVERSITY                         ","2003-2004",1,"Baseball",27883,161008,-133125,27883,161008,-133125,0,0,0,"23",".",113137,0
"13203",144005,"CHICAGO STATE UNIVERSITY                                    ","2003-2004",26,"Volleyball",191389,324737,-133348,0,0,0,191389,324737,-133348,".","13",0,35001
"1731",154518,"WALDORF COLLEGE                                             ","2003-2004",2,"Basketball",42191,175630,-133439,20721,93200,-72479,21470,82430,-60960,"16","11",20000,19500
"4976",121345,"POMONA COLLEGE                                              ","2003-2004",7,"Football",79000,212473,-133473,79000,212473,-133473,0,0,0,"51",".",76461,0
"14749",110608,"CALIFORNIA STATE UNIVERSITY-NORTHRIDGE                      ","2003-2004",27,"Water Polo",3030,136716,-133686,0,0,0,3030,136716,-133686,".","18",0,32183
"7467",223232,"BAYLOR UNIVERSITY                                           ","2003-2004",15,"Soccer",529745,663553,-133808,0,0,0,529745,663553,-133808,".","37",0,91655
"7222",175616,"DELTA STATE UNIVERSITY                                      ","2003-2004",15,"Soccer",0,133900,-133900,0,64347,-64347,0,69553,-69553,"21","24",24192,24192
"6645",193292,"MOLLOY COLLEGE                                              ","2003-2004",11,"Lacrosse",25000,159000,-134000,25000,159000,-134000,0,0,0,"25",".",25000,0
"5045",174844,"SAINT OLAF COLLEGE                                          ","2003-2004",7,"Football",32787,166797,-134010,32787,166797,-134010,0,0,0,"74",".",55864,0
"6951",191630,"HOBART WILLIAM SMITH COLLEGES                               ","2003-2004",13,"Rowing",54943,189000,-134057,28157,84363,-56206,26786,104637,-77851,"29","38",5344,5344
"16361",219134,"SI TANKA UNIVERSITY-HURON CAMPUS                            ","2003-2004",39,"Total Participants",283345,417840,-134495,137965,209981,-72016,145380,207859,-62479,"153","70",243191,181238
"8139",193292,"MOLLOY COLLEGE                                              ","2003-2004",15,"Soccer",28000,162500,-134500,13000,80000,-67000,15000,82500,-67500,"21","20",10000,10000
"9805",102067,"SHELTON STATE COMMUNITY COLLEGE                             ","2003-2004",16,"Softball",1236,135885,-134649,0,0,0,1236,135885,-134649,".","18",0,29940
"1625",213507,"LEBANON VALLEY COLLEGE                                      ","2003-2004",2,"Basketball",73116,207803,-134687,42804,113231,-70427,30312,94572,-64260,"23","14",30142,26917
"8355",121150,"PEPPERDINE UNIVERSITY                                       ","2003-2004",15,"Soccer",552080,686907,-134827,0,0,0,552080,686907,-134827,".","23",0,59572
"8840",213385,"LAFAYETTE COLLEGE                                           ","2003-2004",16,"Softball",104111,239166,-135055,0,0,0,104111,239166,-135055,".","18",0,30859
"9219",138275,"WARNER SOUTHERN COLLEGE                                     ","2003-2004",16,"Softball",2509,137722,-135213,0,0,0,2509,137722,-135213,".","15",0,30268
"4709",177968,"LINDENWOOD UNIVERSITY                                       ","2003-2004",7,"Football",87260,222474,-135214,87260,222474,-135214,0,0,0,"98",".",135214,0
"8517",181817,"WESTERN NEBRASKA COMMUNITY COLLEGE                          ","2003-2004",15,"Soccer",9274,144518,-135244,4637,69271,-64634,4637,75247,-70610,"28","23",31096,32929
"7603",188182,"COLLEGE OF THE SOUTHWEST                                    ","2003-2004",15,"Soccer",2,135400,-135398,1,68950,-68949,1,66450,-66449,"18","19",37950,36450
"117",156365,"CAMPBELLSVILLE UNIVERSITY                                   ","2003-2004",1,"Baseball",37652,173146,-135494,37652,173146,-135494,0,0,0,"34",".",27114,0
"11226",136172,"UNIVERSITY OF NORTH FLORIDA                                 ","2003-2004",22,"Tennis",76729,212225,-135496,29026,109866,-80840,47703,102359,-54656,"9","7",34660,27964
"11403",234207,"WASHINGTON AND LEE UNIVERSITY                               ","2003-2004",22,"Tennis",12183,147704,-135521,1466,51985,-50519,10717,95719,-85002,"16","19",13118,13185
"16229",142285,"UNIVERSITY OF IDAHO                                         ","2003-2004",39,"Total Participants",2302100,2437658,-135558,529439,607002,-77563,1772661,1830656,-57995,"194","125",1082900,559865
"3890",110097,"BIOLA UNIVERSITY                                            ","2003-2004",3,"All Track Combined",48955,184546,-135591,12238,73818,-61580,36717,110728,-74011,"9","26",6182,18546
"2655",127060,"UNIVERSITY OF DENVER                                        ","2003-2004",2,"Basketball",2377491,2513112,-135621,1201430,1262125,-60695,1176061,1250987,-74926,"13","14",237256,229969
"5592",133669,"FLORIDA ATLANTIC UNIVERSITY-BOCA RATON                      ","2003-2004",8,"Golf",2810,139012,-136202,1960,28087,-26127,850,110925,-110075,"11","9",21920,26322
"6086",198215,"CATAWBA COLLEGE                                             ","2003-2004",8,"Golf",49820,186030,-136210,24910,100017,-75107,24910,86013,-61103,"11","7",14560,14560
"12148",140960,"SAVANNAH STATE UNIVERSITY                                   ","2003-2004",24,"Track and Field, Outdoor",0,136231,-136231,0,68063,-68063,0,68168,-68168,"16","13",39544,32896
"236",157386,"MOREHEAD STATE UNIVERSITY                                   ","2003-2004",1,"Baseball",131476,267772,-136296,131476,267772,-136296,0,0,0,"32",".",65794,0
"5483",128771,"CENTRAL CONNECTICUT STATE UNIVERSITY                        ","2003-2004",8,"Golf",17963,154352,-136389,9564,91908,-82344,8399,62444,-54045,"8","6",24048,19115
"14246",174233,"UNIVERSITY OF MINNESOTA-DULUTH                              ","2003-2004",26,"Volleyball",76493,212914,-136421,0,0,0,76493,212914,-136421,"0","13",0,29517
"16929",148937,"SOUTHEASTERN ILLINOIS COLLEGE                               ","2003-2004",39,"Total Participants",10850,147278,-136428,4054,97741,-93687,6796,49537,-42741,"38","32",47330,33686
"333",142328,"LEWIS-CLARK STATE COLLEGE                                   ","2003-2004",1,"Baseball",181733,318178,-136445,181733,318178,-136445,0,0,0,"47",".",43547,0
"4372",211361,"CALIFORNIA UNIVERSITY OF PENNSYLVANIA                       ","2003-2004",7,"Football",715808,852407,-136599,715808,852407,-136599,0,0,0,"90",".",120258,0
"1129",154004,"MORNINGSIDE COLLEGE                                         ","2003-2004",1,"Baseball",21500,158116,-136616,21500,158116,-136616,0,0,0,"30",".",38970,0
"4476",139904,"GEORGIA MILITARY COLLEGE-MAIN CAMPUS                        ","2003-2004",7,"Football",656681,793380,-136699,656681,793380,-136699,0,0,0,"69",".",92224,0
"7789",216667,"WASHINGTON &amp; JEFFERSON COLLEGE                              ","2003-2004",15,"Soccer",136026,272765,-136739,74554,149969,-75415,61472,122796,-61324,"29","23",15501,15284
"12080",132903,"UNIVERSITY OF CENTRAL FLORIDA                               ","2003-2004",24,"Track and Field, Outdoor",41004,177749,-136745,0,0,0,41004,177749,-136745,".","57",0,27707
"11831",132903,"UNIVERSITY OF CENTRAL FLORIDA                               ","2003-2004",23,"Track and Field, Indoor",41003,177749,-136746,0,0,0,41003,177749,-136746,".","58",0,27707
"11141",218964,"WINTHROP UNIVERSITY                                         ","2003-2004",22,"Tennis",129799,266635,-136836,63796,114098,-50302,66003,152537,-86534,"8","7",24102,25814
"2155",179964,"WILLIAM WOODS UNIVERSITY                                    ","2003-2004",2,"Basketball",46996,183921,-136925,0,0,0,46996,183921,-136925,"0","9",0,11496
"9896",198215,"CATAWBA COLLEGE                                             ","2003-2004",16,"Softball",22825,159784,-136959,0,0,0,22825,159784,-136959,".","19",0,20875
"3116",229027,"THE UNIVERSITY OF TEXAS AT SAN ANTONIO                      ","2003-2004",2,"Basketball",1358091,1495199,-137108,712856,791621,-78765,645235,703578,-58343,"10","13",156005,119038
"11171",144005,"CHICAGO STATE UNIVERSITY                                    ","2003-2004",22,"Tennis",60979,198160,-137181,30522,91005,-60483,30457,107155,-76698,"12","5",12253,17634
"3627",243197,"UNIVERSITY OF PUERTO RICO-MAYAGUEZ                          ","2003-2004",3,"All Track Combined",12405,149612,-137207,7739,101454,-93715,4666,48158,-43492,"19","11",16673,7758
"2117",197027,"UNITED STATES MERCHANT MARINE ACADEMY                       ","2003-2004",2,"Basketball",6930,144195,-137265,4980,87268,-82288,1950,56927,-54977,"17","14",28714,24667
"1535",181817,"WESTERN NEBRASKA COMMUNITY COLLEGE                          ","2003-2004",1,"Baseball",15256,152569,-137313,15256,152569,-137313,0,0,0,"30",".",73607,0
"6807",198215,"CATAWBA COLLEGE                                             ","2003-2004",11,"Lacrosse",33545,170934,-137389,33545,170934,-137389,0,0,0,"21",".",26195,0
"10089",136172,"UNIVERSITY OF NORTH FLORIDA                                 ","2003-2004",18,"Swimming and Diving",61047,198504,-137457,0,0,0,61047,198504,-137457,"0","27",0,47533
"9018",175342,"ALCORN STATE UNIVERSITY                                     ","2003-2004",16,"Softball",3968,141603,-137635,0,0,0,3968,141603,-137635,".","16",0,14550
"2303",221838,"TENNESSEE STATE UNIVERSITY                                  ","2003-2004",2,"Basketball",1159797,1297533,-137736,777189,767944,9245,382608,529589,-146981,"13","12",108934,68656
"15984",239318,"MILWAUKEE SCHOOL OF ENGINEERING                             ","2003-2004",39,"Total Participants",242419,380189,-137770,196159,298006,-101847,46260,82183,-35923,"226","92",270968,62570
"3476",227757,"RICE UNIVERSITY                                             ","2003-2004",2,"Basketball",2794099,2931872,-137773,1363403,1624272,-260869,1430696,1307600,123096,"18","14",358217,238254
"7067",142115,"BOISE STATE UNIVERSITY                                      ","2003-2004",14,"Skiing",19182,156971,-137789,0,0,0,19182,156971,-137789,".","5",0,45538
"12248",138275,"WARNER SOUTHERN COLLEGE                                     ","2003-2004",25,"Track and Field, X-Country",1075,138884,-137809,955,76646,-75691,120,62238,-62118,"11","11",7654,6307
"7619",233295,"RANDOLPH-MACON COLLEGE                                      ","2003-2004",15,"Soccer",5040,142900,-137860,4350,97654,-93304,690,45246,-44556,"26","20",14100,13400
"6566",197036,"UNITED STATES MILITARY ACADEMY                              ","2003-2004",11,"Lacrosse",302062,439943,-137881,302062,439943,-137881,0,0,0,"48",".",48885,0
"15039",197036,"UNITED STATES MILITARY ACADEMY                              ","2003-2004",28,"Wrestling",191565,329453,-137888,191565,329453,-137888,0,0,0,"49",".",71280,0
"16615",228608,"TEMPLE COLLEGE                                              ","2003-2004",39,"Total Participants",260674,398867,-138193,131427,212427,-81000,129247,186440,-57193,"70","49",96904,71243
"4978",149772,"WESTERN ILLINOIS UNIVERSITY                                 ","2003-2004",7,"Football",1368265,1506563,-138298,1368265,1506563,-138298,0,0,0,"100",".",294375,0
"9550",136172,"UNIVERSITY OF NORTH FLORIDA                                 ","2003-2004",16,"Softball",41349,179714,-138365,0,0,0,41349,179714,-138365,".","16",0,55591
"9892",207740,"SEMINOLE STATE COLLEGE                                      ","2003-2004",16,"Softball",45262,183736,-138474,0,0,0,45262,183736,-138474,".","19",0,47108
"13478",190415,"CORNELL UNIVERSITY-ENDOWED COLLEGES                         ","2003-2004",26,"Volleyball",18032,156596,-138564,0,0,0,18032,156596,-138564,".","14",0,36231
"11625",180489,"THE UNIVERSITY OF MONTANA-MISSOULA                          ","2003-2004",22,"Tennis",194950,333544,-138594,89690,152776,-63086,105260,180768,-75508,"11","9",25737,25737
"10278",188030,"NEW MEXICO STATE UNIVERSITY-MAIN CAMPUS                     ","2003-2004",18,"Swimming and Diving",80439,219166,-138727,0,0,0,80439,219166,-138727,".","17",0,40784
"8034",110495,"CALIFORNIA STATE UNIVERSITY-STANISLAUS                      ","2003-2004",15,"Soccer",23615,162380,-138765,13467,69617,-56150,10148,92763,-82615,"20","28",30209,41447
"17253",172200,"SCHOOLCRAFT COLLEGE                                         ","2003-2004",39,"Total Participants",244633,383531,-138898,113275,152632,-39357,131358,230899,-99541,"41","57",62285,118890
"2252",202222,"COLUMBUS STATE COMMUNITY COLLEGE                            ","2003-2004",2,"Basketball",42800,181790,-138990,21400,106746,-85346,21400,75044,-53644,"15","14",23552,17930
"1516",123651,"VANGUARD UNIVERSITY OF SOUTHERN CALIFORNIA                  ","2003-2004",1,"Baseball",73416,212566,-139150,73416,212566,-139150,0,0,0,"26",".",19000,0
"13186",218973,"WOFFORD COLLEGE                                             ","2003-2004",26,"Volleyball",16210,155430,-139220,0,0,0,16210,155430,-139220,".","11",0,22873
"5139",207971,"UNIVERSITY OF TULSA                                         ","2003-2004",8,"Golf",325580,464912,-139332,128968,232382,-103414,196612,232530,-35918,"10","5",46527,30811
"6348",110617,"CALIFORNIA STATE UNIVERSITY-SACRAMENTO                      ","2003-2004",9,"Gymnastics",115036,254394,-139358,0,0,0,115036,254394,-139358,".","17",0,25687
"4314",154749,"BETHEL COLLEGE                                              ","2003-2004",7,"Football",50687,190051,-139364,50687,190051,-139364,0,0,0,"44",".",43913,0
"15870",230092,"COLLEGE OF EASTERN UTAH                                     ","2003-2004",39,"Total Participants",2500,141903,-139403,1500,66400,-64900,1000,75503,-74503,"41","29",51000,44500
"3276",166638,"UNIVERSITY OF MASSACHUSETTS-BOSTON                          ","2003-2004",2,"Basketball",1658,141085,-139427,1432,65773,-64341,226,75312,-75086,"13","13",31880,18480
"1431",220941,"CRICHTON COLLEGE                                            ","2003-2004",1,"Baseball",1696,141153,-139457,1696,141153,-139457,0,0,0,"22",".",71192,0
"8788",215132,"UNIVERSITY OF THE SCIENCES IN PHILADELPHIA                  ","2003-2004",16,"Softball",1,139533,-139532,0,0,0,1,139533,-139532,".","18",0,12800
"6133",160612,"SOUTHEASTERN LOUISIANA UNIVERSITY                           ","2003-2004",8,"Golf",73113,212648,-139535,73113,212648,-139535,0,0,0,"8",".",59077,0
"4710",112826,"CONTRA COSTA COLLEGE                                        ","2003-2004",7,"Football",7000,146750,-139750,7000,146750,-139750,0,0,0,"54",".",13150,0
"17020",220941,"CRICHTON COLLEGE                                            ","2003-2004",39,"Total Participants",11521,151388,-139867,1696,141153,-139457,9825,10235,-410,"34","27",123844,4542
"657",109785,"AZUSA PACIFIC UNIVERSITY                                    ","2003-2004",1,"Baseball",53939,193974,-140035,53939,193974,-140035,0,0,0,"30",".",31943,0
"3378",203845,"MARIETTA COLLEGE                                            ","2003-2004",2,"Basketball",101474,241561,-140087,52314,131282,-78968,49160,110279,-61119,"15","20",31873,27619
"2708",196176,"SUNY COLLEGE AT NEW PALTZ                                   ","2003-2004",2,"Basketball",10695,150803,-140108,6057,83045,-76988,4638,67758,-63120,"16","13",22154,20357
"1393",152099,"OAKLAND CITY UNIVERSITY                                     ","2003-2004",1,"Baseball",11000,151192,-140192,11000,151192,-140192,0,0,0,"23",".",21646,0
"5664",198385,"DAVIDSON COLLEGE                                            ","2003-2004",8,"Golf",3167,143361,-140194,3167,143361,-140194,0,0,0,"13",".",26868,0
"2742",117627,"LA SIERRA UNIVERSITY                                        ","2003-2004",2,"Basketball",9500,149737,-140237,4500,72482,-67982,5000,77255,-72255,"16","15",5250,5250
"15345",200059,"DICKINSON STATE UNIVERSITY                                  ","2003-2004",35,"Rodeo",52216,192555,-140339,26108,102852,-76744,26108,89703,-63595,"37","20",38686,38686
"16749",183211,"RIVIER COLLEGE                                              ","2003-2004",39,"Total Participants",8715,149103,-140388,4620,79066,-74446,4095,70037,-65942,"73","60",58610,38532
"16863",155140,"HASKELL INDIAN NATIONS UNIVERSITY                           ","2003-2004",39,"Total Participants",46305,186755,-140450,12950,49610,-36660,33355,137145,-103790,"81","69",72950,45950
"16672",196167,"SUNY COLLEGE AT GENESEO                                     ","2003-2004",39,"Total Participants",593055,733544,-140489,273138,333863,-60725,319917,399681,-79764,"208","222",204928,262197
"3598",217819,"COLLEGE OF CHARLESTON                                       ","2003-2004",3,"All Track Combined",9250,149807,-140557,1795,33972,-32177,7455,115835,-108380,"11","20",11838,33721
"15826",138293,"WEBBER INTERNATIONAL UNIVERSITY                             ","2003-2004",39,"Total Participants",1019524,1160425,-140901,532795,649063,-116268,486729,511362,-24633,"244","111",185317,98298
"1682",213783,"MANSFIELD UNIVERSITY OF PENNSYLVANIA                        ","2003-2004",2,"Basketball",328482,469477,-140995,191625,253986,-62361,136857,215491,-78634,"17","13",48984,42896
"6670",110635,"UNIVERSITY OF CALIFORNIA-BERKELEY                           ","2003-2004",11,"Lacrosse",288215,429236,-141021,0,0,0,288215,429236,-141021,".","22",0,126489
"2606",118693,"MENLO COLLEGE                                               ","2003-2004",2,"Basketball",31800,173379,-141579,26000,92219,-66219,5800,81160,-75360,"14","12",43270,41540
"11068",220215,"FREED-HARDEMAN UNIVERSITY                                   ","2003-2004",22,"Tennis",20500,162113,-141613,10250,92091,-81841,10250,70022,-59772,"6","6",10250,10250
"2588",162654,"GOUCHER COLLEGE                                             ","2003-2004",2,"Basketball",21433,163109,-141676,18767,97252,-78485,2666,65857,-63191,"14","11",31603,25743
"10163",216667,"WASHINGTON &amp; JEFFERSON COLLEGE                              ","2003-2004",18,"Swimming and Diving",96226,237914,-141688,48113,118957,-70844,48113,118957,-70844,"20","29",14324,14324
"16640",220710,"MARYVILLE COLLEGE                                           ","2003-2004",39,"Total Participants",148676,290519,-141843,67300,135594,-68294,81376,154925,-73549,"200","77",189116,111022
"3433",164580,"BABSON COLLEGE                                              ","2003-2004",2,"Basketball",28268,170168,-141900,14319,77219,-62900,13949,92949,-79000,"15","14",14319,13949
"2656",172334,"SPRING ARBOR UNIVERSITY                                     ","2003-2004",2,"Basketball",40420,182347,-141927,22130,92258,-70128,18290,90089,-71799,"11","13",22130,18290
"16342",199306,"PFEIFFER UNIVERSITY                                         ","2003-2004",39,"Total Participants",122663,264662,-141999,106901,184208,-77307,15762,80454,-64692,"151","114",208385,86278
"3536",129215,"EASTERN CONNECTICUT STATE UNIVERSITY                        ","2003-2004",3,"All Track Combined",2548,144711,-142163,1274,71718,-70444,1274,72993,-71719,"40","38",15138,16413
"9306",153658,"UNIVERSITY OF IOWA                                          ","2003-2004",16,"Softball",162834,305032,-142198,0,0,0,162834,305032,-142198,".","18",0,119867
"7193",237118,"ALDERSON BROADDUS COLLEGE                                   ","2003-2004",15,"Soccer",20352,162635,-142283,20352,162635,-142283,0,0,0,"16",".",16378,0
"16482",123341,"SIERRA COLLEGE                                              ","2003-2004",39,"Total Participants",70758,213057,-142299,36911,95567,-58656,33847,117490,-83643,"165","110",102579,91778
"6359",190415,"CORNELL UNIVERSITY-ENDOWED COLLEGES                         ","2003-2004",9,"Gymnastics",16867,159426,-142559,0,0,0,16867,159426,-142559,".","16",0,36721
"6725",120184,"NOTRE DAME DE NAMUR UNIVERSITY                              ","2003-2004",11,"Lacrosse",87327,229912,-142585,87327,229912,-142585,0,0,0,"32",".",70459,0
"14112",188304,"WESTERN NEW MEXICO UNIVERSITY                               ","2003-2004",26,"Volleyball",45532,188159,-142627,0,0,0,45532,188159,-142627,".","15",0,35295
"10645",100830,"AUBURN UNIVERSITY-MONTGOMERY                                ","2003-2004",22,"Tennis",54938,197754,-142816,23451,92788,-69337,31487,104966,-73479,"10","6",14861,14861
"16347",196194,"SUNY COLLEGE AT OSWEGO                                      ","2003-2004",39,"Total Participants",829326,972167,-142841,554060,615776,-61716,275266,356391,-81125,"250","181",280591,225308
"10051",159009,"GRAMBLING STATE UNIVERSITY                                  ","2003-2004",16,"Softball",1,142845,-142844,0,0,0,1,142845,-142844,".","16",0,85113
"10347",213543,"LEHIGH UNIVERSITY                                           ","2003-2004",18,"Swimming and Diving",610748,753734,-142986,261727,333220,-71493,349021,420514,-71493,"25","30",34064,34064
"7082",227881,"SAM HOUSTON STATE UNIVERSITY                                ","2003-2004",15,"Soccer",45000,188119,-143119,0,0,0,45000,188119,-143119,".","27",0,39547
"16930",192925,"MEDAILLE COLLEGE                                            ","2003-2004",39,"Total Participants",20706,163828,-143122,14663,92066,-77403,6043,71762,-65719,"93","76",86502,63324
"3589",134945,"JACKSONVILLE UNIVERSITY                                     ","2003-2004",3,"All Track Combined",220366,363635,-143269,35950,35950,0,184416,327685,-143269,"7","23",2376,21440
"16316",170541,"KALAMAZOO VALLEY COMMUNITY COLLEGE                          ","2003-2004",39,"Total Participants",6,143278,-143272,3,69900,-69897,3,73378,-73375,"62","49",63811,78761
"8736",197869,"APPALACHIAN STATE UNIVERSITY                                ","2003-2004",16,"Softball",7598,151028,-143430,0,0,0,7598,151028,-143430,".","20",0,55960
"11249",232265,"HAMPTON UNIVERSITY                                          ","2003-2004",22,"Tennis",188870,332345,-143475,91890,144091,-52201,96980,188254,-91274,"8","7",46063,37014
"9723",110617,"CALIFORNIA STATE UNIVERSITY-SACRAMENTO                      ","2003-2004",16,"Softball",144140,288075,-143935,0,0,0,144140,288075,-143935,".","20",0,34279
"2684",106412,"UNIVERSITY OF ARKANSAS AT PINE BLUFF                        ","2003-2004",2,"Basketball",304680,448718,-144038,280368,254897,25471,24312,193821,-169509,"15","10",97380,88971
"6888",183044,"UNIVERSITY OF NEW HAMPSHIRE-MAIN CAMPUS                     ","2003-2004",13,"Rowing",37455,181505,-144050,0,0,0,37455,181505,-144050,".","82",0,77883
"16079",220400,"JACKSON STATE COMMUNITY COLLEGE                             ","2003-2004",39,"Total Participants",9288,153428,-144140,8759,83965,-75206,529,69463,-68934,"36","26",20718,16179
"10974",227845,"SAINT EDWARD'S UNIVERSITY                                   ","2003-2004",22,"Tennis",200,144500,-144300,100,72650,-72550,100,71850,-71750,"9","7",11050,10250
"1054",190761,"DOMINICAN COLLEGE OF BLAUVELT                               ","2003-2004",1,"Baseball",12318,156820,-144502,12318,156820,-144502,0,0,0,"31",".",32530,0
"1650",168421,"WORCESTER POLYTECHNIC INSTITUTE                             ","2003-2004",2,"Basketball",33000,177586,-144586,16500,87984,-71484,16500,89602,-73102,"16","12",18199,18014
"11388",106458,"ARKANSAS STATE UNIVERSITY-MAIN CAMPUS                       ","2003-2004",22,"Tennis",1000,145587,-144587,0,0,0,1000,145587,-144587,".","6",0,38815
"419",144005,"CHICAGO STATE UNIVERSITY                                    ","2003-2004",1,"Baseball",101742,246337,-144595,101742,246337,-144595,0,0,0,"34",".",69768,0
"1733",220598,"LANE COLLEGE                                                ","2003-2004",2,"Basketball",114040,258729,-144689,47020,153078,-106058,67020,105651,-38631,"13","12",37795,29393
"16268",110671,"UNIVERSITY OF CALIFORNIA-RIVERSIDE                          ","2003-2004",39,"Total Participants",2983165,3127891,-144726,1300002,1337504,-37502,1683163,1790387,-107224,"160","190",145360,113884
"13189",230746,"SALT LAKE COMMUNITY COLLEGE                                 ","2003-2004",26,"Volleyball",6663,151433,-144770,0,0,0,6663,151433,-144770,".","13",0,29102
"2091",228246,"SOUTHERN METHODIST UNIVERSITY                               ","2003-2004",2,"Basketball",4050346,4195212,-144866,2386828,2444871,-58043,1663518,1750341,-86823,"16","13",359658,227376
"5102",227881,"SAM HOUSTON STATE UNIVERSITY                                ","2003-2004",8,"Golf",77996,222890,-144894,38998,104695,-65697,38998,118195,-79197,"13","9",38917,38917
"1130",215132,"UNIVERSITY OF THE SCIENCES IN PHILADELPHIA                  ","2003-2004",1,"Baseball",1,144926,-144925,1,144926,-144925,0,0,0,"25",".",17800,0
"405",143358,"BRADLEY UNIVERSITY                                          ","2003-2004",1,"Baseball",426888,571841,-144953,426888,571841,-144953,0,0,0,"34",".",85705,0
"3697",155025,"EMPORIA STATE UNIVERSITY                                    ","2003-2004",3,"All Track Combined",119037,264103,-145066,65644,133586,-67942,53393,130517,-77124,"101","57",40761,48999
"13444",219000,"AUGUSTANA COLLEGE                                           ","2003-2004",26,"Volleyball",110300,255473,-145173,0,0,0,110300,255473,-145173,".","16",0,42711
"5761",221847,"TENNESSEE TECHNOLOGICAL UNIVERSITY                          ","2003-2004",8,"Golf",22102,167333,-145231,15095,77065,-61970,7007,90268,-83261,"12","13",25548,22317
"7369",164580,"BABSON COLLEGE                                              ","2003-2004",15,"Soccer",25622,171102,-145480,12748,79228,-66480,12874,91874,-79000,"29","24",12748,12874
"10350",240277,"UNIVERSITY OF WISCONSIN-GREEN BAY                           ","2003-2004",18,"Swimming and Diving",276491,421983,-145492,133290,191216,-57926,143201,230767,-87566,"24","23",30983,29329
"11400",227368,"THE UNIVERSITY OF TEXAS-PAN AMERICAN                        ","2003-2004",22,"Tennis",280,145839,-145559,140,62127,-61987,140,83712,-83572,"9","10",17943,13784
"17294",213321,"KINGS COLLEGE                                               ","2003-2004",39,"Total Participants",230530,376130,-145600,114282,183680,-69398,116248,192450,-76202,"274","137",210191,139398
"6719",212009,"DICKINSON COLLEGE                                           ","2003-2004",11,"Lacrosse",26768,172600,-145832,16211,103140,-86929,10557,69460,-58903,"44","25",20211,13057
"16414",174251,"UNIVERSITY OF MINNESOTA-MORRIS                              ","2003-2004",39,"Total Participants",167037,312926,-145889,64564,119975,-55411,102473,192951,-90478,"160","148",123435,109263
"11468",123651,"VANGUARD UNIVERSITY OF SOUTHERN CALIFORNIA                  ","2003-2004",22,"Tennis",43837,189834,-145997,21696,98060,-76364,22141,91774,-69633,"8","7",12675,12675
"11307",230038,"BRIGHAM YOUNG UNIVERSITY                                    ","2003-2004",22,"Tennis",555468,701715,-146247,254492,335529,-81037,300976,366186,-65210,"11","10",87408,59272
"5491",153269,"DRAKE UNIVERSITY                                            ","2003-2004",8,"Golf",7452,153861,-146409,7452,153861,-146409,0,0,0,"8",".",38333,0
"6616",164216,"WASHINGTON COLLEGE                                          ","2003-2004",11,"Lacrosse",60969,207512,-146543,39853,148825,-108972,21116,58687,-37571,"43","24",33210,33899
"11456",188030,"NEW MEXICO STATE UNIVERSITY-MAIN CAMPUS                     ","2003-2004",22,"Tennis",79003,225724,-146721,34059,85654,-51595,44944,140070,-95126,"9","8",29383,30168
"10023",188304,"WESTERN NEW MEXICO UNIVERSITY                               ","2003-2004",16,"Softball",1,146753,-146752,0,0,0,1,146753,-146752,".","18",0,60611
"15012",198385,"DAVIDSON COLLEGE                                            ","2003-2004",28,"Wrestling",5650,152474,-146824,5650,152474,-146824,0,0,0,"18",".",24914,0
"17071",240453,"UNIVERSITY OF WISCONSIN-MILWAUKEE                           ","2003-2004",39,"Total Participants",2802643,2949629,-146986,1241109,1349957,-108848,1561534,1599672,-38138,"148","151",760378,388098
"10421",199102,"NORTH CAROLINA  A &amp;T STATE UNIVERSITY                       ","2003-2004",18,"Swimming and Diving",18026,165057,-147031,0,0,0,18026,165057,-147031,".","12",0,8321
"6172",223232,"BAYLOR UNIVERSITY                                           ","2003-2004",8,"Golf",582417,729530,-147113,311103,389685,-78582,271314,339845,-68531,"25","8",111164,69056
"11072",217864,"CITADEL MILITARY COLLEGE OF SOUTH CAROLINA                  ","2003-2004",22,"Tennis",17995,165335,-147340,17995,165335,-147340,0,0,0,"9",".",27367,0
"142",237969,"WEST VIRGINIA WESLEYAN COLLEGE                              ","2003-2004",1,"Baseball",57785,205185,-147400,57785,205185,-147400,0,0,0,"30",".",22656,0
"13019",215655,"ROBERT MORRIS UNIVERSITY                                    ","2003-2004",26,"Volleyball",119323,266826,-147503,0,0,0,119323,266826,-147503,".","16",0,30116
"7018",164924,"BOSTON COLLEGE                                              ","2003-2004",13,"Rowing",39895,187508,-147613,0,0,0,39895,187508,-147613,".","53",0,94236
"3100",138716,"ALBANY STATE UNIVERSITY                                     ","2003-2004",2,"Basketball",104528,252230,-147702,47793,115055,-67262,56735,137175,-80440,"17","19",42324,45442
"1639",155937,"STERLING COLLEGE                                            ","2003-2004",2,"Basketball",13177,160918,-147741,7533,91958,-84425,5644,68960,-63316,"21","20",91957,68955
"927",137209,"SEMINOLE COMMUNITY COLLEGE                                  ","2003-2004",1,"Baseball",72897,220739,-147842,72897,220739,-147842,0,0,0,"27",".",41567,0
"6617",192448,"LONG ISLAND UNIVERSITY-C W POST CAMPUS                      ","2003-2004",11,"Lacrosse",503452,651360,-147908,271869,343898,-72029,231583,307462,-75879,"34","28",51382,73403
"4858",226833,"MIDWESTERN STATE UNIVERSITY                                 ","2003-2004",7,"Football",57221,205142,-147921,57221,205142,-147921,0,0,0,"95",".",155000,0
"2409",219888,"COLUMBIA STATE COMMUNITY COLLEGE                            ","2003-2004",2,"Basketball",3290,151235,-147945,1645,81797,-80152,1645,69438,-67793,"15","12",28018,25229
"9155",222831,"ANGELO STATE UNIVERSITY                                     ","2003-2004",16,"Softball",7485,155620,-148135,0,0,0,7485,155620,-148135,".","15",0,26905
"366",234085,"VIRGINIA MILITARY INSTITUTE                                 ","2003-2004",1,"Baseball",200590,348886,-148296,200590,348886,-148296,0,0,0,"40",".",62880,0
"6760",233426,"ROANOKE COLLEGE                                             ","2003-2004",11,"Lacrosse",10658,159092,-148434,9083,94155,-85072,1575,64937,-63362,"37","21",34155,29937
"1977",229799,"WEATHERFORD COLLEGE                                         ","2003-2004",2,"Basketball",25070,173514,-148444,19175,84231,-65056,5895,89283,-83388,"13","14",49908,54020
"11959",241225,"BAYAMON CENTRAL UNIVERSITY                                  ","2003-2004",24,"Track and Field, Outdoor",18200,167000,-148800,12000,130000,-118000,6200,37000,-30800,"23","8",6930,3080
"3128",198613,"GUILFORD COLLEGE                                            ","2003-2004",2,"Basketball",82051,231243,-149192,46382,120180,-73798,35669,111063,-75394,"14","14",15926,13922
"6509",174844,"SAINT OLAF COLLEGE                                          ","2003-2004",10,"Ice Hockey",5915,155163,-149248,5055,90729,-85674,860,64434,-63574,"31","20",56918,38316
"2741",137078,"ST PETERSBURG COLLEGE                                       ","2003-2004",2,"Basketball",299920,449438,-149518,161973,241454,-79481,137947,207984,-70037,"12","16",55200,55200
"12944",137351,"UNIVERSITY OF SOUTH FLORIDA                                 ","2003-2004",25,"Track and Field, X-Country",5895,155495,-149600,3537,51645,-48108,2358,103850,-101492,"6","26",15618,42663
"2231",237367,"FAIRMONT STATE COLLEGE                                      ","2003-2004",2,"Basketball",229988,379700,-149712,160777,215258,-54481,69211,164442,-95231,"15","15",29647,24156
"11972",160612,"SOUTHEASTERN LOUISIANA UNIVERSITY                           ","2003-2004",24,"Track and Field, Outdoor",17424,167141,-149717,9556,67446,-57890,7868,99695,-91827,"29","26",17045,17045
"4923",154518,"WALDORF COLLEGE                                             ","2003-2004",7,"Football",44384,194146,-149762,44384,194146,-149762,0,0,0,"44",".",43000,0
"11519",215293,"UNIVERSITY OF PITTSBURGH-MAIN CAMPUS                        ","2003-2004",22,"Tennis",0,149921,-149921,0,0,0,0,149921,-149921,".","8",0,30088
"15537",190594,"CUNY HUNTER COLLEGE                                         ","2003-2004",39,"Total Participants",8569,158608,-150039,4508,77337,-72829,4061,81271,-77210,"147","169",49670,53029
"15869",155450,"LABETTE COMMUNITY COLLEGE                                   ","2003-2004",39,"Total Participants",21014,171071,-150057,16358,124997,-108639,4656,46074,-41418,"69","36",78838,46590
"14871",199120,"UNIVERSITY OF NORTH CAROLINA AT CHAPEL HILL                 ","2003-2004",28,"Wrestling",241749,391844,-150095,241749,391844,-150095,0,0,0,"34",".",56264,0
"8773",209807,"PORTLAND STATE UNIVERSITY                                   ","2003-2004",16,"Softball",180995,331551,-150556,0,0,0,180995,331551,-150556,".","17",0,65599
"14067",201104,"ASHLAND UNIVERSITY                                          ","2003-2004",26,"Volleyball",180289,330960,-150671,0,0,0,180289,330960,-150671,".","11",0,19800
"13454",159966,"NICHOLLS STATE UNIVERSITY                                   ","2003-2004",26,"Volleyball",5508,156400,-150892,0,0,0,5508,156400,-150892,".","15",0,28228
"6268",188304,"WESTERN NEW MEXICO UNIVERSITY                               ","2003-2004",8,"Golf",116,151328,-151212,1,78275,-78274,115,73053,-72938,"8","6",20784,33134
"17354",217873,"CLAFLIN UNIVERSITY                                          ","2003-2004",39,"Total Participants",17000,168500,-151500,9500,77000,-67500,7500,91500,-84000,"88","81",68500,59500
"296",102429,"BEVILL STATE COMMUNITY COLLEGE                              ","2003-2004",1,"Baseball",86109,237626,-151517,86109,237626,-151517,0,0,0,"43",".",29637,0
"15905",232089,"FERRUM COLLEGE                                              ","2003-2004",39,"Total Participants",263367,414904,-151537,157561,225515,-67954,105806,189389,-83583,"213","83",227533,113105
"7349",203845,"MARIETTA COLLEGE                                            ","2003-2004",15,"Soccer",40785,192329,-151544,21981,97703,-75722,18804,94626,-75822,"35","19",18696,17860
"16617",239628,"RIPON COLLEGE                                               ","2003-2004",39,"Total Participants",197810,349449,-151639,97246,163215,-65969,100564,186234,-85670,"268","149",167692,129164
"12695",138716,"ALBANY STATE UNIVERSITY                                     ","2003-2004",25,"Track and Field, X-Country",72457,224175,-151718,38689,109968,-71279,33768,114207,-80439,"25","31",34761,30947
"13755",181215,"UNIVERSITY OF NEBRASKA AT KEARNEY                           ","2003-2004",26,"Volleyball",135287,287046,-151759,0,0,0,135287,287046,-151759,".","16",0,54943
"12630",217864,"CITADEL MILITARY COLLEGE OF SOUTH CAROLINA                  ","2003-2004",25,"Track and Field, X-Country",1320,153234,-151914,787,86413,-85626,533,66821,-66288,"18","11",19952,10356
"11871",217864,"CITADEL MILITARY COLLEGE OF SOUTH CAROLINA                  ","2003-2004",23,"Track and Field, Indoor",1319,153234,-151915,787,86413,-85626,532,66821,-66289,"42","19",19952,10357
"12125",217864,"CITADEL MILITARY COLLEGE OF SOUTH CAROLINA                  ","2003-2004",24,"Track and Field, Outdoor",1319,153234,-151915,787,86413,-85626,532,66821,-66289,"34","19",19952,10357
"11044",207324,"OKLAHOMA CHRISTIAN UNIVERSITY                               ","2003-2004",22,"Tennis",1215,153336,-152121,965,79244,-78279,250,74092,-73842,"8","10",12355,12250
"5993",154095,"UNIVERSITY OF NORTHERN IOWA                                 ","2003-2004",8,"Golf",14417,166616,-152199,1,52071,-52070,14416,114545,-100129,"12","8",27027,30249
"3599",147660,"NORTH CENTRAL COLLEGE                                       ","2003-2004",3,"All Track Combined",154800,307087,-152287,104396,190841,-86445,50404,116246,-65842,"114","62",46626,33615
"4387",197027,"UNITED STATES MERCHANT MARINE ACADEMY                       ","2003-2004",7,"Football",95509,247859,-152350,95509,247859,-152350,0,0,0,"91",".",55610,0
"6572",198808,"LEES-MCRAE COLLEGE                                          ","2003-2004",11,"Lacrosse",42720,195201,-152481,24720,117255,-92535,18000,77946,-59946,"25","16",24066,18136
"12312",195030,"UNIVERSITY OF ROCHESTER                                     ","2003-2004",25,"Track and Field, X-Country",79132,231670,-152538,39792,115551,-75759,39340,116119,-76779,"59","51",49568,50783
"2850",195720,"SAINT JOHN FISHER COLLEGE                                   ","2003-2004",2,"Basketball",43932,196697,-152765,26194,94250,-68056,17738,102447,-84709,"31","16",21665,20645
"8336",165936,"GORDON COLLEGE                                              ","2003-2004",15,"Soccer",17490,170261,-152771,11490,96366,-84876,6000,73895,-67895,"24","18",33455,15346
"16017",235097,"EASTERN WASHINGTON UNIVERSITY                               ","2003-2004",39,"Total Participants",1238938,1391801,-152863,168037,207754,-39717,1070901,1184047,-113146,"186","249",553345,415450
"8719",175616,"DELTA STATE UNIVERSITY                                      ","2003-2004",16,"Softball",936,153953,-153017,0,0,0,936,153953,-153017,".","18",0,31788
"12213",217907,"COKER COLLEGE                                               ","2003-2004",25,"Track and Field, X-Country",14251,167378,-153127,7276,99251,-91975,6975,68127,-61152,"9","5",6739,6871
"5375",136172,"UNIVERSITY OF NORTH FLORIDA                                 ","2003-2004",8,"Golf",56445,209603,-153158,56445,209603,-153158,0,0,0,"9",".",53221,0
"1406",197036,"UNITED STATES MILITARY ACADEMY                              ","2003-2004",1,"Baseball",176320,329543,-153223,176320,329543,-153223,0,0,0,"38",".",81803,0
"7056",168342,"WILLIAMS COLLEGE                                            ","2003-2004",14,"Skiing",109234,262463,-153229,54617,131299,-76682,54617,131164,-76547,"22","25",35371,27264
"656",180814,"BELLEVUE UNIVERSITY                                         ","2003-2004",1,"Baseball",1000,154257,-153257,1000,154257,-153257,0,0,0,"30",".",76257,0
"8141",222831,"ANGELO STATE UNIVERSITY                                     ","2003-2004",15,"Soccer",653,154213,-153560,0,0,0,653,154213,-153560,".","24",0,33745
"2250",228981,"TEXAS LUTHERAN UNIVERSITY                                   ","2003-2004",2,"Basketball",12150,165814,-153664,5875,88256,-82381,6275,77558,-71283,"14","16",31010,28664
"8592",187648,"EASTERN NEW MEXICO UNIVERSITY-MAIN CAMPUS                   ","2003-2004",16,"Softball",7417,161089,-153672,0,0,0,7417,161089,-153672,".","26",0,34648
"7917",204617,"OHIO DOMINICAN UNIVERSITY                                   ","2003-2004",15,"Soccer",4171,157983,-153812,1759,89374,-87615,2412,68609,-66197,"26","20",11884,11435
"13262",181394,"UNIVERSITY OF NEBRASKA AT OMAHA                             ","2003-2004",26,"Volleyball",189786,343734,-153948,0,0,0,189786,343734,-153948,".","16",0,58599
"295",187648,"EASTERN NEW MEXICO UNIVERSITY-MAIN CAMPUS                   ","2003-2004",1,"Baseball",24940,178991,-154051,24940,178991,-154051,0,0,0,"47",".",48324,0
"12039",110495,"CALIFORNIA STATE UNIVERSITY-STANISLAUS                      ","2003-2004",24,"Track and Field, Outdoor",13654,167820,-154166,4566,52126,-47560,9088,115694,-106606,"27","32",11147,23400
"4271",173920,"MINNESOTA STATE UNVERSITY-MANKATO                           ","2003-2004",7,"Football",518681,672997,-154316,518681,672997,-154316,0,0,0,"78",".",132255,0
"8598",151102,"INDIANA UNIVERSITY-PURDUE UNIVERSITY-FORT WAYNE             ","2003-2004",16,"Softball",2206,156793,-154587,0,0,0,2206,156793,-154587,".","21",0,57220
"13424",157386,"MOREHEAD STATE UNIVERSITY                                   ","2003-2004",26,"Volleyball",79998,234632,-154634,0,0,0,79998,234632,-154634,"0","14",0,38211
"6970",207458,"OKLAHOMA CITY UNIVERSITY                                    ","2003-2004",13,"Rowing",200,155000,-154800,100,77500,-77400,100,77500,-77400,"12","14",57500,57500
"16944",199032,"MONTREAT COLLEGE                                            ","2003-2004",39,"Total Participants",153249,308212,-154963,85469,172506,-87037,67780,135706,-67926,"80","65",92016,74322
"6096",232982,"OLD DOMINION UNIVERSITY                                     ","2003-2004",8,"Golf",80241,235283,-155042,74463,119596,-45133,5778,115687,-109909,"12","7",35916,18129
"14362",197197,"WAGNER COLLEGE                                              ","2003-2004",26,"Volleyball",24214,179564,-155350,0,0,0,24214,179564,-155350,".","16",0,16050
"173",151102,"INDIANA UNIVERSITY-PURDUE UNIVERSITY-FORT WAYNE             ","2003-2004",1,"Baseball",25715,181141,-155426,25715,181141,-155426,0,0,0,"29",".",76653,0
"5977",110556,"CALIFORNIA STATE UNIVERSITY-FRESNO                          ","2003-2004",8,"Golf",75840,231362,-155522,75840,231362,-155522,0,0,0,"12",".",41960,0
"11358",218742,"UNIVERSITY OF SOUTH CAROLINA-SPARTANBURG                    ","2003-2004",22,"Tennis",5626,161170,-155544,2813,83913,-81100,2813,77257,-74444,"9","8",11000,11353
"4298",221351,"RHODES COLLEGE                                              ","2003-2004",7,"Football",136900,292502,-155602,136900,292502,-155602,0,0,0,"66",".",72541,0
"5396",232566,"LONGWOOD UNIVERSITY                                         ","2003-2004",8,"Golf",11913,167666,-155753,4994,76079,-71085,6919,91587,-84668,"9","6",17220,17562
"6112",197197,"WAGNER COLLEGE                                              ","2003-2004",8,"Golf",30269,186045,-155776,16715,96990,-80275,13554,89055,-75501,"11","6",9632,8447
"3390",230092,"COLLEGE OF EASTERN UTAH                                     ","2003-2004",2,"Basketball",9500,165324,-155824,9000,88488,-79488,500,76836,-76336,"16","15",26000,23500
"7854",110565,"CALIFORNIA STATE UNIVERSITY-FULLERTON                       ","2003-2004",15,"Soccer",501461,657306,-155845,303830,368283,-64453,197631,289023,-91392,"25","25",53336,55139
"15371",191630,"HOBART WILLIAM SMITH COLLEGES                               ","2003-2004",36,"Sailing",40690,196538,-155848,22155,96427,-74272,18535,100111,-81576,"17","15",9523,9523
"194",140960,"SAVANNAH STATE UNIVERSITY                                   ","2003-2004",1,"Baseball",0,155855,-155855,0,155855,-155855,0,0,0,"14",".",70826,0
"4838",207351,"OKLAHOMA PANHANDLE STATE UNIVERSITY                         ","2003-2004",7,"Football",103440,259603,-156163,103440,259603,-156163,0,0,0,"94",".",41643,0
"2137",228486,"SOUTHWESTERN CHRISTIAN COLLEGE                              ","2003-2004",2,"Basketball",3000,159250,-156250,1600,85700,-84100,1400,73550,-72150,"15","15",6410,6612
"101",101161,"JAMES H FAULKNER STATE COMMUNITY COLLEGE                    ","2003-2004",1,"Baseball",29172,185669,-156497,29172,185669,-156497,0,0,0,"35",".",37864,0
"12582",120184,"NOTRE DAME DE NAMUR UNIVERSITY                              ","2003-2004",25,"Track and Field, X-Country",49382,206032,-156650,25514,68564,-43050,23868,137468,-113600,"8","6",12341,10789
"9281",221740,"THE UNIVERSITY OF TENNESSEE-CHATTANOOGA                     ","2003-2004",16,"Softball",21719,178583,-156864,0,0,0,21719,178583,-156864,".","20",0,78555
"779",226134,"LAREDO COMMUNITY COLLEGE                                    ","2003-2004",1,"Baseball",7500,164375,-156875,7500,164375,-156875,0,0,0,"30",".",81198,0
"8436",174233,"UNIVERSITY OF MINNESOTA-DULUTH                              ","2003-2004",15,"Soccer",40504,197451,-156947,0,0,0,40504,197451,-156947,"0","28",0,26250
"6141",149222,"SOUTHERN ILLINOIS UNIVERSITY-CARBONDALE                     ","2003-2004",8,"Golf",123028,280045,-157017,33451,107958,-74507,89577,172087,-82510,"8","10",29658,54761
"2210",218964,"WINTHROP UNIVERSITY                                         ","2003-2004",2,"Basketball",1065734,1223087,-157353,733840,683233,50607,331894,539854,-207960,"16","15",119301,84860
"9381",159966,"NICHOLLS STATE UNIVERSITY                                   ","2003-2004",16,"Softball",44712,202085,-157373,0,0,0,44712,202085,-157373,".","22",0,40985
"10297",197036,"UNITED STATES MILITARY ACADEMY                              ","2003-2004",18,"Swimming and Diving",261140,418695,-157555,192070,248867,-56797,69070,169828,-100758,"36","25",75660,50061
"2214",120184,"NOTRE DAME DE NAMUR UNIVERSITY                              ","2003-2004",2,"Basketball",165729,323322,-157593,80222,161706,-81484,85507,161616,-76109,"14","10",42649,27603
"2014",173920,"MINNESOTA STATE UNVERSITY-MANKATO                           ","2003-2004",2,"Basketball",427142,584977,-157835,210604,303592,-92988,216538,281385,-64847,"18","13",75169,71321
"7411",184782,"ROWAN UNIVERSITY                                            ","2003-2004",15,"Soccer",11550,169890,-158340,9850,99638,-89788,1700,70252,-68552,"32","27",26498,22754
"2717",238078,"WHEELING JESUIT UNIVERSITY                                  ","2003-2004",2,"Basketball",1844,160314,-158470,940,102074,-101134,904,58240,-57336,"13","12",22151,20682
"10849",121309,"POINT LOMA NAZARENE UNIVERSITY                              ","2003-2004",22,"Tennis",9174,167675,-158501,6087,73419,-67332,3087,94256,-91169,"9","13",21903,26391
"7339",171571,"OAKLAND UNIVERSITY                                          ","2003-2004",15,"Soccer",555999,714851,-158852,284120,370881,-86761,271879,343970,-72091,"27","26",73543,72073
"14962",164988,"BOSTON UNIVERSITY                                           ","2003-2004",28,"Wrestling",238866,397727,-158861,238866,397727,-158861,0,0,0,"30",".",45460,0
"15358",130794,"YALE UNIVERSITY                                             ","2003-2004",36,"Sailing",185011,343991,-158980,0,0,0,185011,343991,-158980,".","36",0,58698
"16291",201654,"CEDARVILLE UNIVERSITY                                       ","2003-2004",39,"Total Participants",857021,1016075,-159054,384358,482540,-98182,472663,533535,-60872,"118","108",174895,177545
"6679",217402,"PROVIDENCE COLLEGE                                          ","2003-2004",11,"Lacrosse",18375,177491,-159116,18375,177491,-159116,0,0,0,"41",".",74511,0
"10439",164988,"BOSTON UNIVERSITY                                           ","2003-2004",18,"Swimming and Diving",25364,184490,-159126,12324,92456,-80132,13040,92034,-78994,"22","26",26516,26068
"14716",197197,"WAGNER COLLEGE                                              ","2003-2004",27,"Water Polo",33420,192625,-159205,0,0,0,33420,192625,-159205,".","17",0,26255
"16297",181330,"MIDLAND LUTHERAN COLLEGE                                    ","2003-2004",39,"Total Participants",133355,292614,-159259,56637,138982,-82345,76718,153632,-76914,"217","141",118499,96874
"3665",201690,"CENTRAL STATE UNIVERSITY                                    ","2003-2004",3,"All Track Combined",36312,195646,-159334,18156,97823,-79667,18156,97823,-79667,"18","19",18516,18516
"8287",185262,"KEAN UNIVERSITY                                             ","2003-2004",15,"Soccer",2,159341,-159339,1,96780,-96779,1,62561,-62560,"34","24",19439,18135
"10354",175616,"DELTA STATE UNIVERSITY                                      ","2003-2004",18,"Swimming and Diving",5723,165102,-159379,0,92980,-92980,5723,72122,-66399,"26","17",6630,6630
"6051",159939,"UNIVERSITY OF NEW ORLEANS                                   ","2003-2004",8,"Golf",4025,163455,-159430,2100,79547,-77447,1925,83908,-81983,"9","7",31005,24073
"16413",163338,"UNIVERSITY OF MARYLAND-EASTERN SHORE                        ","2003-2004",39,"Total Participants",863515,1022979,-159464,359619,343823,15796,503896,679156,-175260,"89","115",166139,238333
"1865",234207,"WASHINGTON AND LEE UNIVERSITY                               ","2003-2004",2,"Basketball",11039,170540,-159501,10612,100887,-90275,427,69653,-69226,"13","10",22634,12795
"6738",168342,"WILLIAMS COLLEGE                                            ","2003-2004",11,"Lacrosse",65437,224985,-159548,36787,136376,-99589,28650,88609,-59959,"40","21",28573,26278
"14720",120883,"UNIVERSITY OF THE PACIFIC                                   ","2003-2004",27,"Water Polo",192046,351690,-159644,105141,184961,-79820,86905,166729,-79824,"24","19",29620,33104
"8730",195164,"SAINT BONAVENTURE UNIVERSITY                                ","2003-2004",16,"Softball",12213,171986,-159773,0,0,0,12213,171986,-159773,".","18",0,28165
"9840",207403,"OKLAHOMA BAPTIST UNIVERSITY                                 ","2003-2004",16,"Softball",20796,180587,-159791,0,0,0,20796,180587,-159791,".","8",0,19489
"15940",155858,"SEWARD COUNTY COMMUNITY COLLEGE                             ","2003-2004",39,"Total Participants",271866,431764,-159898,111877,196356,-84479,159989,235408,-75419,"49","41",62452,53836
"14619",159993,"UNIVERSITY OF LOUISIANA AT MONROE                           ","2003-2004",26,"Volleyball",1020,160971,-159951,0,0,0,1020,160971,-159951,".","12",0,27215
"4984",155061,"FORT HAYS STATE UNIVERSITY                                  ","2003-2004",7,"Football",337560,497638,-160078,337560,497638,-160078,0,0,0,"87",".",88994,0
"7120",145813,"ILLINOIS STATE UNIVERSITY                                   ","2003-2004",15,"Soccer",82029,242185,-160156,0,0,0,82029,242185,-160156,".","25",0,32220
"4630",198613,"GUILFORD COLLEGE                                            ","2003-2004",7,"Football",113688,274017,-160329,113688,274017,-160329,0,0,0,"76",".",57645,0
"1852",201885,"UNIVERSITY OF CINCINNATI-MAIN CAMPUS                        ","2003-2004",2,"Basketball",5384073,5544453,-160380,5078999,4473232,605767,305074,1071221,-766147,"13","14",789233,204846
"10685",217907,"COKER COLLEGE                                               ","2003-2004",22,"Tennis",19286,179769,-160483,9694,87562,-77868,9592,92207,-82615,"7","10",9225,8136
"16353",226329,"LON MORRIS COLLEGE                                          ","2003-2004",39,"Total Participants",88000,248594,-160594,40506,106947,-66441,47494,141647,-94153,"95","78",71322,58630
"757",181394,"UNIVERSITY OF NEBRASKA AT OMAHA                             ","2003-2004",1,"Baseball",59516,220172,-160656,59516,220172,-160656,0,0,0,"34",".",62405,0
"5410",142276,"IDAHO STATE UNIVERSITY                                      ","2003-2004",8,"Golf",23775,184512,-160737,1770,61089,-59319,22005,123423,-101418,"11","8",27602,34239
"14562",199111,"UNIVERSITY OF NORTH CAROLINA AT ASHEVILLE                   ","2003-2004",26,"Volleyball",13212,173964,-160752,0,0,0,13212,173964,-160752,".","14",0,34575
"4302",154527,"WARTBURG COLLEGE                                            ","2003-2004",7,"Football",70895,231671,-160776,70895,231671,-160776,0,0,0,"129",".",48684,0
"994",197869,"APPALACHIAN STATE UNIVERSITY                                ","2003-2004",1,"Baseball",28838,189857,-161019,28838,189857,-161019,0,0,0,"29",".",72099,0
"11809",201441,"BOWLING GREEN STATE UNIVERSITY-MAIN CAMPUS                  ","2003-2004",23,"Track and Field, Indoor",15704,176742,-161038,0,0,0,15704,176742,-161038,".","43",0,21698
"12054",201441,"BOWLING GREEN STATE UNIVERSITY-MAIN CAMPUS                  ","2003-2004",24,"Track and Field, Outdoor",15704,176742,-161038,0,0,0,15704,176742,-161038,".","44",0,21698
"15622",117052,"REEDLEY COLLEGE                                             ","2003-2004",39,"Total Participants",61445,222707,-161262,31634,105907,-74273,29811,116800,-86989,"181","41",55266,42524
"1687",192448,"LONG ISLAND UNIVERSITY-C W POST CAMPUS                      ","2003-2004",2,"Basketball",546741,708074,-161333,306015,418301,-112286,240726,289773,-49047,"15","10",40492,20811
"1272",222062,"WALTERS STATE COMMUNITY COLLEGE                             ","2003-2004",1,"Baseball",7000,168339,-161339,7000,168339,-161339,0,0,0,"27",".",43460,0
"17288",226833,"MIDWESTERN STATE UNIVERSITY                                 ","2003-2004",39,"Total Participants",11183,172555,-161372,2998,46813,-43815,8185,125742,-117557,"145","71",252450,144950
"10094",121345,"POMONA COLLEGE                                              ","2003-2004",18,"Swimming and Diving",48015,209429,-161414,13591,58976,-45385,34424,150453,-116029,"19","30",3632,17436
"16714",105525,"PIMA COMMUNITY COLLEGE                                      ","2003-2004",39,"Total Participants",270528,431950,-161422,133021,218763,-85742,137507,213187,-75680,"231","103",207431,95072
"15131",206996,"CONNORS STATE COLLEGE                                       ","2003-2004",29,"Other Sports",2,161446,-161444,1,105569,-105568,1,55877,-55876,"39",".",161460,0
"15561",175829,"ITAWAMBA COMMUNITY COLLEGE                                  ","2003-2004",39,"Total Participants",1048,162493,-161445,1046,113238,-112192,2,49255,-49253,"126","32",118852,36873
"2796",213376,"LACKAWANNA COLLEGE                                          ","2003-2004",2,"Basketball",1500,162959,-161459,750,100722,-99972,750,62237,-61487,"9","7",84295,45810
"11229",197036,"UNITED STATES MILITARY ACADEMY                              ","2003-2004",22,"Tennis",208438,369952,-161514,127536,178150,-50614,80902,191802,-110900,"16","12",50240,72122
"2601",155973,"TABOR COLLEGE                                               ","2003-2004",2,"Basketball",22860,184537,-161677,11933,108894,-96961,10927,75643,-64716,"28","21",25900,18438
"4821",200156,"JAMESTOWN COLLEGE                                           ","2003-2004",7,"Football",142451,304192,-161741,142451,304192,-161741,0,0,0,"42",".",38211,0
"80",160038,"NORTHWESTERN STATE UNIVERSITY OF LOUISIANA                  ","2003-2004",1,"Baseball",152164,313908,-161744,152164,313908,-161744,0,0,0,"38",".",92745,0
"3564",154697,"BARTON COUNTY COMMUNITY COLLEGE                             ","2003-2004",3,"All Track Combined",83230,245007,-161777,42965,122504,-79539,40265,122503,-82238,"37","29",32746,32746
"15416",231420,"AVERETT UNIVERSITY                                          ","2003-2004",39,"Total Participants",180960,342861,-161901,88480,171626,-83146,92480,171235,-78755,"158","86",194134,126980
"16136",219888,"COLUMBIA STATE COMMUNITY COLLEGE                            ","2003-2004",39,"Total Participants",4576,166502,-161926,2460,109469,-107009,2116,57033,-54917,"40","26",63710,49496
"14957",233921,"VIRGINIA POLYTECHNIC INSTITUTE AND STATE UNIV               ","2003-2004",28,"Wrestling",156271,318224,-161953,156271,318224,-161953,0,0,0,"22",".",51328,0
"6861",157085,"UNIVERSITY OF KENTUCKY                                      ","2003-2004",12,"Rifle",0,161992,-161992,0,0,0,0,161992,-161992,".","12",0,72092
"13472",160038,"NORTHWESTERN STATE UNIVERSITY OF LOUISIANA                  ","2003-2004",26,"Volleyball",86321,248402,-162081,0,0,0,86321,248402,-162081,".","12",0,37223
"10292",230038,"BRIGHAM YOUNG UNIVERSITY                                    ","2003-2004",18,"Swimming and Diving",705796,867890,-162094,295370,363539,-68169,410426,504351,-93925,"29","33",66192,107235
"7565",121345,"POMONA COLLEGE                                              ","2003-2004",15,"Soccer",39284,201481,-162197,23444,127665,-104221,15840,73816,-57976,"24","22",21213,10862
"368",152600,"VALPARAISO UNIVERSITY                                       ","2003-2004",1,"Baseball",456297,618546,-162249,456297,618546,-162249,0,0,0,"70",".",28655,0
"3366",181011,"DANA COLLEGE                                                ","2003-2004",2,"Basketball",23450,185750,-162300,13000,133000,-120000,10450,52750,-42300,"24","13",19048,13995
"4611",216357,"THIEL COLLEGE                                               ","2003-2004",7,"Football",129449,291901,-162452,129449,291901,-162452,0,0,0,"112",".",67461,0
"6774",232186,"GEORGE MASON UNIVERSITY                                     ","2003-2004",11,"Lacrosse",166227,328800,-162573,0,0,0,166227,328800,-162573,".","24",0,66023
"15744",238430,"CARDINAL STRITCH UNIVERSITY                                 ","2003-2004",39,"Total Participants",89816,252405,-162589,45666,126765,-81099,44150,125640,-81490,"79","63",57819,53386
"13624",180179,"MONTANA STATE UNIVERSITY-BILLINGS                           ","2003-2004",26,"Volleyball",6352,168953,-162601,0,0,0,6352,168953,-162601,".","11",0,36882
"16817",198543,"FAYETTEVILLE STATE UNIVERSITY                               ","2003-2004",39,"Total Participants",7,162652,-162645,2,33166,-33164,5,129486,-129481,"131","69",485994,224307
"15282",100858,"AUBURN UNIVERSITY MAIN CAMPUS                               ","2003-2004",34,"Equestrian",12790,175866,-163076,0,0,0,12790,175866,-163076,".","33",0,47528
"15787",217998,"ERSKINE COLLEGE AND SEMINARY                                ","2003-2004",39,"Total Participants",112000,275267,-163267,59000,127210,-68210,53000,148057,-95057,"91","68",96775,81357
"2941",225627,"UNIVERSITY OF THE INCARNATE WORD                            ","2003-2004",2,"Basketball",634870,798257,-163387,357929,464196,-106267,276941,334061,-57120,"13","12",42419,29765
"2440",218070,"FURMAN UNIVERSITY                                           ","2003-2004",2,"Basketball",1740615,1904069,-163454,961522,1047756,-86234,779093,856313,-77220,"14","16",152339,106524
"12404",237118,"ALDERSON BROADDUS COLLEGE                                   ","2003-2004",25,"Track and Field, X-Country",16456,179951,-163495,8228,104597,-96369,8228,75354,-67126,"10","7",7406,7406
"7759",194958,"ROBERTS WESLEYAN COLLEGE                                    ","2003-2004",15,"Soccer",103445,267000,-163555,69547,160423,-90876,33898,106577,-72679,"23","17",26521,24302
"9311",141264,"VALDOSTA STATE UNIVERSITY                                   ","2003-2004",16,"Softball",55283,218912,-163629,0,0,0,55283,218912,-163629,".","18",0,43238
"15573",131283,"CATHOLIC UNIVERSITY OF AMERICA                              ","2003-2004",39,"Total Participants",23211,187001,-163790,14405,91750,-77345,8806,95251,-86445,"202","187",134980,91870
"15824",102270,"STILLMAN COLLEGE                                            ","2003-2004",39,"Total Participants",72650,236725,-164075,29325,66100,-36775,43325,170625,-127300,"152","78",189500,65500
"6946",190150,"COLUMBIA UNIVERSITY IN THE CITY OF NEW YORK                 ","2003-2004",13,"Rowing",48714,213061,-164347,41000,102000,-61000,7714,111061,-103347,"15","34",44682,55652
"8349",219602,"AUSTIN PEAY STATE UNIVERSITY                                ","2003-2004",15,"Soccer",0,164506,-164506,0,0,0,0,164506,-164506,".","20",0,37336
"9049",223232,"BAYLOR UNIVERSITY                                           ","2003-2004",16,"Softball",652367,817149,-164782,0,0,0,652367,817149,-164782,".","18",0,166968
"534",232566,"LONGWOOD UNIVERSITY                                         ","2003-2004",1,"Baseball",14145,178971,-164826,14145,178971,-164826,0,0,0,"22",".",31345,0
"4557",237312,"UNIVERSITY OF CHARLESTON                                    ","2003-2004",7,"Football",269223,434050,-164827,269223,434050,-164827,0,0,0,"89",".",132224,0
"3396",240657,"NORTHWEST COMMUNITY COLLEGE                                 ","2003-2004",2,"Basketball",17689,182573,-164884,10001,109110,-99109,7688,73463,-65775,"13","15",28094,18981
"14951",118693,"MENLO COLLEGE                                               ","2003-2004",28,"Wrestling",17000,181982,-164982,15000,157414,-142414,2000,24568,-22568,"41","10",65100,13900
"5406",172699,"WESTERN MICHIGAN UNIVERSITY                                 ","2003-2004",8,"Golf",21251,186310,-165059,0,0,0,21251,186310,-165059,".","9",0,46883
"10192",198419,"DUKE UNIVERSITY                                             ","2003-2004",18,"Swimming and Diving",15392,180984,-165592,7696,86778,-79082,7696,94206,-86510,"32","26",47964,44630
"14747",122409,"SAN DIEGO STATE UNIVERSITY                                  ","2003-2004",27,"Water Polo",97317,262924,-165607,0,0,0,97317,262924,-165607,".","23",0,51344
"2667",147660,"NORTH CENTRAL COLLEGE                                       ","2003-2004",2,"Basketball",72165,237850,-165685,45366,125392,-80026,26799,112458,-85659,"22","18",37120,21772
"17259",163453,"MORGAN STATE UNIVERSITY                                     ","2003-2004",39,"Total Participants",1261434,1427267,-165833,370364,415328,-44964,891070,1011939,-120869,"133","79",420211,252458
"12483",187648,"EASTERN NEW MEXICO UNIVERSITY-MAIN CAMPUS                   ","2003-2004",25,"Track and Field, X-Country",11100,177210,-166110,5550,108439,-102889,5550,68771,-63221,"43","32",14968,14968
"11840",207403,"OKLAHOMA BAPTIST UNIVERSITY                                 ","2003-2004",23,"Track and Field, Indoor",19295,185550,-166255,9488,91441,-81953,9807,94109,-84302,"30","33",13528,14861
"11877",160612,"SOUTHEASTERN LOUISIANA UNIVERSITY                           ","2003-2004",23,"Track and Field, Indoor",19359,185711,-166352,10617,74939,-64322,8742,110772,-102030,"27","24",15341,15341
"13389",160658,"UNIVERSITY OF LOUISIANA AT LAFAYETTE                        ","2003-2004",26,"Volleyball",1408,167845,-166437,0,0,0,1408,167845,-166437,".","12",0,50020
"14767",110422,"CALIFORNIA POLYTECHNIC STATE UNIV-SAN LUIS OBISPO           ","2003-2004",28,"Wrestling",112936,279481,-166545,112936,279481,-166545,0,0,0,"33",".",46182,0
"15618",237011,"WESTERN WASHINGTON UNIVERSITY                               ","2003-2004",39,"Total Participants",830988,997571,-166583,235205,241295,-6090,595783,756276,-160493,"273","312",371876,294160
"10269",178615,"TRUMAN STATE UNIVERSITY                                     ","2003-2004",18,"Swimming and Diving",30211,196980,-166769,11220,72401,-61181,18991,124579,-105588,"24","32",24764,35387
"1385",175616,"DELTA STATE UNIVERSITY                                      ","2003-2004",1,"Baseball",56151,222960,-166809,56151,222960,-166809,0,0,0,"43",".",45838,0
"2535",185590,"MONTCLAIR STATE UNIVERSITY                                  ","2003-2004",2,"Basketball",19050,185898,-166848,9466,101599,-92133,9584,84299,-74715,"23","13",30310,23402
"8228",178615,"TRUMAN STATE UNIVERSITY                                     ","2003-2004",15,"Soccer",31972,198851,-166879,20528,93740,-73212,11444,105111,-93667,"26","25",23119,27171
"9725",219602,"AUSTIN PEAY STATE UNIVERSITY                                ","2003-2004",16,"Softball",0,166956,-166956,0,0,0,0,166956,-166956,".","17",0,32498
"17118",154059,"NORTH IOWA AREA COMMUNITY COLLEGE                           ","2003-2004",39,"Total Participants",27893,194878,-166985,22234,109824,-87590,5659,85054,-79395,"155","43",143972,65963
"8902",120184,"NOTRE DAME DE NAMUR UNIVERSITY                              ","2003-2004",16,"Softball",101407,268395,-166988,0,0,0,101407,268395,-166988,".","24",0,63695
"14477",159009,"GRAMBLING STATE UNIVERSITY                                  ","2003-2004",26,"Volleyball",1,167053,-167052,0,0,0,1,167053,-167052,".","17",0,98404
"12983",122755,"SAN JOSE STATE UNIVERSITY                                   ","2003-2004",25,"Track and Field, X-Country",4760,171989,-167229,2380,56024,-53644,2380,115965,-113585,"10","18",9810,15077
"8401",120883,"UNIVERSITY OF THE PACIFIC                                   ","2003-2004",15,"Soccer",407883,575388,-167505,0,0,0,407883,575388,-167505,".","22",0,70809
"6972",166683,"MASSACHUSETTS INSTITUTE OF TECHNOLOGY                       ","2003-2004",13,"Rowing",540580,708239,-167659,315625,379972,-64347,224955,328267,-103312,"85","58",259337,203796
"11944",138275,"WARNER SOUTHERN COLLEGE                                     ","2003-2004",24,"Track and Field, Outdoor",459,168124,-167665,458,99237,-98779,1,68887,-68886,"30","14",11987,11743
"5135",199120,"UNIVERSITY OF NORTH CAROLINA AT CHAPEL HILL                 ","2003-2004",8,"Golf",334418,502095,-167677,145369,216496,-71127,189049,285599,-96550,"12","8",16039,33465
"14874",232982,"OLD DOMINION UNIVERSITY                                     ","2003-2004",28,"Wrestling",34385,202068,-167683,34385,202068,-167683,0,0,0,"29",".",20834,0
"4322",237330,"CONCORD COLLEGE                                             ","2003-2004",7,"Football",348168,515943,-167775,348168,515943,-167775,0,0,0,"74",".",60042,0
"13609",223232,"BAYLOR UNIVERSITY                                           ","2003-2004",26,"Volleyball",665752,833913,-168161,0,0,0,665752,833913,-168161,".","14",0,183765
"8477",190761,"DOMINICAN COLLEGE OF BLAUVELT                               ","2003-2004",15,"Soccer",48666,216870,-168204,24685,129606,-104921,23981,87264,-63283,"27","18",20526,13463
"6749",231174,"UNIVERSITY OF VERMONT AND STATE AGRICULTURAL COLL           ","2003-2004",11,"Lacrosse",267700,436034,-168334,167521,287136,-119615,100179,148898,-48719,"44","24",109631,79384
"16824",180948,"CHADRON STATE COLLEGE                                       ","2003-2004",39,"Total Participants",133477,301851,-168374,69257,131900,-62643,64220,169951,-105731,"220","76",119633,51247
"8777",208488,"CONCORDIA UNIVERSITY                                        ","2003-2004",16,"Softball",36739,205174,-168435,0,0,0,36739,205174,-168435,".","19",0,27424
"4347",176071,"MISSISSIPPI GULF COAST COMMUNITY COLLEGE                    ","2003-2004",7,"Football",13995,182511,-168516,13995,182511,-168516,0,0,0,"55",".",55294,0
"9142",137078,"ST PETERSBURG COLLEGE                                       ","2003-2004",16,"Softball",278741,447485,-168744,0,0,0,278741,447485,-168744,".","25",0,70300
"5061",217484,"UNIVERSITY OF RHODE ISLAND                                  ","2003-2004",7,"Football",2733091,2901917,-168826,2733091,2901917,-168826,0,0,0,"75",".",339329,0
"7756",237969,"WEST VIRGINIA WESLEYAN COLLEGE                              ","2003-2004",15,"Soccer",130172,299192,-169020,65894,162034,-96140,64278,137158,-72880,"33","27",22273,26479
"11727",199111,"UNIVERSITY OF NORTH CAROLINA AT ASHEVILLE                   ","2003-2004",22,"Tennis",7971,177045,-169074,1690,91572,-89882,6281,85473,-79192,"8","8",16207,16785
"4779",200280,"UNIVERSITY OF NORTH DAKOTA-MAIN CAMPUS                      ","2003-2004",7,"Football",1316666,1485800,-169134,1316666,1485800,-169134,0,0,0,"109",".",134600,0
"1045",199102,"NORTH CAROLINA  A &amp;T STATE UNIVERSITY                       ","2003-2004",1,"Baseball",40311,209486,-169175,40311,209486,-169175,0,0,0,"33",".",42490,0
"7561",201104,"ASHLAND UNIVERSITY                                          ","2003-2004",15,"Soccer",570429,739677,-169248,308485,393109,-84624,261944,346568,-84624,"26","24",13632,13632
"14050",217165,"BRYANT COLLEGE                                              ","2003-2004",26,"Volleyball",55860,225157,-169297,0,0,0,55860,225157,-169297,".","13",0,42874
"7652",181394,"UNIVERSITY OF NEBRASKA AT OMAHA                             ","2003-2004",15,"Soccer",76357,245798,-169441,0,0,0,76357,245798,-169441,".","24",0,39822
"4202",190150,"COLUMBIA UNIVERSITY IN THE CITY OF NEW YORK                 ","2003-2004",6,"Field hocky",681,170389,-169708,0,0,0,681,170389,-169708,".","22",0,54784
"7125",221768,"THE UNIVERSITY OF TENNESSEE-MARTIN                          ","2003-2004",15,"Soccer",9799,179666,-169867,0,0,0,9799,179666,-169867,".","19",0,25707
"8949",157386,"MOREHEAD STATE UNIVERSITY                                   ","2003-2004",16,"Softball",95428,265484,-170056,0,0,0,95428,265484,-170056,".","20",0,40526
"3894",153825,"LORAS COLLEGE                                               ","2003-2004",3,"All Track Combined",20546,190845,-170299,10273,102332,-92059,10273,88513,-78240,"74","66",31346,29098
"5093",191630,"HOBART WILLIAM SMITH COLLEGES                               ","2003-2004",7,"Football",100387,270809,-170422,100387,270809,-170422,0,0,0,"81",".",33966,0
"10922",175616,"DELTA STATE UNIVERSITY                                      ","2003-2004",22,"Tennis",4095,174988,-170893,0,83174,-83174,4095,91814,-87719,"10","8",7580,6776
"5821",237525,"MARSHALL UNIVERSITY                                         ","2003-2004",8,"Golf",161726,332635,-170909,101646,175984,-74338,60080,156651,-96571,"11","12",41294,40368
"3893",241739,"UNIVERSIDAD METROPOLITANA                                   ","2003-2004",3,"All Track Combined",2,171080,-171078,1,115520,-115519,1,55560,-55559,"21","18",25000,22000
"1166",219806,"CARSON-NEWMAN COLLEGE                                       ","2003-2004",1,"Baseball",5366,176651,-171285,5366,176651,-171285,0,0,0,"36",".",25704,0
"2315",147679,"NORTH PARK UNIVERSITY                                       ","2003-2004",2,"Basketball",67425,239156,-171731,36071,155854,-119783,31354,83302,-51948,"21","14",35941,30967
"11849",202480,"UNIVERSITY OF DAYTON                                        ","2003-2004",23,"Track and Field, Indoor",10,171939,-171929,0,0,0,10,171939,-171929,".","20",0,34594
"12058",202480,"UNIVERSITY OF DAYTON                                        ","2003-2004",24,"Track and Field, Outdoor",10,171939,-171929,0,0,0,10,171939,-171929,".","21",0,34594
"16694",237367,"FAIRMONT STATE COLLEGE                                      ","2003-2004",39,"Total Participants",163019,335086,-172067,65514,140610,-75096,97505,194476,-96971,"187","83",127463,79817
"4852",199102,"NORTH CAROLINA  A &amp;T STATE UNIVERSITY                       ","2003-2004",7,"Football",1538783,1710873,-172090,1538783,1710873,-172090,0,0,0,"96",".",135038,0
"485",106397,"UNIVERSITY OF ARKANSAS MAIN CAMPUS                          ","2003-2004",1,"Baseball",978005,1150159,-172154,978005,1150159,-172154,0,0,0,"44",".",353752,0
"8989",179566,"SOUTHWEST MISSOURI STATE UNIVERSITY                         ","2003-2004",16,"Softball",201345,373726,-172381,0,0,0,201345,373726,-172381,".","17",0,77364
"7391",219383,"UNIVERSITY OF SIOUX FALLS                                   ","2003-2004",15,"Soccer",340,172837,-172497,270,94939,-94669,70,77898,-77828,"25","20",11118,9745
"1614",191630,"HOBART WILLIAM SMITH COLLEGES                               ","2003-2004",2,"Basketball",79130,251635,-172505,54168,135767,-81599,24962,115868,-90906,"21","13",20318,15922
"3350",187903,"NEW MEXICO JUNIOR COLLEGE                                   ","2003-2004",2,"Basketball",1400,173964,-172564,800,86982,-86182,600,86982,-86382,"12","12",23740,23440
"3831",200004,"WESTERN CAROLINA UNIVERSITY                                 ","2003-2004",3,"All Track Combined",83046,255831,-172785,41523,122560,-81037,41523,133271,-91748,"37","27",43432,43432
"15818",166683,"MASSACHUSETTS INSTITUTE OF TECHNOLOGY                       ","2003-2004",39,"Total Participants",1945776,2118981,-173205,1181195,1266746,-85551,764581,852235,-87654,"604","390",698735,490984
"11918",137351,"UNIVERSITY OF SOUTH FLORIDA                                 ","2003-2004",23,"Track and Field, Indoor",2358,175746,-173388,0,0,0,2358,175746,-173388,".","44",0,72200
"8274",180814,"BELLEVUE UNIVERSITY                                         ","2003-2004",15,"Soccer",700,174226,-173526,500,90788,-90288,200,83438,-83238,"26","15",50788,43438
"16629",127060,"UNIVERSITY OF DENVER                                        ","2003-2004",39,"Total Participants",9133039,9306803,-173764,4887030,4920326,-33296,4246009,4386477,-140468,"147","144",1113064,988046
"17064",215275,"UNIVERSITY OF PITTSBURGH-GREENSBURG                         ","2003-2004",39,"Total Participants",1218,175185,-173967,810,87188,-86378,408,87997,-87589,"100","62",65360,64922
"1689",184782,"ROWAN UNIVERSITY                                            ","2003-2004",2,"Basketball",7977,182480,-174503,467,95984,-95517,7510,86496,-78986,"17","14",25571,22599
"3814",199157,"NORTH CAROLINA CENTRAL UNIVERSITY                           ","2003-2004",3,"All Track Combined",9666,184212,-174546,4833,107162,-102329,4833,77050,-72217,"20","15",34367,18569
"9388",198136,"CAMPBELL UNIVERSITY INC                                     ","2003-2004",16,"Softball",200877,375518,-174641,0,0,0,200877,375518,-174641,".","18",0,83139
"11887",238032,"WEST VIRGINIA UNIVERSITY                                    ","2003-2004",23,"Track and Field, Indoor",1918,176873,-174955,0,0,0,1918,176873,-174955,".","36",0,33785
"8260",159993,"UNIVERSITY OF LOUISIANA AT MONROE                           ","2003-2004",15,"Soccer",17325,192354,-175029,0,0,0,17325,192354,-175029,".","22",0,68232
"2853",109819,"BAKERSFIELD COLLEGE                                         ","2003-2004",2,"Basketball",25908,201054,-175146,12654,106732,-94078,13254,94322,-81068,"16","12",6308,6308
"4967",200004,"WESTERN CAROLINA UNIVERSITY                                 ","2003-2004",7,"Football",1029080,1204256,-175176,1029080,1204256,-175176,0,0,0,"90",".",257680,0
"2938",234164,"VIRGINIA UNION UNIVERSITY                                   ","2003-2004",2,"Basketball",412324,587565,-175241,230665,405466,-174801,181659,182099,-440,"22","13",38570,28700
"16682",211361,"CALIFORNIA UNIVERSITY OF PENNSYLVANIA                       ","2003-2004",39,"Total Participants",1021964,1197527,-175563,309578,367586,-58008,712386,829941,-117555,"186","86",256880,211441
"14457",190150,"COLUMBIA UNIVERSITY IN THE CITY OF NEW YORK                 ","2003-2004",26,"Volleyball",1010,176627,-175617,0,0,0,1010,176627,-175617,".","8",0,48253
"14147",230782,"WEBER STATE UNIVERSITY                                      ","2003-2004",26,"Volleyball",161832,337554,-175722,0,0,0,161832,337554,-175722,".","16",0,61008
"2256",154697,"BARTON COUNTY COMMUNITY COLLEGE                             ","2003-2004",2,"Basketball",175356,351134,-175778,94983,201203,-106220,80373,149931,-69558,"12","12",40880,33493
"7802",209807,"PORTLAND STATE UNIVERSITY                                   ","2003-2004",15,"Soccer",140145,315923,-175778,0,0,0,140145,315923,-175778,".","25",0,58150
"9670",217907,"COKER COLLEGE                                               ","2003-2004",16,"Softball",19859,195685,-175826,0,0,0,19859,195685,-175826,".","18",0,14736
"59",159966,"NICHOLLS STATE UNIVERSITY                                   ","2003-2004",1,"Baseball",35526,211457,-175931,35526,211457,-175931,0,0,0,"32",".",62797,0
"6391",173920,"MINNESOTA STATE UNVERSITY-MANKATO                           ","2003-2004",10,"Ice Hockey",1487551,1663607,-176056,1126737,1095974,30763,360814,567633,-206819,"28","24",302740,164796
"2122",180948,"CHADRON STATE COLLEGE                                       ","2003-2004",2,"Basketball",128210,304498,-176288,78369,183242,-104873,49841,121256,-71415,"13","18",24613,20841
"3839",200059,"DICKINSON STATE UNIVERSITY                                  ","2003-2004",3,"All Track Combined",42337,218698,-176361,23778,140900,-117122,18559,77798,-59239,"55","23",18851,12236
"2703",163453,"MORGAN STATE UNIVERSITY                                     ","2003-2004",2,"Basketball",785031,961453,-176422,415371,519702,-104331,369660,441751,-72091,"14","14",94085,95628
"2090",218229,"LANDER UNIVERSITY                                           ","2003-2004",2,"Basketball",239733,416410,-176677,132451,227551,-95100,107282,188859,-81577,"10","12",30245,36142
"13222",222831,"ANGELO STATE UNIVERSITY                                     ","2003-2004",26,"Volleyball",1913,179106,-177193,0,0,0,1913,179106,-177193,".","14",0,43505
"15482",200280,"UNIVERSITY OF NORTH DAKOTA-MAIN CAMPUS                      ","2003-2004",39,"Total Participants",4641470,4818686,-177216,3840395,3379348,461047,801075,1439338,-638263,"334","280",589514,456717
"10090",217819,"COLLEGE OF CHARLESTON                                       ","2003-2004",18,"Swimming and Diving",3348,180625,-177277,1174,84647,-83473,2174,95978,-93804,"15","25",33152,35632
"12636",196060,"SUNY AT ALBANY                                              ","2003-2004",25,"Track and Field, X-Country",4544,182171,-177627,2252,73126,-70874,2292,109045,-106753,"10","18",15344,18287
"5119",201441,"BOWLING GREEN STATE UNIVERSITY-MAIN CAMPUS                  ","2003-2004",8,"Golf",79254,257410,-178156,38686,127771,-89085,40568,129639,-89071,"10","8",24884,31756
"10804",159939,"UNIVERSITY OF NEW ORLEANS                                   ","2003-2004",22,"Tennis",9036,187406,-178370,4518,76694,-72176,4518,110712,-106194,"8","8",30064,30536
"9750",237525,"MARSHALL UNIVERSITY                                         ","2003-2004",16,"Softball",240700,419241,-178541,0,0,0,240700,419241,-178541,".","20",0,107360
"984",129215,"EASTERN CONNECTICUT STATE UNIVERSITY                        ","2003-2004",1,"Baseball",86484,265212,-178728,86484,265212,-178728,0,0,0,"44",".",112644,0
"12142",207403,"OKLAHOMA BAPTIST UNIVERSITY                                 ","2003-2004",24,"Track and Field, Outdoor",20783,199877,-179094,10737,103473,-92736,10046,96404,-86358,"34","34",15307,15223
"9671",180179,"MONTANA STATE UNIVERSITY-BILLINGS                           ","2003-2004",16,"Softball",9714,188901,-179187,0,0,0,9714,188901,-179187,".","16",0,56376
"9594",181394,"UNIVERSITY OF NEBRASKA AT OMAHA                             ","2003-2004",16,"Softball",31162,210367,-179205,0,0,0,31162,210367,-179205,".","15",0,60334
"12163",206622,"XAVIER UNIVERSITY                                           ","2003-2004",25,"Track and Field, X-Country",1784,181105,-179321,923,62706,-61783,861,118399,-117538,"16","12",28090,37833
"7729",191630,"HOBART WILLIAM SMITH COLLEGES                               ","2003-2004",15,"Soccer",70712,250086,-179374,31541,115457,-83916,39171,134629,-95458,"24","39",19257,19727
"3251",216667,"WASHINGTON &amp; JEFFERSON COLLEGE                              ","2003-2004",2,"Basketball",175421,354888,-179467,88094,173035,-84941,87327,181853,-94526,"17","13",21952,34087
"9797",159993,"UNIVERSITY OF LOUISIANA AT MONROE                           ","2003-2004",16,"Softball",2234,181775,-179541,0,0,0,2234,181775,-179541,".","17",0,46057
"16575",204501,"OBERLIN COLLEGE                                             ","2003-2004",39,"Total Participants",609400,789332,-179932,304563,378931,-74368,304837,410401,-105564,"208","164",207422,170111
"8282",200004,"WESTERN CAROLINA UNIVERSITY                                 ","2003-2004",15,"Soccer",9858,189834,-179976,0,0,0,9858,189834,-179976,".","18",0,39101
"16441",123800,"SOUTHWESTERN COLLEGE                                        ","2003-2004",39,"Total Participants",202752,382763,-180011,135917,230004,-94087,66835,152759,-85924,"216","97",79576,52264
"4501",195030,"UNIVERSITY OF ROCHESTER                                     ","2003-2004",7,"Football",119513,299835,-180322,119513,299835,-180322,0,0,0,"91",".",82395,0
"8943",227881,"SAM HOUSTON STATE UNIVERSITY                                ","2003-2004",16,"Softball",48437,228917,-180480,0,0,0,48437,228917,-180480,".","25",0,59399
"12371",237525,"MARSHALL UNIVERSITY                                         ","2003-2004",25,"Track and Field, X-Country",52378,232889,-180511,20899,110511,-89612,31479,122378,-90899,"8","12",16984,9552
"11500",227216,"UNIVERSITY OF NORTH TEXAS                                   ","2003-2004",22,"Tennis",0,180927,-180927,0,0,0,0,180927,-180927,".","9",0,46954
"221",206996,"CONNORS STATE COLLEGE                                       ","2003-2004",1,"Baseball",580,181975,-181395,580,181975,-181395,0,0,0,"48",".",181968,0
"10890",145813,"ILLINOIS STATE UNIVERSITY                                   ","2003-2004",22,"Tennis",102465,283972,-181507,47727,118647,-70920,54738,165325,-110587,"9","9",36794,41151
"8843",232265,"HAMPTON UNIVERSITY                                          ","2003-2004",16,"Softball",118787,300359,-181572,0,0,0,118787,300359,-181572,".","14",0,46748
"2371",101675,"MILES COLLEGE                                               ","2003-2004",2,"Basketball",173070,354663,-181593,77250,162568,-85318,95820,192095,-96275,"15","15",10838,12806
"3815",177968,"LINDENWOOD UNIVERSITY                                       ","2003-2004",3,"All Track Combined",75267,257401,-182134,37633,133191,-95558,37634,124210,-86576,"101","72",95558,86576
"10664",122755,"SAN JOSE STATE UNIVERSITY                                   ","2003-2004",22,"Tennis",2380,184605,-182225,0,0,0,2380,184605,-182225,".","10",0,21305
"9154",160038,"NORTHWESTERN STATE UNIVERSITY OF LOUISIANA                  ","2003-2004",16,"Softball",87355,269767,-182412,0,0,0,87355,269767,-182412,".","20",0,80710
"16578",207351,"OKLAHOMA PANHANDLE STATE UNIVERSITY                         ","2003-2004",39,"Total Participants",59650,242612,-182962,19455,102243,-82788,40195,140369,-100174,"142","62",92753,65598
"7850",180179,"MONTANA STATE UNIVERSITY-BILLINGS                           ","2003-2004",15,"Soccer",34544,217574,-183030,2990,94231,-91241,31554,123343,-91789,"22","18",24741,31173
"9697",190150,"COLUMBIA UNIVERSITY IN THE CITY OF NEW YORK                 ","2003-2004",16,"Softball",1600,184882,-183282,0,0,0,1600,184882,-183282,".","20",0,79939
"3668",219471,"UNIVERSITY OF SOUTH DAKOTA                                  ","2003-2004",3,"All Track Combined",258380,441722,-183342,105215,193135,-87920,153165,248587,-95422,"109","98",79614,86456
"891",179645,"THREE RIVERS COMMUNITY COLLEGE                              ","2003-2004",1,"Baseball",584,183984,-183400,584,183984,-183400,0,0,0,"19",".",59128,0
"2818",233426,"ROANOKE COLLEGE                                             ","2003-2004",2,"Basketball",19622,203064,-183442,18922,105859,-86937,700,97205,-96505,"27","14",35859,27205
"16319",205470,"SINCLAIR COMMUNITY COLLEGE                                  ","2003-2004",39,"Total Participants",19601,203059,-183458,6099,122981,-116882,13502,80078,-66576,"56","30",107170,75814
"15641",193326,"MONROE COMMUNITY COLLEGE                                    ","2003-2004",39,"Total Participants",419742,603443,-183701,308700,421439,-112739,111042,182004,-70962,"136","72",197237,120238
"8728",121309,"POINT LOMA NAZARENE UNIVERSITY                              ","2003-2004",16,"Softball",18597,202326,-183729,0,0,0,18597,202326,-183729,".","18",0,66074
"14299",200004,"WESTERN CAROLINA UNIVERSITY                                 ","2003-2004",26,"Volleyball",7770,191564,-183794,0,0,0,7770,191564,-183794,".","13",0,32300
"11530",160612,"SOUTHEASTERN LOUISIANA UNIVERSITY                           ","2003-2004",22,"Tennis",8336,192142,-183806,2273,86746,-84473,6063,105396,-99333,"11","6",19704,19704
"10969",223232,"BAYLOR UNIVERSITY                                           ","2003-2004",22,"Tennis",728670,912702,-184032,348124,436033,-87909,380546,476669,-96123,"11","8",132322,88176
"15624",139719,"FORT VALLEY STATE UNIVERSITY                                ","2003-2004",39,"Total Participants",44060,228177,-184117,14030,73179,-59149,30030,154998,-124968,"140","82",120371,63451
"1153",231624,"COLLEGE OF WILLIAM AND MARY                                 ","2003-2004",1,"Baseball",226303,410456,-184153,226303,410456,-184153,0,0,0,"32",".",90886,0
"15776",241225,"BAYAMON CENTRAL UNIVERSITY                                  ","2003-2004",39,"Total Participants",35200,219370,-184170,24000,157560,-133560,11200,61810,-50610,"61","29",19165,10345
"1734",219347,"SOUTH DAKOTA SCHOOL OF MINES AND TECHNOLOGY                 ","2003-2004",2,"Basketball",42000,226312,-184312,21000,122345,-101345,21000,103967,-82967,"12","8",27064,29630
"9305",221768,"THE UNIVERSITY OF TENNESSEE-MARTIN                          ","2003-2004",16,"Softball",28314,212626,-184312,0,0,0,28314,212626,-184312,".","20",0,47492
"781",181464,"UNIVERSITY OF NEBRASKA AT LINCOLN                           ","2003-2004",1,"Baseball",948309,1132631,-184322,948309,1132631,-184322,0,0,0,"42",".",252667,0
"14203",179043,"ROCKHURST UNIVERSITY                                        ","2003-2004",26,"Volleyball",9569,193976,-184407,0,0,0,9569,193976,-184407,".","15",0,193980
"2089",198871,"LOUISBURG COLLEGE                                           ","2003-2004",2,"Basketball",1668,186182,-184514,872,94142,-93270,796,92040,-91244,"18","15",17442,30874
"2456",165936,"GORDON COLLEGE                                              ","2003-2004",2,"Basketball",20000,204896,-184896,10000,118575,-108575,10000,86321,-76321,"11","9",40645,24625
"16458",226204,"LEE COLLEGE                                                 ","2003-2004",39,"Total Participants",59591,244662,-185071,0,0,0,59591,244662,-185071,"12","18",32348,59591
"466",176080,"MISSISSIPPI STATE UNIVERSITY                                ","2003-2004",1,"Baseball",1050066,1235383,-185317,1050066,1235383,-185317,0,0,0,"41",".",195078,0
"13102",199218,"UNIVERSITY OF NORTH CAROLINA-WILMINGTON                     ","2003-2004",26,"Volleyball",36330,221770,-185440,0,0,0,36330,221770,-185440,"0","16",0,35337
"3583",219602,"AUSTIN PEAY STATE UNIVERSITY                                ","2003-2004",3,"All Track Combined",0,185727,-185727,0,54252,-54252,0,131475,-131475,"7","27",5140,22804
"14943",214777,"PENNSYLVANIA STATE UNIVERSITY-MAIN CAMPUS                   ","2003-2004",28,"Wrestling",396497,582315,-185818,396497,582315,-185818,0,0,0,"37",".",120407,0
"4419",168342,"WILLIAMS COLLEGE                                            ","2003-2004",7,"Football",80743,266621,-185878,80743,266621,-185878,0,0,0,"72",".",34702,0
"11630",206695,"YOUNGSTOWN STATE UNIVERSITY                                 ","2003-2004",22,"Tennis",3340,189280,-185940,270,64611,-64341,3070,124669,-121599,"7","8",9769,13079
"799",159993,"UNIVERSITY OF LOUISIANA AT MONROE                           ","2003-2004",1,"Baseball",82706,268702,-185996,82706,268702,-185996,0,0,0,"37",".",94335,0
"4143",179566,"SOUTHWEST MISSOURI STATE UNIVERSITY                         ","2003-2004",6,"Field hocky",81597,267806,-186209,0,0,0,81597,267806,-186209,".","20",0,47683
"3113",137209,"SEMINOLE COMMUNITY COLLEGE                                  ","2003-2004",2,"Basketball",179321,365590,-186269,68976,176345,-107369,110345,189245,-78900,"14","15",25883,30726
"4256",217165,"BRYANT COLLEGE                                              ","2003-2004",6,"Field hocky",47638,233981,-186343,0,0,0,47638,233981,-186343,".","25",0,46850
"12692",109819,"BAKERSFIELD COLLEGE                                         ","2003-2004",25,"Track and Field, X-Country",39520,226080,-186560,20100,111540,-91440,19420,114540,-95120,"11","21",17032,17032
"14628",187648,"EASTERN NEW MEXICO UNIVERSITY-MAIN CAMPUS                   ","2003-2004",26,"Volleyball",1635,188277,-186642,0,0,0,1635,188277,-186642,".","20",0,19262
"5052",197197,"WAGNER COLLEGE                                              ","2003-2004",7,"Football",468596,655249,-186653,468596,655249,-186653,0,0,0,"126",".",152420,0
"5799",198516,"ELON UNIVERSITY                                             ","2003-2004",8,"Golf",39370,226059,-186689,20403,120179,-99776,18967,105880,-86913,"19","13",20403,18967
"267",198871,"LOUISBURG COLLEGE                                           ","2003-2004",1,"Baseball",1,186696,-186695,1,186696,-186695,0,0,0,"24",".",45236,0
"14944",110644,"UNIVERSITY OF CALIFORNIA-DAVIS                              ","2003-2004",28,"Wrestling",20644,207577,-186933,20644,207577,-186933,0,0,0,"35","0",32048,0
"16417",136330,"PALM BEACH ATLANTIC UNIVERSITY-WEST PALM BEACH              ","2003-2004",39,"Total Participants",54963,242105,-187142,20382,105692,-85310,34581,136413,-101832,"106","74",111148,130173
"3126",236452,"SAINT MARTINS COLLEGE                                       ","2003-2004",2,"Basketball",129955,317530,-187575,80621,193292,-112671,49334,124238,-74904,"12","12",38508,38771
"61",100830,"AUBURN UNIVERSITY-MONTGOMERY                                ","2003-2004",1,"Baseball",45262,232889,-187627,45262,232889,-187627,0,0,0,"29",".",32371,0
"5926",200800,"UNIVERSITY OF AKRON MAIN CAMPUS                             ","2003-2004",8,"Golf",11000,198786,-187786,11000,198786,-187786,0,0,0,"8",".",59161,0
"8723",220075,"EAST TENNESSEE STATE UNIVERSITY                             ","2003-2004",16,"Softball",8899,196796,-187897,0,0,0,8899,196796,-187897,".","16",0,17785
"2276",142328,"LEWIS-CLARK STATE COLLEGE                                   ","2003-2004",2,"Basketball",186967,375047,-188080,91833,201681,-109848,95134,173366,-78232,"14","12",35439,36847
"15980",178697,"COLLEGE OF THE OZARKS                                       ","2003-2004",39,"Total Participants",1767,189913,-188146,1060,97436,-96376,707,92477,-91770,"45","23",119857,120627
"4443",213507,"LEBANON VALLEY COLLEGE                                      ","2003-2004",7,"Football",84385,272595,-188210,84385,272595,-188210,0,0,0,"70",".",75950,0
"13682",178615,"TRUMAN STATE UNIVERSITY                                     ","2003-2004",26,"Volleyball",8998,197303,-188305,0,0,0,8998,197303,-188305,".","20",0,36969
"11757",226091,"LAMAR UNIVERSITY                                            ","2003-2004",22,"Tennis",107244,295718,-188474,60956,149499,-88543,46288,146219,-99931,"7","9",30937,25685
"10672",153603,"IOWA STATE UNIVERSITY                                       ","2003-2004",22,"Tennis",90421,279287,-188866,0,0,0,90421,279287,-188866,".","7",0,42804
"4093",198385,"DAVIDSON COLLEGE                                            ","2003-2004",6,"Field hocky",8402,197269,-188867,0,0,0,8402,197269,-188867,".","18",0,42576
"15077",163286,"UNIVERSITY OF MARYLAND-COLLEGE PARK                         ","2003-2004",29,"Other Sports",11,188885,-188874,0,0,0,11,188885,-188874,".","25",0,70747
"7323",198808,"LEES-MCRAE COLLEGE                                          ","2003-2004",15,"Soccer",43538,232643,-189105,24598,136226,-111628,18940,96417,-77477,"24","16",22428,15779
"14683",122755,"SAN JOSE STATE UNIVERSITY                                   ","2003-2004",27,"Water Polo",2380,191550,-189170,0,0,0,2380,191550,-189170,".","24",0,53685
"10264",190415,"CORNELL UNIVERSITY-ENDOWED COLLEGES                         ","2003-2004",18,"Swimming and Diving",166438,355933,-189495,118277,182781,-64504,48161,173152,-124991,"21","27",34224,41150
"4261",190415,"CORNELL UNIVERSITY-ENDOWED COLLEGES                         ","2003-2004",6,"Field hocky",23841,213533,-189692,0,0,0,23841,213533,-189692,".","25",0,50281
"819",160612,"SOUTHEASTERN LOUISIANA UNIVERSITY                           ","2003-2004",1,"Baseball",189584,379299,-189715,189584,379299,-189715,0,0,0,"36",".",96266,0
"1282",137078,"ST PETERSBURG COLLEGE                                       ","2003-2004",1,"Baseball",243609,433386,-189777,243609,433386,-189777,0,0,0,"27",".",52200,0
"3455",179344,"SOUTHWEST MISSOURI STATE UNIVERSITY-WEST PLAINS             ","2003-2004",2,"Basketball",157217,347032,-189815,157217,347032,-189815,0,0,0,"13",".",38153,0
"6744",213543,"LEHIGH UNIVERSITY                                           ","2003-2004",11,"Lacrosse",423957,613842,-189885,250205,347852,-97647,173752,265990,-92238,"48","32",49132,43215
"6856",177968,"LINDENWOOD UNIVERSITY                                       ","2003-2004",12,"Rifle",39962,229984,-190022,19981,119483,-99502,19981,110501,-90520,"29","9",99502,90520
"11320",179043,"ROCKHURST UNIVERSITY                                        ","2003-2004",22,"Tennis",6226,196366,-190140,3113,111156,-108043,3113,85210,-82097,"7","10",111153,85210
"4783",233295,"RANDOLPH-MACON COLLEGE                                      ","2003-2004",7,"Football",16051,206432,-190381,16051,206432,-190381,0,0,0,"78",".",66100,0
"10666",196413,"SYRACUSE UNIVERSITY                                         ","2003-2004",22,"Tennis",255461,445869,-190408,0,0,0,255461,445869,-190408,".","9",0,58803
"1082",159009,"GRAMBLING STATE UNIVERSITY                                  ","2003-2004",1,"Baseball",2702,193296,-190594,2702,193296,-190594,0,0,0,"27",".",142427,0
"10126",213385,"LAFAYETTE COLLEGE                                           ","2003-2004",18,"Swimming and Diving",235328,426237,-190909,77717,142533,-64816,157611,283704,-126093,"19","33",18572,33018
"8995",219709,"BELMONT UNIVERSITY                                          ","2003-2004",16,"Softball",70827,261812,-190985,0,0,0,70827,261812,-190985,".","18",0,44231
"5086",206330,"URBANA UNIVERSITY                                           ","2003-2004",7,"Football",15994,207504,-191510,15994,207504,-191510,0,0,0,"103",".",80257,0
"6128",105330,"NORTHERN ARIZONA UNIVERSITY                                 ","2003-2004",8,"Golf",102,191725,-191623,0,0,0,102,191725,-191623,".","9",0,55701
"9894",139940,"GEORGIA STATE UNIVERSITY                                    ","2003-2004",16,"Softball",53703,245653,-191950,0,0,0,53703,245653,-191950,".","16",0,34899
"12942",121345,"POMONA COLLEGE                                              ","2003-2004",25,"Track and Field, X-Country",45400,237501,-192101,22435,127421,-104986,22965,110080,-87115,"47","35",19046,18077
"2626",176044,"MISSISSIPPI VALLEY STATE UNIVERSITY                         ","2003-2004",2,"Basketball",247000,439343,-192343,161727,225783,-64056,85273,213560,-128287,"14","15",213546,156807
"1412",207403,"OKLAHOMA BAPTIST UNIVERSITY                                 ","2003-2004",1,"Baseball",35273,227701,-192428,35273,227701,-192428,0,0,0,"16",".",37338,0
"8444",227845,"SAINT EDWARD'S UNIVERSITY                                   ","2003-2004",15,"Soccer",200,192804,-192604,100,113404,-113304,100,79400,-79300,"34","24",25704,27800
"3319",148937,"SOUTHEASTERN ILLINOIS COLLEGE                               ","2003-2004",2,"Basketball",11950,204844,-192894,10669,101984,-91315,1281,102860,-101579,"14","15",27372,23966
"2382",174783,"SAINT CLOUD STATE UNIVERSITY                                ","2003-2004",2,"Basketball",435823,628925,-193102,210688,337267,-126579,225135,291658,-66523,"15","17",59930,71808
"8223",160658,"UNIVERSITY OF LOUISIANA AT LAFAYETTE                        ","2003-2004",15,"Soccer",1814,194980,-193166,0,0,0,1814,194980,-193166,".","22",0,71754
"9043",179964,"WILLIAM WOODS UNIVERSITY                                    ","2003-2004",16,"Softball",40019,233188,-193169,0,0,0,40019,233188,-193169,".","19",0,7519
"5680",219709,"BELMONT UNIVERSITY                                          ","2003-2004",8,"Golf",114956,308219,-193263,65594,153675,-88081,49362,154544,-105182,"11","9",34199,29656
"326",199111,"UNIVERSITY OF NORTH CAROLINA AT ASHEVILLE                   ","2003-2004",1,"Baseball",22407,215799,-193392,22407,215799,-193392,0,0,0,"29",".",71316,0
"13669",191931,"IONA COLLEGE                                                ","2003-2004",26,"Volleyball",100,193942,-193842,0,0,0,100,193942,-193842,".","13",0,26361
"1835",207236,"MURRAY STATE COLLEGE                                        ","2003-2004",2,"Basketball",37916,231802,-193886,19743,129251,-109508,18173,102551,-84378,"14","10",19152,17631
"5201",110635,"UNIVERSITY OF CALIFORNIA-BERKELEY                           ","2003-2004",8,"Golf",573818,767868,-194050,368989,365379,3610,204829,402489,-197660,"14","7",61939,53778
"7630",220075,"EAST TENNESSEE STATE UNIVERSITY                             ","2003-2004",15,"Soccer",1361,195684,-194323,0,0,0,1361,195684,-194323,".","19",0,9536
"4254",179159,"SAINT LOUIS UNIVERSITY-MAIN CAMPUS                          ","2003-2004",6,"Field hocky",3567,198171,-194604,0,0,0,3567,198171,-194604,".","18",0,27926
"469",221768,"THE UNIVERSITY OF TENNESSEE-MARTIN                          ","2003-2004",1,"Baseball",14035,208823,-194788,14035,208823,-194788,0,0,0,"32",".",45243,0
"4759",226587,"MCMURRY UNIVERSITY                                          ","2003-2004",7,"Football",132755,327592,-194837,132755,327592,-194837,0,0,0,"106",".",96958,0
"14996",190415,"CORNELL UNIVERSITY-ENDOWED COLLEGES                         ","2003-2004",28,"Wrestling",138387,333754,-195367,138387,333754,-195367,0,0,0,"29",".",64525,0
"17237",240426,"UNIVERSITY OF WISCONSIN-SUPERIOR                            ","2003-2004",39,"Total Participants",415537,611058,-195521,214857,293049,-78192,200680,318009,-117329,"113","123",245190,236376
"8491",110097,"BIOLA UNIVERSITY                                            ","2003-2004",15,"Soccer",38417,234051,-195634,18249,129767,-111518,20168,104284,-84116,"23","21",16604,14883
"6987",199120,"UNIVERSITY OF NORTH CAROLINA AT CHAPEL HILL                 ","2003-2004",13,"Rowing",61605,257873,-196268,0,0,0,61605,257873,-196268,".","52",0,37157
"16246",196006,"SUNY COLLEGE OF TECHNOLOGY AT ALFRED                        ","2003-2004",39,"Total Participants",205227,401639,-196412,127347,254107,-126760,77880,147532,-69652,"218","87",169628,67211
"2470",233499,"SAINT PAULS COLLEGE                                         ","2003-2004",2,"Basketball",118335,314785,-196450,93329,198414,-105085,25006,116371,-91365,"13","11",38345,35422
"9884",221731,"TENNESSEE WESLEYAN COLLEGE                                  ","2003-2004",16,"Softball",23025,219525,-196500,0,0,0,23025,219525,-196500,".","25",0,10250
"5006",185590,"MONTCLAIR STATE UNIVERSITY                                  ","2003-2004",7,"Football",110904,307414,-196510,110904,307414,-196510,0,0,0,"73",".",79270,0
"4818",231712,"CHRISTOPHER NEWPORT UNIVERSITY                              ","2003-2004",7,"Football",194339,390857,-196518,194339,390857,-196518,0,0,0,"90",".",89136,0
"4842",185262,"KEAN UNIVERSITY                                             ","2003-2004",7,"Football",1796,198435,-196639,1796,198435,-196639,0,0,0,"94",".",67231,0
"16754",229160,"TEXAS WESLEYAN UNIVERSITY                                   ","2003-2004",39,"Total Participants",151498,348235,-196737,77318,191180,-113862,74180,157055,-82875,"136","94",102709,90958
"11627",149222,"SOUTHERN ILLINOIS UNIVERSITY-CARBONDALE                     ","2003-2004",22,"Tennis",97019,293876,-196857,25217,116121,-90904,71802,177755,-105953,"6","9",17445,24491
"15730",206835,"OKLAHOMA WESLEYAN UNIVERSITY                                ","2003-2004",39,"Total Participants",144448,341393,-196945,50947,175140,-124193,93501,166253,-72752,"61","60",46489,48074
"15918",102076,"SNEAD STATE COMMUNITY COLLEGE                               ","2003-2004",39,"Total Participants",1544,198626,-197082,997,102295,-101298,547,96331,-95784,"33","33",59298,59914
"12410",174844,"SAINT OLAF COLLEGE                                          ","2003-2004",25,"Track and Field, X-Country",16135,213231,-197096,620,120754,-120134,15515,92477,-76962,"102","175",20349,27576
"12998",237525,"MARSHALL UNIVERSITY                                         ","2003-2004",26,"Volleyball",235873,433282,-197409,0,0,0,235873,433282,-197409,".","13",0,66768
"8743",191931,"IONA COLLEGE                                                ","2003-2004",16,"Softball",8825,206257,-197432,0,0,0,8825,206257,-197432,".","17",0,48439
"11134",123572,"SONOMA STATE UNIVERSITY                                     ","2003-2004",22,"Tennis",24473,222352,-197879,15684,107123,-91439,8789,115229,-106440,"13","12",30892,32564
"17063",185129,"NEW JERSEY CITY UNIVERSITY                                  ","2003-2004",39,"Total Participants",108825,306926,-198101,52650,185389,-132739,56175,121537,-65362,"107","76",40961,35685
"6823",164988,"BOSTON UNIVERSITY                                           ","2003-2004",11,"Lacrosse",37412,235764,-198352,0,0,0,37412,235764,-198352,".","26",0,91974
"15973",155061,"FORT HAYS STATE UNIVERSITY                                  ","2003-2004",39,"Total Participants",512859,711286,-198427,294995,357641,-62646,217864,353645,-135781,"337","164",195906,110536
"11194",196097,"SUNY AT STONY BROOK                                         ","2003-2004",22,"Tennis",73456,271943,-198487,36728,139711,-102983,36728,132232,-95504,"10","10",16474,16474
"8540",151290,"INDIANA INSTITUTE OF TECHNOLOGY                             ","2003-2004",16,"Softball",125,198873,-198748,0,0,0,125,198873,-198748,".","28",0,29567
"2046",196246,"SUNY COLLEGE AT PLATTSBURGH                                 ","2003-2004",2,"Basketball",18803,217627,-198824,7292,107776,-100484,11511,109851,-98340,"13","15",29650,33046
"13018",227881,"SAM HOUSTON STATE UNIVERSITY                                ","2003-2004",26,"Volleyball",31226,230140,-198914,0,0,0,31226,230140,-198914,".","18",0,41237
"10265",206695,"YOUNGSTOWN STATE UNIVERSITY                                 ","2003-2004",18,"Swimming and Diving",15335,214494,-199159,0,0,0,15335,214494,-199159,".","24",0,35439
"625",123572,"SONOMA STATE UNIVERSITY                                     ","2003-2004",1,"Baseball",87072,286349,-199277,87072,286349,-199277,0,0,0,"40",".",93671,0
"9418",199120,"UNIVERSITY OF NORTH CAROLINA AT CHAPEL HILL                 ","2003-2004",16,"Softball",280593,479940,-199347,0,0,0,280593,479940,-199347,".","23",0,78838
"7034",102614,"UNIVERSITY OF ALASKA FAIRBANKS                              ","2003-2004",14,"Skiing",10429,209978,-199549,5252,105691,-100439,5177,104287,-99110,"6","6",31969,29046
"484",232186,"GEORGE MASON UNIVERSITY                                     ","2003-2004",1,"Baseball",229312,429041,-199729,229312,429041,-199729,0,0,0,"37",".",108903,0
"4571",107071,"HENDERSON STATE UNIVERSITY                                  ","2003-2004",7,"Football",403096,602865,-199769,403096,602865,-199769,0,0,0,"96",".",113930,0
"14166",112826,"CONTRA COSTA COLLEGE                                        ","2003-2004",26,"Volleyball",1500,201320,-199820,0,0,0,1500,201320,-199820,".","16",0,7750
"14687",110361,"CALIFORNIA BAPTIST UNIVERSITY                               ","2003-2004",27,"Water Polo",10475,210392,-199917,4775,100066,-95291,5700,110326,-104626,"18","19",18384,23913
"2266",206330,"URBANA UNIVERSITY                                           ","2003-2004",2,"Basketball",16919,216837,-199918,12532,102804,-90272,4387,114033,-109646,"29","21",33327,30768
"7378",219356,"SOUTH DAKOTA STATE UNIVERSITY                               ","2003-2004",15,"Soccer",2566,202760,-200194,0,0,0,2566,202760,-200194,".","23",0,36150
"16716",135188,"LAKE-SUMTER COMMUNITY COLLEGE                               ","2003-2004",39,"Total Participants",2346,202950,-200604,738,75465,-74727,1608,127485,-125877,"20","33",64965,106485
"10389",179159,"SAINT LOUIS UNIVERSITY-MAIN CAMPUS                          ","2003-2004",18,"Swimming and Diving",25070,226017,-200947,12535,95193,-82658,12535,130824,-118289,"23","29",23038,23038
"7215",180489,"THE UNIVERSITY OF MONTANA-MISSOULA                          ","2003-2004",15,"Soccer",274303,475257,-200954,0,0,0,274303,475257,-200954,".","29",0,106750
"3803",181215,"UNIVERSITY OF NEBRASKA AT KEARNEY                           ","2003-2004",3,"All Track Combined",23412,224491,-201079,11931,117335,-105404,11481,107156,-95675,"50","37",28562,24885
"2651",219259,"NORTHERN STATE UNIVERSITY                                   ","2003-2004",2,"Basketball",263260,464391,-201131,189218,271162,-81944,74042,193229,-119187,"16","18",32722,24297
"4708",234207,"WASHINGTON AND LEE UNIVERSITY                               ","2003-2004",7,"Football",19195,220712,-201517,19195,220712,-201517,0,0,0,"65",".",37721,0
"8111",234085,"VIRGINIA MILITARY INSTITUTE                                 ","2003-2004",15,"Soccer",189351,390994,-201643,111001,220370,-109369,78350,170624,-92274,"31","15",30315,38180
"5798",206695,"YOUNGSTOWN STATE UNIVERSITY                                 ","2003-2004",8,"Golf",9875,211580,-201705,7140,98062,-90922,2735,113518,-110783,"11","10",25496,23255
"11933",144740,"DEPAUL UNIVERSITY                                           ","2003-2004",24,"Track and Field, Outdoor",4455,206287,-201832,2513,107487,-104974,1942,98800,-96858,"10","14",17835,16973
"12366",144740,"DEPAUL UNIVERSITY                                           ","2003-2004",25,"Track and Field, X-Country",4455,206287,-201832,2513,107487,-104974,1942,98800,-96858,"8","7",17836,16973
"11802",144740,"DEPAUL UNIVERSITY                                           ","2003-2004",23,"Track and Field, Indoor",4453,206287,-201834,2512,107487,-104975,1941,98800,-96859,"10","14",17835,16973
"15515",176071,"MISSISSIPPI GULF COAST COMMUNITY COLLEGE                    ","2003-2004",39,"Total Participants",1325,203200,-201875,663,135021,-134358,662,68179,-67517,"141","51",90872,23822
"5004",230603,"SOUTHERN UTAH UNIVERSITY                                    ","2003-2004",7,"Football",725919,927899,-201980,725919,927899,-201980,0,0,0,"102",".",217177,0
"12093",238032,"WEST VIRGINIA UNIVERSITY                                    ","2003-2004",24,"Track and Field, Outdoor",100,202142,-202042,0,0,0,100,202142,-202042,".","34",0,38614
"3877",136172,"UNIVERSITY OF NORTH FLORIDA                                 ","2003-2004",3,"All Track Combined",46084,248200,-202116,10226,108164,-97938,35858,140036,-104178,"50","44",34710,44181
"16472",240657,"NORTHWEST COMMUNITY COLLEGE                                 ","2003-2004",39,"Total Participants",27594,229811,-202217,16438,117248,-100810,11156,112563,-101407,"38","29",78274,61182
"8026",240277,"UNIVERSITY OF WISCONSIN-GREEN BAY                           ","2003-2004",15,"Soccer",351533,553839,-202306,195127,287248,-92121,156406,266591,-110185,"23","24",32196,46826
"2339",198899,"MARS HILL COLLEGE                                           ","2003-2004",2,"Basketball",177076,379516,-202440,92542,199780,-107238,84534,179736,-95202,"15","11",21247,19149
"7666",109785,"AZUSA PACIFIC UNIVERSITY                                    ","2003-2004",15,"Soccer",86959,289666,-202707,36735,128632,-91897,50224,161034,-110810,"20","23",26298,31472
"16299",178402,"UNIVERSITY OF MISSOURI-KANSAS CITY                          ","2003-2004",39,"Total Participants",1903077,2105814,-202737,822218,924233,-102015,1080859,1181581,-100722,"122","111",447088,383684
"433",194161,"NYACK COLLEGE                                               ","2003-2004",1,"Baseball",43934,246689,-202755,43934,246689,-202755,0,0,0,"27",".",35500,0
"6687",110644,"UNIVERSITY OF CALIFORNIA-DAVIS                              ","2003-2004",11,"Lacrosse",202,202991,-202789,0,0,0,202,202991,-202789,"0","21",0,67591
"6862",181464,"UNIVERSITY OF NEBRASKA AT LINCOLN                           ","2003-2004",12,"Rifle",834,203627,-202793,0,0,0,834,203627,-202793,".","9",0,26201
"5672",219602,"AUSTIN PEAY STATE UNIVERSITY                                ","2003-2004",8,"Golf",0,202883,-202883,0,99657,-99657,0,103226,-103226,"9","8",23114,14017
"12558",172644,"WAYNE STATE UNIVERSITY                                      ","2003-2004",25,"Track and Field, X-Country",219636,422567,-202931,111525,308531,-197006,108111,114036,-5925,"11","10",27087,31209
"9098",224147,"TEXAS A &amp; M UNIVERSITY-CORPUS CHRISTI                       ","2003-2004",16,"Softball",8862,211846,-202984,0,0,0,8862,211846,-202984,".","17",0,68228
"6239",228459,"TEXAS STATE UNIVERSITY-SAN MARCOS                           ","2003-2004",8,"Golf",21560,224700,-203140,10525,108403,-97878,11035,116297,-105262,"13","10",27275,28380
"16958",233897,"THE UNIVERSITY OF VIRGINIA'S COLLEGE AT WISE                ","2003-2004",39,"Total Participants",134066,337369,-203303,57322,158274,-100952,76744,179095,-102351,"209","95",329674,113270
"10414",145637,"UNIVERSITY OF ILLINOIS AT URBANA-CHAMPAIGN                  ","2003-2004",18,"Swimming and Diving",291499,494832,-203333,0,0,0,291499,494832,-203333,".","30",0,101001
"2051",230728,"UTAH STATE UNIVERSITY                                       ","2003-2004",2,"Basketball",1313660,1517049,-203389,1261709,1032778,228931,51951,484271,-432320,"15","14",242346,150452
"16488",151306,"UNIVERSITY OF SOUTHERN INDIANA                              ","2003-2004",39,"Total Participants",669573,873036,-203463,342757,438601,-95844,326816,434435,-107619,"129","105",248345,196558
"12195",201441,"BOWLING GREEN STATE UNIVERSITY-MAIN CAMPUS                  ","2003-2004",25,"Track and Field, X-Country",17186,220724,-203538,7186,100724,-93538,10000,120000,-110000,"11","18",8847,10000
"8724",164988,"BOSTON UNIVERSITY                                           ","2003-2004",16,"Softball",40905,244605,-203700,0,0,0,40905,244605,-203700,".","23",0,108199
"6119",225511,"UNIVERSITY OF HOUSTON-UNIVERSITY PARK                       ","2003-2004",8,"Golf",9,203753,-203744,9,203753,-203744,0,0,0,"10",".",42572,0
"8739",159647,"LOUISIANA TECH UNIVERSITY                                   ","2003-2004",16,"Softball",104804,308709,-203905,0,0,0,104804,308709,-203905,".","23",0,99415
"7417",213543,"LEHIGH UNIVERSITY                                           ","2003-2004",15,"Soccer",568135,772195,-204060,316675,429047,-112372,251460,343148,-91688,"27","26",46342,34383
"13225",228796,"THE UNIVERSITY OF TEXAS AT EL PASO                          ","2003-2004",26,"Volleyball",212353,416940,-204587,0,0,0,212353,416940,-204587,".","12",0,91894
"15031",190150,"COLUMBIA UNIVERSITY IN THE CITY OF NEW YORK                 ","2003-2004",28,"Wrestling",76843,281587,-204744,76843,281587,-204744,0,0,0,"24",".",75229,0
"7149",215655,"ROBERT MORRIS UNIVERSITY                                    ","2003-2004",15,"Soccer",408609,613490,-204881,215177,296184,-81007,193432,317306,-123874,"27","28",34637,31231
"14442",139931,"GEORGIA SOUTHERN UNIVERSITY                                 ","2003-2004",26,"Volleyball",58879,263920,-205041,0,0,0,58879,263920,-205041,".","16",0,39441
"9789",130794,"YALE UNIVERSITY                                             ","2003-2004",16,"Softball",57123,262229,-205106,0,0,0,57123,262229,-205106,".","19",0,51355
"9529",160612,"SOUTHEASTERN LOUISIANA UNIVERSITY                           ","2003-2004",16,"Softball",28079,233507,-205428,0,0,0,28079,233507,-205428,".","18",0,47583
"7054",183044,"UNIVERSITY OF NEW HAMPSHIRE-MAIN CAMPUS                     ","2003-2004",14,"Skiing",178637,384077,-205440,85745,169486,-83741,92892,214591,-121699,"24","26",50805,55038
"14199",110644,"UNIVERSITY OF CALIFORNIA-DAVIS                              ","2003-2004",26,"Volleyball",17390,222898,-205508,0,0,0,17390,222898,-205508,"0","16",0,39269
"16357",199412,"QUEENS UNIVERSITY OF CHARLOTTE                              ","2003-2004",39,"Total Participants",980164,1185783,-205619,407718,498988,-91270,572446,686795,-114349,"98","111",73245,88829
"4464",147679,"NORTH PARK UNIVERSITY                                       ","2003-2004",7,"Football",77808,283550,-205742,77808,283550,-205742,0,0,0,"85",".",72877,0
"13232",219356,"SOUTH DAKOTA STATE UNIVERSITY                               ","2003-2004",26,"Volleyball",7336,213101,-205765,0,0,0,7336,213101,-205765,".","15",0,37346
"8970",145813,"ILLINOIS STATE UNIVERSITY                                   ","2003-2004",16,"Softball",119422,325377,-205955,0,0,0,119422,325377,-205955,".","20",0,66963
"16063",240462,"UNIVERSITY OF WISCONSIN-PLATTEVILLE                         ","2003-2004",39,"Total Participants",364517,570487,-205970,152097,262658,-110561,212420,307829,-95409,"339","198",268304,173936
"10659",153658,"UNIVERSITY OF IOWA                                          ","2003-2004",22,"Tennis",74679,280665,-205986,6679,160724,-154045,68000,119941,-51941,"13","10",57669,53074
"11009",110705,"UNIVERSITY OF CALIFORNIA-SANTA BARBARA                      ","2003-2004",22,"Tennis",128950,334994,-206044,102333,177074,-74741,26617,157920,-131303,"10","12",48047,24927
"5586",217864,"CITADEL MILITARY COLLEGE OF SOUTH CAROLINA                  ","2003-2004",8,"Golf",74175,280288,-206113,72290,93140,-20850,1885,187148,-185263,"11","7",25550,26338
"8400",159009,"GRAMBLING STATE UNIVERSITY                                  ","2003-2004",15,"Soccer",1,206136,-206135,0,0,0,1,206136,-206135,".","23",0,156001
"4446",207865,"SOUTHWESTERN OKLAHOMA STATE UNIVERSITY                      ","2003-2004",7,"Football",56991,263135,-206144,56991,263135,-206144,0,0,0,"91",".",47836,0
"3812",219000,"AUGUSTANA COLLEGE                                           ","2003-2004",3,"All Track Combined",97906,304245,-206339,48953,128249,-79296,48953,175996,-127043,"26","30",25683,25683
"5099",203845,"MARIETTA COLLEGE                                            ","2003-2004",7,"Football",105858,312265,-206407,105858,312265,-206407,0,0,0,"78",".",63563,0
"9849",190415,"CORNELL UNIVERSITY-ENDOWED COLLEGES                         ","2003-2004",16,"Softball",35139,241595,-206456,0,0,0,35139,241595,-206456,".","20",0,66204
"13907",224147,"TEXAS A &amp; M UNIVERSITY-CORPUS CHRISTI                       ","2003-2004",26,"Volleyball",9907,216688,-206781,0,0,0,9907,216688,-206781,".","17",0,46859
"2921",225520,"HOWARD COUNTY JUNIOR COLLEGE DISTRICT                       ","2003-2004",2,"Basketball",7493,214296,-206803,3397,111519,-108122,4096,102777,-98681,"14","13",29687,29641
"8087",196246,"SUNY COLLEGE AT PLATTSBURGH                                 ","2003-2004",15,"Soccer",5473,212336,-206863,1550,110705,-109155,3923,101631,-97708,"25","24",32394,33318
"3854",213543,"LEHIGH UNIVERSITY                                           ","2003-2004",3,"All Track Combined",749233,956403,-207170,328889,432474,-103585,420344,523929,-103585,"76","54",57729,57729
"10745",230728,"UTAH STATE UNIVERSITY                                       ","2003-2004",22,"Tennis",2,207370,-207368,1,95711,-95710,1,111659,-111658,"8","10",20250,19350
"9955",120883,"UNIVERSITY OF THE PACIFIC                                   ","2003-2004",16,"Softball",401374,608787,-207413,0,0,0,401374,608787,-207413,".","16",0,69960
"762",218973,"WOFFORD COLLEGE                                             ","2003-2004",1,"Baseball",36292,243718,-207426,36292,243718,-207426,0,0,0,"28",".",55314,0
"3892",221847,"TENNESSEE TECHNOLOGICAL UNIVERSITY                          ","2003-2004",3,"All Track Combined",5642,213134,-207492,564,32441,-31877,5078,180693,-175615,"7","74",3229,20531
"4929",235097,"EASTERN WASHINGTON UNIVERSITY                               ","2003-2004",7,"Football",1725370,1933042,-207672,1725370,1933042,-207672,0,0,0,"82",".",320696,0
"6310",179557,"SOUTHEAST MISSOURI STATE UNIVERSITY                         ","2003-2004",9,"Gymnastics",30253,238221,-207968,0,0,0,30253,238221,-207968,".","16",0,45179
"10986",156620,"EASTERN KENTUCKY UNIVERSITY                                 ","2003-2004",22,"Tennis",4180,212329,-208149,2085,93649,-91564,2095,118680,-116585,"10","7",17216,17347
"13356",240277,"UNIVERSITY OF WISCONSIN-GREEN BAY                           ","2003-2004",26,"Volleyball",88242,296455,-208213,0,0,0,88242,296455,-208213,".","13",0,54014
"12544",198808,"LEES-MCRAE COLLEGE                                          ","2003-2004",25,"Track and Field, X-Country",37300,246083,-208783,20150,150112,-129962,17150,95971,-78821,"30","15",15789,7361
"8326",106245,"UNIVERSITY OF ARKANSAS AT LITTLE ROCK                       ","2003-2004",15,"Soccer",44023,253359,-209336,0,0,0,44023,253359,-209336,".","21",0,42916
"17102",192323,"LE MOYNE COLLEGE                                            ","2003-2004",39,"Total Participants",287470,496883,-209413,148439,244567,-96128,139031,252316,-113285,"163","139",197667,186324
"9308",110361,"CALIFORNIA BAPTIST UNIVERSITY                               ","2003-2004",16,"Softball",34819,244250,-209431,0,0,0,34819,244250,-209431,".","15",0,19683
"593",227881,"SAM HOUSTON STATE UNIVERSITY                                ","2003-2004",1,"Baseball",100171,309679,-209508,100171,309679,-209508,0,0,0,"42",".",124692,0
"14575",180489,"THE UNIVERSITY OF MONTANA-MISSOULA                          ","2003-2004",26,"Volleyball",239206,448746,-209540,0,0,0,239206,448746,-209540,".","16",0,79471
"11700",151324,"INDIANA STATE UNIVERSITY                                    ","2003-2004",22,"Tennis",59458,269039,-209581,28624,124723,-96099,30834,144316,-113482,"9","9",21342,18872
"12723",168342,"WILLIAMS COLLEGE                                            ","2003-2004",25,"Track and Field, X-Country",151029,360758,-209729,75612,179689,-104077,75417,181069,-105652,"171","146",47467,46596
"8625",199218,"UNIVERSITY OF NORTH CAROLINA-WILMINGTON                     ","2003-2004",16,"Softball",48054,257910,-209856,0,0,0,48054,257910,-209856,".","20",0,52096
"10161",199218,"UNIVERSITY OF NORTH CAROLINA-WILMINGTON                     ","2003-2004",18,"Swimming and Diving",162537,372598,-210061,89281,202504,-113223,73256,170094,-96838,"24","33",28145,28216
"11462",201441,"BOWLING GREEN STATE UNIVERSITY-MAIN CAMPUS                  ","2003-2004",22,"Tennis",10302,220521,-210219,0,0,0,10302,220521,-210219,".","12",0,18720
"16210",175272,"WINONA STATE UNIVERSITY                                     ","2003-2004",39,"Total Participants",586957,797270,-210313,147816,164695,-16879,439141,632575,-193434,"192","205",219009,248051
"3040",233295,"RANDOLPH-MACON COLLEGE                                      ","2003-2004",2,"Basketball",25507,236097,-210590,20287,131548,-111261,5220,104549,-99329,"17","9",33650,23495
"2790",183062,"KEENE STATE COLLEGE                                         ","2003-2004",2,"Basketball",113689,324420,-210731,70712,159506,-88794,42977,164914,-121937,"18","14",39421,52942
"13680",110617,"CALIFORNIA STATE UNIVERSITY-SACRAMENTO                      ","2003-2004",26,"Volleyball",158882,369687,-210805,0,0,0,158882,369687,-210805,".","14",0,82796
"3468",153825,"LORAS COLLEGE                                               ","2003-2004",2,"Basketball",20361,231210,-210849,14283,123513,-109230,6078,107697,-101619,"26","14",34204,24073
"9283",233921,"VIRGINIA POLYTECHNIC INSTITUTE AND STATE UNIV               ","2003-2004",16,"Softball",232340,443288,-210948,0,0,0,232340,443288,-210948,".","19",0,70242
"6809",198385,"DAVIDSON COLLEGE                                            ","2003-2004",11,"Lacrosse",14811,225914,-211103,0,0,0,14811,225914,-211103,".","22",0,43624
"16270",237154,"MOUNTAIN STATE UNIVERSITY                                   ","2003-2004",39,"Total Participants",17960,229888,-211928,0,0,0,17960,229888,-211928,"11","23",66827,63889
"5823",198136,"CAMPBELL UNIVERSITY INC                                     ","2003-2004",8,"Golf",220975,432941,-211966,93172,207375,-114203,127803,225566,-97763,"13","7",72770,60180
"16019",130989,"GOLDEY-BEACOM COLLEGE                                       ","2003-2004",39,"Total Participants",189276,401275,-211999,74201,169525,-95324,115075,231750,-116675,"62","61",74089,73927
"3928",144005,"CHICAGO STATE UNIVERSITY                                    ","2003-2004",3,"All Track Combined",147205,359369,-212164,69974,153587,-83613,77231,205782,-128551,"19","18",31063,30140
"15480",161554,"UNIVERSITY OF SOUTHERN MAINE                                ","2003-2004",39,"Total Participants",566046,778410,-212364,249475,361081,-111606,316571,417329,-100758,"202","183",244509,305438
"1722",200332,"NORTH DAKOTA STATE UNIVERSITY-MAIN CAMPUS                   ","2003-2004",2,"Basketball",800173,1012549,-212376,409706,534113,-124407,390467,478436,-87969,"15","15",65425,70883
"7999",231174,"UNIVERSITY OF VERMONT AND STATE AGRICULTURAL COLL           ","2003-2004",15,"Soccer",778558,990954,-212396,373959,533079,-159120,404599,457875,-53276,"26","23",79637,88382
"10000",199102,"NORTH CAROLINA  A &amp;T STATE UNIVERSITY                       ","2003-2004",16,"Softball",12805,225309,-212504,0,0,0,12805,225309,-212504,".","18",0,32397
"5026",213376,"LACKAWANNA COLLEGE                                          ","2003-2004",7,"Football",3709,216262,-212553,3709,216262,-212553,0,0,0,"93",".",199835,0
"5221",230782,"WEBER STATE UNIVERSITY                                      ","2003-2004",8,"Golf",106014,318571,-212557,35283,146448,-111165,70731,172123,-101392,"11","12",56743,61434
"12378",206084,"UNIVERSITY OF TOLEDO                                        ","2003-2004",25,"Track and Field, X-Country",3446,216044,-212598,2193,108344,-106151,1253,107700,-106447,"11","16",6697,10212
"2070",127556,"MESA STATE COLLEGE                                          ","2003-2004",2,"Basketball",201456,414161,-212705,124370,221847,-97477,77086,192314,-115228,"13","16",188682,146010
"15684",228699,"TEXARKANA COLLEGE                                           ","2003-2004",39,"Total Participants",6000,219000,-213000,5000,112000,-107000,1000,107000,-106000,"26","19",76000,76000
"3424",181817,"WESTERN NEBRASKA COMMUNITY COLLEGE                          ","2003-2004",2,"Basketball",55341,268794,-213453,31709,132428,-100719,23632,136366,-112734,"17","15",37724,51538
"11348",221768,"THE UNIVERSITY OF TENNESSEE-MARTIN                          ","2003-2004",22,"Tennis",13273,227016,-213743,6733,107497,-100764,6540,119519,-112979,"7","6",11168,18729
"6801",195164,"SAINT BONAVENTURE UNIVERSITY                                ","2003-2004",11,"Lacrosse",15056,228805,-213749,0,0,0,15056,228805,-213749,".","26",0,28886
"14369",226091,"LAMAR UNIVERSITY                                            ","2003-2004",26,"Volleyball",63870,277911,-214041,0,0,0,63870,277911,-214041,".","14",0,59992
"16352",213613,"LOCK HAVEN UNIVERSITY OF PENNSYLVANIA                       ","2003-2004",39,"Total Participants",2541062,2755426,-214364,1109306,1209161,-99855,1431756,1546265,-114509,"282","204",268869,272840
"6448",166638,"UNIVERSITY OF MASSACHUSETTS-BOSTON                          ","2003-2004",10,"Ice Hockey",5112,219577,-214465,4632,115705,-111073,480,103872,-103392,"21","18",52613,41675
"16151",166638,"UNIVERSITY OF MASSACHUSETTS-BOSTON                          ","2003-2004",39,"Total Participants",254653,469118,-214465,123283,234356,-111073,131370,234762,-103392,"109","86",155646,110361
"4085",199120,"UNIVERSITY OF NORTH CAROLINA AT CHAPEL HILL                 ","2003-2004",6,"Field hocky",313967,528525,-214558,0,0,0,313967,528525,-214558,".","22",0,64843
"16304",227225,"NORTHEAST TEXAS COMMUNITY COLLEGE                           ","2003-2004",39,"Total Participants",35094,250245,-215151,34493,192488,-157995,601,57757,-57156,"77","23",165490,49656
"7231",198871,"LOUISBURG COLLEGE                                           ","2003-2004",15,"Soccer",2,215245,-215243,1,138579,-138578,1,76666,-76665,"28","23",35523,13966
"10758",199218,"UNIVERSITY OF NORTH CAROLINA-WILMINGTON                     ","2003-2004",22,"Tennis",59056,274325,-215269,45517,128031,-82514,13539,146294,-132755,"10","12",22467,23449
"8334",123651,"VANGUARD UNIVERSITY OF SOUTHERN CALIFORNIA                  ","2003-2004",15,"Soccer",91376,306872,-215496,61847,186482,-124635,29529,120390,-90861,"17","19",13550,13540
"4006",243744,"STANFORD UNIVERSITY                                         ","2003-2004",5,"Fencing",79884,295547,-215663,18577,161040,-142463,61307,134507,-73200,"16","19",26530,27976
"6921",110617,"CALIFORNIA STATE UNIVERSITY-SACRAMENTO                      ","2003-2004",13,"Rowing",61226,276897,-215671,0,0,0,61226,276897,-215671,".","60",0,71727
"16421",154934,"COLBY COMMUNITY COLLEGE                                     ","2003-2004",39,"Total Participants",69828,285799,-215971,34718,167185,-132467,35110,118614,-83504,"110","95",129191,105760
"4364",231420,"AVERETT UNIVERSITY                                          ","2003-2004",7,"Football",142000,358000,-216000,142000,358000,-216000,0,0,0,"80",".",74634,0
"9655",128771,"CENTRAL CONNECTICUT STATE UNIVERSITY                        ","2003-2004",16,"Softball",3928,220348,-216420,0,0,0,3928,220348,-216420,".","20",0,64832
"623",145813,"ILLINOIS STATE UNIVERSITY                                   ","2003-2004",1,"Baseball",124303,341163,-216860,124303,341163,-216860,0,0,0,"36",".",85482,0
"16805",220312,"HIWASSEE COLLEGE                                            ","2003-2004",39,"Total Participants",57400,274503,-217103,28700,156874,-128174,28700,117629,-88929,"66","40",39542,41028
"810",179043,"ROCKHURST UNIVERSITY                                        ","2003-2004",1,"Baseball",13335,230605,-217270,13335,230605,-217270,0,0,0,"48",".",230592,0
"3459",155061,"FORT HAYS STATE UNIVERSITY                                  ","2003-2004",2,"Basketball",236027,453361,-217334,168581,243570,-74989,67446,209791,-142345,"16","16",34343,31232
"4361",147013,"MCKENDREE COLLEGE                                           ","2003-2004",7,"Football",581724,799077,-217353,581724,799077,-217353,0,0,0,"154",".",132635,0
"9850",154590,"WILLIAM PENN UNIVERSITY                                     ","2003-2004",16,"Softball",34943,252638,-217695,0,0,0,34943,252638,-217695,".","28",0,34272
"4016",190150,"COLUMBIA UNIVERSITY IN THE CITY OF NEW YORK                 ","2003-2004",5,"Fencing",32422,250160,-217738,16211,120305,-104094,16211,129855,-113644,"21","17",34544,46266
"3966",230603,"SOUTHERN UTAH UNIVERSITY                                    ","2003-2004",3,"All Track Combined",211487,429311,-217824,119419,219979,-100560,92068,209332,-117264,"28","26",75996,75996
"10977",106245,"UNIVERSITY OF ARKANSAS AT LITTLE ROCK                       ","2003-2004",22,"Tennis",90284,308492,-218208,44845,148600,-103755,45439,159892,-114453,"9","10",25012,17798
"2255",178697,"COLLEGE OF THE OZARKS                                       ","2003-2004",2,"Basketball",5302,223517,-218215,2474,106879,-104405,2828,116638,-113810,"15","12",65616,69487
"4191",183044,"UNIVERSITY OF NEW HAMPSHIRE-MAIN CAMPUS                     ","2003-2004",6,"Field hocky",318361,536699,-218338,0,0,0,318361,536699,-218338,".","20",0,89406
"3277",173328,"CONCORDIA UNIVERSITY-ST PAUL                                ","2003-2004",2,"Basketball",301841,520335,-218494,152213,262809,-110596,149628,257526,-107898,"14","14",79449,72485
"7046",187985,"UNIVERSITY OF NEW MEXICO-MAIN CAMPUS                        ","2003-2004",14,"Skiing",128007,346564,-218557,63676,173282,-109606,64331,173282,-108951,"10","12",41160,41160
"4473",195720,"SAINT JOHN FISHER COLLEGE                                   ","2003-2004",7,"Football",85478,304196,-218718,85478,304196,-218718,0,0,0,"143",".",50573,0
"2040",227845,"SAINT EDWARD'S UNIVERSITY                                   ","2003-2004",2,"Basketball",5603,224570,-218967,2726,112497,-109771,2877,112073,-109196,"16","13",34797,33673
"992",121309,"POINT LOMA NAZARENE UNIVERSITY                              ","2003-2004",1,"Baseball",16948,235966,-219018,16948,235966,-219018,0,0,0,"29",".",74157,0
"7673",152099,"OAKLAND CITY UNIVERSITY                                     ","2003-2004",15,"Soccer",24215,243579,-219364,12120,127135,-115015,12095,116444,-104349,"20","19",11693,12550
"6100",106245,"UNIVERSITY OF ARKANSAS AT LITTLE ROCK                       ","2003-2004",8,"Golf",102900,322359,-219459,45214,167427,-122213,57686,154932,-97246,"14","8",37781,47086
"9559",160658,"UNIVERSITY OF LOUISIANA AT LAFAYETTE                        ","2003-2004",16,"Softball",19642,239424,-219782,0,0,0,19642,239424,-219782,".","16",0,70002
"12774",219383,"UNIVERSITY OF SIOUX FALLS                                   ","2003-2004",25,"Track and Field, X-Country",2188,222164,-219976,1094,92707,-91613,1094,129457,-128363,"60","56",12547,12547
"15919",110547,"CALIFORNIA STATE UNIVERSITY-DOMINGUEZ HILLS                 ","2003-2004",39,"Total Participants",95362,315463,-220101,42397,120148,-77751,52965,195315,-142350,"74","145",118440,188242
"15863",137209,"SEMINOLE COMMUNITY COLLEGE                                  ","2003-2004",39,"Total Participants",162381,382505,-220124,72897,220739,-147842,89484,161766,-72282,"41","38",67450,73838
"11522",219602,"AUSTIN PEAY STATE UNIVERSITY                                ","2003-2004",22,"Tennis",0,220155,-220155,0,117908,-117908,0,102247,-102247,"9","9",6675,7340
"14257",232265,"HAMPTON UNIVERSITY                                          ","2003-2004",26,"Volleyball",65167,285502,-220335,0,0,0,65167,285502,-220335,".","15",0,49122
"16550",175078,"SOUTHWEST MINNESOTA STATE UNIVERSITY                        ","2003-2004",39,"Total Participants",42728,263268,-220540,29074,94954,-65880,13654,168314,-154660,"198","93",166237,145610
"10980",166629,"UNIVERSITY OF MASSACHUSETTS-AMHERST                         ","2003-2004",22,"Tennis",6560,227163,-220603,0,0,0,6560,227163,-220603,"0","9",0,30507
"16234",176947,"CENTRAL METHODIST COLLEGE                                   ","2003-2004",39,"Total Participants",95869,316549,-220680,46153,138053,-91900,49716,178496,-128780,"251","96",119687,70905
"4011",186380,"RUTGERS UNIVERSITY-NEW BRUNSWICK                            ","2003-2004",5,"Fencing",10465,231167,-220702,0,125753,-125753,10465,105414,-94949,"13","12",24702,21705
"3479",222062,"WALTERS STATE COMMUNITY COLLEGE                             ","2003-2004",2,"Basketball",14286,235428,-221142,7286,130318,-123032,7000,105110,-98110,"16","15",45600,32094
"7544",197984,"BELMONT ABBEY COLLEGE                                       ","2003-2004",15,"Soccer",5605,226783,-221178,2025,99853,-97828,3580,126930,-123350,"20","21",13037,11729
"8445",151324,"INDIANA STATE UNIVERSITY                                    ","2003-2004",15,"Soccer",74377,295942,-221565,0,0,0,74377,295942,-221565,".","27",0,35306
"2899",228705,"TEXAS A &amp; M UNIVERSITY-KINGSVILLE                           ","2003-2004",2,"Basketball",46238,267814,-221576,37036,150479,-113443,9202,117335,-108133,"13","11",110730,101236
"16725",206330,"URBANA UNIVERSITY                                           ","2003-2004",39,"Total Participants",43330,264939,-221609,27526,145444,-117918,15804,119495,-103691,"218","82",189696,90529
"13511",198385,"DAVIDSON COLLEGE                                            ","2003-2004",26,"Volleyball",11454,233240,-221786,0,0,0,11454,233240,-221786,".","11",0,28583
"4294",227526,"PRAIRIE VIEW A &amp; M UNIVERSITY                               ","2003-2004",7,"Football",574174,796342,-222168,574174,796342,-222168,0,0,0,"85",".",574174,0
"10796",219709,"BELMONT UNIVERSITY                                          ","2003-2004",22,"Tennis",35610,257996,-222386,16038,125367,-109329,19572,132629,-113057,"6","10",13254,18519
"1342",207740,"SEMINOLE STATE COLLEGE                                      ","2003-2004",1,"Baseball",58287,280902,-222615,58287,280902,-222615,0,0,0,"35",".",89500,0
"7572",154095,"UNIVERSITY OF NORTHERN IOWA                                 ","2003-2004",15,"Soccer",53502,276212,-222710,0,0,0,53502,276212,-222710,".","24",0,54484
"16031",185828,"NEW JERSEY INSTITUTE OF TECHNOLOGY                          ","2003-2004",39,"Total Participants",112490,335301,-222811,70580,205121,-134541,41910,130180,-88270,"121","75",106692,74044
"11521",179566,"SOUTHWEST MISSOURI STATE UNIVERSITY                         ","2003-2004",22,"Tennis",140756,363593,-222837,62836,143134,-80298,77920,220459,-142539,"8","7",28105,36814
"1245",220215,"FREED-HARDEMAN UNIVERSITY                                   ","2003-2004",1,"Baseball",33780,256636,-222856,33780,256636,-222856,0,0,0,"25",".",33356,0
"11692",133669,"FLORIDA ATLANTIC UNIVERSITY-BOCA RATON                      ","2003-2004",22,"Tennis",1196,224082,-222886,601,81326,-80725,595,142756,-142161,"13","6",20385,19662
"13495",106245,"UNIVERSITY OF ARKANSAS AT LITTLE ROCK                       ","2003-2004",26,"Volleyball",72688,295617,-222929,0,0,0,72688,295617,-222929,".","9",0,45574
"1775",107071,"HENDERSON STATE UNIVERSITY                                  ","2003-2004",2,"Basketball",171958,395116,-223158,96071,209378,-113307,75887,185738,-109851,"16","17",38939,29986
"9404",202480,"UNIVERSITY OF DAYTON                                        ","2003-2004",16,"Softball",10646,233923,-223277,0,0,0,10646,233923,-223277,".","20",0,58565
"9108",228796,"THE UNIVERSITY OF TEXAS AT EL PASO                          ","2003-2004",16,"Softball",171293,394718,-223425,0,0,0,171293,394718,-223425,".","16",0,134539
"549",195164,"SAINT BONAVENTURE UNIVERSITY                                ","2003-2004",1,"Baseball",27801,251291,-223490,27801,251291,-223490,0,0,0,"27",".",47387,0
"13422",159647,"LOUISIANA TECH UNIVERSITY                                   ","2003-2004",26,"Volleyball",99988,323798,-223810,0,0,0,99988,323798,-223810,".","15",0,86667
"6098",132602,"BETHUNE COOKMAN COLLEGE                                     ","2003-2004",8,"Golf",116877,341145,-224268,72003,173065,-101062,44874,168080,-123206,"6","5",62794,29426
"4639",132602,"BETHUNE COOKMAN COLLEGE                                     ","2003-2004",7,"Football",2758260,2982600,-224340,2758260,2982600,-224340,0,0,0,"82",".",681555,0
"14320",196097,"SUNY AT STONY BROOK                                         ","2003-2004",26,"Volleyball",123230,347611,-224381,0,0,0,123230,347611,-224381,".","16",0,50990
"10945",206622,"XAVIER UNIVERSITY                                           ","2003-2004",22,"Tennis",43556,267974,-224418,21778,110738,-88960,21778,157236,-135458,"11","9",24623,47202
"11429",142276,"IDAHO STATE UNIVERSITY                                      ","2003-2004",22,"Tennis",71550,296183,-224633,37195,127830,-90635,34355,168353,-133998,"12","9",23510,34439
"12698",224147,"TEXAS A &amp; M UNIVERSITY-CORPUS CHRISTI                       ","2003-2004",25,"Track and Field, X-Country",145730,370517,-224787,70865,170210,-99345,74865,200307,-125442,"47","86",24473,26302
"9954",198516,"ELON UNIVERSITY                                             ","2003-2004",16,"Softball",43177,268010,-224833,0,0,0,43177,268010,-224833,".","21",0,45135
"10091",153658,"UNIVERSITY OF IOWA                                          ","2003-2004",18,"Swimming and Diving",160985,385828,-224843,7143,191417,-184274,153842,194411,-40569,"29","29",64704,81482
"263",108092,"UNIVERSITY OF ARKANSAS AT FT SMITH                          ","2003-2004",1,"Baseball",29854,254871,-225017,29854,254871,-225017,0,0,0,"24",".",38105,0
"14542",233921,"VIRGINIA POLYTECHNIC INSTITUTE AND STATE UNIV               ","2003-2004",26,"Volleyball",252792,478494,-225702,0,0,0,252792,478494,-225702,".","14",0,74142
"3936",203845,"MARIETTA COLLEGE                                            ","2003-2004",3,"All Track Combined",52812,278962,-226150,20891,144855,-123964,31921,134107,-102186,"26","26",29344,19159
"14913",199193,"NORTH CAROLINA STATE UNIVERSITY AT RALEIGH                  ","2003-2004",28,"Wrestling",100,226466,-226366,100,226466,-226366,0,0,0,"35",".",54000,0
"8428",160612,"SOUTHEASTERN LOUISIANA UNIVERSITY                           ","2003-2004",15,"Soccer",21113,247917,-226804,0,0,0,21113,247917,-226804,".","16",0,35612
"15577",100706,"UNIVERSITY OF ALABAMA IN HUNTSVILLE                         ","2003-2004",39,"Total Participants",1538458,1765295,-226837,903429,1048905,-145476,635029,716390,-81361,"128","129",336576,193416
"13939",209807,"PORTLAND STATE UNIVERSITY                                   ","2003-2004",26,"Volleyball",213839,440746,-226907,0,0,0,213839,440746,-226907,".","17",0,82808
"854",198419,"DUKE UNIVERSITY                                             ","2003-2004",1,"Baseball",19953,247060,-227107,19953,247060,-227107,0,0,0,"33",".",130599,0
"3840",160658,"UNIVERSITY OF LOUISIANA AT LAFAYETTE                        ","2003-2004",3,"All Track Combined",1750,228997,-227247,875,131005,-130130,875,97992,-97117,"30","24",28050,23406
"8466",228459,"TEXAS STATE UNIVERSITY-SAN MARCOS                           ","2003-2004",15,"Soccer",5067,232745,-227678,0,0,0,5067,232745,-227678,".","25",0,42184
"9795",197197,"WAGNER COLLEGE                                              ","2003-2004",16,"Softball",78653,306344,-227691,0,0,0,78653,306344,-227691,".","17",0,31117
"16066",131399,"UNIVERSITY OF THE DISTRICT OF COLUMBIA                      ","2003-2004",39,"Total Participants",140000,368079,-228079,70000,210583,-140583,70000,157496,-87496,"43","33",33546,31154
"7415",218742,"UNIVERSITY OF SOUTH CAROLINA-SPARTANBURG                    ","2003-2004",15,"Soccer",8108,236537,-228429,5752,129490,-123738,2356,107047,-104691,"23","24",13100,19580
"5487",217882,"CLEMSON UNIVERSITY                                          ","2003-2004",8,"Golf",69256,297825,-228569,69256,297825,-228569,0,0,0,"11",".",56109,0
"10313",187985,"UNIVERSITY OF NEW MEXICO-MAIN CAMPUS                        ","2003-2004",18,"Swimming and Diving",126757,355413,-228656,0,0,0,126757,355413,-228656,".","30",0,98555
"14208",139940,"GEORGIA STATE UNIVERSITY                                    ","2003-2004",26,"Volleyball",8754,237410,-228656,0,0,0,8754,237410,-228656,".","11",0,32433
"9244",207324,"OKLAHOMA CHRISTIAN UNIVERSITY                               ","2003-2004",16,"Softball",7495,236154,-228659,0,0,0,7495,236154,-228659,".","15",0,29190
"6739",234207,"WASHINGTON AND LEE UNIVERSITY                               ","2003-2004",11,"Lacrosse",46471,275237,-228766,31342,166080,-134738,15129,109157,-94028,"42","25",66040,23627
"7230",232566,"LONGWOOD UNIVERSITY                                         ","2003-2004",15,"Soccer",16517,245574,-229057,11505,116861,-105356,5012,128713,-123701,"26","25",26604,28021
"11808",197197,"WAGNER COLLEGE                                              ","2003-2004",23,"Track and Field, Indoor",25256,254327,-229071,12746,131511,-118765,12510,122816,-110306,"38","28",9884,9231
"12063",197197,"WAGNER COLLEGE                                              ","2003-2004",24,"Track and Field, Outdoor",25256,254327,-229071,12746,131511,-118765,12510,122816,-110306,"34","23",9884,9231
"12876",197197,"WAGNER COLLEGE                                              ","2003-2004",25,"Track and Field, X-Country",25256,254327,-229071,12746,131511,-118765,12510,122816,-110306,"12","13",9884,9231
"3898",201104,"ASHLAND UNIVERSITY                                          ","2003-2004",3,"All Track Combined",888938,1118046,-229108,432977,547531,-114554,455961,570515,-114554,"51","42",12607,12607
"13829",199102,"NORTH CAROLINA  A &amp;T STATE UNIVERSITY                       ","2003-2004",26,"Volleyball",13520,242773,-229253,0,0,0,13520,242773,-229253,".","12",0,27784
"1587",181011,"DANA COLLEGE                                                ","2003-2004",1,"Baseball",13000,242325,-229325,13000,242325,-229325,0,0,0,"34",".",21395,0
"7598",230728,"UTAH STATE UNIVERSITY                                       ","2003-2004",15,"Soccer",2000,231501,-229501,0,0,0,2000,231501,-229501,".","28",0,64210
"6397",196246,"SUNY COLLEGE AT PLATTSBURGH                                 ","2003-2004",10,"Ice Hockey",92838,322355,-229517,76171,198119,-121948,16667,124236,-107569,"26","23",89363,57305
"2977",185262,"KEAN UNIVERSITY                                             ","2003-2004",2,"Basketball",1050,230590,-229540,525,108605,-108080,525,121985,-121460,"18","18",40072,46157
"1204",198385,"DAVIDSON COLLEGE                                            ","2003-2004",1,"Baseball",29385,259043,-229658,29385,259043,-229658,0,0,0,"32",".",56164,0
"240",129020,"UNIVERSITY OF CONNECTICUT                                   ","2003-2004",1,"Baseball",157906,387697,-229791,157906,387697,-229791,0,0,0,"35",".",235400,0
"7437",145600,"UNIVERSITY OF ILLINOIS AT CHICAGO                           ","2003-2004",15,"Soccer",1,229901,-229900,1,229901,-229900,0,0,0,"25",".",48042,0
"7461",207500,"UNIVERSITY OF OKLAHOMA NORMAN CAMPUS                        ","2003-2004",15,"Soccer",25940,256109,-230169,0,0,0,25940,256109,-230169,".","41",0,131501
"6281",227368,"THE UNIVERSITY OF TEXAS-PAN AMERICAN                        ","2003-2004",8,"Golf",6920,237145,-230225,2190,97796,-95606,4730,139349,-134619,"6","10",29436,33241
"71",139931,"GEORGIA SOUTHERN UNIVERSITY                                 ","2003-2004",1,"Baseball",178361,408996,-230635,178361,408996,-230635,0,0,0,"32",".",97236,0
"8162",100830,"AUBURN UNIVERSITY-MONTGOMERY                                ","2003-2004",15,"Soccer",67487,298122,-230635,36690,165865,-129175,30797,132257,-101460,"26","18",14861,14861
"4417",198969,"METHODIST COLLEGE                                           ","2003-2004",7,"Football",25859,256659,-230800,25859,256659,-230800,0,0,0,"102",".",61129,0
"10642",218973,"WOFFORD COLLEGE                                             ","2003-2004",22,"Tennis",27678,258570,-230892,13369,115908,-102539,14309,142662,-128353,"13","11",12292,15784
"1221",230746,"SALT LAKE COMMUNITY COLLEGE                                 ","2003-2004",1,"Baseball",11945,243013,-231068,11945,243013,-231068,0,0,0,"30",".",54568,0
"11548",197869,"APPALACHIAN STATE UNIVERSITY                                ","2003-2004",22,"Tennis",9043,240318,-231275,8019,113194,-105175,1024,127124,-126100,"10","8",28609,28343
"8177",219806,"CARSON-NEWMAN COLLEGE                                       ","2003-2004",15,"Soccer",2306,233810,-231504,941,126559,-125618,1365,107251,-105886,"25","20",18150,18160
"5667",156620,"EASTERN KENTUCKY UNIVERSITY                                 ","2003-2004",8,"Golf",57486,289159,-231673,18164,127334,-109170,39322,161825,-122503,"12","11",55215,68421
"17172",200156,"JAMESTOWN COLLEGE                                           ","2003-2004",39,"Total Participants",263115,494994,-231879,117975,246925,-128950,145140,248069,-102929,"154","110",108819,77222
"14751",110705,"UNIVERSITY OF CALIFORNIA-SANTA BARBARA                      ","2003-2004",27,"Water Polo",52375,284260,-231885,35850,142440,-106590,16525,141820,-125295,"24","42",37446,47196
"6164",226091,"LAMAR UNIVERSITY                                            ","2003-2004",8,"Golf",84557,317003,-232446,61289,178089,-116800,23268,138914,-115646,"7","6",52414,32756
"3448",230171,"DIXIE STATE COLLEGE OF UTAH                                 ","2003-2004",2,"Basketball",32477,265352,-232875,30377,147922,-117545,2100,117430,-115330,"13","15",50585,47553
"13135",183044,"UNIVERSITY OF NEW HAMPSHIRE-MAIN CAMPUS                     ","2003-2004",26,"Volleyball",414653,647881,-233228,0,0,0,414653,647881,-233228,".","15",0,93076
"1514",198136,"CAMPBELL UNIVERSITY INC                                     ","2003-2004",1,"Baseball",269392,503035,-233643,269392,503035,-233643,0,0,0,"29",".",135975,0
"13736",234030,"VIRGINIA COMMONWEALTH UNIVERSITY                            ","2003-2004",26,"Volleyball",1,234545,-234544,0,0,0,1,234545,-234544,".","10",0,26345
"3497",188030,"NEW MEXICO STATE UNIVERSITY-MAIN CAMPUS                     ","2003-2004",3,"All Track Combined",98119,332874,-234755,8245,25100,-16855,89874,307774,-217900,"9","65",10130,89335
"1224",220075,"EAST TENNESSEE STATE UNIVERSITY                             ","2003-2004",1,"Baseball",35662,270610,-234948,35662,270610,-234948,0,0,0,"25",".",35630,0
"7657",154004,"MORNINGSIDE COLLEGE                                         ","2003-2004",15,"Soccer",32024,267070,-235046,16012,133535,-117523,16012,133535,-117523,"26","27",17315,17315
"4584",127556,"MESA STATE COLLEGE                                          ","2003-2004",7,"Football",247702,482804,-235102,247702,482804,-235102,0,0,0,"100",".",352045,0
"15060",131159,"AMERICAN UNIVERSITY                                         ","2003-2004",28,"Wrestling",108992,344130,-235138,108992,344130,-235138,0,0,0,"18",".",74610,0
"436",196097,"SUNY AT STONY BROOK                                         ","2003-2004",1,"Baseball",172165,407414,-235249,172165,407414,-235249,0,0,0,"30",".",123829,0
"8573",230728,"UTAH STATE UNIVERSITY                                       ","2003-2004",16,"Softball",29000,264257,-235257,0,0,0,29000,264257,-235257,".","18",0,68523
"17336",234827,"CENTRAL WASHINGTON UNIVERSITY                               ","2003-2004",39,"Total Participants",302829,538567,-235738,250489,145971,104518,52340,392596,-340256,"209","187",286532,247127
"13377",223427,"BLINN COLLEGE                                               ","2003-2004",26,"Volleyball",2115,238188,-236073,0,0,0,2115,238188,-236073,"0","14",0,22697
"8438",181011,"DANA COLLEGE                                                ","2003-2004",15,"Soccer",13800,250321,-236521,6800,149321,-142521,7000,101000,-94000,"26","20",9250,13887
"4028",164988,"BOSTON UNIVERSITY                                           ","2003-2004",6,"Field hocky",14208,251015,-236807,0,0,0,14208,251015,-236807,".","22",0,55885
"16041",168254,"WESTERN NEW ENGLAND COLLEGE                                 ","2003-2004",39,"Total Participants",209399,446298,-236899,142864,228729,-85865,66535,217569,-151034,"253","162",157210,94275
"1937",199698,"ST ANDREWS PRESBYTERIAN COLLEGE                             ","2003-2004",2,"Basketball",176761,414007,-237246,95020,210890,-115870,81741,203117,-121376,"39","25",31550,22271
"1628",217633,"ANDERSON COLLEGE                                            ","2003-2004",2,"Basketball",211836,449087,-237251,123916,239939,-116023,87920,209148,-121228,"24","14",34008,33264
"16908",195720,"SAINT JOHN FISHER COLLEGE                                   ","2003-2004",39,"Total Participants",99196,336563,-237367,51899,153228,-101329,47297,183335,-136038,"296","114",130630,83593
"15139",228723,"TEXAS A &amp; M UNIVERSITY                                      ","2003-2004",30,"Archery",1127,238657,-237530,0,0,0,1127,238657,-237530,".","25",0,46593
"4720",101675,"MILES COLLEGE                                               ","2003-2004",7,"Football",320516,558071,-237555,320516,558071,-237555,0,0,0,"79",".",7064,0
"13121",160612,"SOUTHEASTERN LOUISIANA UNIVERSITY                           ","2003-2004",26,"Volleyball",25975,263573,-237598,0,0,0,25975,263573,-237598,".","12",0,34555
"355",110361,"CALIFORNIA BAPTIST UNIVERSITY                               ","2003-2004",1,"Baseball",29292,266986,-237694,29292,266986,-237694,0,0,0,"28",".",13851,0
"4242",234030,"VIRGINIA COMMONWEALTH UNIVERSITY                            ","2003-2004",6,"Field hocky",9101,246834,-237733,0,0,0,9101,246834,-237733,".","23",0,49083
"2581",121345,"POMONA COLLEGE                                              ","2003-2004",2,"Basketball",39580,277441,-237861,22150,178822,-156672,17430,98619,-81189,"16","11",15792,12946
"14614",153658,"UNIVERSITY OF IOWA                                          ","2003-2004",26,"Volleyball",120251,358607,-238356,0,0,0,120251,358607,-238356,".","20",0,80100
"2990",234827,"CENTRAL WASHINGTON UNIVERSITY                               ","2003-2004",2,"Basketball",69551,308119,-238568,59407,166054,-106647,10144,142065,-131921,"14","15",69128,78696
"1269",200004,"WESTERN CAROLINA UNIVERSITY                                 ","2003-2004",1,"Baseball",48008,286616,-238608,48008,286616,-238608,0,0,0,"32",".",115688,0
"7723",136172,"UNIVERSITY OF NORTH FLORIDA                                 ","2003-2004",15,"Soccer",74286,313003,-238717,21706,141296,-119590,52580,171707,-119127,"29","33",29651,47115
"10991",160658,"UNIVERSITY OF LOUISIANA AT LAFAYETTE                        ","2003-2004",22,"Tennis",830,239640,-238810,450,149272,-148822,380,90368,-89988,"8","8",48208,19803
"297",220516,"KING COLLEGE                                                ","2003-2004",1,"Baseball",39538,278449,-238911,39538,278449,-238911,0,0,0,"25",".",16356,0
"4692",163453,"MORGAN STATE UNIVERSITY                                     ","2003-2004",7,"Football",1460851,1700682,-239831,1460851,1700682,-239831,0,0,0,"86",".",256956,0
"10566",110705,"UNIVERSITY OF CALIFORNIA-SANTA BARBARA                      ","2003-2004",19,"Swimming",131427,371291,-239864,99480,180039,-80559,31947,191252,-159305,"31","32",22770,19957
"14826",154590,"WILLIAM PENN UNIVERSITY                                     ","2003-2004",28,"Wrestling",34453,274657,-240204,34453,274657,-240204,0,0,0,"40",".",34440,0
"13518",232186,"GEORGE MASON UNIVERSITY                                     ","2003-2004",26,"Volleyball",245383,485963,-240580,67799,135336,-67537,177584,350627,-173043,"17","13",48245,51289
"4179",129020,"UNIVERSITY OF CONNECTICUT                                   ","2003-2004",6,"Field hocky",21000,261938,-240938,0,0,0,21000,261938,-240938,".","26",0,71021
"3044",207740,"SEMINOLE STATE COLLEGE                                      ","2003-2004",2,"Basketball",61676,302925,-241249,30838,147999,-117161,30838,154926,-124088,"16","16",17790,14620
"4642",228705,"TEXAS A &amp; M UNIVERSITY-KINGSVILLE                           ","2003-2004",7,"Football",109867,351146,-241279,109867,351146,-241279,0,0,0,"63",".",336688,0
"4152",130794,"YALE UNIVERSITY                                             ","2003-2004",6,"Field hocky",49731,291049,-241318,0,0,0,49731,291049,-241318,".","24",0,54774
"16911",179894,"WEBSTER UNIVERSITY                                          ","2003-2004",39,"Total Participants",38696,280029,-241333,11365,108949,-97584,27331,171080,-143749,"107","104",65291,103108
"11153",110608,"CALIFORNIA STATE UNIVERSITY-NORTHRIDGE                      ","2003-2004",22,"Tennis",6794,248138,-241344,0,0,0,6794,248138,-241344,".","10",0,44457
"6602",191630,"HOBART WILLIAM SMITH COLLEGES                               ","2003-2004",11,"Lacrosse",134677,376059,-241382,98280,239249,-140969,36397,136810,-100413,"45","25",40442,22220
"13429",207971,"UNIVERSITY OF TULSA                                         ","2003-2004",26,"Volleyball",295347,536885,-241538,0,0,0,295347,536885,-241538,".","12",0,97200
"14548",110635,"UNIVERSITY OF CALIFORNIA-BERKELEY                           ","2003-2004",26,"Volleyball",659232,901289,-242057,0,0,0,659232,901289,-242057,".","18",0,157515
"13417",197869,"APPALACHIAN STATE UNIVERSITY                                ","2003-2004",26,"Volleyball",4350,246710,-242360,0,0,0,4350,246710,-242360,".","13",0,37708
"3542",145600,"UNIVERSITY OF ILLINOIS AT CHICAGO                           ","2003-2004",3,"All Track Combined",5272,248706,-243434,1778,106776,-104998,3494,141930,-138436,"65","63",33645,33373
"3886",128771,"CENTRAL CONNECTICUT STATE UNIVERSITY                        ","2003-2004",3,"All Track Combined",46519,290017,-243498,25815,167531,-141716,20704,122486,-101782,"41","59",39278,39931
"3080",195030,"UNIVERSITY OF ROCHESTER                                     ","2003-2004",2,"Basketball",178649,422240,-243591,88232,211176,-122944,90417,211064,-120647,"14","25",54995,81110
"4063",164076,"TOWSON UNIVERSITY                                           ","2003-2004",6,"Field hocky",12669,256328,-243659,0,0,0,12669,256328,-243659,".","22",0,47221
"4353",200332,"NORTH DAKOTA STATE UNIVERSITY-MAIN CAMPUS                   ","2003-2004",7,"Football",1309531,1553273,-243742,1309531,1553273,-243742,0,0,0,"112",".",231803,0
"4701",155937,"STERLING COLLEGE                                            ","2003-2004",7,"Football",1,243750,-243749,1,243750,-243749,0,0,0,"60",".",243749,0
"10196",122755,"SAN JOSE STATE UNIVERSITY                                   ","2003-2004",18,"Swimming and Diving",2380,246192,-243812,0,0,0,2380,246192,-243812,".","29",0,60369
"17073",231174,"UNIVERSITY OF VERMONT AND STATE AGRICULTURAL COLL           ","2003-2004",39,"Total Participants",4607077,4851131,-244054,2862112,2698256,163856,1744965,2152875,-407910,"196","260",756859,717549
"3138",206996,"CONNORS STATE COLLEGE                                       ","2003-2004",2,"Basketball",4682,249059,-244377,3333,125860,-122527,1349,123199,-121850,"10","12",125860,123204
"4612",220598,"LANE COLLEGE                                                ","2003-2004",7,"Football",57012,301745,-244733,57012,301745,-244733,0,0,0,"56",".",82634,0
"958",217907,"COKER COLLEGE                                               ","2003-2004",1,"Baseball",55274,300032,-244758,55274,300032,-244758,0,0,0,"38",".",49191,0
"11045",200800,"UNIVERSITY OF AKRON MAIN CAMPUS                             ","2003-2004",22,"Tennis",2862,248023,-245161,0,0,0,2862,248023,-245161,".","10",0,29601
"3404",102067,"SHELTON STATE COMMUNITY COLLEGE                             ","2003-2004",2,"Basketball",14570,259939,-245369,9871,140899,-131028,4699,119040,-114341,"17","12",31348,26676
"750",134097,"FLORIDA STATE UNIVERSITY                                    ","2003-2004",1,"Baseball",758472,1003904,-245432,758472,1003904,-245432,0,0,0,"32",".",435576,0
"2888",215655,"ROBERT MORRIS UNIVERSITY                                    ","2003-2004",2,"Basketball",1220980,1466552,-245572,706057,826890,-120833,514923,639662,-124739,"13","14",203938,138280
"1127",122409,"SAN DIEGO STATE UNIVERSITY                                  ","2003-2004",1,"Baseball",1002476,1248392,-245916,1002476,1248392,-245916,0,0,0,"44",".",575060,0
"5418",171100,"MICHIGAN STATE UNIVERSITY                                   ","2003-2004",8,"Golf",305916,551926,-246010,142740,226982,-84242,163176,324944,-161768,"9","17",41986,63056
"7785",110617,"CALIFORNIA STATE UNIVERSITY-SACRAMENTO                      ","2003-2004",15,"Soccer",152450,398649,-246199,68673,172111,-103438,83777,226538,-142761,"23","31",48354,47315
"1254",206695,"YOUNGSTOWN STATE UNIVERSITY                                 ","2003-2004",1,"Baseball",31723,277992,-246269,31723,277992,-246269,0,0,0,"35",".",69847,0
"16390",113634,"DIABLO VALLEY COLLEGE                                       ","2003-2004",39,"Total Participants",10824,257178,-246354,4510,110138,-105628,6314,147040,-140726,"203","136",45376,30163
"3961",160038,"NORTHWESTERN STATE UNIVERSITY OF LOUISIANA                  ","2003-2004",3,"All Track Combined",155607,402094,-246487,63137,183986,-120849,92470,218108,-125638,"76","69",35124,34790
"16707",213598,"LINCOLN UNIVERSITY                                          ","2003-2004",39,"Total Participants",145100,391752,-246652,75900,204476,-128576,69200,187276,-118076,"149","111",36600,105100
"14868",142115,"BOISE STATE UNIVERSITY                                      ","2003-2004",28,"Wrestling",33609,280280,-246671,33609,280280,-246671,0,0,0,"22",".",36648,0
"2222",211361,"CALIFORNIA UNIVERSITY OF PENNSYLVANIA                       ","2003-2004",2,"Basketball",578845,825636,-246791,281528,397266,-115738,297317,428370,-131053,"13","12",54394,76901
"6205",137351,"UNIVERSITY OF SOUTH FLORIDA                                 ","2003-2004",8,"Golf",14148,261106,-246958,7074,112592,-105518,7074,148514,-141440,"9","12",37019,39452
"17189",142443,"NORTH IDAHO COLLEGE                                         ","2003-2004",39,"Total Participants",285313,532470,-247157,118927,210682,-91755,166386,321788,-155402,"70","73",137667,145844
"14232",221768,"THE UNIVERSITY OF TENNESSEE-MARTIN                          ","2003-2004",26,"Volleyball",13780,260969,-247189,0,0,0,13780,260969,-247189,".","15",0,26823
"577",120883,"UNIVERSITY OF THE PACIFIC                                   ","2003-2004",1,"Baseball",584315,831804,-247489,584315,831804,-247489,0,0,0,"31",".",180965,0
"11432",139931,"GEORGIA SOUTHERN UNIVERSITY                                 ","2003-2004",22,"Tennis",2,247951,-247949,1,113147,-113146,1,134804,-134803,"10","8",21892,24327
"13315",219709,"BELMONT UNIVERSITY                                          ","2003-2004",26,"Volleyball",42343,290302,-247959,0,0,0,42343,290302,-247959,".","11",0,33532
"2443",129215,"EASTERN CONNECTICUT STATE UNIVERSITY                        ","2003-2004",2,"Basketball",17470,265577,-248107,5695,133301,-127606,11775,132276,-120501,"12","17",21876,27185
"16759",101240,"GADSDEN STATE COMMUNITY COLLEGE                             ","2003-2004",39,"Total Participants",238396,486649,-248253,126825,244232,-117407,111571,242417,-130846,"51","56",95999,107596
"6660",213385,"LAFAYETTE COLLEGE                                           ","2003-2004",11,"Lacrosse",151852,400211,-248359,64780,168694,-103914,87072,231517,-144445,"30","29",44068,36690
"15579",225627,"UNIVERSITY OF THE INCARNATE WORD                            ","2003-2004",39,"Total Participants",1982654,2231098,-248444,847449,959086,-111637,1135205,1272012,-136807,"104","104",114690,131905
"10835",221847,"TENNESSEE TECHNOLOGICAL UNIVERSITY                          ","2003-2004",22,"Tennis",22288,270906,-248618,11938,112628,-100690,10350,158278,-147928,"6","6",21339,18484
"6332",110644,"UNIVERSITY OF CALIFORNIA-DAVIS                              ","2003-2004",9,"Gymnastics",3405,252294,-248889,0,0,0,3405,252294,-248889,"0","19",0,29899
"13331",130794,"YALE UNIVERSITY                                             ","2003-2004",26,"Volleyball",12389,261718,-249329,0,0,0,12389,261718,-249329,".","13",0,36376
"5595",243780,"PURDUE UNIVERSITY-MAIN CAMPUS                               ","2003-2004",8,"Golf",373062,622791,-249729,151140,286791,-135651,221922,336000,-114078,"11","10",69393,81756
"768",110617,"CALIFORNIA STATE UNIVERSITY-SACRAMENTO                      ","2003-2004",1,"Baseball",190128,439994,-249866,190128,439994,-249866,0,0,0,"31",".",178165,0
"8004",179557,"SOUTHEAST MISSOURI STATE UNIVERSITY                         ","2003-2004",15,"Soccer",20274,270140,-249866,0,0,0,20274,270140,-249866,".","23",0,55229
"13405",196413,"SYRACUSE UNIVERSITY                                         ","2003-2004",26,"Volleyball",528853,778828,-249975,0,0,0,528853,778828,-249975,".","12",0,62800
"17007",101286,"GEORGE C WALLACE COMMUNITY COLLEGE-DOTHAN                   ","2003-2004",39,"Total Participants",68046,318333,-250287,53202,182658,-129456,14844,135675,-120831,"29","22",85473,53526
"9724",206695,"YOUNGSTOWN STATE UNIVERSITY                                 ","2003-2004",16,"Softball",11618,261928,-250310,0,0,0,11618,261928,-250310,".","21",0,53599
"3972",199111,"UNIVERSITY OF NORTH CAROLINA AT ASHEVILLE                   ","2003-2004",3,"All Track Combined",39678,290247,-250569,21609,134839,-113230,18069,155408,-137339,"50","55",27849,34280
"12697",176017,"UNIVERSITY OF MISSISSIPPI MAIN CAMPUS                       ","2003-2004",25,"Track and Field, X-Country",0,250993,-250993,0,119673,-119673,0,131320,-131320,"15","13",43544,40679
"10107",233921,"VIRGINIA POLYTECHNIC INSTITUTE AND STATE UNIV               ","2003-2004",18,"Swimming and Diving",306151,557678,-251527,98965,225993,-127028,207186,331685,-124499,"27","27",55783,51355
"15807",201690,"CENTRAL STATE UNIVERSITY                                    ","2003-2004",39,"Total Participants",56562,308181,-251619,23281,133543,-110262,33281,174638,-141357,"46","53",74591,84996
"15014",207388,"OKLAHOMA STATE UNIVERSITY-MAIN CAMPUS                       ","2003-2004",28,"Wrestling",412482,664396,-251914,412482,664396,-251914,0,0,0,"33",".",225088,0
"2878",190761,"DOMINICAN COLLEGE OF BLAUVELT                               ","2003-2004",2,"Basketball",14618,266560,-251942,7309,141080,-133771,7309,125480,-118171,"11","15",19780,19570
"17216",142294,"ALBERTSON COLLEGE OF IDAHO                                  ","2003-2004",39,"Total Participants",117502,369625,-252123,77965,181395,-103430,39537,188230,-148693,"97","96",102935,117097
"16851",230171,"DIXIE STATE COLLEGE OF UTAH                                 ","2003-2004",39,"Total Participants",55174,307548,-252374,53646,147639,-93993,1528,159909,-158381,"136","70",200024,145618
"1897",221731,"TENNESSEE WESLEYAN COLLEGE                                  ","2003-2004",2,"Basketball",63450,315850,-252400,35100,161000,-125900,28350,154850,-126500,"13","14",11750,11750
"15015",147703,"NORTHERN ILLINOIS UNIVERSITY                                ","2003-2004",28,"Wrestling",181042,433691,-252649,181042,433691,-252649,0,0,0,"36",".",59670,0
"6071",164924,"BOSTON COLLEGE                                              ","2003-2004",8,"Golf",149457,402145,-252688,115402,128428,-13026,34055,273717,-239662,"10","8",93157,63630
"13524",179344,"SOUTHWEST MISSOURI STATE UNIVERSITY-WEST PLAINS             ","2003-2004",26,"Volleyball",63027,315859,-252832,0,0,0,63027,315859,-252832,".","14",0,51446
"17318",179344,"SOUTHWEST MISSOURI STATE UNIVERSITY-WEST PLAINS             ","2003-2004",39,"Total Participants",63027,315859,-252832,0,0,0,63027,315859,-252832,"13","14",38153,51446
"6621",131159,"AMERICAN UNIVERSITY                                         ","2003-2004",11,"Lacrosse",1910,255195,-253285,0,0,0,1910,255195,-253285,".","19",0,39328
"6993",151351,"INDIANA UNIVERSITY-BLOOMINGTON                              ","2003-2004",13,"Rowing",103439,356807,-253368,0,0,0,103439,356807,-253368,".","56",0,87820
"7935",197036,"UNITED STATES MILITARY ACADEMY                              ","2003-2004",15,"Soccer",265743,519115,-253372,122138,262423,-140285,143605,256692,-113087,"29","31",41481,42153
"3883",196097,"SUNY AT STONY BROOK                                         ","2003-2004",3,"All Track Combined",116292,370164,-253872,58146,151766,-93620,58146,218398,-160252,"25","32",37454,37454
"14345",132602,"BETHUNE COOKMAN COLLEGE                                     ","2003-2004",26,"Volleyball",111221,365297,-254076,0,0,0,111221,365297,-254076,".","9",0,69984
"868",179557,"SOUTHEAST MISSOURI STATE UNIVERSITY                         ","2003-2004",1,"Baseball",20788,275296,-254508,20788,275296,-254508,0,0,0,"28",".",80425,0
"14641",220075,"EAST TENNESSEE STATE UNIVERSITY                             ","2003-2004",26,"Volleyball",1590,256268,-254678,0,0,0,1590,256268,-254678,".","12",0,15018
"11651",139940,"GEORGIA STATE UNIVERSITY                                    ","2003-2004",22,"Tennis",280,255023,-254743,230,112139,-111909,50,142884,-142834,"7","7",26454,31851
"993",138275,"WARNER SOUTHERN COLLEGE                                     ","2003-2004",1,"Baseball",13534,268975,-255441,13534,268975,-255441,0,0,0,"38",".",39929,0
"16722",232681,"MARY WASHINGTON COLLEGE                                     ","2003-2004",39,"Total Participants",539728,795235,-255507,240788,362647,-121859,298940,432588,-133648,"214","268",147249,189256
"16481",236328,"UNIVERSITY OF PUGET SOUND                                   ","2003-2004",39,"Total Participants",164920,420522,-255602,80699,193275,-112576,84221,227247,-143026,"291","259",294359,244791
"13191",129020,"UNIVERSITY OF CONNECTICUT                                   ","2003-2004",26,"Volleyball",35839,291886,-256047,0,0,0,35839,291886,-256047,".","14",0,152631
"2501",193292,"MOLLOY COLLEGE                                              ","2003-2004",2,"Basketball",28500,285000,-256500,12000,151000,-139000,16500,134000,-117500,"13","14",13500,12000
"4471",118693,"MENLO COLLEGE                                               ","2003-2004",7,"Football",40000,296524,-256524,40000,296524,-256524,0,0,0,"131",".",176873,0
"13172",179557,"SOUTHEAST MISSOURI STATE UNIVERSITY                         ","2003-2004",26,"Volleyball",25358,281940,-256582,0,0,0,25358,281940,-256582,".","13",0,43505
"13657",145813,"ILLINOIS STATE UNIVERSITY                                   ","2003-2004",26,"Volleyball",114554,371374,-256820,0,0,0,114554,371374,-256820,".","13",0,99581
"6377",122755,"SAN JOSE STATE UNIVERSITY                                   ","2003-2004",9,"Gymnastics",2380,259216,-256836,0,0,0,2380,259216,-256836,".","17",0,32687
"3904",147703,"NORTHERN ILLINOIS UNIVERSITY                                ","2003-2004",3,"All Track Combined",103396,360476,-257080,0,0,0,103396,360476,-257080,".","67",0,63947
"12433",234085,"VIRGINIA MILITARY INSTITUTE                                 ","2003-2004",25,"Track and Field, X-Country",425548,682693,-257145,252655,381895,-129240,172893,300798,-127905,"117","38",24749,27849
"16133",238476,"CARTHAGE COLLEGE                                            ","2003-2004",39,"Total Participants",853718,1110960,-257242,396169,550528,-154359,457549,560432,-102883,"425","270",186250,122750
"8027",217165,"BRYANT COLLEGE                                              ","2003-2004",15,"Soccer",84096,341494,-257398,45988,147622,-101634,38108,193872,-155764,"25","28",53575,33852
"14060",149222,"SOUTHERN ILLINOIS UNIVERSITY-CARBONDALE                     ","2003-2004",26,"Volleyball",133745,391350,-257605,0,0,0,133745,391350,-257605,".","17",0,66493
"13474",227368,"THE UNIVERSITY OF TEXAS-PAN AMERICAN                        ","2003-2004",26,"Volleyball",10252,267940,-257688,0,0,0,10252,267940,-257688,"0","16",0,51690
"1306",128771,"CENTRAL CONNECTICUT STATE UNIVERSITY                        ","2003-2004",1,"Baseball",39350,297119,-257769,39350,297119,-257769,0,0,0,"22",".",90362,0
"2246",204617,"OHIO DOMINICAN UNIVERSITY                                   ","2003-2004",2,"Basketball",9943,267751,-257808,3603,152718,-149115,6340,115033,-108693,"14","10",24336,35512
"4712",216667,"WASHINGTON &amp; JEFFERSON COLLEGE                              ","2003-2004",7,"Football",322013,580260,-258247,322013,580260,-258247,0,0,0,"129",".",105046,0
"14133",198419,"DUKE UNIVERSITY                                             ","2003-2004",26,"Volleyball",3112,261359,-258247,0,0,0,3112,261359,-258247,".","17",0,103622
"14553",217864,"CITADEL MILITARY COLLEGE OF SOUTH CAROLINA                  ","2003-2004",26,"Volleyball",386,258660,-258274,0,0,0,386,258660,-258274,".","11",0,34447
"15458",162584,"FROSTBURG STATE UNIVERSITY                                  ","2003-2004",39,"Total Participants",666858,925256,-258398,224819,369190,-144371,442039,556066,-114027,"276","157",288233,182354
"10550",120883,"UNIVERSITY OF THE PACIFIC                                   ","2003-2004",19,"Swimming",533872,792285,-258413,192550,334919,-142369,341322,457366,-116044,"20","25",48070,66487
"1029",149222,"SOUTHERN ILLINOIS UNIVERSITY-CARBONDALE                     ","2003-2004",1,"Baseball",191121,449863,-258742,191121,449863,-258742,0,0,0,"29",".",105321,0
"219",166629,"UNIVERSITY OF MASSACHUSETTS-AMHERST                         ","2003-2004",1,"Baseball",30263,289069,-258806,30263,289069,-258806,0,0,0,"32",".",128959,0
"12385",222831,"ANGELO STATE UNIVERSITY                                     ","2003-2004",25,"Track and Field, X-Country",3205,262105,-258900,1603,132157,-130554,1602,129948,-128346,"47","40",29350,32472
"10512",197197,"WAGNER COLLEGE                                              ","2003-2004",19,"Swimming",81182,340123,-258941,0,0,0,81182,340123,-258941,".","18",0,26832
"6351",150136,"BALL STATE UNIVERSITY                                       ","2003-2004",9,"Gymnastics",16329,275361,-259032,0,0,0,16329,275361,-259032,".","16",0,30831
"1386",130794,"YALE UNIVERSITY                                             ","2003-2004",1,"Baseball",153325,412678,-259353,153325,412678,-259353,0,0,0,"24",".",91325,0
"15111",243744,"STANFORD UNIVERSITY                                         ","2003-2004",29,"Other Sports",174351,433734,-259383,0,0,0,174351,433734,-259383,".","52",0,98831
"14464",199120,"UNIVERSITY OF NORTH CAROLINA AT CHAPEL HILL                 ","2003-2004",26,"Volleyball",278540,538867,-260327,0,0,0,278540,538867,-260327,".","14",0,71596
"6016",147703,"NORTHERN ILLINOIS UNIVERSITY                                ","2003-2004",8,"Golf",60219,320793,-260574,23781,130139,-106358,36438,190654,-154216,"9","10",34191,38585
"1419",187985,"UNIVERSITY OF NEW MEXICO-MAIN CAMPUS                        ","2003-2004",1,"Baseball",182682,443387,-260705,182682,443387,-260705,0,0,0,"34",".",160459,0
"2208",138275,"WARNER SOUTHERN COLLEGE                                     ","2003-2004",2,"Basketball",21732,283309,-261577,7977,164159,-156182,13755,119150,-105395,"13","13",34945,29282
"6222",233921,"VIRGINIA POLYTECHNIC INSTITUTE AND STATE UNIV               ","2003-2004",8,"Golf",125476,387058,-261582,125476,387058,-261582,0,0,0,"9",".",43612,0
"15881",142328,"LEWIS-CLARK STATE COLLEGE                                   ","2003-2004",39,"Total Participants",388326,649918,-261592,241162,395142,-153980,147164,254776,-107612,"92","56",102550,99929
"14921",196088,"SUNY AT BUFFALO                                             ","2003-2004",28,"Wrestling",64825,326668,-261843,64825,326668,-261843,0,0,0,"26",".",43336,0
"8826",196097,"SUNY AT STONY BROOK                                         ","2003-2004",16,"Softball",80743,342636,-261893,0,0,0,80743,342636,-261893,".","14",0,80445
"11070",110644,"UNIVERSITY OF CALIFORNIA-DAVIS                              ","2003-2004",22,"Tennis",1515,263639,-262124,635,126166,-125531,880,137473,-136593,"13","11",28347,26102
"3549",230782,"WEBER STATE UNIVERSITY                                      ","2003-2004",3,"All Track Combined",321035,583212,-262177,144543,259620,-115077,176492,323592,-147100,"37","40",61548,63388
"4673",106412,"UNIVERSITY OF ARKANSAS AT PINE BLUFF                        ","2003-2004",7,"Football",565116,827838,-262722,565116,827838,-262722,0,0,0,"89",".",232815,0
"13119",207500,"UNIVERSITY OF OKLAHOMA NORMAN CAMPUS                        ","2003-2004",26,"Volleyball",3747,267286,-263539,0,0,0,3747,267286,-263539,".","21",0,148406
"11575",190150,"COLUMBIA UNIVERSITY IN THE CITY OF NEW YORK                 ","2003-2004",22,"Tennis",21870,286091,-264221,6795,169831,-163036,15075,116260,-101185,"12","13",49614,31782
"8506",199111,"UNIVERSITY OF NORTH CAROLINA AT ASHEVILLE                   ","2003-2004",15,"Soccer",23565,287839,-264274,15781,150013,-134232,7784,137826,-130042,"22","22",29826,28908
"5283",227216,"UNIVERSITY OF NORTH TEXAS                                   ","2003-2004",8,"Golf",28488,292794,-264306,14244,136657,-122413,14244,156137,-141893,"11","9",37066,37445
"4100",214777,"PENNSYLVANIA STATE UNIVERSITY-MAIN CAMPUS                   ","2003-2004",6,"Field hocky",234562,498873,-264311,0,0,0,234562,498873,-264311,".","23",0,97205
"550",131496,"GEORGETOWN UNIVERSITY                                       ","2003-2004",1,"Baseball",89074,353551,-264477,89074,353551,-264477,0,0,0,"35",".",123027,0
"14162",196060,"SUNY AT ALBANY                                              ","2003-2004",26,"Volleyball",985,265467,-264482,0,0,0,985,265467,-264482,".","12",0,52305
"5594",139940,"GEORGIA STATE UNIVERSITY                                    ","2003-2004",8,"Golf",41954,306671,-264717,27939,139450,-111511,14015,167221,-153206,"8","8",27705,32243
"8744",110644,"UNIVERSITY OF CALIFORNIA-DAVIS                              ","2003-2004",16,"Softball",10252,275314,-265062,0,0,0,10252,275314,-265062,".","22",0,52302
"8415",206695,"YOUNGSTOWN STATE UNIVERSITY                                 ","2003-2004",15,"Soccer",24350,289869,-265519,0,0,0,24350,289869,-265519,".","24",0,42646
"13686",159939,"UNIVERSITY OF NEW ORLEANS                                   ","2003-2004",26,"Volleyball",12970,278588,-265618,0,0,0,12970,278588,-265618,".","14",0,101623
"10371",196097,"SUNY AT STONY BROOK                                         ","2003-2004",18,"Swimming and Diving",60728,326459,-265731,30364,146728,-116364,30364,179731,-149367,"28","33",26360,26360
"14311",102614,"UNIVERSITY OF ALASKA FAIRBANKS                              ","2003-2004",26,"Volleyball",24152,289977,-265825,0,0,0,24152,289977,-265825,".","14",0,54002
"10287",199120,"UNIVERSITY OF NORTH CAROLINA AT CHAPEL HILL                 ","2003-2004",18,"Swimming and Diving",547385,813297,-265912,225892,358848,-132956,321493,454449,-132956,"33","35",47889,47889
"15549",229832,"WESTERN TEXAS COLLEGE                                       ","2003-2004",39,"Total Participants",248883,515230,-266347,129299,233944,-104645,119584,281286,-161702,"70","47",175473,229734
"6199",145637,"UNIVERSITY OF ILLINOIS AT URBANA-CHAMPAIGN                  ","2003-2004",8,"Golf",211750,478646,-266896,121418,265975,-144557,90332,212671,-122339,"9","11",66401,63883
"1239",224147,"TEXAS A &amp; M UNIVERSITY-CORPUS CHRISTI                       ","2003-2004",1,"Baseball",16703,283784,-267081,16703,283784,-267081,0,0,0,"28",".",81391,0
"9050",188030,"NEW MEXICO STATE UNIVERSITY-MAIN CAMPUS                     ","2003-2004",16,"Softball",88934,356166,-267232,0,0,0,88934,356166,-267232,".","18",0,109417
"14861",203517,"KENT STATE UNIVERSITY-MAIN CAMPUS                           ","2003-2004",28,"Wrestling",5789,273210,-267421,5789,273210,-267421,0,0,0,"28","0",45933,0
"13311",206695,"YOUNGSTOWN STATE UNIVERSITY                                 ","2003-2004",26,"Volleyball",109668,377363,-267695,0,0,0,109668,377363,-267695,".","14",0,38192
"7650",228796,"THE UNIVERSITY OF TEXAS AT EL PASO                          ","2003-2004",15,"Soccer",224690,492432,-267742,0,0,0,224690,492432,-267742,".","21",0,98289
"12941",164076,"TOWSON UNIVERSITY                                           ","2003-2004",25,"Track and Field, X-Country",4846,272797,-267951,2423,111723,-109300,2423,161074,-158651,"77","103",25468,25469
"9987",151324,"INDIANA STATE UNIVERSITY                                    ","2003-2004",16,"Softball",99185,367180,-267995,0,0,0,99185,367180,-267995,".","28",0,61527
"14792",145637,"UNIVERSITY OF ILLINOIS AT URBANA-CHAMPAIGN                  ","2003-2004",28,"Wrestling",372609,640664,-268055,372609,640664,-268055,0,0,0,"37",".",117422,0
"1365",176372,"UNIVERSITY OF SOUTHERN MISSISSIPPI                          ","2003-2004",1,"Baseball",327590,595781,-268191,327590,595781,-268191,0,0,0,"35",".",167308,0
"5529",198464,"EAST CAROLINA UNIVERSITY                                    ","2003-2004",8,"Golf",16664,285047,-268383,8332,125701,-117369,8332,159346,-151014,"9","9",33818,38931
"14755",110644,"UNIVERSITY OF CALIFORNIA-DAVIS                              ","2003-2004",27,"Water Polo",11865,280631,-268766,6485,128807,-122322,5380,151824,-146444,"25","27",36269,33767
"4813",102270,"STILLMAN COLLEGE                                            ","2003-2004",7,"Football",156368,425375,-269007,156368,425375,-269007,0,0,0,"90",".",138000,0
"9538",179159,"SAINT LOUIS UNIVERSITY-MAIN CAMPUS                          ","2003-2004",16,"Softball",3567,272667,-269100,0,0,0,3567,272667,-269100,".","16",0,68612
"9852",164076,"TOWSON UNIVERSITY                                           ","2003-2004",16,"Softball",60053,329162,-269109,0,0,0,60053,329162,-269109,".","23",0,57376
"8500",145637,"UNIVERSITY OF ILLINOIS AT URBANA-CHAMPAIGN                  ","2003-2004",15,"Soccer",336279,605813,-269534,0,0,0,336279,605813,-269534,".","23",0,112320
"10420",110361,"CALIFORNIA BAPTIST UNIVERSITY                               ","2003-2004",18,"Swimming and Diving",4250,274632,-270382,2075,138425,-136350,2175,136207,-134032,"27","20",15771,15769
"9513",139931,"GEORGIA SOUTHERN UNIVERSITY                                 ","2003-2004",16,"Softball",96345,366856,-270511,0,0,0,96345,366856,-270511,".","23",0,66061
"3187",163268,"UNIVERSITY OF MARYLAND-BALTIMORE COUNTY                     ","2003-2004",2,"Basketball",436655,707354,-270699,322046,445108,-123062,114609,262246,-147637,"12","12",157583,113596
"2801",219356,"SOUTH DAKOTA STATE UNIVERSITY                               ","2003-2004",2,"Basketball",391893,662691,-270798,196447,355552,-159105,195446,307139,-111693,"16","12",71116,70834
"10207",227216,"UNIVERSITY OF NORTH TEXAS                                   ","2003-2004",18,"Swimming and Diving",1142,272167,-271025,0,0,0,1142,272167,-271025,".","24",0,44168
"2055",110565,"CALIFORNIA STATE UNIVERSITY-FULLERTON                       ","2003-2004",2,"Basketball",1034713,1306077,-271364,616798,692731,-75933,417915,613346,-195431,"16","16",131484,130570
"11142",110422,"CALIFORNIA POLYTECHNIC STATE UNIV-SAN LUIS OBISPO           ","2003-2004",22,"Tennis",4956,276327,-271371,2300,123708,-121408,2656,152619,-149963,"11","12",25541,24316
"16480",203599,"LAKELAND COMMUNITY COLLEGE                                  ","2003-2004",39,"Total Participants",19772,291336,-271564,15787,183480,-167693,3985,107856,-103871,"64","34",117639,82166
"16283",225520,"HOWARD COUNTY JUNIOR COLLEGE DISTRICT                       ","2003-2004",39,"Total Participants",31144,303123,-271979,22901,188643,-165742,8243,114480,-106237,"69","41",94895,63815
"16736",198613,"GUILFORD COLLEGE                                            ","2003-2004",39,"Total Participants",325610,597661,-272051,160371,290346,-129975,165239,307315,-142076,"186","91",135452,67015
"8151",112826,"CONTRA COSTA COLLEGE                                        ","2003-2004",15,"Soccer",4500,276700,-272200,3000,158350,-155350,1500,118350,-116850,"22","4",8250,8250
"7758",123572,"SONOMA STATE UNIVERSITY                                     ","2003-2004",15,"Soccer",231119,503592,-272473,220609,340312,-119703,10510,163280,-152770,"24","26",53774,44755
"4422",155973,"TABOR COLLEGE                                               ","2003-2004",7,"Football",40044,312654,-272610,40044,312654,-272610,0,0,0,"72",".",35208,0
"8605",122409,"SAN DIEGO STATE UNIVERSITY                                  ","2003-2004",16,"Softball",257940,530564,-272624,0,0,0,257940,530564,-272624,".","20",0,129316
"14931",110556,"CALIFORNIA STATE UNIVERSITY-FRESNO                          ","2003-2004",28,"Wrestling",193632,466434,-272802,193632,466434,-272802,0,0,0,"22",".",76619,0
"5581",110608,"CALIFORNIA STATE UNIVERSITY-NORTHRIDGE                      ","2003-2004",8,"Golf",40961,313792,-272831,34260,153522,-119262,6701,160270,-153569,"11","10",59058,46668
"16893",216357,"THIEL COLLEGE                                               ","2003-2004",39,"Total Participants",100554,374078,-273524,53204,199698,-146494,47350,174380,-127030,"297","151",165947,84155
"6615",129020,"UNIVERSITY OF CONNECTICUT                                   ","2003-2004",11,"Lacrosse",1,274234,-274233,0,0,0,1,274234,-274233,".","28",0,136230
"7031",182290,"UNIVERSITY OF NEVADA-RENO                                   ","2003-2004",14,"Skiing",50000,324265,-274265,25000,150150,-125150,25000,174115,-149115,"10","12",39565,32425
"9199",129020,"UNIVERSITY OF CONNECTICUT                                   ","2003-2004",16,"Softball",20000,294294,-274294,0,0,0,20000,294294,-274294,".","18",0,115875
"10791",122409,"SAN DIEGO STATE UNIVERSITY                                  ","2003-2004",22,"Tennis",255296,529696,-274400,102882,210919,-108037,152414,318777,-166363,"9","8",29326,43012
"16092",186371,"RUTGERS UNIVERSITY-CAMDEN                                   ","2003-2004",39,"Total Participants",72521,347077,-274556,52105,210867,-158762,20416,136210,-115794,"122","93",145146,120599
"4652",156365,"CAMPBELLSVILLE UNIVERSITY                                   ","2003-2004",7,"Football",135260,410029,-274769,135260,410029,-274769,0,0,0,"127",".",102446,0
"2542",188304,"WESTERN NEW MEXICO UNIVERSITY                               ","2003-2004",2,"Basketball",16646,291747,-275101,10286,140014,-129728,6360,151733,-145373,"16","13",48139,37825
"4032",196060,"SUNY AT ALBANY                                              ","2003-2004",6,"Field hocky",345,275577,-275232,0,0,0,345,275577,-275232,".","23",0,37625
"9498",149222,"SOUTHERN ILLINOIS UNIVERSITY-CARBONDALE                     ","2003-2004",16,"Softball",139358,414784,-275426,0,0,0,139358,414784,-275426,".","18",0,125866
"3601",110617,"CALIFORNIA STATE UNIVERSITY-SACRAMENTO                      ","2003-2004",3,"All Track Combined",193671,469099,-275428,66013,160694,-94681,127658,308405,-180747,"63","73",44982,39761
"13318",179964,"WILLIAM WOODS UNIVERSITY                                    ","2003-2004",26,"Volleyball",45592,321097,-275505,22109,155645,-133536,23483,165452,-141969,"7","11",5609,6983
"5155",199218,"UNIVERSITY OF NORTH CAROLINA-WILMINGTON                     ","2003-2004",8,"Golf",35375,310999,-275624,11000,147228,-136228,24375,163771,-139396,"9","10",28838,44943
"5768",233374,"UNIVERSITY OF RICHMOND                                      ","2003-2004",8,"Golf",32562,308228,-275666,13618,157862,-144244,18944,150366,-131422,"10","9",37509,29987
"9854",139755,"GEORGIA INSTITUTE OF TECHNOLOGY-MAIN CAMPUS                 ","2003-2004",16,"Softball",278015,553704,-275689,0,0,0,278015,553704,-275689,".","15",0,90467
"13284",110583,"CALIFORNIA STATE UNIVERSITY-LONG BEACH                      ","2003-2004",26,"Volleyball",734488,1010606,-276118,246402,353218,-106816,488086,657388,-169302,"18","16",121395,85306
"2290",101161,"JAMES H FAULKNER STATE COMMUNITY COLLEGE                    ","2003-2004",2,"Basketball",84880,361311,-276431,51654,226280,-174626,33226,135031,-101805,"20","14",54997,36245
"10783",238032,"WEST VIRGINIA UNIVERSITY                                    ","2003-2004",22,"Tennis",1533,278069,-276536,0,0,0,1533,278069,-276536,".","10",0,62993
"4453",184782,"ROWAN UNIVERSITY                                            ","2003-2004",7,"Football",20456,297091,-276635,20456,297091,-276635,0,0,0,"92",".",102340,0
"4699",219602,"AUSTIN PEAY STATE UNIVERSITY                                ","2003-2004",7,"Football",98748,375714,-276966,98748,375714,-276966,0,0,0,"85",".",99983,0
"2322",240453,"UNIVERSITY OF WISCONSIN-MILWAUKEE                           ","2003-2004",2,"Basketball",2522735,2799744,-277009,1761613,1945793,-184180,761122,853951,-92829,"24","20",386915,161746
"12452",121309,"POINT LOMA NAZARENE UNIVERSITY                              ","2003-2004",25,"Track and Field, X-Country",15972,293870,-277898,10986,144458,-133472,4986,149412,-144426,"28","29",34779,41623
"14515",228459,"TEXAS STATE UNIVERSITY-SAN MARCOS                           ","2003-2004",26,"Volleyball",39989,317920,-277931,0,0,0,39989,317920,-277931,".","19",0,34894
"4657",176044,"MISSISSIPPI VALLEY STATE UNIVERSITY                         ","2003-2004",7,"Football",445316,723956,-278640,445316,723956,-278640,0,0,0,"85",".",416957,0
"6013",130794,"YALE UNIVERSITY                                             ","2003-2004",8,"Golf",203926,482597,-278671,101963,241849,-139886,101963,240748,-138785,"15","7",49189,61327
"8127",138275,"WARNER SOUTHERN COLLEGE                                     ","2003-2004",15,"Soccer",346,279200,-278854,51,155498,-155447,295,123702,-123407,"24","21",12588,11575
"2010",186380,"RUTGERS UNIVERSITY-NEW BRUNSWICK                            ","2003-2004",2,"Basketball",3830400,4109306,-278906,3540571,2322358,1218213,289829,1786948,-1497119,"15","11",455113,333072
"11413",233921,"VIRGINIA POLYTECHNIC INSTITUTE AND STATE UNIV               ","2003-2004",22,"Tennis",294430,574079,-279649,106779,242015,-135236,187651,332064,-144413,"11","11",49907,51979
"84",139940,"GEORGIA STATE UNIVERSITY                                    ","2003-2004",1,"Baseball",33535,313558,-280023,33535,313558,-280023,0,0,0,"34",".",49720,0
"7075",121309,"POINT LOMA NAZARENE UNIVERSITY                              ","2003-2004",15,"Soccer",5505,285599,-280094,5080,141998,-136918,425,143601,-143176,"20","25",14835,16063
"4774",157386,"MOREHEAD STATE UNIVERSITY                                   ","2003-2004",7,"Football",369395,649680,-280285,369395,649680,-280285,0,0,0,"126",".",99088,0
"10022",228459,"TEXAS STATE UNIVERSITY-SAN MARCOS                           ","2003-2004",16,"Softball",54850,335185,-280335,0,0,0,54850,335185,-280335,".","19",0,95678
"3772",219356,"SOUTH DAKOTA STATE UNIVERSITY                               ","2003-2004",3,"All Track Combined",175,280534,-280359,175,138023,-137848,0,142511,-142511,"40","25",44721,44721
"9220",179557,"SOUTHEAST MISSOURI STATE UNIVERSITY                         ","2003-2004",16,"Softball",4115,284483,-280368,0,0,0,4115,284483,-280368,".","23",0,52643
"1504",226091,"LAMAR UNIVERSITY                                            ","2003-2004",1,"Baseball",274984,555711,-280727,274984,555711,-280727,0,0,0,"34",".",140808,0
"15914",213376,"LACKAWANNA COLLEGE                                          ","2003-2004",39,"Total Participants",2156,282984,-280828,255,103293,-103038,1901,179691,-177790,"125","25",362773,112743
"3581",200332,"NORTH DAKOTA STATE UNIVERSITY-MAIN CAMPUS                   ","2003-2004",3,"All Track Combined",221170,502191,-281021,103997,251698,-147701,117173,250493,-133320,"68","41",103269,92260
"17303",168591,"ALMA COLLEGE                                                ","2003-2004",39,"Total Participants",318414,599669,-281255,138974,256683,-117709,179440,342986,-163546,"253","161",202788,150652
"16313",154527,"WARTBURG COLLEGE                                            ","2003-2004",39,"Total Participants",327394,608772,-281378,179013,355133,-176120,148381,253639,-105258,"393","227",194840,138965
"6337",130794,"YALE UNIVERSITY                                             ","2003-2004",9,"Gymnastics",5559,286981,-281422,0,0,0,5559,286981,-281422,".","15",0,50675
"4853",213321,"KINGS COLLEGE                                               ","2003-2004",7,"Football",146198,427888,-281690,146198,427888,-281690,0,0,0,"110",".",83214,0
"670",228459,"TEXAS STATE UNIVERSITY-SAN MARCOS                           ","2003-2004",1,"Baseball",75553,357371,-281818,75553,357371,-281818,0,0,0,"35",".",116638,0
"8379",179566,"SOUTHWEST MISSOURI STATE UNIVERSITY                         ","2003-2004",15,"Soccer",274773,556728,-281955,147077,249535,-102458,127696,307193,-179497,"27","27",38446,40107
"10298",198385,"DAVIDSON COLLEGE                                            ","2003-2004",18,"Swimming and Diving",17880,300650,-282770,7078,109777,-102699,10802,190873,-180071,"23","25",17313,21059
"6248",186380,"RUTGERS UNIVERSITY-NEW BRUNSWICK                            ","2003-2004",8,"Golf",6977,289990,-283013,0,153135,-153135,6977,136855,-129878,"8","8",40329,36456
"10055",104179,"UNIVERSITY OF ARIZONA                                       ","2003-2004",16,"Softball",443325,726458,-283133,0,0,0,443325,726458,-283133,".","19",0,121288
"4136",196413,"SYRACUSE UNIVERSITY                                         ","2003-2004",6,"Field hocky",675918,959129,-283211,0,0,0,675918,959129,-283211,".","23",0,109603
"11101",232982,"OLD DOMINION UNIVERSITY                                     ","2003-2004",22,"Tennis",61892,345174,-283282,33316,158478,-125162,28576,186696,-158120,"10","7",22090,18659
"395",201885,"UNIVERSITY OF CINCINNATI-MAIN CAMPUS                        ","2003-2004",1,"Baseball",275026,558342,-283316,275026,558342,-283316,0,0,0,"33",".",173853,0
"15616",110510,"CALIFORNIA STATE UNIVERSITY-SAN BERNARDINO                  ","2003-2004",39,"Total Participants",510346,794028,-283682,202652,315736,-113084,307694,478292,-170598,"84","119",117958,153161
"12597",221999,"VANDERBILT UNIVERSITY                                       ","2003-2004",25,"Track and Field, X-Country",788156,1071840,-283684,356660,74977,281683,431496,996863,-565367,"10","43",9069,141559
"16105",147013,"MCKENDREE COLLEGE                                           ","2003-2004",39,"Total Participants",1346064,1629936,-283872,654169,828951,-174782,691895,800985,-109090,"306","145",324353,175732
"9764",133669,"FLORIDA ATLANTIC UNIVERSITY-BOCA RATON                      ","2003-2004",16,"Softball",13645,297679,-284034,0,0,0,13645,297679,-284034,".","17",0,59259
"10307",225511,"UNIVERSITY OF HOUSTON-UNIVERSITY PARK                       ","2003-2004",18,"Swimming and Diving",11138,295297,-284159,0,0,0,11138,295297,-284159,".","29",0,70671
"15760",240727,"UNIVERSITY OF WYOMING                                       ","2003-2004",39,"Total Participants",3071954,3356133,-284179,1000556,1125111,-124555,2071398,2231022,-159624,"205","164",972063,751497
"2839",217721,"BENEDICT COLLEGE                                            ","2003-2004",2,"Basketball",4460,288882,-284422,2230,148905,-146675,2230,139977,-137747,"18","12",48473,39546
"8479",110556,"CALIFORNIA STATE UNIVERSITY-FRESNO                          ","2003-2004",15,"Soccer",413183,697786,-284603,228184,281312,-53128,184999,416474,-231475,"21","23",78178,125913
"13922",198516,"ELON UNIVERSITY                                             ","2003-2004",26,"Volleyball",1221,286553,-285332,0,0,0,1221,286553,-285332,".","14",0,37528
"3036",174233,"UNIVERSITY OF MINNESOTA-DULUTH                              ","2003-2004",2,"Basketball",342071,627562,-285491,176829,309365,-132536,165242,318197,-152955,"17","18",40997,39348
"3937",183044,"UNIVERSITY OF NEW HAMPSHIRE-MAIN CAMPUS                     ","2003-2004",3,"All Track Combined",219096,504706,-285610,86304,208411,-122107,132792,296295,-163503,"137","146",68533,54339
"835",136172,"UNIVERSITY OF NORTH FLORIDA                                 ","2003-2004",1,"Baseball",67507,353155,-285648,67507,353155,-285648,0,0,0,"39",".",101829,0
"3738",102094,"UNIVERSITY OF SOUTH ALABAMA                                 ","2003-2004",3,"All Track Combined",330951,616815,-285864,167170,272193,-105023,163781,344622,-180841,"39","59",46947,44618
"3757",198385,"DAVIDSON COLLEGE                                            ","2003-2004",3,"All Track Combined",4359,290582,-286223,3012,139904,-136892,1347,150678,-149331,"26","14",20557,21373
"4105",198419,"DUKE UNIVERSITY                                             ","2003-2004",6,"Field hocky",5625,291939,-286314,0,0,0,5625,291939,-286314,".","21",0,98659
"1591",208488,"CONCORDIA UNIVERSITY                                        ","2003-2004",2,"Basketball",59190,345614,-286424,35167,203470,-168303,24023,142144,-118121,"14","15",21062,16434
"1556",164076,"TOWSON UNIVERSITY                                           ","2003-2004",1,"Baseball",5208,291748,-286540,5208,291748,-286540,0,0,0,"37",".",87259,0
"17035",148654,"UNIVERSITY OF ILLINOIS AT SPRINGFIELD                       ","2003-2004",39,"Total Participants",442278,728832,-286554,202946,316158,-113212,239332,412674,-173342,"43","49",99187,149939
"11402",198516,"ELON UNIVERSITY                                             ","2003-2004",22,"Tennis",8766,295386,-286620,4383,151907,-147524,4383,143479,-139096,"13","14",15136,18235
"576",179964,"WILLIAM WOODS UNIVERSITY                                    ","2003-2004",1,"Baseball",43663,330334,-286671,43663,330334,-286671,0,0,0,"31",".",12163,0
"6303",147703,"NORTHERN ILLINOIS UNIVERSITY                                ","2003-2004",9,"Gymnastics",6671,293394,-286723,0,0,0,6671,293394,-286723,".","20",0,34825
"11708",155399,"KANSAS STATE UNIVERSITY                                     ","2003-2004",22,"Tennis",23907,310653,-286746,0,0,0,23907,310653,-286746,"0","7",0,65519
"4478",219259,"NORTHERN STATE UNIVERSITY                                   ","2003-2004",7,"Football",70003,356961,-286958,70003,356961,-286958,0,0,0,"97",".",49438,0
"2685",154925,"COFFEYVILLE COMMUNITY COLLEGE &amp; AREA TECH SCHOOL            ","2003-2004",2,"Basketball",58050,345482,-287432,29025,195063,-166038,29025,150419,-121394,"22","16",25046,16985
"1339",221847,"TENNESSEE TECHNOLOGICAL UNIVERSITY                          ","2003-2004",1,"Baseball",33123,320630,-287507,33123,320630,-287507,0,0,0,"37",".",48816,0
"1132",198516,"ELON UNIVERSITY                                             ","2003-2004",1,"Baseball",13670,301219,-287549,13670,301219,-287549,0,0,0,"39",".",64582,0
"16816",240480,"UNIVERSITY OF WISCONSIN-STEVENS POINT                       ","2003-2004",39,"Total Participants",541650,829214,-287564,285344,407553,-122209,256306,421661,-165355,"365","325",246349,209079
"3083",112826,"CONTRA COSTA COLLEGE                                        ","2003-2004",2,"Basketball",10500,298380,-287880,1500,169940,-168440,9000,128440,-119440,"12","14",8250,8250
"11260",198464,"EAST CAROLINA UNIVERSITY                                    ","2003-2004",22,"Tennis",22350,310293,-287943,17750,144022,-126272,4600,166271,-161671,"8","10",29445,25162
"17062",153108,"CENTRAL COLLEGE                                             ","2003-2004",39,"Total Participants",439736,727686,-287950,171614,320046,-148432,268122,407640,-139518,"438","228",232726,136240
"17185",222062,"WALTERS STATE COMMUNITY COLLEGE                             ","2003-2004",39,"Total Participants",17900,305919,-288019,8900,210202,-201302,9000,95717,-86717,"52","29",103965,57351
"6301",183044,"UNIVERSITY OF NEW HAMPSHIRE-MAIN CAMPUS                     ","2003-2004",9,"Gymnastics",380865,668936,-288071,0,0,0,380865,668936,-288071,".","16",0,89690
"217",151324,"INDIANA STATE UNIVERSITY                                    ","2003-2004",1,"Baseball",153887,441996,-288109,153887,441996,-288109,0,0,0,"33",".",84032,0
"918",110644,"UNIVERSITY OF CALIFORNIA-DAVIS                              ","2003-2004",1,"Baseball",12979,301360,-288381,12979,301360,-288381,0,0,0,"34",".",79775,0
"11238",225511,"UNIVERSITY OF HOUSTON-UNIVERSITY PARK                       ","2003-2004",22,"Tennis",289,288933,-288644,0,0,0,289,288933,-288644,".","10",0,47263
"788",196088,"SUNY AT BUFFALO                                             ","2003-2004",1,"Baseball",35996,324900,-288904,35996,324900,-288904,0,0,0,"31",".",97658,0
"12657",237969,"WEST VIRGINIA WESLEYAN COLLEGE                              ","2003-2004",25,"Track and Field, X-Country",80288,369462,-289174,40144,222318,-182174,40144,147144,-107000,"34","35",15705,15705
"12472",154590,"WILLIAM PENN UNIVERSITY                                     ","2003-2004",25,"Track and Field, X-Country",21554,310875,-289321,11413,170633,-159220,10141,140242,-130101,"38","30",11400,10140
"9063",199139,"UNIVERSITY OF NORTH CAROLINA AT CHARLOTTE                   ","2003-2004",16,"Softball",3225,292722,-289497,0,0,0,3225,292722,-289497,".","13",0,67590
"4018",130794,"YALE UNIVERSITY                                             ","2003-2004",5,"Fencing",37708,327385,-289677,18854,164813,-145959,18854,162572,-143718,"23","16",27703,25307
"4162",213385,"LAFAYETTE COLLEGE                                           ","2003-2004",6,"Field hocky",51084,341314,-290230,0,0,0,51084,341314,-290230,".","29",0,57289
"14387",199193,"NORTH CAROLINA STATE UNIVERSITY AT RALEIGH                  ","2003-2004",26,"Volleyball",100,290363,-290263,0,0,0,100,290363,-290263,".","15",0,108500
"11083",126818,"COLORADO STATE UNIVERSITY                                   ","2003-2004",22,"Tennis",30022,320704,-290682,0,0,0,30022,320704,-290682,".","8",0,84529
"2115",109785,"AZUSA PACIFIC UNIVERSITY                                    ","2003-2004",2,"Basketball",130612,421723,-291111,87984,251045,-163061,42628,170678,-128050,"14","11",49329,29611
"9526",187985,"UNIVERSITY OF NEW MEXICO-MAIN CAMPUS                        ","2003-2004",16,"Softball",131067,422550,-291483,0,0,0,131067,422550,-291483,".","20",0,116033
"6906",110644,"UNIVERSITY OF CALIFORNIA-DAVIS                              ","2003-2004",13,"Rowing",5745,297382,-291637,0,0,0,5745,297382,-291637,"0","73",0,76394
"5639",220862,"UNIVERSITY OF MEMPHIS                                       ","2003-2004",8,"Golf",29788,321456,-291668,26296,175639,-149343,3492,145817,-142325,"10","5",25998,38809
"14353",225399,"HOUSTON BAPTIST UNIVERSITY                                  ","2003-2004",26,"Volleyball",800,292516,-291716,0,0,0,800,292516,-291716,".","11",0,42559
"10353",153603,"IOWA STATE UNIVERSITY                                       ","2003-2004",18,"Swimming and Diving",206326,498920,-292594,0,0,0,206326,498920,-292594,".","25",0,40553
"8058",221731,"TENNESSEE WESLEYAN COLLEGE                                  ","2003-2004",15,"Soccer",39000,332000,-293000,19500,165000,-145500,19500,167000,-147500,"23","19",8250,8250
"6275",139755,"GEORGIA INSTITUTE OF TECHNOLOGY-MAIN CAMPUS                 ","2003-2004",8,"Golf",393035,686136,-293101,393035,686136,-293101,0,0,0,"6",".",87336,0
"4368",229814,"WEST TEXAS A &amp; M UNIVERSITY                                 ","2003-2004",7,"Football",215865,509166,-293301,215865,509166,-293301,0,0,0,"103",".",109373,0
"10216",191931,"IONA COLLEGE                                                ","2003-2004",18,"Swimming and Diving",11466,304775,-293309,5133,165831,-160698,6333,138944,-132611,"25","24",44726,45249
"584",132602,"BETHUNE COOKMAN COLLEGE                                     ","2003-2004",1,"Baseball",290187,584111,-293924,290187,584111,-293924,0,0,0,"25",".",215334,0
"17265",126580,"UNIVERSITY OF COLORADO AT COLORADO SPRINGS                  ","2003-2004",39,"Total Participants",426638,720786,-294148,170895,336757,-165862,255743,384029,-128286,"80","74",236628,286313
"15490",188182,"COLLEGE OF THE SOUTHWEST                                    ","2003-2004",39,"Total Participants",6,294215,-294209,3,161195,-161192,3,133020,-133017,"51","36",87475,76310
"636",216597,"VILLANOVA UNIVERSITY                                        ","2003-2004",1,"Baseball",68758,362978,-294220,68758,362978,-294220,0,0,0,"33",".",84158,0
"5066",173328,"CONCORDIA UNIVERSITY-ST PAUL                                ","2003-2004",7,"Football",409045,703286,-294241,409045,703286,-294241,0,0,0,"106",".",202486,0
"587",232982,"OLD DOMINION UNIVERSITY                                     ","2003-2004",1,"Baseball",125776,420177,-294401,125776,420177,-294401,0,0,0,"29",".",81292,0
"13109",221847,"TENNESSEE TECHNOLOGICAL UNIVERSITY                          ","2003-2004",26,"Volleyball",12913,307619,-294706,0,0,0,12913,307619,-294706,".","11",0,24189
"5676",150136,"BALL STATE UNIVERSITY                                       ","2003-2004",8,"Golf",33079,328240,-295161,20300,149157,-128857,12779,179083,-166304,"12","11",38315,33213
"10070",130794,"YALE UNIVERSITY                                             ","2003-2004",17,"Squash",188430,484211,-295781,94215,252695,-158480,94215,231516,-137301,"19","16",37136,47705
"12767",174066,"UNIVERSITY OF MINNESOTA-TWIN CITIES                         ","2003-2004",25,"Track and Field, X-Country",8108,303962,-295854,2118,152337,-150219,5990,151625,-145635,"17","27",40884,41291
"6378",199193,"NORTH CAROLINA STATE UNIVERSITY AT RALEIGH                  ","2003-2004",9,"Gymnastics",15000,312183,-297183,0,0,0,15000,312183,-297183,".","21",0,113500
"11755",199120,"UNIVERSITY OF NORTH CAROLINA AT CHAPEL HILL                 ","2003-2004",22,"Tennis",320665,617936,-297271,133915,283358,-149443,186750,334578,-147828,"14","9",41947,54002
"3545",207324,"OKLAHOMA CHRISTIAN UNIVERSITY                               ","2003-2004",3,"All Track Combined",465,298756,-298291,295,149378,-149083,170,149378,-149208,"25","20",19630,19630
"9639",154095,"UNIVERSITY OF NORTHERN IOWA                                 ","2003-2004",16,"Softball",54888,353436,-298548,0,0,0,54888,353436,-298548,".","16",0,74525
"10762",236939,"WASHINGTON STATE UNIVERSITY                                 ","2003-2004",22,"Tennis",134877,433769,-298892,0,0,0,134877,433769,-298892,".","8",0,130044
"4370",174783,"SAINT CLOUD STATE UNIVERSITY                                ","2003-2004",7,"Football",384219,683240,-299021,384219,683240,-299021,0,0,0,"110",".",138133,0
"14114",110361,"CALIFORNIA BAPTIST UNIVERSITY                               ","2003-2004",26,"Volleyball",5529,304614,-299085,2060,159922,-157862,3469,144692,-141223,"14","10",29250,11311
"2020",222831,"ANGELO STATE UNIVERSITY                                     ","2003-2004",2,"Basketball",75237,374403,-299166,36009,191484,-155475,39228,182919,-143691,"15","16",33238,46321
"10473",206622,"XAVIER UNIVERSITY                                           ","2003-2004",19,"Swimming",3986,303710,-299724,2993,107352,-104359,993,196358,-195365,"19","22",29267,48349
"15557",147679,"NORTH PARK UNIVERSITY                                       ","2003-2004",39,"Total Participants",247698,547636,-299938,82736,227861,-145125,164962,319775,-154813,"200","121",200821,177327
"3419",152099,"OAKLAND CITY UNIVERSITY                                     ","2003-2004",2,"Basketball",65792,365804,-300012,38602,174172,-135570,27190,191632,-164442,"16","16",22212,20990
"4485",159993,"UNIVERSITY OF LOUISIANA AT MONROE                           ","2003-2004",7,"Football",1796303,2096641,-300338,1796303,2096641,-300338,0,0,0,"86",".",425195,0
"6798",232982,"OLD DOMINION UNIVERSITY                                     ","2003-2004",11,"Lacrosse",14259,315463,-301204,0,0,0,14259,315463,-301204,".","33",0,42014
"7842",183044,"UNIVERSITY OF NEW HAMPSHIRE-MAIN CAMPUS                     ","2003-2004",15,"Soccer",464558,765960,-301402,136032,267215,-131183,328526,498745,-170219,"29","24",96627,77120
"5204",132903,"UNIVERSITY OF CENTRAL FLORIDA                               ","2003-2004",8,"Golf",78460,379949,-301489,30210,207565,-177355,48250,172384,-124134,"9","6",48015,41331
"431",208488,"CONCORDIA UNIVERSITY                                        ","2003-2004",1,"Baseball",47631,349234,-301603,47631,349234,-301603,0,0,0,"31",".",34236,0
"1909",198543,"FAYETTEVILLE STATE UNIVERSITY                               ","2003-2004",2,"Basketball",46038,347726,-301688,30692,192181,-161489,15346,155545,-140199,"17","15",124569,136274
"4500",217721,"BENEDICT COLLEGE                                            ","2003-2004",7,"Football",306968,609001,-302033,306968,609001,-302033,0,0,0,"93",".",114001,0
"10147",110608,"CALIFORNIA STATE UNIVERSITY-NORTHRIDGE                      ","2003-2004",18,"Swimming and Diving",2210,304321,-302111,1105,86112,-85007,1105,218209,-217104,"15","22",20561,32995
"2203",145813,"ILLINOIS STATE UNIVERSITY                                   ","2003-2004",2,"Basketball",1237589,1539778,-302189,1103440,946723,156717,134149,593055,-458906,"16","16",207323,97965
"1198",153658,"UNIVERSITY OF IOWA                                          ","2003-2004",1,"Baseball",38739,341449,-302710,38739,341449,-302710,0,0,0,"47",".",148530,0
"4002",214777,"PENNSYLVANIA STATE UNIVERSITY-MAIN CAMPUS                   ","2003-2004",5,"Fencing",205441,509048,-303607,88336,233407,-145071,117105,275641,-158536,"18","21",46312,55377
"9236",207971,"UNIVERSITY OF TULSA                                         ","2003-2004",16,"Softball",294086,597877,-303791,0,0,0,294086,597877,-303791,".","16",0,124094
"6070",106458,"ARKANSAS STATE UNIVERSITY-MAIN CAMPUS                       ","2003-2004",8,"Golf",10985,314998,-304013,5000,138954,-133954,5985,176044,-170059,"10","9",56840,66004
"4081",231624,"COLLEGE OF WILLIAM AND MARY                                 ","2003-2004",6,"Field hocky",37181,341635,-304454,0,0,0,37181,341635,-304454,".","24",0,42852
"3808",133669,"FLORIDA ATLANTIC UNIVERSITY-BOCA RATON                      ","2003-2004",3,"All Track Combined",288,304856,-304568,26,23434,-23408,262,281422,-281160,"4","47",7537,51468
"13420",106458,"ARKANSAS STATE UNIVERSITY-MAIN CAMPUS                       ","2003-2004",26,"Volleyball",2681,307379,-304698,0,0,0,2681,307379,-304698,".","13",0,76757
"16763",221838,"TENNESSEE STATE UNIVERSITY                                  ","2003-2004",39,"Total Participants",758070,1062899,-304829,208440,294448,-86008,549630,768451,-218821,"137","81",399324,257423
"4815",228796,"THE UNIVERSITY OF TEXAS AT EL PASO                          ","2003-2004",7,"Football",3526517,3831545,-305028,3526517,3831545,-305028,0,0,0,"110",".",777375,0
"8568",196413,"SYRACUSE UNIVERSITY                                         ","2003-2004",16,"Softball",606718,912489,-305771,0,0,0,606718,912489,-305771,".","21",0,144578
"2845",131469,"GEORGE WASHINGTON UNIVERSITY                                ","2003-2004",2,"Basketball",3861164,4166999,-305835,2024950,2208925,-183975,1836214,1958074,-121860,"16","15",351131,299337
"14446",133669,"FLORIDA ATLANTIC UNIVERSITY-BOCA RATON                      ","2003-2004",26,"Volleyball",2700,309163,-306463,0,0,0,2700,309163,-306463,".","16",0,46189
"157",219602,"AUSTIN PEAY STATE UNIVERSITY                                ","2003-2004",1,"Baseball",8222,314750,-306528,8222,314750,-306528,0,0,0,"30",".",47273,0
"4805",179557,"SOUTHEAST MISSOURI STATE UNIVERSITY                         ","2003-2004",7,"Football",1114455,1421619,-307164,1114455,1421619,-307164,0,0,0,"95",".",111508,0
"2668",185828,"NEW JERSEY INSTITUTE OF TECHNOLOGY                          ","2003-2004",2,"Basketball",68246,375426,-307180,36112,187089,-150977,32134,188337,-156203,"14","13",36112,32134
"11733",110556,"CALIFORNIA STATE UNIVERSITY-FRESNO                          ","2003-2004",22,"Tennis",197691,505137,-307446,75509,226614,-151105,122182,278523,-156341,"9","16",53199,57509
"5720",179964,"WILLIAM WOODS UNIVERSITY                                    ","2003-2004",8,"Golf",26064,333575,-307511,12132,199600,-187468,13932,133975,-120043,"13","9",6882,8682
"12566",132903,"UNIVERSITY OF CENTRAL FLORIDA                               ","2003-2004",25,"Track and Field, X-Country",41084,348936,-307852,80,171187,-171107,41004,177749,-136745,"9","24",13967,27706
"12003",196060,"SUNY AT ALBANY                                              ","2003-2004",24,"Track and Field, Outdoor",6393,314498,-308105,3366,158122,-154756,3027,156376,-153349,"39","46",52710,57418
"8410",227216,"UNIVERSITY OF NORTH TEXAS                                   ","2003-2004",15,"Soccer",0,308368,-308368,0,0,0,0,308368,-308368,".","25",0,63717
"12238",109785,"AZUSA PACIFIC UNIVERSITY                                    ","2003-2004",25,"Track and Field, X-Country",86859,395504,-308645,46475,206033,-159558,40384,189471,-149087,"36","22",32292,27167
"9331",110705,"UNIVERSITY OF CALIFORNIA-SANTA BARBARA                      ","2003-2004",16,"Softball",28927,337767,-308840,0,0,0,28927,337767,-308840,".","20",0,80139
"4129",150136,"BALL STATE UNIVERSITY                                       ","2003-2004",6,"Field hocky",2220,311161,-308941,0,0,0,2220,311161,-308941,".","17",0,33951
"6961",157289,"UNIVERSITY OF LOUISVILLE                                    ","2003-2004",13,"Rowing",65605,374636,-309031,0,0,0,65605,374636,-309031,".","60",0,118730
"15476",229018,"THE UNIVERSITY OF TEXAS OF THE PERMIAN BASIN                ","2003-2004",39,"Total Participants",3005,312558,-309553,2,102893,-102891,3003,209665,-206662,"61","78",78600,128910
"4441",228246,"SOUTHERN METHODIST UNIVERSITY                               ","2003-2004",7,"Football",9057201,9366801,-309600,9057201,9366801,-309600,0,0,0,"111",".",908611,0
"16248",216807,"WESTMINSTER COLLEGE                                         ","2003-2004",39,"Total Participants",374161,683774,-309613,172868,308828,-135960,201293,374946,-173653,"228","139",132479,97733
"15292",110556,"CALIFORNIA STATE UNIVERSITY-FRESNO                          ","2003-2004",34,"Equestrian",191734,501383,-309649,0,0,0,191734,501383,-309649,".","104",0,192129
"16613",152336,"UNIVERSITY OF SAINT FRANCIS-FT WAYNE                        ","2003-2004",39,"Total Participants",129383,439390,-310007,56450,218492,-162042,72933,220898,-147965,"256","111",226343,101471
"5082",233897,"THE UNIVERSITY OF VIRGINIA'S COLLEGE AT WISE                ","2003-2004",7,"Football",143573,453668,-310095,143573,453668,-310095,0,0,0,"72",".",234069,0
"3584",175342,"ALCORN STATE UNIVERSITY                                     ","2003-2004",3,"All Track Combined",11656,321974,-310318,5642,158121,-152479,6014,163853,-157839,"22","25",24447,24447
"11912",196060,"SUNY AT ALBANY                                              ","2003-2004",23,"Track and Field, Indoor",4783,315322,-310539,2561,161047,-158486,2222,154275,-152053,"46","43",55617,55299
"15049",154095,"UNIVERSITY OF NORTHERN IOWA                                 ","2003-2004",28,"Wrestling",48624,359170,-310546,48624,359170,-310546,0,0,0,"33",".",53436,0
"4206",232982,"OLD DOMINION UNIVERSITY                                     ","2003-2004",6,"Field hocky",209752,520681,-310929,0,0,0,209752,520681,-310929,".","24",0,56342
"14901",243780,"PURDUE UNIVERSITY-MAIN CAMPUS                               ","2003-2004",28,"Wrestling",235595,546625,-311030,235595,546625,-311030,0,0,0,"27",".",112878,0
"756",159647,"LOUISIANA TECH UNIVERSITY                                   ","2003-2004",1,"Baseball",178633,489696,-311063,178633,489696,-311063,0,0,0,"46",".",228849,0
"1293",133669,"FLORIDA ATLANTIC UNIVERSITY-BOCA RATON                      ","2003-2004",1,"Baseball",75776,386864,-311088,75776,386864,-311088,0,0,0,"39",".",132309,0
"6320",231624,"COLLEGE OF WILLIAM AND MARY                                 ","2003-2004",9,"Gymnastics",47521,358754,-311233,47520,115808,-68288,1,242946,-242945,"18","19",30699,24763
"11377",132903,"UNIVERSITY OF CENTRAL FLORIDA                               ","2003-2004",22,"Tennis",148635,460435,-311800,51858,202791,-150933,96777,257644,-160867,"8","8",41136,38678
"1863",226019,"KILGORE COLLEGE                                             ","2003-2004",2,"Basketball",6393,318301,-311908,3028,167942,-164914,3365,150359,-146994,"13","11",41701,29556
"5111",156125,"WICHITA STATE UNIVERSITY                                    ","2003-2004",8,"Golf",51100,363014,-311914,40300,204558,-164258,10800,158456,-147656,"10","9",78106,44987
"8280",220516,"KING COLLEGE                                                ","2003-2004",15,"Soccer",51163,363130,-311967,34134,223625,-189491,17029,139505,-122476,"21","16",12476,10335
"4856",191931,"IONA COLLEGE                                                ","2003-2004",7,"Football",28123,340100,-311977,28123,340100,-311977,0,0,0,"122",".",144224,0
"13978",128771,"CENTRAL CONNECTICUT STATE UNIVERSITY                        ","2003-2004",26,"Volleyball",2987,315275,-312288,0,0,0,2987,315275,-312288,".","15",0,32122
"6918",129020,"UNIVERSITY OF CONNECTICUT                                   ","2003-2004",13,"Rowing",1,312547,-312546,0,0,0,1,312547,-312546,".","90",0,182240
"3610",164988,"BOSTON UNIVERSITY                                           ","2003-2004",3,"All Track Combined",83654,396625,-312971,28848,203543,-174695,54806,193082,-138276,"100","105",63778,59762
"2345",215132,"UNIVERSITY OF THE SCIENCES IN PHILADELPHIA                  ","2003-2004",2,"Basketball",2,313138,-313136,1,154823,-154822,1,158315,-158314,"14","16",12800,15500
"3932",209807,"PORTLAND STATE UNIVERSITY                                   ","2003-2004",3,"All Track Combined",156049,469218,-313169,46016,170070,-124054,110033,299148,-189115,"20","31",53960,55663
"1649",195243,"SAINT THOMAS AQUINAS COLLEGE                                ","2003-2004",2,"Basketball",62908,376388,-313480,28666,184596,-155930,34242,191792,-157550,"13","14",31006,38825
"14946",207500,"UNIVERSITY OF OKLAHOMA NORMAN CAMPUS                        ","2003-2004",28,"Wrestling",64040,377783,-313743,64040,377783,-313743,0,0,0,"35",".",91287,0
"4020",147767,"NORTHWESTERN UNIVERSITY                                     ","2003-2004",5,"Fencing",12112,325899,-313787,0,0,0,12112,325899,-313787,".","23",0,82031
"15976",138716,"ALBANY STATE UNIVERSITY                                     ","2003-2004",39,"Total Participants",218220,532415,-314195,92143,194862,-102719,126077,337553,-211476,"158","83",369435,162523
"3622",180489,"THE UNIVERSITY OF MONTANA-MISSOULA                          ","2003-2004",3,"All Track Combined",309615,623857,-314242,143881,295036,-151155,165734,328821,-163087,"56","40",52473,52473
"17144",154925,"COFFEYVILLE COMMUNITY COLLEGE &amp; AREA TECH SCHOOL            ","2003-2004",39,"Total Participants",26200,340538,-314338,11896,168028,-156132,14304,172510,-158206,"203","48",80604,42839
"13975",151324,"INDIANA STATE UNIVERSITY                                    ","2003-2004",26,"Volleyball",79597,394480,-314883,0,0,0,79597,394480,-314883,".","15",0,50075
"14508",227216,"UNIVERSITY OF NORTH TEXAS                                   ","2003-2004",26,"Volleyball",0,314990,-314990,0,0,0,0,314990,-314990,".","15",0,87726
"404",154590,"WILLIAM PENN UNIVERSITY                                     ","2003-2004",1,"Baseball",47896,363227,-315331,47896,363227,-315331,0,0,0,"51",".",46767,0
"16565",155937,"STERLING COLLEGE                                            ","2003-2004",39,"Total Participants",7343,322770,-315427,6506,164811,-158305,837,157959,-157122,"141","94",500513,226909
"15021",217864,"CITADEL MILITARY COLLEGE OF SOUTH CAROLINA                  ","2003-2004",28,"Wrestling",8650,324135,-315485,8650,324135,-315485,0,0,0,"25",".",75180,0
"11034",207971,"UNIVERSITY OF TULSA                                         ","2003-2004",22,"Tennis",555106,871273,-316167,337072,460355,-123283,218034,410918,-192884,"10","8",86399,64124
"4425",109785,"AZUSA PACIFIC UNIVERSITY                                    ","2003-2004",7,"Football",204171,520518,-316347,204171,520518,-316347,0,0,0,"98",".",126999,0
"1128",196060,"SUNY AT ALBANY                                              ","2003-2004",1,"Baseball",6662,323035,-316373,6662,323035,-316373,0,0,0,"32",".",104958,0
"12313",178615,"TRUMAN STATE UNIVERSITY                                     ","2003-2004",25,"Track and Field, X-Country",10675,327402,-316727,3584,139739,-136155,7091,187663,-180572,"75","61",32326,42302
"7134",217907,"COKER COLLEGE                                               ","2003-2004",15,"Soccer",28945,345977,-317032,14322,191637,-177315,14623,154340,-139717,"19","14",14404,17183
"1168",221731,"TENNESSEE WESLEYAN COLLEGE                                  ","2003-2004",1,"Baseball",38000,355500,-317500,38000,355500,-317500,0,0,0,"47",".",18500,0
"4663",153825,"LORAS COLLEGE                                               ","2003-2004",7,"Football",2348,320093,-317745,2348,320093,-317745,0,0,0,"102",".",65982,0
"6779",217165,"BRYANT COLLEGE                                              ","2003-2004",11,"Lacrosse",99774,417595,-317821,67499,283439,-215940,32275,134156,-101881,"38","17",70148,42160
"6456",130794,"YALE UNIVERSITY                                             ","2003-2004",10,"Ice Hockey",699234,1017473,-318239,564385,698611,-134226,134849,318862,-184013,"28","21",220201,80616
"10178",179566,"SOUTHWEST MISSOURI STATE UNIVERSITY                         ","2003-2004",18,"Swimming and Diving",222919,541236,-318317,110170,264101,-153931,112749,277135,-164386,"24","35",27408,26182
"4962",180948,"CHADRON STATE COLLEGE                                       ","2003-2004",7,"Football",299421,618318,-318897,299421,618318,-318897,0,0,0,"116",".",71517,0
"15546",147660,"NORTH CENTRAL COLLEGE                                       ","2003-2004",39,"Total Participants",328999,648464,-319465,186837,373671,-186834,142162,274793,-132631,"357","179",187371,107364
"4470",155025,"EMPORIA STATE UNIVERSITY                                    ","2003-2004",7,"Football",381742,701318,-319576,381742,701318,-319576,0,0,0,"95",".",103514,0
"8462",197197,"WAGNER COLLEGE                                              ","2003-2004",15,"Soccer",33694,353544,-319850,0,0,0,33694,353544,-319850,".","30",0,23863
"11647",105330,"NORTHERN ARIZONA UNIVERSITY                                 ","2003-2004",22,"Tennis",3712,323606,-319894,1856,110731,-108875,1856,212875,-211019,"10","11",35170,80468
"139",198464,"EAST CAROLINA UNIVERSITY                                    ","2003-2004",1,"Baseball",460696,780720,-320024,460696,780720,-320024,0,0,0,"35",".",257208,0
"8587",196060,"SUNY AT ALBANY                                              ","2003-2004",16,"Softball",985,321131,-320146,0,0,0,985,321131,-320146,".","21",0,77183
"3347",160038,"NORTHWESTERN STATE UNIVERSITY OF LOUISIANA                  ","2003-2004",2,"Basketball",552752,872932,-320180,312785,440559,-127774,239967,432373,-192406,"25","17",103613,114400
"10267",129020,"UNIVERSITY OF CONNECTICUT                                   ","2003-2004",18,"Swimming and Diving",110000,430260,-320260,55000,215130,-160130,55000,215130,-160130,"23","31",99974,99974
"17298",187903,"NEW MEXICO JUNIOR COLLEGE                                   ","2003-2004",39,"Total Participants",1300,321571,-320271,700,210348,-209648,600,111223,-110623,"52","27",102976,57024
"4498",226019,"KILGORE COLLEGE                                             ","2003-2004",7,"Football",28823,349587,-320764,28823,349587,-320764,0,0,0,"82",".",90723,0
"16913",218229,"LANDER UNIVERSITY                                           ","2003-2004",39,"Total Participants",443700,764523,-320823,239427,414807,-175380,204273,349716,-145443,"74","71",117693,108686
"10212",145600,"UNIVERSITY OF ILLINOIS AT CHICAGO                           ","2003-2004",18,"Swimming and Diving",18830,339708,-320878,10015,139957,-129942,8815,199751,-190936,"25","21",34528,30199
"7731",183062,"KEENE STATE COLLEGE                                         ","2003-2004",15,"Soccer",512283,833766,-321483,259392,456099,-196707,252891,377667,-124776,"37","25",33320,25588
"718",225399,"HOUSTON BAPTIST UNIVERSITY                                  ","2003-2004",1,"Baseball",800,322480,-321680,800,322480,-321680,0,0,0,"22",".",52947,0
"4841",228981,"TEXAS LUTHERAN UNIVERSITY                                   ","2003-2004",7,"Football",47976,369687,-321711,47976,369687,-321711,0,0,0,"123",".",136308,0
"10886",178396,"UNIVERSITY OF MISSOURI-COLUMBIA                             ","2003-2004",22,"Tennis",571,322501,-321930,0,0,0,571,322501,-321930,".","9",0,42137
"8213",106458,"ARKANSAS STATE UNIVERSITY-MAIN CAMPUS                       ","2003-2004",15,"Soccer",1000,323041,-322041,0,0,0,1000,323041,-322041,".","23",0,103308
"963",197197,"WAGNER COLLEGE                                              ","2003-2004",1,"Baseball",104025,426267,-322242,104025,426267,-322242,0,0,0,"31",".",40797,0
"1964",237969,"WEST VIRGINIA WESLEYAN COLLEGE                              ","2003-2004",2,"Basketball",166520,488820,-322300,101592,226892,-125300,64928,261928,-197000,"11","16",29697,22884
"3298",179539,"STATE FAIR COMMUNITY COLLEGE                                ","2003-2004",2,"Basketball",2542,324851,-322309,1271,168437,-167166,1271,156414,-155143,"12","12",19982,18982
"6123",198419,"DUKE UNIVERSITY                                             ","2003-2004",8,"Golf",11896,334522,-322626,10558,168849,-158291,1338,165673,-164335,"12","6",63184,48082
"16968",207458,"OKLAHOMA CITY UNIVERSITY                                    ","2003-2004",39,"Total Participants",34125,356853,-322728,21502,175357,-153855,12623,181496,-168873,"81","67",156717,156450
"63",237525,"MARSHALL UNIVERSITY                                         ","2003-2004",1,"Baseball",75823,398617,-322794,75823,398617,-322794,0,0,0,"33",".",95535,0
"17171",175935,"MERIDIAN COMMUNITY COLLEGE                                  ","2003-2004",39,"Total Participants",180441,503738,-323297,106502,297461,-190959,73939,206277,-132338,"80","61",178001,110859
"5259",122409,"SAN DIEGO STATE UNIVERSITY                                  ","2003-2004",8,"Golf",271852,596010,-324158,137891,297007,-159116,133961,299003,-165042,"15","13",125291,74293
"11448",207500,"UNIVERSITY OF OKLAHOMA NORMAN CAMPUS                        ","2003-2004",22,"Tennis",7164,331555,-324391,2363,167489,-165126,4801,164066,-159265,"10","16",97138,107795
"8012",176372,"UNIVERSITY OF SOUTHERN MISSISSIPPI                          ","2003-2004",15,"Soccer",54378,378788,-324410,0,0,0,54378,378788,-324410,".","32",0,82969
"17117",213303,"KEYSTONE COLLEGE                                            ","2003-2004",39,"Total Participants",123381,448141,-324760,62300,210560,-148260,61081,237581,-176500,"86","65",84413,80046
"9548",122755,"SAN JOSE STATE UNIVERSITY                                   ","2003-2004",16,"Softball",3367,328245,-324878,0,0,0,3367,328245,-324878,".","21",0,76476
"982",110705,"UNIVERSITY OF CALIFORNIA-SANTA BARBARA                      ","2003-2004",1,"Baseball",71925,397263,-325338,71925,397263,-325338,0,0,0,"35",".",92850,0
"2780",237118,"ALDERSON BROADDUS COLLEGE                                   ","2003-2004",2,"Basketball",47378,372737,-325359,26659,211531,-184872,20719,161206,-140487,"11","12",21944,18988
"12899",147767,"NORTHWESTERN UNIVERSITY                                     ","2003-2004",25,"Track and Field, X-Country",3732,329174,-325442,0,0,0,3732,329174,-325442,".","26",0,60688
"3795",227881,"SAM HOUSTON STATE UNIVERSITY                                ","2003-2004",3,"All Track Combined",91134,416658,-325524,45567,172329,-126762,45567,244329,-198762,"40","35",52618,52618
"5471",153603,"IOWA STATE UNIVERSITY                                       ","2003-2004",8,"Golf",110464,436581,-326117,1,178953,-178952,110463,257628,-147165,"13","9",49329,46838
"1826",152600,"VALPARAISO UNIVERSITY                                       ","2003-2004",2,"Basketball",1961187,2287389,-326202,1334290,1342945,-8655,626897,944444,-317547,"13","16",46142,41137
"15567",155566,"NEOSHO COUNTY COMMUNITY COLLEGE                             ","2003-2004",39,"Total Participants",800,327397,-326597,400,185138,-184738,400,142259,-141859,"140","76",103258,63695
"9530",137351,"UNIVERSITY OF SOUTH FLORIDA                                 ","2003-2004",16,"Softball",142793,469405,-326612,0,0,0,142793,469405,-326612,".","16",0,134612
"6743",233921,"VIRGINIA POLYTECHNIC INSTITUTE AND STATE UNIV               ","2003-2004",11,"Lacrosse",242288,568937,-326649,0,0,0,242288,568937,-326649,".","27",0,57298
"8155",207324,"OKLAHOMA CHRISTIAN UNIVERSITY                               ","2003-2004",15,"Soccer",2000,328790,-326790,1200,165590,-164390,800,163200,-162400,"18","16",16701,18140
"14074",154095,"UNIVERSITY OF NORTHERN IOWA                                 ","2003-2004",26,"Volleyball",82713,409590,-326877,0,0,0,82713,409590,-326877,".","17",0,58755
"10324",232982,"OLD DOMINION UNIVERSITY                                     ","2003-2004",18,"Swimming and Diving",23193,350720,-327527,10924,170814,-159890,12269,179906,-167637,"28","21",29221,27944
"11904",207500,"UNIVERSITY OF OKLAHOMA NORMAN CAMPUS                        ","2003-2004",23,"Track and Field, Indoor",22955,350709,-327754,11452,156693,-145241,11503,194016,-182513,"38","63",56409,72744
"16326",226134,"LAREDO COMMUNITY COLLEGE                                    ","2003-2004",39,"Total Participants",24500,352443,-327943,12000,208159,-196159,12500,144284,-131784,"38","22",104053,79945
"3212",180461,"MONTANA STATE UNIVERSITY-BOZEMAN                            ","2003-2004",2,"Basketball",1614743,1942929,-328186,982159,1174487,-192328,632584,768442,-135858,"14","14",176357,162654
"10370",122409,"SAN DIEGO STATE UNIVERSITY                                  ","2003-2004",18,"Swimming and Diving",127455,456033,-328578,0,0,0,127455,456033,-328578,".","19",0,112741
"16939",102429,"BEVILL STATE COMMUNITY COLLEGE                              ","2003-2004",39,"Total Participants",164751,493505,-328754,86109,237626,-151517,78642,255879,-177237,"71","103",62523,53550
"3593",145813,"ILLINOIS STATE UNIVERSITY                                   ","2003-2004",3,"All Track Combined",200257,529325,-329068,96320,249611,-153291,103937,279714,-175777,"25","30",58217,56586
"1583",164924,"BOSTON COLLEGE                                              ","2003-2004",1,"Baseball",133474,462637,-329163,133474,462637,-329163,0,0,0,"34",".",166439,0
"14384",132903,"UNIVERSITY OF CENTRAL FLORIDA                               ","2003-2004",26,"Volleyball",149537,478763,-329226,0,0,0,149537,478763,-329226,".","12",0,55323
"9857",243780,"PURDUE UNIVERSITY-MAIN CAMPUS                               ","2003-2004",16,"Softball",372687,702772,-330085,0,0,0,372687,702772,-330085,".","20",0,134020
"9353",156620,"EASTERN KENTUCKY UNIVERSITY                                 ","2003-2004",16,"Softball",27777,357982,-330205,0,0,0,27777,357982,-330205,".","22",0,84094
"13553",122409,"SAN DIEGO STATE UNIVERSITY                                  ","2003-2004",26,"Volleyball",215337,545865,-330528,0,0,0,215337,545865,-330528,".","21",0,90577
"4733",196097,"SUNY AT STONY BROOK                                         ","2003-2004",7,"Football",466348,797008,-330660,466348,797008,-330660,0,0,0,"104",".",94204,0
"7084",142115,"BOISE STATE UNIVERSITY                                      ","2003-2004",15,"Soccer",43363,374605,-331242,0,0,0,43363,374605,-331242,".","21",0,80021
"579",223232,"BAYLOR UNIVERSITY                                           ","2003-2004",1,"Baseball",1312443,1643951,-331508,1312443,1643951,-331508,0,0,0,"43",".",406868,0
"14192",142276,"IDAHO STATE UNIVERSITY                                      ","2003-2004",26,"Volleyball",73411,405045,-331634,0,0,0,73411,405045,-331634,".","12",0,116124
"510",106458,"ARKANSAS STATE UNIVERSITY-MAIN CAMPUS                       ","2003-2004",1,"Baseball",32632,364363,-331731,32632,364363,-331731,0,0,0,"35",".",134631,0
"2247",100830,"AUBURN UNIVERSITY-MONTGOMERY                                ","2003-2004",2,"Basketball",93188,424994,-331806,52353,236535,-184182,40835,188459,-147624,"14","11",26191,26191
"7401",120184,"NOTRE DAME DE NAMUR UNIVERSITY                              ","2003-2004",15,"Soccer",192609,524704,-332095,92743,246286,-153543,99866,278418,-178552,"21","23",66297,72658
"11585",110635,"UNIVERSITY OF CALIFORNIA-BERKELEY                           ","2003-2004",22,"Tennis",475905,808470,-332565,206954,382399,-175445,268951,426071,-157120,"10","9",106031,112280
"2083",123572,"SONOMA STATE UNIVERSITY                                     ","2003-2004",2,"Basketball",73419,406327,-332908,50262,230548,-180286,23157,175779,-152622,"16","20",39491,38141
"3729",139940,"GEORGIA STATE UNIVERSITY                                    ","2003-2004",3,"All Track Combined",6648,339750,-333102,6548,158300,-151752,100,181450,-181350,"20","29",15984,31600
"151",238032,"WEST VIRGINIA UNIVERSITY                                    ","2003-2004",1,"Baseball",87315,420832,-333517,87315,420832,-333517,0,0,0,"36",".",101245,0
"8533",225399,"HOUSTON BAPTIST UNIVERSITY                                  ","2003-2004",16,"Softball",1,333593,-333592,0,0,0,1,333593,-333592,".","13",0,39426
"11989",207500,"UNIVERSITY OF OKLAHOMA NORMAN CAMPUS                        ","2003-2004",24,"Track and Field, Outdoor",40194,373816,-333622,20352,174372,-154020,19842,199444,-179602,"35","55",51970,63508
"4938",234827,"CENTRAL WASHINGTON UNIVERSITY                               ","2003-2004",7,"Football",221563,555505,-333942,221563,555505,-333942,0,0,0,"88",".",143677,0
"12219",198419,"DUKE UNIVERSITY                                             ","2003-2004",25,"Track and Field, X-Country",51110,385236,-334126,41878,214056,-172178,9232,171180,-161948,"50","46",129096,112414
"1666",156365,"CAMPBELLSVILLE UNIVERSITY                                   ","2003-2004",2,"Basketball",109010,443257,-334247,60845,257981,-197136,48165,185276,-137111,"24","13",49449,40301
"8314",198215,"CATAWBA COLLEGE                                             ","2003-2004",15,"Soccer",61635,395948,-334313,31175,207753,-176578,30460,188195,-157735,"24","22",24510,24510
"13367",188030,"NEW MEXICO STATE UNIVERSITY-MAIN CAMPUS                     ","2003-2004",26,"Volleyball",108500,442968,-334468,0,0,0,108500,442968,-334468,".","19",0,110152
"6350",203517,"KENT STATE UNIVERSITY-MAIN CAMPUS                           ","2003-2004",9,"Gymnastics",10254,345045,-334791,0,0,0,10254,345045,-334791,"0","16",0,45944
"6371",230728,"UTAH STATE UNIVERSITY                                       ","2003-2004",9,"Gymnastics",24174,359099,-334925,0,0,0,24174,359099,-334925,".","15",0,68370
"14850",178396,"UNIVERSITY OF MISSOURI-COLUMBIA                             ","2003-2004",28,"Wrestling",141982,477125,-335143,141982,477125,-335143,0,0,0,"34",".",94009,0
"15945",213507,"LEBANON VALLEY COLLEGE                                      ","2003-2004",39,"Total Participants",247439,582711,-335272,151896,317285,-165389,95543,265426,-169883,"259","192",250951,86127
"16555",224226,"DALLAS BAPTIST UNIVERSITY                                   ","2003-2004",39,"Total Participants",1086041,1421412,-335371,804917,1000648,-195731,281124,420764,-139640,"140","82",375727,101464
"3151",198808,"LEES-MCRAE COLLEGE                                          ","2003-2004",2,"Basketball",79839,415415,-335576,44906,221791,-176885,34933,193624,-158691,"17","20",38204,29661
"13128",217819,"COLLEGE OF CHARLESTON                                       ","2003-2004",26,"Volleyball",7796,343441,-335645,0,0,0,7796,343441,-335645,".","16",0,50509
"14623",137351,"UNIVERSITY OF SOUTH FLORIDA                                 ","2003-2004",26,"Volleyball",52361,388243,-335882,0,0,0,52361,388243,-335882,".","14",0,99296
"8408",229115,"TEXAS TECH UNIVERSITY                                       ","2003-2004",15,"Soccer",58700,394824,-336124,0,0,0,58700,394824,-336124,".","22",0,81922
"8513",154590,"WILLIAM PENN UNIVERSITY                                     ","2003-2004",15,"Soccer",33137,369285,-336148,18022,176736,-158714,15115,192549,-177434,"32","25",18016,14525
"7501",221847,"TENNESSEE TECHNOLOGICAL UNIVERSITY                          ","2003-2004",15,"Soccer",24767,361241,-336474,0,0,0,24767,361241,-336474,".","24",0,50519
"5588",214777,"PENNSYLVANIA STATE UNIVERSITY-MAIN CAMPUS                   ","2003-2004",8,"Golf",204247,540993,-336746,75336,253354,-178018,128911,287639,-158728,"12","15",57645,47603
"15430",228705,"TEXAS A &amp; M UNIVERSITY-KINGSVILLE                           ","2003-2004",39,"Total Participants",119378,456245,-336867,57889,194700,-136811,61489,261545,-200056,"134","69",563610,281869
"7421",150136,"BALL STATE UNIVERSITY                                       ","2003-2004",15,"Soccer",10473,347582,-337109,0,0,0,10473,347582,-337109,".","24",0,34973
"4890",234164,"VIRGINIA UNION UNIVERSITY                                   ","2003-2004",7,"Football",553148,890291,-337143,553148,890291,-337143,0,0,0,"70",".",46902,0
"4166",217402,"PROVIDENCE COLLEGE                                          ","2003-2004",6,"Field hocky",5955,343108,-337153,0,0,0,5955,343108,-337153,".","20",0,40350
"14994",181011,"DANA COLLEGE                                                ","2003-2004",28,"Wrestling",9300,346650,-337350,9300,346650,-337350,0,0,0,"47",".",21794,0
"1875",110495,"CALIFORNIA STATE UNIVERSITY-STANISLAUS                      ","2003-2004",2,"Basketball",121007,458362,-337355,90107,204606,-114499,30900,253756,-222856,"14","15",41293,60492
"502",147703,"NORTHERN ILLINOIS UNIVERSITY                                ","2003-2004",1,"Baseball",78875,417031,-338156,78875,417031,-338156,0,0,0,"35",".",120569,0
"116",160658,"UNIVERSITY OF LOUISIANA AT LAFAYETTE                        ","2003-2004",1,"Baseball",191083,529521,-338438,191083,529521,-338438,0,0,0,"34",".",119710,0
"15810",108092,"UNIVERSITY OF ARKANSAS AT FT SMITH                          ","2003-2004",39,"Total Participants",35691,374211,-338520,29854,254871,-225017,5837,119340,-113503,"38","25",64805,61355
"7191",151102,"INDIANA UNIVERSITY-PURDUE UNIVERSITY-FORT WAYNE             ","2003-2004",15,"Soccer",49455,388384,-338929,40796,189756,-148960,8659,198628,-189969,"24","21",60160,48388
"169",219709,"BELMONT UNIVERSITY                                          ","2003-2004",1,"Baseball",88395,427392,-338997,88395,427392,-338997,0,0,0,"36",".",64346,0
"15531",168421,"WORCESTER POLYTECHNIC INSTITUTE                             ","2003-2004",39,"Total Participants",204276,543599,-339323,109634,304824,-195190,94642,238775,-144133,"383","168",198698,118927
"652",200800,"UNIVERSITY OF AKRON MAIN CAMPUS                             ","2003-2004",1,"Baseball",13719,353957,-340238,13719,353957,-340238,0,0,0,"27",".",88030,0
"15275",155399,"KANSAS STATE UNIVERSITY                                     ","2003-2004",34,"Equestrian",80480,420833,-340353,0,0,0,80480,420833,-340353,".","74",0,162782
"5402",220075,"EAST TENNESSEE STATE UNIVERSITY                             ","2003-2004",8,"Golf",2,340373,-340371,1,206050,-206049,1,134323,-134322,"8","8",9770,17090
"16506",219259,"NORTHERN STATE UNIVERSITY                                   ","2003-2004",39,"Total Participants",208754,550298,-341544,80685,199966,-119281,128069,350332,-222263,"237","131",141697,97541
"8120",122931,"SANTA CLARA UNIVERSITY                                      ","2003-2004",15,"Soccer",1238095,1579810,-341715,592530,654832,-62302,645565,924978,-279413,"32","25",61104,57308
"1426",199120,"UNIVERSITY OF NORTH CAROLINA AT CHAPEL HILL                 ","2003-2004",1,"Baseball",295306,637039,-341733,295306,637039,-341733,0,0,0,"35",".",144503,0
"4287",243744,"STANFORD UNIVERSITY                                         ","2003-2004",7,"Football",9920845,10262787,-341942,9920845,10262787,-341942,0,0,0,"95",".",1000803,0
"6908",201885,"UNIVERSITY OF CINCINNATI-MAIN CAMPUS                        ","2003-2004",13,"Rowing",240971,583035,-342064,0,0,0,240971,583035,-342064,".","62",0,92675
"2232",219000,"AUGUSTANA COLLEGE                                           ","2003-2004",2,"Basketball",345203,687284,-342081,199453,387938,-188485,145750,299346,-153596,"18","14",70257,48937
"3626",230038,"BRIGHAM YOUNG UNIVERSITY                                    ","2003-2004",3,"All Track Combined",1420569,1763489,-342920,571262,699747,-128485,849307,1063742,-214435,"121","152",202935,366628
"2180",141264,"VALDOSTA STATE UNIVERSITY                                   ","2003-2004",2,"Basketball",174760,518002,-343242,92874,275890,-183016,81886,242112,-160226,"15","12",55396,37519
"13546",156620,"EASTERN KENTUCKY UNIVERSITY                                 ","2003-2004",26,"Volleyball",14997,358631,-343634,0,0,0,14997,358631,-343634,".","16",0,70028
"14288",145637,"UNIVERSITY OF ILLINOIS AT URBANA-CHAMPAIGN                  ","2003-2004",26,"Volleyball",518024,861825,-343801,0,0,0,518024,861825,-343801,".","16",0,176642
"9426",223427,"BLINN COLLEGE                                               ","2003-2004",16,"Softball",5554,349532,-343978,0,0,0,5554,349532,-343978,".","13",0,35462
"13292",198464,"EAST CAROLINA UNIVERSITY                                    ","2003-2004",26,"Volleyball",10470,354599,-344129,0,0,0,10470,354599,-344129,".","14",0,69097
"204",145637,"UNIVERSITY OF ILLINOIS AT URBANA-CHAMPAIGN                  ","2003-2004",1,"Baseball",422148,766431,-344283,422148,766431,-344283,0,0,0,"43",".",204173,0
"4552",240189,"UNIVERSITY OF WISCONSIN-WHITEWATER                          ","2003-2004",7,"Football",180039,524490,-344451,180039,524490,-344451,0,0,0,"100",".",70118,0
"8150",105330,"NORTHERN ARIZONA UNIVERSITY                                 ","2003-2004",15,"Soccer",33591,378255,-344664,0,0,0,33591,378255,-344664,".","26",0,147070
"15207",181464,"UNIVERSITY OF NEBRASKA AT LINCOLN                           ","2003-2004",33,"Bowling",30018,375376,-345358,0,0,0,30018,375376,-345358,".","15",0,44902
"16491",236452,"SAINT MARTINS COLLEGE                                       ","2003-2004",39,"Total Participants",157618,503176,-345558,88159,258678,-170519,69459,244498,-175039,"65","54",108817,109924
"7449",217864,"CITADEL MILITARY COLLEGE OF SOUTH CAROLINA                  ","2003-2004",15,"Soccer",195,346146,-345951,0,0,0,195,346146,-345951,".","19",0,37010
"9025",181002,"CREIGHTON UNIVERSITY                                        ","2003-2004",16,"Softball",59203,405169,-345966,0,0,0,59203,405169,-345966,".","21",0,59875
"16507",172334,"SPRING ARBOR UNIVERSITY                                     ","2003-2004",39,"Total Participants",133570,479754,-346184,66785,241059,-174274,66785,238695,-171910,"80","83",88915,85075
"6311",186380,"RUTGERS UNIVERSITY-NEW BRUNSWICK                            ","2003-2004",9,"Gymnastics",21802,368337,-346535,0,0,0,21802,368337,-346535,".","25",0,87321
"203",151290,"INDIANA INSTITUTE OF TECHNOLOGY                             ","2003-2004",1,"Baseball",5283,352269,-346986,5283,352269,-346986,0,0,0,"55",".",78495,0
"5038",152336,"UNIVERSITY OF SAINT FRANCIS-FT WAYNE                        ","2003-2004",7,"Football",117000,464106,-347106,117000,464106,-347106,0,0,0,"142",".",141110,0
"6250",187985,"UNIVERSITY OF NEW MEXICO-MAIN CAMPUS                        ","2003-2004",8,"Golf",149819,496961,-347142,72308,246034,-173726,77511,250927,-173416,"16","9",82949,63262
"6369",142115,"BOISE STATE UNIVERSITY                                      ","2003-2004",9,"Gymnastics",35594,382997,-347403,0,0,0,35594,382997,-347403,".","16",0,50117
"2823",123651,"VANGUARD UNIVERSITY OF SOUTHERN CALIFORNIA                  ","2003-2004",2,"Basketball",144519,491930,-347411,94517,270781,-176264,50002,221149,-171147,"13","9",18065,18160
"11784",179159,"SAINT LOUIS UNIVERSITY-MAIN CAMPUS                          ","2003-2004",22,"Tennis",7134,354698,-347564,3567,136184,-132617,3567,218514,-214947,"7","7",25371,22337
"10738",199139,"UNIVERSITY OF NORTH CAROLINA AT CHARLOTTE                   ","2003-2004",22,"Tennis",5802,353570,-347768,5000,140918,-135918,802,212652,-211850,"9","10",32451,36447
"11057",196088,"SUNY AT BUFFALO                                             ","2003-2004",22,"Tennis",2,348114,-348112,1,138953,-138952,1,209161,-209160,"12","9",39683,38269
"8729",172699,"WESTERN MICHIGAN UNIVERSITY                                 ","2003-2004",16,"Softball",28379,376664,-348285,0,0,0,28379,376664,-348285,".","20",0,90966
"16014",113573,"COLLEGE OF THE DESERT                                       ","2003-2004",39,"Total Participants",33749,382040,-348291,22865,178130,-155265,10884,203910,-193026,"175","82",100780,69777
"5781",176372,"UNIVERSITY OF SOUTHERN MISSISSIPPI                          ","2003-2004",8,"Golf",29426,377872,-348446,26295,188728,-162433,3131,189144,-186013,"11","9",32612,33439
"11274",155317,"UNIVERSITY OF KANSAS MAIN CAMPUS                            ","2003-2004",22,"Tennis",6000,355409,-349409,0,0,0,6000,355409,-349409,".","9",0,86911
"5324",155399,"KANSAS STATE UNIVERSITY                                     ","2003-2004",8,"Golf",172502,522290,-349788,82948,262044,-179096,89554,260246,-170692,"11","9",81304,62016
"15000",238032,"WEST VIRGINIA UNIVERSITY                                    ","2003-2004",28,"Wrestling",162703,512612,-349909,162703,512612,-349909,0,0,0,"44",".",82287,0
"7081",198136,"CAMPBELL UNIVERSITY INC                                     ","2003-2004",15,"Soccer",381608,731709,-350101,174371,348732,-174361,207237,382977,-175740,"25","26",84695,78757
"11262",147703,"NORTHERN ILLINOIS UNIVERSITY                                ","2003-2004",22,"Tennis",9192,359336,-350144,4524,132226,-127702,4668,227110,-222442,"7","8",22251,37409
"12116",137351,"UNIVERSITY OF SOUTH FLORIDA                                 ","2003-2004",24,"Track and Field, Outdoor",5895,356505,-350610,3537,180759,-177222,2358,175746,-173388,"21","44",54662,72200
"1285",154095,"UNIVERSITY OF NORTHERN IOWA                                 ","2003-2004",1,"Baseball",53372,404233,-350861,53372,404233,-350861,0,0,0,"40",".",122254,0
"8024",190415,"CORNELL UNIVERSITY-ENDOWED COLLEGES                         ","2003-2004",15,"Soccer",88957,440773,-351816,43931,177010,-133079,45026,263763,-218737,"28","27",54963,71375
"6382",153603,"IOWA STATE UNIVERSITY                                       ","2003-2004",9,"Gymnastics",226168,578051,-351883,0,0,0,226168,578051,-351883,".","15",0,91357
"14558",230728,"UTAH STATE UNIVERSITY                                       ","2003-2004",26,"Volleyball",9162,361065,-351903,0,0,0,9162,361065,-351903,".","14",0,66400
"6385",172699,"WESTERN MICHIGAN UNIVERSITY                                 ","2003-2004",9,"Gymnastics",35175,387657,-352482,0,0,0,35175,387657,-352482,".","21",0,65848
"14435",131496,"GEORGETOWN UNIVERSITY                                       ","2003-2004",26,"Volleyball",52011,404628,-352617,0,0,0,52011,404628,-352617,".","13",0,45375
"8977",147703,"NORTHERN ILLINOIS UNIVERSITY                                ","2003-2004",16,"Softball",43822,396455,-352633,0,0,0,43822,396455,-352633,".","19",0,82471
"1998",144005,"CHICAGO STATE UNIVERSITY                                    ","2003-2004",2,"Basketball",681704,1034724,-353020,404153,493463,-89310,277551,541261,-263710,"13","13",94812,99608
"881",156620,"EASTERN KENTUCKY UNIVERSITY                                 ","2003-2004",1,"Baseball",20442,374338,-353896,20442,374338,-353896,0,0,0,"32",".",144280,0
"3204",240277,"UNIVERSITY OF WISCONSIN-GREEN BAY                           ","2003-2004",2,"Basketball",1684816,2038741,-353925,1186679,1163666,23013,498137,875075,-376938,"14","14",323904,173634
"2932",178402,"UNIVERSITY OF MISSOURI-KANSAS CITY                          ","2003-2004",2,"Basketball",1470786,1824827,-354041,981876,1146830,-164954,488910,677997,-189087,"16","11",285574,189459
"4957",225308,"TRINITY VALLEY COMMUNITY COLLEGE                            ","2003-2004",7,"Football",16110,370298,-354188,16110,370298,-354188,0,0,0,"62",".",46322,0
"6487",190415,"CORNELL UNIVERSITY-ENDOWED COLLEGES                         ","2003-2004",10,"Ice Hockey",780262,1134473,-354211,683025,730096,-47071,97237,404377,-307140,"24","19",194091,117299
"7715",199120,"UNIVERSITY OF NORTH CAROLINA AT CHAPEL HILL                 ","2003-2004",15,"Soccer",663834,1018127,-354293,206427,383655,-177228,457407,634472,-177065,"28","32",38673,179034
"5724",126818,"COLORADO STATE UNIVERSITY                                   ","2003-2004",8,"Golf",112062,466395,-354333,86724,252587,-165863,25338,213808,-188470,"10","10",67976,57132
"10593",236939,"WASHINGTON STATE UNIVERSITY                                 ","2003-2004",19,"Swimming",133992,488344,-354352,0,0,0,133992,488344,-354352,".","22",0,121208
"5907",206622,"XAVIER UNIVERSITY                                           ","2003-2004",8,"Golf",160640,515453,-354813,106230,345638,-239408,54410,169815,-115405,"10","7",125555,101262
"12245",199218,"UNIVERSITY OF NORTH CAROLINA-WILMINGTON                     ","2003-2004",25,"Track and Field, X-Country",10700,365622,-354922,5350,164905,-159555,5350,200717,-195367,"70","110",28825,47424
"15036",186380,"RUTGERS UNIVERSITY-NEW BRUNSWICK                            ","2003-2004",28,"Wrestling",0,355744,-355744,0,355744,-355744,0,0,0,"32",".",55874,0
"1067",188030,"NEW MEXICO STATE UNIVERSITY-MAIN CAMPUS                     ","2003-2004",1,"Baseball",142611,498378,-355767,142611,498378,-355767,0,0,0,"30",".",160910,0
"6375",153658,"UNIVERSITY OF IOWA                                          ","2003-2004",9,"Gymnastics",178597,534429,-355832,13084,279951,-266867,165513,254478,-88965,"22","18",44707,76646
"16881",195243,"SAINT THOMAS AQUINAS COLLEGE                                ","2003-2004",39,"Total Participants",140178,496574,-356396,90022,278902,-188880,50156,217672,-167516,"103","87",114359,77075
"16380",226587,"MCMURRY UNIVERSITY                                          ","2003-2004",39,"Total Participants",478753,835365,-356612,296718,494015,-197297,182035,341350,-159315,"356","146",330785,191824
"11854",126614,"UNIVERSITY OF COLORADO AT BOULDER                           ","2003-2004",23,"Track and Field, Indoor",52428,409076,-356648,20072,164674,-144602,32356,244402,-212046,"47","42",44212,43885
"12517",126614,"UNIVERSITY OF COLORADO AT BOULDER                           ","2003-2004",25,"Track and Field, X-Country",52429,409077,-356648,20073,164674,-144601,32356,244403,-212047,"16","18",44212,43887
"12110",126614,"UNIVERSITY OF COLORADO AT BOULDER                           ","2003-2004",24,"Track and Field, Outdoor",52427,409076,-356649,20072,164674,-144602,32355,244402,-212047,"47","42",44212,43885
"9824",227216,"UNIVERSITY OF NORTH TEXAS                                   ","2003-2004",16,"Softball",0,357042,-357042,0,0,0,0,357042,-357042,".","18",0,122085
"11139",199193,"NORTH CAROLINA STATE UNIVERSITY AT RALEIGH                  ","2003-2004",22,"Tennis",200,357284,-357084,100,175869,-175769,100,181415,-181315,"11","12",55500,62900
"1038",206084,"UNIVERSITY OF TOLEDO                                        ","2003-2004",1,"Baseball",10189,367286,-357097,10189,367286,-357097,0,0,0,"31",".",83168,0
"16165",172644,"WAYNE STATE UNIVERSITY                                      ","2003-2004",39,"Total Participants",3079934,3437938,-358004,1502555,1849359,-346804,1577379,1588579,-11200,"229","104",568128,432979
"11375",230764,"UNIVERSITY OF UTAH                                          ","2003-2004",22,"Tennis",53248,412196,-358948,31660,199618,-167958,21588,212578,-190990,"8","11",46992,40989
"16163",241739,"UNIVERSIDAD METROPOLITANA                                   ","2003-2004",39,"Total Participants",14,359026,-359012,7,182688,-182681,7,176338,-176331,"71","68",56261,51775
"3809",227368,"THE UNIVERSITY OF TEXAS-PAN AMERICAN                        ","2003-2004",3,"All Track Combined",3650,363256,-359606,1825,141158,-139333,1825,222098,-220273,"51","85",34700,32726
"2450",121309,"POINT LOMA NAZARENE UNIVERSITY                              ","2003-2004",2,"Basketball",30710,390503,-359793,19108,209391,-190283,11602,181112,-169510,"16","12",26711,39328
"3516",159993,"UNIVERSITY OF LOUISIANA AT MONROE                           ","2003-2004",3,"All Track Combined",6812,366828,-360016,3406,164518,-161112,3406,202310,-198904,"50","65",29027,36541
"6539",231624,"COLLEGE OF WILLIAM AND MARY                                 ","2003-2004",11,"Lacrosse",22146,382212,-360066,0,0,0,22146,382212,-360066,".","28",0,55985
"5146",221999,"VANDERBILT UNIVERSITY                                       ","2003-2004",8,"Golf",434007,794265,-360258,262467,338548,-76081,171540,455717,-284177,"9","7",67565,55331
"14806",234076,"UNIVERSITY OF VIRGINIA-MAIN CAMPUS                          ","2003-2004",28,"Wrestling",48741,409344,-360603,48741,409344,-360603,0,0,0,"33",".",85341,0
"10285",201441,"BOWLING GREEN STATE UNIVERSITY-MAIN CAMPUS                  ","2003-2004",18,"Swimming and Diving",39905,400646,-360741,0,0,0,39905,400646,-360741,".","18",0,42309
"1776",154004,"MORNINGSIDE COLLEGE                                         ","2003-2004",2,"Basketball",65091,425912,-360821,35500,234735,-199235,29591,191177,-161586,"29","19",22408,24524
"8634",214777,"PENNSYLVANIA STATE UNIVERSITY-MAIN CAMPUS                   ","2003-2004",16,"Softball",269369,630641,-361272,0,0,0,269369,630641,-361272,".","15",0,136244
"6220",217819,"COLLEGE OF CHARLESTON                                       ","2003-2004",8,"Golf",61682,423092,-361410,51046,191373,-140327,10636,231719,-221083,"11","12",51469,50937
"10452",149222,"SOUTHERN ILLINOIS UNIVERSITY-CARBONDALE                     ","2003-2004",18,"Swimming and Diving",230404,592171,-361767,78901,259274,-180373,151503,332897,-181394,"27","33",47648,59386
"4115",216597,"VILLANOVA UNIVERSITY                                        ","2003-2004",6,"Field hocky",3602,365523,-361921,0,0,0,3602,365523,-361921,".","22",0,59354
"1923",225308,"TRINITY VALLEY COMMUNITY COLLEGE                            ","2003-2004",2,"Basketball",9347,371300,-361953,3058,177788,-174730,6289,193512,-187223,"14","11",25931,38023
"6373",201441,"BOWLING GREEN STATE UNIVERSITY-MAIN CAMPUS                  ","2003-2004",9,"Gymnastics",36761,398841,-362080,0,0,0,36761,398841,-362080,".","18",0,39394
"6124",178396,"UNIVERSITY OF MISSOURI-COLUMBIA                             ","2003-2004",8,"Golf",91011,453291,-362280,43929,186459,-142530,47082,266832,-219750,"10","10",56758,65570
"3868",106245,"UNIVERSITY OF ARKANSAS AT LITTLE ROCK                       ","2003-2004",3,"All Track Combined",63690,426395,-362705,38705,240597,-201892,24985,185798,-160813,"49","64",46434,25930
"7265",230764,"UNIVERSITY OF UTAH                                          ","2003-2004",15,"Soccer",73918,436732,-362814,0,0,0,73918,436732,-362814,".","23",0,94617
"3566",159009,"GRAMBLING STATE UNIVERSITY                                  ","2003-2004",3,"All Track Combined",2,363014,-363012,1,161486,-161485,1,201528,-201527,"25","28",98536,108458
"7291",207971,"UNIVERSITY OF TULSA                                         ","2003-2004",15,"Soccer",500576,863654,-363078,222193,420514,-198321,278383,443140,-164757,"24","19",60546,66520
"14797",163286,"UNIVERSITY OF MARYLAND-COLLEGE PARK                         ","2003-2004",28,"Wrestling",113,364416,-364303,113,364416,-364303,0,0,0,"34",".",66169,0
"2526",138983,"AUGUSTA STATE UNIVERSITY                                    ","2003-2004",2,"Basketball",115613,480278,-364665,51068,238005,-186937,64545,242273,-177728,"13","15",33429,50036
"16928",164465,"AMHERST COLLEGE                                             ","2003-2004",39,"Total Participants",1438501,1803224,-364723,751474,910078,-158604,687027,893146,-206119,"341","236",289144,229087
"16702",118693,"MENLO COLLEGE                                               ","2003-2004",39,"Total Participants",26100,390836,-364736,23050,274091,-251041,3050,116745,-113695,"275","63",370122,115140
"10634",204796,"OHIO STATE UNIVERSITY-MAIN CAMPUS                           ","2003-2004",20,"Synchronized swimming",5000,369933,-364933,0,0,0,5000,369933,-364933,".","26",0,50567
"16521",102067,"SHELTON STATE COMMUNITY COLLEGE                             ","2003-2004",39,"Total Participants",7283,372820,-365537,821,129474,-128653,6462,243346,-236884,"47","50",71357,77529
"4958",130794,"YALE UNIVERSITY                                             ","2003-2004",7,"Football",1469383,1835155,-365772,1469383,1835155,-365772,0,0,0,"114",".",444910,0
"7384",182290,"UNIVERSITY OF NEVADA-RENO                                   ","2003-2004",15,"Soccer",5810,371605,-365795,0,0,0,5810,371605,-365795,".","26",0,74340
"3922",197036,"UNITED STATES MILITARY ACADEMY                              ","2003-2004",3,"All Track Combined",255275,621098,-365823,154007,350175,-196168,101268,270923,-169655,"236","155",146322,97548
"10639",243744,"STANFORD UNIVERSITY                                         ","2003-2004",20,"Synchronized swimming",7370,373285,-365915,0,0,0,7370,373285,-365915,".","10",0,35797
"11514",176372,"UNIVERSITY OF SOUTHERN MISSISSIPPI                          ","2003-2004",22,"Tennis",21628,387702,-366074,16600,188893,-172293,5028,198809,-193781,"9","8",39397,48794
"2611",159966,"NICHOLLS STATE UNIVERSITY                                   ","2003-2004",2,"Basketball",216020,582221,-366201,173029,306088,-133059,42991,276133,-233142,"13","18",68474,57696
"3959",159939,"UNIVERSITY OF NEW ORLEANS                                   ","2003-2004",3,"All Track Combined",5956,372329,-366373,2978,180566,-177588,2978,191763,-188785,"20","18",51368,57600
"14277",176372,"UNIVERSITY OF SOUTHERN MISSISSIPPI                          ","2003-2004",26,"Volleyball",5215,371673,-366458,0,0,0,5215,371673,-366458,".","15",0,91557
"13946",196088,"SUNY AT BUFFALO                                             ","2003-2004",26,"Volleyball",13138,380406,-367268,0,0,0,13138,380406,-367268,".","12",0,65182
"6904",122409,"SAN DIEGO STATE UNIVERSITY                                  ","2003-2004",13,"Rowing",109001,476478,-367477,0,0,0,109001,476478,-367477,".","60",0,96660
"2916",218742,"UNIVERSITY OF SOUTH CAROLINA-SPARTANBURG                    ","2003-2004",2,"Basketball",79456,447856,-368400,72610,243979,-171369,6846,203877,-197031,"13","17",37281,33510
"6461",174233,"UNIVERSITY OF MINNESOTA-DULUTH                              ","2003-2004",10,"Ice Hockey",1705372,2074520,-369148,1392434,1108012,284422,312938,966508,-653570,"26","21",290124,164776
"5518",182290,"UNIVERSITY OF NEVADA-RENO                                   ","2003-2004",8,"Golf",13300,382560,-369260,5800,210690,-204890,7500,171870,-164370,"16","8",51360,47800
"3256",219383,"UNIVERSITY OF SIOUX FALLS                                   ","2003-2004",2,"Basketball",40245,410046,-369801,22692,221224,-198532,17553,188822,-171269,"29","31",30171,28971
"8277",190150,"COLUMBIA UNIVERSITY IN THE CITY OF NEW YORK                 ","2003-2004",15,"Soccer",15760,385705,-369945,8880,199324,-190444,6880,186381,-179501,"24","24",58605,60502
"9321",221847,"TENNESSEE TECHNOLOGICAL UNIVERSITY                          ","2003-2004",16,"Softball",19333,390497,-371164,0,0,0,19333,390497,-371164,".","21",0,50315
"9095",199193,"NORTH CAROLINA STATE UNIVERSITY AT RALEIGH                  ","2003-2004",16,"Softball",100,371988,-371888,0,0,0,100,371988,-371888,".","20",0,156000
"13249",145600,"UNIVERSITY OF ILLINOIS AT CHICAGO                           ","2003-2004",26,"Volleyball",1337,374031,-372694,0,0,0,1337,374031,-372694,".","29",0,50364
"10444",199193,"NORTH CAROLINA STATE UNIVERSITY AT RALEIGH                  ","2003-2004",18,"Swimming and Diving",200,373214,-373014,100,177373,-177273,100,195841,-195741,"25","30",60050,90700
"9101",110422,"CALIFORNIA POLYTECHNIC STATE UNIV-SAN LUIS OBISPO           ","2003-2004",16,"Softball",7984,381305,-373321,0,0,0,7984,381305,-373321,".","21",0,65372
"4279",215655,"ROBERT MORRIS UNIVERSITY                                    ","2003-2004",7,"Football",294972,668360,-373388,294972,668360,-373388,0,0,0,"108",".",137930,0
"7293",225511,"UNIVERSITY OF HOUSTON-UNIVERSITY PARK                       ","2003-2004",15,"Soccer",4038,377426,-373388,0,0,0,4038,377426,-373388,".","24",0,67298
"13547",238032,"WEST VIRGINIA UNIVERSITY                                    ","2003-2004",26,"Volleyball",268,374171,-373903,0,0,0,268,374171,-373903,".","12",0,55630
"3856",199120,"UNIVERSITY OF NORTH CAROLINA AT CHAPEL HILL                 ","2003-2004",3,"All Track Combined",816595,1190677,-374082,341699,528740,-187041,474896,661937,-187041,"103","109",72932,72931
"2485",220516,"KING COLLEGE                                                ","2003-2004",2,"Basketball",90311,464916,-374605,68828,279590,-210762,21483,185326,-163843,"20","15",24510,10232
"14092",164076,"TOWSON UNIVERSITY                                           ","2003-2004",26,"Volleyball",58992,434295,-375303,0,0,0,58992,434295,-375303,".","14",0,59787
"11248",182290,"UNIVERSITY OF NEVADA-RENO                                   ","2003-2004",22,"Tennis",1660,377005,-375345,1560,171920,-170360,100,205085,-204985,"11","6",39575,44470
"7094",110361,"CALIFORNIA BAPTIST UNIVERSITY                               ","2003-2004",15,"Soccer",21653,397229,-375576,3150,151823,-148673,18503,245406,-226903,"22","30",15863,19891
"6750",130794,"YALE UNIVERSITY                                             ","2003-2004",11,"Lacrosse",356989,733277,-376288,100550,425801,-325251,256439,307476,-51037,"45","29",146663,78390
"1126",191931,"IONA COLLEGE                                                ","2003-2004",1,"Baseball",3510,379953,-376443,3510,379953,-376443,0,0,0,"33",".",73047,0
"11865",176017,"UNIVERSITY OF MISSISSIPPI MAIN CAMPUS                       ","2003-2004",23,"Track and Field, Indoor",0,376487,-376487,0,179508,-179508,0,196979,-196979,"47","28",65317,61019
"7273",142276,"IDAHO STATE UNIVERSITY                                      ","2003-2004",15,"Soccer",108953,485555,-376602,0,0,0,108953,485555,-376602,".","21",0,104277
"5690",142115,"BOISE STATE UNIVERSITY                                      ","2003-2004",8,"Golf",38364,415853,-377489,19182,181630,-162448,19182,234223,-215041,"12","8",30605,30889
"693",233921,"VIRGINIA POLYTECHNIC INSTITUTE AND STATE UNIV               ","2003-2004",1,"Baseball",449730,827377,-377647,449730,827377,-377647,0,0,0,"30",".",135994,0
"2825",127741,"UNIVERSITY OF NORTHERN COLORADO                             ","2003-2004",2,"Basketball",300087,677898,-377811,200900,378571,-177671,99187,299327,-200140,"17","17",86302,45814
"12319",110705,"UNIVERSITY OF CALIFORNIA-SANTA BARBARA                      ","2003-2004",25,"Track and Field, X-Country",34227,414196,-379969,31233,211594,-180361,2994,202602,-199608,"56","52",60726,56407
"16271",173328,"CONCORDIA UNIVERSITY-ST PAUL                                ","2003-2004",39,"Total Participants",458399,838514,-380115,160683,273994,-113311,297716,564520,-266804,"193","109",363177,235905
"9502",217819,"COLLEGE OF CHARLESTON                                       ","2003-2004",16,"Softball",45045,425574,-380529,0,0,0,45045,425574,-380529,".","18",0,89325
"17310",117645,"LONG BEACH CITY COLLEGE                                     ","2003-2004",39,"Total Participants",148569,529513,-380944,72662,255362,-182700,75907,274151,-198244,"251","125",129809,78703
"3804",190415,"CORNELL UNIVERSITY-ENDOWED COLLEGES                         ","2003-2004",3,"All Track Combined",387535,768571,-381036,189789,373620,-183831,197746,394951,-197205,"164","176",152036,153209
"5846",207500,"UNIVERSITY OF OKLAHOMA NORMAN CAMPUS                        ","2003-2004",8,"Golf",14657,396457,-381800,9473,214965,-205492,5184,181492,-176308,"11","13",86170,96557
"8852",198464,"EAST CAROLINA UNIVERSITY                                    ","2003-2004",16,"Softball",21625,403664,-382039,0,0,0,21625,403664,-382039,".","17",0,128941
"1176",202480,"UNIVERSITY OF DAYTON                                        ","2003-2004",1,"Baseball",332095,714283,-382188,332095,714283,-382188,0,0,0,"37",".",80608,0
"10121",200800,"UNIVERSITY OF AKRON MAIN CAMPUS                             ","2003-2004",18,"Swimming and Diving",11258,393653,-382395,0,0,0,11258,393653,-382395,".","32",0,55545
"17324",204936,"OTTERBEIN COLLEGE                                           ","2003-2004",39,"Total Participants",268343,651410,-383067,142087,286817,-144730,126256,364593,-238337,"340","190",169738,127981
"6998",198419,"DUKE UNIVERSITY                                             ","2003-2004",13,"Rowing",3985,387217,-383232,0,0,0,3985,387217,-383232,".","44",0,223840
"4317",217165,"BRYANT COLLEGE                                              ","2003-2004",7,"Football",218912,602237,-383325,218912,602237,-383325,0,0,0,"86",".",109908,0
"8880",150136,"BALL STATE UNIVERSITY                                       ","2003-2004",16,"Softball",18142,401526,-383384,0,0,0,18142,401526,-383384,".","19",0,61864
"10938",217819,"COLLEGE OF CHARLESTON                                       ","2003-2004",22,"Tennis",4743,388138,-383395,3848,159632,-155784,895,228506,-227611,"14","12",17674,15733
"986",172699,"WESTERN MICHIGAN UNIVERSITY                                 ","2003-2004",1,"Baseball",89062,472507,-383445,89062,472507,-383445,0,0,0,"33",".",100484,0
"17140",127556,"MESA STATE COLLEGE                                          ","2003-2004",39,"Total Participants",355424,739050,-383626,130491,218498,-88007,224933,520552,-295619,"157","108",721050,538046
"7066",230764,"UNIVERSITY OF UTAH                                          ","2003-2004",14,"Skiing",81897,466153,-384256,29263,221391,-192128,52634,244762,-192128,"9","11",44566,44566
"14264",147703,"NORTHERN ILLINOIS UNIVERSITY                                ","2003-2004",26,"Volleyball",107220,491552,-384332,0,0,0,107220,491552,-384332,".","13",0,67285
"15694",194958,"ROBERTS WESLEYAN COLLEGE                                    ","2003-2004",39,"Total Participants",262267,646929,-384662,136730,315318,-178588,125537,331611,-206074,"83","95",85269,92495
"4910",199157,"NORTH CAROLINA CENTRAL UNIVERSITY                           ","2003-2004",7,"Football",315158,700024,-384866,315158,700024,-384866,0,0,0,"86",".",102017,0
"8586",153603,"IOWA STATE UNIVERSITY                                       ","2003-2004",16,"Softball",174344,559663,-385319,0,0,0,174344,559663,-385319,".","21",0,125910
"8211",207388,"OKLAHOMA STATE UNIVERSITY-MAIN CAMPUS                       ","2003-2004",15,"Soccer",110896,496253,-385357,0,0,0,110896,496253,-385357,".","27",0,155005
"10318",196413,"SYRACUSE UNIVERSITY                                         ","2003-2004",18,"Swimming and Diving",958438,1343802,-385364,414300,639314,-225014,544138,704488,-160350,"22","21",81361,75898
"3934",226091,"LAMAR UNIVERSITY                                            ","2003-2004",3,"All Track Combined",90351,475865,-385514,47953,214014,-166061,42398,261851,-219453,"48","70",53275,55101
"5041",154925,"COFFEYVILLE COMMUNITY COLLEGE &amp; AREA TECH SCHOOL            ","2003-2004",7,"Football",71406,456928,-385522,71406,456928,-385522,0,0,0,"126",".",18188,0
"5376",122755,"SAN JOSE STATE UNIVERSITY                                   ","2003-2004",8,"Golf",4760,390512,-385752,2380,165537,-163157,2380,224975,-222595,"7","7",36944,35964
"1823",234085,"VIRGINIA MILITARY INSTITUTE                                 ","2003-2004",2,"Basketball",428223,814188,-385965,428223,814188,-385965,0,0,0,"12",".",119624,0
"2387",153603,"IOWA STATE UNIVERSITY                                       ","2003-2004",2,"Basketball",5382517,5768651,-386134,4384504,4026109,358395,998013,1742542,-744529,"18","12",638429,482404
"1655",219602,"AUSTIN PEAY STATE UNIVERSITY                                ","2003-2004",2,"Basketball",419771,806163,-386392,415771,432381,-16610,4000,373782,-369782,"15","12",80621,65734
"1884",201104,"ASHLAND UNIVERSITY                                          ","2003-2004",2,"Basketball",523219,909686,-386467,285096,471147,-186051,238123,438539,-200416,"15","12",39356,31270
"7150",139931,"GEORGIA SOUTHERN UNIVERSITY                                 ","2003-2004",15,"Soccer",166113,552766,-386653,58682,237748,-179066,107431,315018,-207587,"30","19",42158,37052
"16117",231712,"CHRISTOPHER NEWPORT UNIVERSITY                              ","2003-2004",39,"Total Participants",178183,564980,-386797,77469,272735,-195266,100714,292245,-191531,"273","185",154631,88275
"9262",145600,"UNIVERSITY OF ILLINOIS AT CHICAGO                           ","2003-2004",16,"Softball",48688,435718,-387030,0,0,0,48688,435718,-387030,".","21",0,101568
"8761",203517,"KENT STATE UNIVERSITY-MAIN CAMPUS                           ","2003-2004",16,"Softball",18298,406108,-387810,0,0,0,18298,406108,-387810,".","28",0,80287
"4499",198543,"FAYETTEVILLE STATE UNIVERSITY                               ","2003-2004",7,"Football",110685,499042,-388357,110685,499042,-388357,0,0,0,"94",".",332595,0
"9592",110608,"CALIFORNIA STATE UNIVERSITY-NORTHRIDGE                      ","2003-2004",16,"Softball",14786,403642,-388856,0,0,0,14786,403642,-388856,".","25",0,106820
"13610",120883,"UNIVERSITY OF THE PACIFIC                                   ","2003-2004",26,"Volleyball",851182,1240058,-388876,205304,380977,-175673,645878,859081,-213203,"19","15",25734,93491
"9246",200800,"UNIVERSITY OF AKRON MAIN CAMPUS                             ","2003-2004",16,"Softball",11921,402650,-390729,0,0,0,11921,402650,-390729,".","22",0,75535
"10943",156125,"WICHITA STATE UNIVERSITY                                    ","2003-2004",22,"Tennis",8170,399193,-391023,2885,223884,-220999,5285,175309,-170024,"7","7",79801,30774
"11179",130794,"YALE UNIVERSITY                                             ","2003-2004",22,"Tennis",132286,523494,-391208,66143,262620,-196477,66143,260874,-194731,"13","19",71764,73066
"11855",105330,"NORTHERN ARIZONA UNIVERSITY                                 ","2003-2004",23,"Track and Field, Indoor",2650,393904,-391254,1325,175156,-173831,1325,218748,-217423,"31","37",46499,60101
"12153",105330,"NORTHERN ARIZONA UNIVERSITY                                 ","2003-2004",24,"Track and Field, Outdoor",2650,393904,-391254,1325,175156,-173831,1325,218748,-217423,"31","37",46499,60101
"10458",130794,"YALE UNIVERSITY                                             ","2003-2004",18,"Swimming and Diving",202026,593404,-391378,101016,310319,-209303,101010,283085,-182075,"36","29",64748,65813
"14173",200800,"UNIVERSITY OF AKRON MAIN CAMPUS                             ","2003-2004",26,"Volleyball",11075,402529,-391454,0,0,0,11075,402529,-391454,".","16",0,68050
"2622",159993,"UNIVERSITY OF LOUISIANA AT MONROE                           ","2003-2004",2,"Basketball",251832,644439,-392607,236213,366174,-129961,15619,278265,-262646,"13","12",76493,62431
"15722",153384,"GRINNELL COLLEGE                                            ","2003-2004",39,"Total Participants",215635,608267,-392632,102882,311580,-208698,112753,296687,-183934,"321","254",183370,136891
"15723",171571,"OAKLAND UNIVERSITY                                          ","2003-2004",39,"Total Participants",1652622,2045419,-392797,711866,889165,-177299,940756,1156254,-215498,"135","142",386441,388645
"11061",145600,"UNIVERSITY OF ILLINOIS AT CHICAGO                           ","2003-2004",22,"Tennis",275,393683,-393408,75,133957,-133882,200,259726,-259526,"11","8",19739,27628
"15545",107071,"HENDERSON STATE UNIVERSITY                                  ","2003-2004",39,"Total Participants",271333,665235,-393902,102842,253325,-150483,168491,411910,-243419,"184","85",204449,96681
"3149",159009,"GRAMBLING STATE UNIVERSITY                                  ","2003-2004",2,"Basketball",360180,754180,-394000,349040,434035,-84995,11140,320145,-309005,"15","22",360524,237120
"312",214777,"PENNSYLVANIA STATE UNIVERSITY-MAIN CAMPUS                   ","2003-2004",1,"Baseball",238969,633616,-394647,238969,633616,-394647,0,0,0,"32",".",219350,0
"16652",199157,"NORTH CAROLINA CENTRAL UNIVERSITY                           ","2003-2004",39,"Total Participants",77208,472091,-394883,21534,163176,-141642,55674,308915,-253241,"135","68",236241,116595
"16302",154518,"WALDORF COLLEGE                                             ","2003-2004",39,"Total Participants",92500,488040,-395540,49250,275687,-226437,43250,212353,-169103,"115","65",112250,62750
"4055",131159,"AMERICAN UNIVERSITY                                         ","2003-2004",6,"Field hocky",4130,399760,-395630,0,0,0,4130,399760,-395630,".","22",0,66794
"16346",137078,"ST PETERSBURG COLLEGE                                       ","2003-2004",39,"Total Participants",636610,1032703,-396093,243609,433386,-189777,393001,599317,-206316,"39","55",107400,163600
"10374",190150,"COLUMBIA UNIVERSITY IN THE CITY OF NEW YORK                 ","2003-2004",18,"Swimming and Diving",43820,440101,-396281,21910,235256,-213346,21910,204845,-182935,"42","29",97903,77396
"10021",132903,"UNIVERSITY OF CENTRAL FLORIDA                               ","2003-2004",16,"Softball",93831,490132,-396301,0,0,0,93831,490132,-396301,".","18",0,95641
"1717",180489,"THE UNIVERSITY OF MONTANA-MISSOULA                          ","2003-2004",2,"Basketball",1485092,1881584,-396492,838817,1057005,-218188,646275,824579,-178304,"15","16",267993,223957
"3492",232186,"GEORGE MASON UNIVERSITY                                     ","2003-2004",2,"Basketball",1614853,2012750,-397897,1039287,1128655,-89368,575566,884095,-308529,"15","16",260004,153658
"7445",191931,"IONA COLLEGE                                                ","2003-2004",15,"Soccer",44782,442776,-397994,24369,233757,-209388,20413,209019,-188606,"23","23",54647,34567
"17127",198899,"MARS HILL COLLEGE                                           ","2003-2004",39,"Total Participants",496049,895029,-398980,278739,512216,-233477,217310,382813,-165503,"234","98",229651,109979
"7790",203517,"KENT STATE UNIVERSITY-MAIN CAMPUS                           ","2003-2004",15,"Soccer",5341,404431,-399090,0,0,0,5341,404431,-399090,"0","26",0,58330
"1543",243780,"PURDUE UNIVERSITY-MAIN CAMPUS                               ","2003-2004",1,"Baseball",316224,715406,-399182,316224,715406,-399182,0,0,0,"33",".",206776,0
"7447",196097,"SUNY AT STONY BROOK                                         ","2003-2004",15,"Soccer",347261,746452,-399191,174280,339764,-165484,172981,406688,-233707,"28","21",55023,56932
"7376",198419,"DUKE UNIVERSITY                                             ","2003-2004",15,"Soccer",7040,406270,-399230,5540,209355,-203815,1500,196915,-195415,"23","22",64078,77661
"8006",197869,"APPALACHIAN STATE UNIVERSITY                                ","2003-2004",15,"Soccer",12653,411915,-399262,7049,204468,-197419,5604,207447,-201843,"26","32",41149,55304
"9972",145637,"UNIVERSITY OF ILLINOIS AT URBANA-CHAMPAIGN                  ","2003-2004",16,"Softball",283949,683981,-400032,0,0,0,283949,683981,-400032,".","26",0,212398
"15752",179645,"THREE RIVERS COMMUNITY COLLEGE                              ","2003-2004",39,"Total Participants",2336,402501,-400165,584,183984,-183400,1752,218517,-216765,"32","35",185576,138624
"3129",175616,"DELTA STATE UNIVERSITY                                      ","2003-2004",2,"Basketball",24308,424675,-400367,10585,238131,-227546,13723,186544,-172821,"18","16",33786,30496
"7701",139940,"GEORGIA STATE UNIVERSITY                                    ","2003-2004",15,"Soccer",11619,412235,-400616,4820,200884,-196064,6799,211351,-204552,"25","28",28531,29558
"15251",218663,"UNIVERSITY OF SOUTH CAROLINA-COLUMBIA                       ","2003-2004",34,"Equestrian",0,400751,-400751,0,0,0,0,400751,-400751,".","30",0,57347
"10734",214777,"PENNSYLVANIA STATE UNIVERSITY-MAIN CAMPUS                   ","2003-2004",22,"Tennis",312274,714194,-401920,93559,279485,-185926,218715,434709,-215994,"10","13",62179,56134
"1184",135726,"UNIVERSITY OF MIAMI                                         ","2003-2004",1,"Baseball",1426592,1828611,-402019,1426592,1828611,-402019,0,0,0,"32",".",130961,0
"6318",145637,"UNIVERSITY OF ILLINOIS AT URBANA-CHAMPAIGN                  ","2003-2004",9,"Gymnastics",510307,913009,-402702,178928,382840,-203912,331379,530169,-198790,"16","18",81783,95023
"13866",153269,"DRAKE UNIVERSITY                                            ","2003-2004",26,"Volleyball",5988,409785,-403797,0,0,0,5988,409785,-403797,".","16",0,50799
"4165",186380,"RUTGERS UNIVERSITY-NEW BRUNSWICK                            ","2003-2004",6,"Field hocky",16570,420579,-404009,0,0,0,16570,420579,-404009,".","19",0,80579
"4577",174233,"UNIVERSITY OF MINNESOTA-DULUTH                              ","2003-2004",7,"Football",226590,631080,-404490,226590,631080,-404490,0,0,0,"98",".",88243,0
"10272",126818,"COLORADO STATE UNIVERSITY                                   ","2003-2004",18,"Swimming and Diving",79300,484059,-404759,0,0,0,79300,484059,-404759,".","37",0,55241
"11244",220862,"UNIVERSITY OF MEMPHIS                                       ","2003-2004",22,"Tennis",16558,421686,-405128,8380,189006,-180626,8178,232680,-224502,"10","8",32831,37441
"10351",139755,"GEORGIA INSTITUTE OF TECHNOLOGY-MAIN CAMPUS                 ","2003-2004",18,"Swimming and Diving",505562,911173,-405611,279075,498002,-218927,226487,413171,-186684,"21","23",56019,63419
"5053",160038,"NORTHWESTERN STATE UNIVERSITY OF LOUISIANA                  ","2003-2004",7,"Football",862770,1268808,-406038,862770,1268808,-406038,0,0,0,"105",".",168730,0
"6894",166629,"UNIVERSITY OF MASSACHUSETTS-AMHERST                         ","2003-2004",13,"Rowing",12591,419336,-406745,0,0,0,12591,419336,-406745,"0","78",0,116955
"10798",150136,"BALL STATE UNIVERSITY                                       ","2003-2004",22,"Tennis",35589,442351,-406762,32961,246665,-213704,2628,195686,-193058,"8","8",47049,24399
"10150",217882,"CLEMSON UNIVERSITY                                          ","2003-2004",18,"Swimming and Diving",480530,887598,-407068,203690,397290,-193600,276840,490308,-213468,"26","38",71332,88254
"3606",207971,"UNIVERSITY OF TULSA                                         ","2003-2004",3,"All Track Combined",695852,1102934,-407082,271928,455377,-183449,423924,647557,-223633,"24","26",93324,87207
"14164",105330,"NORTHERN ARIZONA UNIVERSITY                                 ","2003-2004",26,"Volleyball",23755,430925,-407170,0,0,0,23755,430925,-407170,".","18",0,132811
"15592",101295,"GEORGE C WALLACE STATE COMMUNITY COLL-HANCEVILLE            ","2003-2004",39,"Total Participants",98295,506310,-408015,58613,321483,-262870,39682,184827,-145145,"103","61",67322,52522
"7805",208488,"CONCORDIA UNIVERSITY                                        ","2003-2004",15,"Soccer",111547,519663,-408116,61575,256614,-195039,49972,263049,-213077,"25","21",25997,40278
"13954",186380,"RUTGERS UNIVERSITY-NEW BRUNSWICK                            ","2003-2004",26,"Volleyball",12209,420412,-408203,0,0,0,12209,420412,-408203,".","14",0,71281
"15756",221351,"RHODES COLLEGE                                              ","2003-2004",39,"Total Participants",332070,740328,-408258,157945,351128,-193183,174125,389200,-215075,"251","157",233141,173770
"15048",215293,"UNIVERSITY OF PITTSBURGH-MAIN CAMPUS                        ","2003-2004",28,"Wrestling",3885,412227,-408342,3885,412227,-408342,0,0,0,"29",".",55035,0
"16047",156408,"CENTRE COLLEGE                                              ","2003-2004",39,"Total Participants",38253,446872,-408619,24125,200186,-176061,14128,246686,-232558,"228","128",240126,186024
"10702",206084,"UNIVERSITY OF TOLEDO                                        ","2003-2004",22,"Tennis",1443,410151,-408708,551,198209,-197658,892,211942,-211050,"10","8",29885,33902
"3780",220075,"EAST TENNESSEE STATE UNIVERSITY                             ","2003-2004",3,"All Track Combined",500,409489,-408989,250,173010,-172760,250,236479,-236229,"15","19",7323,10207
"13014",156125,"WICHITA STATE UNIVERSITY                                    ","2003-2004",26,"Volleyball",45399,454441,-409042,0,0,0,45399,454441,-409042,".","18",0,93926
"10112",166629,"UNIVERSITY OF MASSACHUSETTS-AMHERST                         ","2003-2004",18,"Swimming and Diving",72808,481854,-409046,39378,217888,-178510,33430,263966,-230536,"24","26",57109,50183
"6911",238032,"WEST VIRGINIA UNIVERSITY                                    ","2003-2004",13,"Rowing",1000,410271,-409271,0,0,0,1000,410271,-409271,".","54",0,66261
"416",159939,"UNIVERSITY OF NEW ORLEANS                                   ","2003-2004",1,"Baseball",84539,494316,-409777,84539,494316,-409777,0,0,0,"35",".",317746,0
"15593",238078,"WHEELING JESUIT UNIVERSITY                                  ","2003-2004",39,"Total Participants",6000,416103,-410103,3000,192549,-189549,3000,223554,-220554,"121","97",104301,121280
"10395",110644,"UNIVERSITY OF CALIFORNIA-DAVIS                              ","2003-2004",18,"Swimming and Diving",4291,414473,-410182,2074,177326,-175252,2217,237147,-234930,"28","36",52370,58511
"7946",243780,"PURDUE UNIVERSITY-MAIN CAMPUS                               ","2003-2004",15,"Soccer",356122,766345,-410223,0,0,0,356122,766345,-410223,".","30",0,191698
"1137",150136,"BALL STATE UNIVERSITY                                       ","2003-2004",1,"Baseball",51573,461842,-410269,51573,461842,-410269,0,0,0,"33",".",125313,0
"11566",187985,"UNIVERSITY OF NEW MEXICO-MAIN CAMPUS                        ","2003-2004",22,"Tennis",177235,587686,-410451,75265,254561,-179296,101970,333125,-231155,"10","10",94497,116797
"13703",231624,"COLLEGE OF WILLIAM AND MARY                                 ","2003-2004",26,"Volleyball",79376,490920,-411544,0,0,0,79376,490920,-411544,".","14",0,54133
"13537",110422,"CALIFORNIA POLYTECHNIC STATE UNIV-SAN LUIS OBISPO           ","2003-2004",26,"Volleyball",7758,419332,-411574,0,0,0,7758,419332,-411574,".","12",0,66681
"703",201441,"BOWLING GREEN STATE UNIVERSITY-MAIN CAMPUS                  ","2003-2004",1,"Baseball",84370,496203,-411833,84370,496203,-411833,0,0,0,"36",".",151085,0
"2937",201690,"CENTRAL STATE UNIVERSITY                                    ","2003-2004",2,"Basketball",120123,532020,-411897,61075,263217,-202142,59048,268803,-209755,"17","14",51075,51480
"11699",220075,"EAST TENNESSEE STATE UNIVERSITY                             ","2003-2004",22,"Tennis",2,411941,-411939,1,200037,-200036,1,211904,-211903,"7","9",19104,14703
"4397",153269,"DRAKE UNIVERSITY                                            ","2003-2004",7,"Football",88998,501249,-412251,88998,501249,-412251,0,0,0,"109",".",234431,0
"4700",154004,"MORNINGSIDE COLLEGE                                         ","2003-2004",7,"Football",66850,479207,-412357,66850,479207,-412357,0,0,0,"82",".",41672,0
"11478",164924,"BOSTON COLLEGE                                              ","2003-2004",22,"Tennis",10069,422588,-412519,9760,46127,-36367,309,376461,-376152,"8","8",24896,29528
"3792",110556,"CALIFORNIA STATE UNIVERSITY-FRESNO                          ","2003-2004",3,"All Track Combined",267016,679582,-412566,103611,316256,-212645,163405,363326,-199921,"38","114",48546,73044
"8090",237525,"MARSHALL UNIVERSITY                                         ","2003-2004",15,"Soccer",215941,628540,-412599,38210,296135,-257925,177731,332405,-154674,"31","22",43462,53152
"9144",156125,"WICHITA STATE UNIVERSITY                                    ","2003-2004",16,"Softball",58600,471259,-412659,0,0,0,58600,471259,-412659,".","19",0,103950
"13930",203517,"KENT STATE UNIVERSITY-MAIN CAMPUS                           ","2003-2004",26,"Volleyball",8737,421529,-412792,0,0,0,8737,421529,-412792,"0","14",0,56882
"2147",110097,"BIOLA UNIVERSITY                                            ","2003-2004",2,"Basketball",95047,507853,-412806,60481,331223,-270742,34566,176630,-142064,"11","12",20043,19053
"8685",201441,"BOWLING GREEN STATE UNIVERSITY-MAIN CAMPUS                  ","2003-2004",16,"Softball",50434,463356,-412922,0,0,0,50434,463356,-412922,".","23",0,95331
"2120",155399,"KANSAS STATE UNIVERSITY                                     ","2003-2004",2,"Basketball",4099739,4513351,-413612,3067953,2581074,486879,1031786,1932277,-900491,"16","14",528138,609507
"6507",164924,"BOSTON COLLEGE                                              ","2003-2004",10,"Ice Hockey",1843778,2257974,-414196,1821347,1896622,-75275,22431,361352,-338921,"27","23",181881,65834
"6990",110635,"UNIVERSITY OF CALIFORNIA-BERKELEY                           ","2003-2004",13,"Rowing",878420,1293193,-414773,618868,684583,-65715,259552,608610,-349058,"42","55",167350,123099
"7286",110644,"UNIVERSITY OF CALIFORNIA-DAVIS                              ","2003-2004",15,"Soccer",28226,443709,-415483,9635,222252,-212617,18591,221457,-202866,"29","25",55351,46536
"17116",109819,"BAKERSFIELD COLLEGE                                         ","2003-2004",39,"Total Participants",180430,596200,-415770,85668,258020,-172352,94762,338180,-243418,"186","95",76281,43470
"7256",122409,"SAN DIEGO STATE UNIVERSITY                                  ","2003-2004",15,"Soccer",361510,777607,-416097,153332,277112,-123780,208178,500495,-292317,"28","27",69088,93990
"14228",217882,"CLEMSON UNIVERSITY                                          ","2003-2004",26,"Volleyball",229924,646083,-416159,0,0,0,229924,646083,-416159,".","16",0,143237
"9558",182281,"UNIVERSITY OF NEVADA-LAS VEGAS                              ","2003-2004",16,"Softball",149676,566641,-416965,0,0,0,149676,566641,-416965,".","19",0,148477
"5237",236948,"UNIVERSITY OF WASHINGTON-SEATTLE CAMPUS                     ","2003-2004",8,"Golf",280700,698027,-417327,152123,351898,-199775,128577,346129,-217552,"9","7",91815,88356
"7828",179964,"WILLIAM WOODS UNIVERSITY                                    ","2003-2004",15,"Soccer",51556,469578,-418022,24611,254197,-229586,26945,215381,-188436,"24","19",7111,9445
"12310",219709,"BELMONT UNIVERSITY                                          ","2003-2004",25,"Track and Field, X-Country",87876,506603,-418727,40881,221959,-181078,46995,284644,-237649,"19","19",36523,43755
"8863",176372,"UNIVERSITY OF SOUTHERN MISSISSIPPI                          ","2003-2004",16,"Softball",58288,477078,-418790,0,0,0,58288,477078,-418790,".","19",0,137937
"8347",236939,"WASHINGTON STATE UNIVERSITY                                 ","2003-2004",15,"Soccer",251739,671116,-419377,0,0,0,251739,671116,-419377,".","26",0,122890
"4383",213543,"LEHIGH UNIVERSITY                                           ","2003-2004",7,"Football",2316287,2735715,-419428,2316287,2735715,-419428,0,0,0,"115",".",340536,0
"6273",152080,"UNIVERSITY OF NOTRE DAME                                    ","2003-2004",8,"Golf",294082,713865,-419783,132194,352478,-220284,161888,361387,-199499,"13","10",67975,62588
"3771",131159,"AMERICAN UNIVERSITY                                         ","2003-2004",3,"All Track Combined",13810,434282,-420472,13605,186741,-173136,205,247541,-247336,"68","47",31059,41172
"10981",153269,"DRAKE UNIVERSITY                                            ","2003-2004",22,"Tennis",7925,428442,-420517,5750,168210,-162460,2175,260232,-258057,"6","10",50351,40470
"3747",234030,"VIRGINIA COMMONWEALTH UNIVERSITY                            ","2003-2004",3,"All Track Combined",2501,423640,-421139,1,204529,-204528,2500,219111,-216611,"53","51",43090,49980
"13142",181002,"CREIGHTON UNIVERSITY                                        ","2003-2004",26,"Volleyball",65832,487201,-421369,0,0,0,65832,487201,-421369,".","13",0,54812
"6928",131496,"GEORGETOWN UNIVERSITY                                       ","2003-2004",13,"Rowing",270035,691574,-421539,93208,332216,-239008,176827,359358,-182531,"95","80",113793,113795
"11721",186380,"RUTGERS UNIVERSITY-NEW BRUNSWICK                            ","2003-2004",22,"Tennis",6105,428053,-421948,0,180436,-180436,6105,247617,-241512,"9","7",40205,42216
"7331",153603,"IOWA STATE UNIVERSITY                                       ","2003-2004",15,"Soccer",179241,601522,-422281,0,0,0,179241,601522,-422281,".","21",0,130850
"6325",236948,"UNIVERSITY OF WASHINGTON-SEATTLE CAMPUS                     ","2003-2004",9,"Gymnastics",143592,565943,-422351,0,0,0,143592,565943,-422351,".","16",0,102056
"8052",206084,"UNIVERSITY OF TOLEDO                                        ","2003-2004",15,"Soccer",5929,428320,-422391,0,0,0,5929,428320,-422391,".","29",0,46438
"2840",239105,"MARQUETTE UNIVERSITY                                        ","2003-2004",2,"Basketball",6191611,6614180,-422569,6020233,5111771,908462,171378,1502409,-1331031,"16","13",744470,265242
"1801",108092,"UNIVERSITY OF ARKANSAS AT FT SMITH                          ","2003-2004",2,"Basketball",53812,476544,-422732,26638,254063,-227425,27174,222481,-195307,"14","15",26700,41911
"6015",199193,"NORTH CAROLINA STATE UNIVERSITY AT RALEIGH                  ","2003-2004",8,"Golf",200,423653,-423453,100,214941,-214841,100,208712,-208612,"12","12",71000,77900
"6627",199120,"UNIVERSITY OF NORTH CAROLINA AT CHAPEL HILL                 ","2003-2004",11,"Lacrosse",673318,1096878,-423560,351055,582818,-231763,322263,514060,-191797,"49","29",116203,78195
"15659",212009,"DICKINSON COLLEGE                                           ","2003-2004",39,"Total Participants",142086,565648,-423562,65586,259099,-193513,76500,306549,-230049,"263","199",159623,113367
"4847",231624,"COLLEGE OF WILLIAM AND MARY                                 ","2003-2004",7,"Football",2243361,2667056,-423695,2243361,2667056,-423695,0,0,0,"96",".",331992,0
"13027",122755,"SAN JOSE STATE UNIVERSITY                                   ","2003-2004",26,"Volleyball",7042,430853,-423811,0,0,0,7042,430853,-423811,".","16",0,104585
"13740",201441,"BOWLING GREEN STATE UNIVERSITY-MAIN CAMPUS                  ","2003-2004",26,"Volleyball",90729,515105,-424376,0,0,0,90729,515105,-424376,".","13",0,45380
"14613",142115,"BOISE STATE UNIVERSITY                                      ","2003-2004",26,"Volleyball",34514,459139,-424625,0,0,0,34514,459139,-424625,".","13",0,85859
"17162",133650,"FLORIDA AGRICULTURAL AND MECHANICAL UNIVERSITY              ","2003-2004",39,"Total Participants",8805,433776,-424971,6001,198156,-192155,2804,235620,-232816,"234","97",726247,313898
"9943",228778,"THE UNIVERSITY OF TEXAS AT AUSTIN                           ","2003-2004",16,"Softball",456405,881382,-424977,0,0,0,456405,881382,-424977,".","17",0,223689
"10751",182281,"UNIVERSITY OF NEVADA-LAS VEGAS                              ","2003-2004",22,"Tennis",96335,521622,-425287,13643,224542,-210899,82692,297080,-214388,"11","8",37779,43568
"5580",206084,"UNIVERSITY OF TOLEDO                                        ","2003-2004",8,"Golf",18281,443869,-425588,9086,227409,-218323,9195,216460,-207265,"10","9",63151,54384
"798",156125,"WICHITA STATE UNIVERSITY                                    ","2003-2004",1,"Baseball",947552,1373429,-425877,947552,1373429,-425877,0,0,0,"38",".",261264,0
"9822",230764,"UNIVERSITY OF UTAH                                          ","2003-2004",16,"Softball",86020,512183,-426163,0,0,0,86020,512183,-426163,".","17",0,151822
"15711",122205,"SADDLEBACK COLLEGE                                          ","2003-2004",39,"Total Participants",185541,612000,-426459,100014,322000,-221986,85527,290000,-204473,"225","124",101094,89319
"1388",230764,"UNIVERSITY OF UTAH                                          ","2003-2004",1,"Baseball",138768,565244,-426476,138768,565244,-426476,0,0,0,"29",".",192321,0
"13136",199139,"UNIVERSITY OF NORTH CAROLINA AT CHARLOTTE                   ","2003-2004",26,"Volleyball",14051,440629,-426578,0,0,0,14051,440629,-426578,".","15",0,70070
"8353",232186,"GEORGE MASON UNIVERSITY                                     ","2003-2004",15,"Soccer",433106,860181,-427075,220752,409093,-188341,212354,451088,-238734,"25","24",71179,58400
"14685",110635,"UNIVERSITY OF CALIFORNIA-BERKELEY                           ","2003-2004",27,"Water Polo",374751,802412,-427661,172420,391128,-218708,202331,411284,-208953,"47","29",82028,108018
"6538",164924,"BOSTON COLLEGE                                              ","2003-2004",11,"Lacrosse",31272,459050,-427778,0,0,0,31272,459050,-427778,".","28",0,70695
"10768",233374,"UNIVERSITY OF RICHMOND                                      ","2003-2004",22,"Tennis",43747,472279,-428532,30490,106266,-75776,13257,366013,-352756,"9","9",29163,44899
"1753",187648,"EASTERN NEW MEXICO UNIVERSITY-MAIN CAMPUS                   ","2003-2004",2,"Basketball",130928,560513,-429585,126168,359644,-233476,4760,200869,-196109,"14","21",66459,39484
"16086",155025,"EMPORIA STATE UNIVERSITY                                    ","2003-2004",39,"Total Participants",427020,857251,-430231,180692,310351,-129659,246328,546900,-300572,"260","132",246503,201192
"3672",153658,"UNIVERSITY OF IOWA                                          ","2003-2004",3,"All Track Combined",159343,590123,-430780,15115,317405,-302290,144228,272718,-128490,"108","127",117787,104750
"6606",197197,"WAGNER COLLEGE                                              ","2003-2004",11,"Lacrosse",127761,558808,-431047,47365,180957,-133592,80396,377851,-297455,"31","25",36307,29563
"1260",203517,"KENT STATE UNIVERSITY-MAIN CAMPUS                           ","2003-2004",1,"Baseball",49306,480735,-431429,49306,480735,-431429,0,0,0,"32",".",125902,0
"15644",155973,"TABOR COLLEGE                                               ","2003-2004",39,"Total Participants",38664,470102,-431438,22387,281648,-259261,16277,188454,-172177,"198","99",111054,54012
"3631",197869,"APPALACHIAN STATE UNIVERSITY                                ","2003-2004",3,"All Track Combined",88391,520066,-431675,42433,240003,-197570,45958,280063,-234105,"99","115",83324,76544
"6669",190415,"CORNELL UNIVERSITY-ENDOWED COLLEGES                         ","2003-2004",11,"Lacrosse",299904,731833,-431929,219233,403328,-184095,80671,328505,-247834,"40","25",108523,77088
"10342",216764,"WEST CHESTER UNIVERSITY OF PENNSYLVANIA                     ","2003-2004",18,"Swimming and Diving",46259,478248,-431989,23267,239124,-215857,22992,239124,-216132,"25","19",38736,38736
"11586",172699,"WESTERN MICHIGAN UNIVERSITY                                 ","2003-2004",22,"Tennis",33673,466036,-432363,15372,199581,-184209,18301,266455,-248154,"9","7",42988,42574
"12970",213385,"LAFAYETTE COLLEGE                                           ","2003-2004",25,"Track and Field, X-Country",115987,548702,-432715,62984,213327,-150343,53003,335375,-282372,"88","90",36856,34022
"8816",153269,"DRAKE UNIVERSITY                                            ","2003-2004",16,"Softball",674,434265,-433591,0,0,0,674,434265,-433591,".","16",0,57816
"5183",236939,"WASHINGTON STATE UNIVERSITY                                 ","2003-2004",8,"Golf",81385,515030,-433645,6353,232805,-226452,75032,282225,-207193,"12","8",82584,89776
"6500",170639,"LAKE SUPERIOR STATE UNIVERSITY                              ","2003-2004",10,"Ice Hockey",307202,740967,-433765,307202,740967,-433765,0,0,0,"30",".",133247,0
"1471",236939,"WASHINGTON STATE UNIVERSITY                                 ","2003-2004",1,"Baseball",383173,817965,-434792,383173,817965,-434792,0,0,0,"35",".",269705,0
"15851",197027,"UNITED STATES MERCHANT MARINE ACADEMY                       ","2003-2004",39,"Total Participants",106461,541328,-434867,69506,314328,-244822,36955,227000,-190045,"361","102",168729,72295
"9147",206084,"UNIVERSITY OF TOLEDO                                        ","2003-2004",16,"Softball",1113,436544,-435431,0,0,0,1113,436544,-435431,".","20",0,60643
"6330",145600,"UNIVERSITY OF ILLINOIS AT CHICAGO                           ","2003-2004",9,"Gymnastics",66477,501927,-435450,22161,224330,-202169,44316,277597,-233281,"15","15",37785,44794
"1046",181002,"CREIGHTON UNIVERSITY                                        ","2003-2004",1,"Baseball",123516,559785,-436269,123516,559785,-436269,0,0,0,"33",".",82917,0
"7554",126678,"COLORADO COLLEGE                                            ","2003-2004",15,"Soccer",281396,717757,-436361,56392,67413,-11021,225004,650344,-425340,"27","25",33438,70272
"8899",196088,"SUNY AT BUFFALO                                             ","2003-2004",16,"Softball",9974,446580,-436606,0,0,0,9974,446580,-436606,".","19",0,104145
"10165",157289,"UNIVERSITY OF LOUISVILLE                                    ","2003-2004",18,"Swimming and Diving",24141,460937,-436796,2000,151123,-149123,22141,309814,-287673,"22","16",14106,72398
"4615",198899,"MARS HILL COLLEGE                                           ","2003-2004",7,"Football",327016,764454,-437438,327016,764454,-437438,0,0,0,"105",".",77024,0
"6769",196097,"SUNY AT STONY BROOK                                         ","2003-2004",11,"Lacrosse",265865,704067,-438202,141400,433860,-292460,124465,270207,-145742,"38","20",49867,53633
"10326",233374,"UNIVERSITY OF RICHMOND                                      ","2003-2004",18,"Swimming and Diving",14732,452971,-438239,0,0,0,14732,452971,-438239,".","24",0,69185
"1442",223427,"BLINN COLLEGE                                               ","2003-2004",1,"Baseball",490,438975,-438485,490,438975,-438485,0,0,0,"24",".",46271,0
"16777",206589,"COLLEGE OF WOOSTER                                          ","2003-2004",39,"Total Participants",9043,448406,-439363,4721,212549,-207828,4322,235857,-231535,"368","271",255226,191249
"14754",104151,"ARIZONA STATE UNIVERSITY-MAIN CAMPUS                        ","2003-2004",27,"Water Polo",32055,471465,-439410,0,0,0,32055,471465,-439410,".","21",0,102931
"4216",166629,"UNIVERSITY OF MASSACHUSETTS-AMHERST                         ","2003-2004",6,"Field hocky",42894,482876,-439982,0,0,0,42894,482876,-439982,".","23",0,77931
"11461",234030,"VIRGINIA COMMONWEALTH UNIVERSITY                            ","2003-2004",22,"Tennis",5060,445120,-440060,2420,218708,-216288,2640,226412,-223772,"8","7",28685,15207
"3440",179645,"THREE RIVERS COMMUNITY COLLEGE                              ","2003-2004",2,"Basketball",9344,449948,-440604,7008,314992,-307984,2336,134956,-132620,"13","11",126448,61588
"3207",178615,"TRUMAN STATE UNIVERSITY                                     ","2003-2004",2,"Basketball",39379,480391,-441012,23603,249416,-225813,15776,230975,-215199,"14","12",40875,36452
"16715",194161,"NYACK COLLEGE                                               ","2003-2004",39,"Total Participants",306976,748421,-441445,177976,475008,-297032,129000,273413,-144413,"78","60",105400,90100
"752",110422,"CALIFORNIA POLYTECHNIC STATE UNIV-SAN LUIS OBISPO           ","2003-2004",1,"Baseball",63949,505649,-441700,63949,505649,-441700,0,0,0,"44",".",103467,0
"16395",110565,"CALIFORNIA STATE UNIVERSITY-FULLERTON                       ","2003-2004",39,"Total Participants",3150183,3591898,-441715,1636948,1720419,-83471,1513235,1871479,-358244,"156","172",481924,479415
"15033",240444,"UNIVERSITY OF WISCONSIN-MADISON                             ","2003-2004",28,"Wrestling",149875,591634,-441759,149875,591634,-441759,0,0,0,"28",".",108668,0
"10033",110635,"UNIVERSITY OF CALIFORNIA-BERKELEY                           ","2003-2004",16,"Softball",493750,935771,-442021,0,0,0,493750,935771,-442021,".","16",0,217767
"3198",236939,"WASHINGTON STATE UNIVERSITY                                 ","2003-2004",2,"Basketball",2465214,2907570,-442356,2148239,1653650,494589,316975,1253920,-936945,"17","13",378946,361609
"14725",151351,"INDIANA UNIVERSITY-BLOOMINGTON                              ","2003-2004",27,"Water Polo",536,443033,-442497,0,0,0,536,443033,-442497,".","19",0,84222
"11356",198385,"DAVIDSON COLLEGE                                            ","2003-2004",22,"Tennis",12468,455082,-442614,2400,214514,-212114,10068,240568,-230500,"18","12",16162,33346
"6329",164076,"TOWSON UNIVERSITY                                           ","2003-2004",9,"Gymnastics",16242,459452,-443210,0,0,0,16242,459452,-443210,".","16",0,45890
"7324",218973,"WOFFORD COLLEGE                                             ","2003-2004",15,"Soccer",23647,467807,-444160,12732,227287,-214555,10915,240520,-229605,"28","23",35354,27797
"6935",110662,"UNIVERSITY OF CALIFORNIA-LOS ANGELES                        ","2003-2004",13,"Rowing",0,444166,-444166,0,0,0,0,444166,-444166,"0","92",0,112943
"1983",154590,"WILLIAM PENN UNIVERSITY                                     ","2003-2004",2,"Basketball",72264,516501,-444237,43594,310752,-267158,28670,205749,-177079,"44","28",38412,26712
"337",104179,"UNIVERSITY OF ARIZONA                                       ","2003-2004",1,"Baseball",416087,860353,-444266,416087,860353,-444266,0,0,0,"34",".",221691,0
"5493",176080,"MISSISSIPPI STATE UNIVERSITY                                ","2003-2004",8,"Golf",2,444454,-444452,1,220556,-220555,1,223898,-223897,"11","6",51218,43809
"2841",197984,"BELMONT ABBEY COLLEGE                                       ","2003-2004",2,"Basketball",4712,449359,-444647,950,221516,-220566,3762,227843,-224081,"14","13",19463,18220
"7207",199218,"UNIVERSITY OF NORTH CAROLINA-WILMINGTON                     ","2003-2004",15,"Soccer",193325,638120,-444795,98128,326211,-228083,95197,311909,-216712,"24","34",42561,43950
"10270",105330,"NORTHERN ARIZONA UNIVERSITY                                 ","2003-2004",18,"Swimming and Diving",24840,469693,-444853,0,0,0,24840,469693,-444853,".","34",0,104459
"16186",228246,"SOUTHERN METHODIST UNIVERSITY                               ","2003-2004",39,"Total Participants",8264401,8710065,-445664,3335446,3474694,-139248,4928955,5235371,-306416,"253","198",1617409,868016
"3166",230746,"SALT LAKE COMMUNITY COLLEGE                                 ","2003-2004",2,"Basketball",26408,472335,-445927,18086,271888,-253802,8322,200447,-192125,"15","13",33568,30810
"911",217819,"COLLEGE OF CHARLESTON                                       ","2003-2004",1,"Baseball",51481,497618,-446137,51481,497618,-446137,0,0,0,"31",".",99032,0
"14401",216597,"VILLANOVA UNIVERSITY                                        ","2003-2004",26,"Volleyball",4151,450462,-446311,0,0,0,4151,450462,-446311,".","17",0,56253
"2298",110361,"CALIFORNIA BAPTIST UNIVERSITY                               ","2003-2004",2,"Basketball",26434,473129,-446695,16815,193370,-176555,9619,279759,-270140,"12","14",23436,22156
"5558",203517,"KENT STATE UNIVERSITY-MAIN CAMPUS                           ","2003-2004",8,"Golf",47500,494222,-446722,44350,258277,-213927,3150,235945,-232795,"11","8",59500,61395
"9300",166629,"UNIVERSITY OF MASSACHUSETTS-AMHERST                         ","2003-2004",16,"Softball",50121,498061,-447940,0,0,0,50121,498061,-447940,".","20",0,93243
"11220",144740,"DEPAUL UNIVERSITY                                           ","2003-2004",22,"Tennis",3551,451560,-448009,3550,162751,-159201,1,288809,-288808,"5","8",31708,26670
"10542",150136,"BALL STATE UNIVERSITY                                       ","2003-2004",19,"Swimming",24140,472988,-448848,10123,182943,-172820,14017,290045,-276028,"28","36",32612,34815
"4098",151351,"INDIANA UNIVERSITY-BLOOMINGTON                              ","2003-2004",6,"Field hocky",0,449170,-449170,0,0,0,0,449170,-449170,".","21",0,65224
"8042",130794,"YALE UNIVERSITY                                             ","2003-2004",15,"Soccer",85520,534791,-449271,43231,281248,-238017,42289,253543,-211254,"26","23",43825,41319
"13525",182290,"UNIVERSITY OF NEVADA-RENO                                   ","2003-2004",26,"Volleyball",13180,462520,-449340,0,0,0,13180,462520,-449340,".","14",0,85250
"4889",152530,"TAYLOR UNIVERSITY-UPLAND                                    ","2003-2004",7,"Football",12304,461803,-449499,12304,461803,-449499,0,0,0,"67",".",104068,0
"10936",207388,"OKLAHOMA STATE UNIVERSITY-MAIN CAMPUS                       ","2003-2004",22,"Tennis",109454,559250,-449796,78451,323067,-244616,31003,236183,-205180,"6","11",126086,69940
"901",110635,"UNIVERSITY OF CALIFORNIA-BERKELEY                           ","2003-2004",1,"Baseball",539981,989811,-449830,539981,989811,-449830,0,0,0,"42",".",220125,0
"15287",139959,"UNIVERSITY OF GEORGIA                                       ","2003-2004",34,"Equestrian",1,450113,-450112,0,0,0,1,450113,-450112,".","63",0,155851
"5816",176017,"UNIVERSITY OF MISSISSIPPI MAIN CAMPUS                       ","2003-2004",8,"Golf",12305,462488,-450183,12305,210881,-198576,0,251607,-251607,"17","7",48784,62384
"8268",187985,"UNIVERSITY OF NEW MEXICO-MAIN CAMPUS                        ","2003-2004",15,"Soccer",257453,708838,-451385,128578,348004,-219426,128875,360834,-231959,"23","34",113044,135674
"1791",232265,"HAMPTON UNIVERSITY                                          ","2003-2004",2,"Basketball",1016041,1468119,-452078,475532,684216,-208684,540509,783903,-243394,"15","13",188731,252277
"11327",137351,"UNIVERSITY OF SOUTH FLORIDA                                 ","2003-2004",22,"Tennis",29234,481922,-452688,7074,246021,-238947,22160,235901,-213741,"10","10",67883,56116
"2999",179043,"ROCKHURST UNIVERSITY                                        ","2003-2004",2,"Basketball",24834,477913,-453079,21219,298048,-276829,3615,179865,-176250,"17","14",298044,179872
"3220",175342,"ALCORN STATE UNIVERSITY                                     ","2003-2004",2,"Basketball",74917,528424,-453507,39547,264064,-224517,35370,264360,-228990,"14","15",106699,112040
"620",233374,"UNIVERSITY OF RICHMOND                                      ","2003-2004",1,"Baseball",69551,523479,-453928,69551,523479,-453928,0,0,0,"30",".",103839,0
"14903",209551,"UNIVERSITY OF OREGON                                        ","2003-2004",28,"Wrestling",13110,468026,-454916,13110,468026,-454916,0,0,0,"33",".",82730,0
"6244",240444,"UNIVERSITY OF WISCONSIN-MADISON                             ","2003-2004",8,"Golf",105711,561225,-455514,35652,232361,-196709,70059,328864,-258805,"10","12",42069,48572
"3086",207324,"OKLAHOMA CHRISTIAN UNIVERSITY                               ","2003-2004",2,"Basketball",23102,478622,-455520,11458,214888,-203430,11644,263734,-252090,"14","14",31863,32432
"6643",233374,"UNIVERSITY OF RICHMOND                                      ","2003-2004",11,"Lacrosse",14694,470226,-455532,0,0,0,14694,470226,-455532,".","28",0,59798
"8922",126818,"COLORADO STATE UNIVERSITY                                   ","2003-2004",16,"Softball",50687,506705,-456018,0,0,0,50687,506705,-456018,".","17",0,144741
"6381",110635,"UNIVERSITY OF CALIFORNIA-BERKELEY                           ","2003-2004",9,"Gymnastics",359977,816535,-456558,119852,322098,-202246,240125,494437,-254312,"15","11",68344,113842
"7640",110422,"CALIFORNIA POLYTECHNIC STATE UNIV-SAN LUIS OBISPO           ","2003-2004",15,"Soccer",53979,511498,-457519,22974,232633,-209659,31005,278865,-247860,"33","31",39457,61996
"17230",181817,"WESTERN NEBRASKA COMMUNITY COLLEGE                          ","2003-2004",39,"Total Participants",45576,503095,-457519,19893,221840,-201947,25683,281255,-255572,"75","69",142427,156980
"5784",234076,"UNIVERSITY OF VIRGINIA-MAIN CAMPUS                          ","2003-2004",8,"Golf",36194,493982,-457788,15629,277430,-261801,20565,216552,-195987,"11","8",44175,33087
"7113",195164,"SAINT BONAVENTURE UNIVERSITY                                ","2003-2004",15,"Soccer",12583,470493,-457910,6987,255115,-248128,5596,215378,-209782,"23","24",30533,35211
"4772",198385,"DAVIDSON COLLEGE                                            ","2003-2004",7,"Football",37986,496037,-458051,37986,496037,-458051,0,0,0,"77",".",136182,0
"11003",198419,"DUKE UNIVERSITY                                             ","2003-2004",22,"Tennis",20100,478431,-458331,16500,226937,-210437,3600,251494,-247894,"11","10",100808,168052
"5890",228778,"THE UNIVERSITY OF TEXAS AT AUSTIN                           ","2003-2004",8,"Golf",856706,1315697,-458991,426495,714533,-288038,430211,601164,-170953,"13","8",190909,107486
"8073",164076,"TOWSON UNIVERSITY                                           ","2003-2004",15,"Soccer",40671,500179,-459508,10630,227736,-217106,30041,272443,-242402,"28","26",44532,34485
"3888",230764,"UNIVERSITY OF UTAH                                          ","2003-2004",3,"All Track Combined",145151,604732,-459581,42039,189105,-147066,103112,415627,-312515,"54","93",45853,97438
"9540",110556,"CALIFORNIA STATE UNIVERSITY-FRESNO                          ","2003-2004",16,"Softball",374125,834074,-459949,0,0,0,374125,834074,-459949,".","15",0,223754
"4338",188304,"WESTERN NEW MEXICO UNIVERSITY                               ","2003-2004",7,"Football",53391,514004,-460613,53391,514004,-460613,0,0,0,"71",".",68731,0
"3582",228796,"THE UNIVERSITY OF TEXAS AT EL PASO                          ","2003-2004",3,"All Track Combined",530929,992263,-461334,222217,509510,-287293,308712,482753,-174041,"83","52",138927,103144
"9660",132602,"BETHUNE COOKMAN COLLEGE                                     ","2003-2004",16,"Softball",172188,634044,-461856,0,0,0,172188,634044,-461856,".","17",0,250002
"8036",135726,"UNIVERSITY OF MIAMI                                         ","2003-2004",15,"Soccer",329281,791264,-461983,0,0,0,329281,791264,-461983,".","26",0,106900
"2605",170639,"LAKE SUPERIOR STATE UNIVERSITY                              ","2003-2004",2,"Basketball",159426,621675,-462249,53880,303224,-249344,105546,318451,-212905,"15","14",51597,69606
"8473",198516,"ELON UNIVERSITY                                             ","2003-2004",15,"Soccer",12788,476119,-463331,8480,209823,-201343,4308,266296,-261988,"27","26",29190,32714
"16237",164580,"BABSON COLLEGE                                              ","2003-2004",39,"Total Participants",194171,657912,-463741,105356,303473,-198117,88815,354439,-265624,"196","159",119675,102764
"15702",165936,"GORDON COLLEGE                                              ","2003-2004",39,"Total Participants",78219,542391,-464172,40389,242465,-202076,37830,299926,-262096,"107","141",152464,149031
"13097",230764,"UNIVERSITY OF UTAH                                          ","2003-2004",26,"Volleyball",69151,533647,-464496,0,0,0,69151,533647,-464496,".","14",0,104037
"11873",155399,"KANSAS STATE UNIVERSITY                                     ","2003-2004",23,"Track and Field, Indoor",29672,494190,-464518,14289,254949,-240660,15383,239241,-223858,"39","44",90464,54513
"12151",155399,"KANSAS STATE UNIVERSITY                                     ","2003-2004",24,"Track and Field, Outdoor",29672,494190,-464518,14289,254949,-240660,15383,239241,-223858,"36","42",90464,54513
"12850",155399,"KANSAS STATE UNIVERSITY                                     ","2003-2004",25,"Track and Field, X-Country",29671,494190,-464519,14288,254949,-240661,15383,239241,-223858,"8","16",90464,54513
"3969",187985,"UNIVERSITY OF NEW MEXICO-MAIN CAMPUS                        ","2003-2004",3,"All Track Combined",253609,718582,-464973,106044,359291,-253247,147565,359291,-211726,"108","139",104039,104040
"716",234076,"UNIVERSITY OF VIRGINIA-MAIN CAMPUS                          ","2003-2004",1,"Baseball",370957,836426,-465469,370957,836426,-465469,0,0,0,"37",".",198758,0
"4082",233374,"UNIVERSITY OF RICHMOND                                      ","2003-2004",6,"Field hocky",19551,485605,-466054,0,0,0,19551,485605,-466054,".","15",0,55129
"12466",122409,"SAN DIEGO STATE UNIVERSITY                                  ","2003-2004",25,"Track and Field, X-Country",208474,674896,-466422,0,0,0,208474,674896,-466422,".","95",0,180095
"10966",243780,"PURDUE UNIVERSITY-MAIN CAMPUS                               ","2003-2004",22,"Tennis",355109,821750,-466641,118704,357103,-238399,236405,464647,-228242,"11","12",79218,91607
"14886",153658,"UNIVERSITY OF IOWA                                          ","2003-2004",28,"Wrestling",535620,1002315,-466695,535620,1002315,-466695,0,0,0,"33",".",82529,0
"425",176017,"UNIVERSITY OF MISSISSIPPI MAIN CAMPUS                       ","2003-2004",1,"Baseball",547488,1014331,-466843,547488,1014331,-466843,0,0,0,"41",".",272230,0
"5810",181464,"UNIVERSITY OF NEBRASKA AT LINCOLN                           ","2003-2004",8,"Golf",30838,498342,-467504,10900,237257,-226357,19938,261085,-241147,"12","13",63019,62555
"7777",196060,"SUNY AT ALBANY                                              ","2003-2004",15,"Soccer",2944,470532,-467588,2183,261955,-259772,761,208577,-207816,"24","21",43003,41547
"7509",164988,"BOSTON UNIVERSITY                                           ","2003-2004",15,"Soccer",53525,522044,-468519,29038,259646,-230608,24487,262398,-237911,"30","27",44842,64031
"2170",152530,"TAYLOR UNIVERSITY-UPLAND                                    ","2003-2004",2,"Basketball",32042,500625,-468583,19947,286026,-266079,12095,214599,-202504,"12","14",59550,43957
"8389",179043,"ROCKHURST UNIVERSITY                                        ","2003-2004",15,"Soccer",12000,481115,-469115,11850,221952,-210102,150,259163,-259013,"48","25",221952,259175
"1314",234030,"VIRGINIA COMMONWEALTH UNIVERSITY                            ","2003-2004",1,"Baseball",25443,494587,-469144,25443,494587,-469144,0,0,0,"30",".",112941,0
"17131",199698,"ST ANDREWS PRESBYTERIAN COLLEGE                             ","2003-2004",39,"Total Participants",586596,1057006,-470410,311441,595510,-284069,275155,461496,-186341,"185","116",158391,120426
"13438",106397,"UNIVERSITY OF ARKANSAS MAIN CAMPUS                          ","2003-2004",26,"Volleyball",121130,592224,-471094,0,0,0,121130,592224,-471094,"0","10",0,125113
"15990",173920,"MINNESOTA STATE UNVERSITY-MANKATO                           ","2003-2004",39,"Total Participants",2690357,3161779,-471422,1622249,1668175,-45926,1068108,1493604,-425496,"333","223",703746,511400
"3533",142276,"IDAHO STATE UNIVERSITY                                      ","2003-2004",3,"All Track Combined",128822,600259,-471437,78399,295457,-217058,50423,304802,-254379,"103","108",62916,62194
"924",217864,"CITADEL MILITARY COLLEGE OF SOUTH CAROLINA                  ","2003-2004",1,"Baseball",98480,570342,-471862,98480,570342,-471862,0,0,0,"43",".",155824,0
"11659",142115,"BOISE STATE UNIVERSITY                                      ","2003-2004",22,"Tennis",39424,511614,-472190,19242,264240,-244998,20182,247374,-227192,"9","8",45475,39092
"9045",207500,"UNIVERSITY OF OKLAHOMA NORMAN CAMPUS                        ","2003-2004",16,"Softball",115117,587374,-472257,0,0,0,115117,587374,-472257,".","19",0,218320
"350",199139,"UNIVERSITY OF NORTH CAROLINA AT CHARLOTTE                   ","2003-2004",1,"Baseball",14741,487633,-472892,14741,487633,-472892,0,0,0,"26",".",165748,0
"7210",151290,"INDIANA INSTITUTE OF TECHNOLOGY                             ","2003-2004",15,"Soccer",250,473770,-473520,125,249746,-249621,125,224024,-223899,"39","36",46045,35083
"3313",219806,"CARSON-NEWMAN COLLEGE                                       ","2003-2004",2,"Basketball",12176,486417,-474241,6671,251209,-244538,5505,235208,-229703,"13","17",29900,28798
"1688",217907,"COKER COLLEGE                                               ","2003-2004",2,"Basketball",53733,528003,-474270,31362,293064,-261702,22371,234939,-212568,"22","14",20155,41346
"1548",137351,"UNIVERSITY OF SOUTH FLORIDA                                 ","2003-2004",1,"Baseball",18788,493228,-474440,18788,493228,-474440,0,0,0,"32",".",140615,0
"2354",213543,"LEHIGH UNIVERSITY                                           ","2003-2004",2,"Basketball",963482,1438028,-474546,491986,679571,-187585,471496,758457,-286961,"15","15",120441,113587
"13001",151102,"INDIANA UNIVERSITY-PURDUE UNIVERSITY-FORT WAYNE             ","2003-2004",26,"Volleyball",81904,557008,-475104,62412,279430,-217018,19492,277578,-258086,"17","15",84397,44851
"16531",233295,"RANDOLPH-MACON COLLEGE                                      ","2003-2004",39,"Total Participants",20885,496044,-475159,13376,268868,-255492,7509,227176,-219667,"194","118",166755,97320
"11343",217882,"CLEMSON UNIVERSITY                                          ","2003-2004",22,"Tennis",297105,772486,-475381,108719,346326,-237607,188386,426160,-237774,"11","9",121468,97838
"8249",110635,"UNIVERSITY OF CALIFORNIA-BERKELEY                           ","2003-2004",15,"Soccer",779784,1255682,-475898,362749,545938,-183189,417035,709744,-292709,"27","27",89768,105698
"4859",181215,"UNIVERSITY OF NEBRASKA AT KEARNEY                           ","2003-2004",7,"Football",115031,591210,-476179,115031,591210,-476179,0,0,0,"117",".",83671,0
"1818",181215,"UNIVERSITY OF NEBRASKA AT KEARNEY                           ","2003-2004",2,"Basketball",117544,594966,-477422,70601,314124,-243523,46943,280842,-233899,"15","13",69713,62516
"7582",174066,"UNIVERSITY OF MINNESOTA-TWIN CITIES                         ","2003-2004",15,"Soccer",26410,503995,-477585,0,0,0,26410,503995,-477585,".","22",0,103381
"3106",227881,"SAM HOUSTON STATE UNIVERSITY                                ","2003-2004",2,"Basketball",251675,729948,-478273,178675,414515,-235840,73000,315433,-242433,"18","15",123787,64279
"4061",203517,"KENT STATE UNIVERSITY-MAIN CAMPUS                           ","2003-2004",6,"Field hocky",10523,489609,-479086,0,0,0,10523,489609,-479086,".","22",0,72958
"10970",135726,"UNIVERSITY OF MIAMI                                         ","2003-2004",22,"Tennis",312071,791252,-479181,103558,308425,-204867,208513,482827,-274314,"8","8",56943,73620
"3531",159647,"LOUISIANA TECH UNIVERSITY                                   ","2003-2004",3,"All Track Combined",134483,613741,-479258,65105,330983,-265878,69378,282758,-213380,"64","61",67964,63737
"1310",132903,"UNIVERSITY OF CENTRAL FLORIDA                               ","2003-2004",1,"Baseball",74513,553788,-479275,74513,553788,-479275,0,0,0,"40",".",167000,0
"17057",208822,"GEORGE FOX UNIVERSITY                                       ","2003-2004",39,"Total Participants",51885,531197,-479312,47864,303795,-255931,4021,227402,-223381,"128","117",191514,145322
"10148",182290,"UNIVERSITY OF NEVADA-RENO                                   ","2003-2004",18,"Swimming and Diving",100,479450,-479350,0,0,0,100,479450,-479350,".","25",0,114280
"7567",198385,"DAVIDSON COLLEGE                                            ","2003-2004",15,"Soccer",39424,518912,-479488,34699,282998,-248299,4725,235914,-231189,"26","27",44272,31966
"14949",171100,"MICHIGAN STATE UNIVERSITY                                   ","2003-2004",28,"Wrestling",89844,569563,-479719,89844,569563,-479719,0,0,0,"30",".",82053,0
"7722",176080,"MISSISSIPPI STATE UNIVERSITY                                ","2003-2004",15,"Soccer",25994,506286,-480292,0,0,0,25994,506286,-480292,".","28",0,71576
"10222",195164,"SAINT BONAVENTURE UNIVERSITY                                ","2003-2004",18,"Swimming and Diving",49418,530289,-480871,35870,269030,-233160,13548,261259,-247711,"25","19",28552,19123
"8456",133669,"FLORIDA ATLANTIC UNIVERSITY-BOCA RATON                      ","2003-2004",15,"Soccer",20977,501867,-480890,5309,232092,-226783,15668,269775,-254107,"29","31",71622,67316
"6317",215293,"UNIVERSITY OF PITTSBURGH-MAIN CAMPUS                        ","2003-2004",9,"Gymnastics",2153,483889,-481736,0,0,0,2153,483889,-481736,".","14",0,42408
"434",215293,"UNIVERSITY OF PITTSBURGH-MAIN CAMPUS                        ","2003-2004",1,"Baseball",0,481836,-481836,0,481836,-481836,0,0,0,"33",".",137953,0
"7539",219709,"BELMONT UNIVERSITY                                          ","2003-2004",15,"Soccer",89913,572058,-482145,47855,300150,-252295,42058,271908,-229850,"21","26",41339,36597
"6887",217882,"CLEMSON UNIVERSITY                                          ","2003-2004",13,"Rowing",270518,752995,-482477,0,0,0,270518,752995,-482477,".","73",0,188231
"14993",174066,"UNIVERSITY OF MINNESOTA-TWIN CITIES                         ","2003-2004",28,"Wrestling",148410,631658,-483248,148410,631658,-483248,0,0,0,"34",".",99681,0
"6689",214777,"PENNSYLVANIA STATE UNIVERSITY-MAIN CAMPUS                   ","2003-2004",11,"Lacrosse",536974,1020278,-483304,291495,536104,-244609,245479,484174,-238695,"38","31",66857,82402
"14845",151351,"INDIANA UNIVERSITY-BLOOMINGTON                              ","2003-2004",28,"Wrestling",2438,486012,-483574,2438,486012,-483574,0,0,0,"34",".",64276,0
"3534",228459,"TEXAS STATE UNIVERSITY-SAN MARCOS                           ","2003-2004",3,"All Track Combined",52660,536720,-484060,26330,240457,-214127,26330,296263,-269933,"53","38",54273,49752
"13484",202480,"UNIVERSITY OF DAYTON                                        ","2003-2004",26,"Volleyball",10888,495726,-484838,0,0,0,10888,495726,-484838,".","15",0,78601
"12771",132602,"BETHUNE COOKMAN COLLEGE                                     ","2003-2004",25,"Track and Field, X-Country",214764,700041,-485277,110312,323480,-213168,104452,376561,-272109,"13","24",97115,49348
"14248",139755,"GEORGIA INSTITUTE OF TECHNOLOGY-MAIN CAMPUS                 ","2003-2004",26,"Volleyball",281810,767413,-485603,0,0,0,281810,767413,-485603,".","16",0,152620
"6699",198419,"DUKE UNIVERSITY                                             ","2003-2004",11,"Lacrosse",131918,617692,-485774,126893,333721,-206828,5025,283971,-278946,"45","31",132891,134856
"10020",186380,"RUTGERS UNIVERSITY-NEW BRUNSWICK                            ","2003-2004",16,"Softball",14826,500777,-485951,0,0,0,14826,500777,-485951,".","17",0,104546
"15834",230746,"SALT LAKE COMMUNITY COLLEGE                                 ","2003-2004",39,"Total Participants",48783,534955,-486172,11945,243013,-231068,36838,291942,-255104,"45","41",88136,98992
"3716",179566,"SOUTHWEST MISSOURI STATE UNIVERSITY                         ","2003-2004",3,"All Track Combined",274942,761521,-486579,133480,350431,-216951,141462,411090,-269628,"29","31",55719,60587
"1781",151290,"INDIANA INSTITUTE OF TECHNOLOGY                             ","2003-2004",2,"Basketball",3294,490296,-487002,2711,278611,-275900,583,211685,-211102,"43","24",56535,34362
"7276",147703,"NORTHERN ILLINOIS UNIVERSITY                                ","2003-2004",15,"Soccer",166698,654242,-487544,72476,306403,-233927,94222,347839,-253617,"25","32",28525,54225
"8953",163286,"UNIVERSITY OF MARYLAND-COLLEGE PARK                         ","2003-2004",16,"Softball",1525,489542,-488017,0,0,0,1525,489542,-488017,".","18",0,105134
"2140",199102,"NORTH CAROLINA  A &amp;T STATE UNIVERSITY                       ","2003-2004",2,"Basketball",471739,959958,-488219,437379,529728,-92349,34360,430230,-395870,"17","14",83968,57493
"1071",217882,"CLEMSON UNIVERSITY                                          ","2003-2004",1,"Baseball",580506,1068951,-488445,580506,1068951,-488445,0,0,0,"33",".",245653,0
"6201",209551,"UNIVERSITY OF OREGON                                        ","2003-2004",8,"Golf",118337,607097,-488760,80020,302879,-222859,38317,304218,-265901,"13","8",67228,71199
"3973",206695,"YOUNGSTOWN STATE UNIVERSITY                                 ","2003-2004",3,"All Track Combined",19416,508596,-489180,9708,185542,-175834,9708,323054,-313346,"78","89",47154,54823
"3286",199157,"NORTH CAROLINA CENTRAL UNIVERSITY                           ","2003-2004",2,"Basketball",74846,564450,-489604,65197,316984,-251787,9649,247466,-237817,"14","11",83555,45558
"4197",157289,"UNIVERSITY OF LOUISVILLE                                    ","2003-2004",6,"Field hocky",13785,503454,-489669,0,0,0,13785,503454,-489669,".","25",0,63258
"16562",215132,"UNIVERSITY OF THE SCIENCES IN PHILADELPHIA                  ","2003-2004",39,"Total Participants",9,490757,-490748,5,245012,-245007,4,245745,-245741,"82","68",43400,41700
"1728",181394,"UNIVERSITY OF NEBRASKA AT OMAHA                             ","2003-2004",2,"Basketball",301077,791889,-490812,222854,442427,-219573,78223,349462,-271239,"14","15",66834,66583
"10671",231624,"COLLEGE OF WILLIAM AND MARY                                 ","2003-2004",22,"Tennis",165467,657045,-491578,92454,255043,-162589,73013,402002,-328989,"10","10",53885,51009
"2658",136172,"UNIVERSITY OF NORTH FLORIDA                                 ","2003-2004",2,"Basketball",155382,647161,-491779,85978,345003,-259025,69404,302158,-232754,"15","17",54247,65811
"3717",199102,"NORTH CAROLINA  A &amp;T STATE UNIVERSITY                       ","2003-2004",3,"All Track Combined",90575,582486,-491911,38125,249743,-211618,52450,332743,-280293,"62","45",50745,42570
"10376",133669,"FLORIDA ATLANTIC UNIVERSITY-BOCA RATON                      ","2003-2004",18,"Swimming and Diving",1235,493195,-491960,685,159370,-158685,550,333825,-333275,"14","22",41020,46204
"5494",151351,"INDIANA UNIVERSITY-BLOOMINGTON                              ","2003-2004",8,"Golf",13056,505603,-492547,10136,267481,-257345,2920,238122,-235202,"15","11",50087,44762
"6367",106397,"UNIVERSITY OF ARKANSAS MAIN CAMPUS                          ","2003-2004",9,"Gymnastics",660059,1153113,-493054,0,0,0,660059,1153113,-493054,"0","13",0,179067
"13040",135726,"UNIVERSITY OF MIAMI                                         ","2003-2004",26,"Volleyball",342794,836737,-493943,0,0,0,342794,836737,-493943,".","16",0,113183
"10769",163286,"UNIVERSITY OF MARYLAND-COLLEGE PARK                         ","2003-2004",22,"Tennis",0,494209,-494209,0,154817,-154817,0,339392,-339392,"10","9",37680,59863
"10504",106397,"UNIVERSITY OF ARKANSAS MAIN CAMPUS                          ","2003-2004",19,"Swimming",99106,593814,-494708,0,0,0,99106,593814,-494708,"0","23",0,86280
"4715",142115,"BOISE STATE UNIVERSITY                                      ","2003-2004",7,"Football",2824122,3318890,-494768,2824122,3318890,-494768,0,0,0,"115",".",678659,0
"3587",231624,"COLLEGE OF WILLIAM AND MARY                                 ","2003-2004",3,"All Track Combined",258883,754177,-495294,184937,346222,-161285,73946,407955,-334009,"126","138",87481,88999
"2467",110617,"CALIFORNIA STATE UNIVERSITY-SACRAMENTO                      ","2003-2004",2,"Basketball",427322,927749,-500427,249477,455866,-206389,177845,471883,-294038,"15","18",156325,150222
"3915",129020,"UNIVERSITY OF CONNECTICUT                                   ","2003-2004",3,"All Track Combined",51001,552540,-501539,51000,376767,-325767,1,175773,-175772,"38","44",186513,102973
"11164",139755,"GEORGIA INSTITUTE OF TECHNOLOGY-MAIN CAMPUS                 ","2003-2004",22,"Tennis",261130,762782,-501652,138364,378139,-239775,122766,384643,-261877,"11","7",69392,62603
"4722",201104,"ASHLAND UNIVERSITY                                          ","2003-2004",7,"Football",1206593,1708864,-502271,1206593,1708864,-502271,0,0,0,"96",".",76622,0
"4127",234076,"UNIVERSITY OF VIRGINIA-MAIN CAMPUS                          ","2003-2004",6,"Field hocky",34931,537726,-502795,0,0,0,34931,537726,-502795,".","18",0,57679
"6299",126614,"UNIVERSITY OF COLORADO AT BOULDER                           ","2003-2004",8,"Golf",128529,632353,-503824,66503,272552,-206049,62026,359801,-297775,"9","13",83527,65065
"15625",140960,"SAVANNAH STATE UNIVERSITY                                   ","2003-2004",39,"Total Participants",0,504692,-504692,0,231609,-231609,0,273083,-273083,"90","73",613393,231674
"7849",122755,"SAN JOSE STATE UNIVERSITY                                   ","2003-2004",15,"Soccer",11655,516777,-505122,6468,274056,-267588,5187,242721,-237534,"23","26",53685,59068
"15901",152530,"TAYLOR UNIVERSITY-UPLAND                                    ","2003-2004",39,"Total Participants",87222,592694,-505472,48419,274398,-225979,38803,318296,-279493,"165","93",283285,150930
"5094",222831,"ANGELO STATE UNIVERSITY                                     ","2003-2004",7,"Football",73263,578853,-505590,73263,578853,-505590,0,0,0,"101",".",110502,0
"6368",104179,"UNIVERSITY OF ARIZONA                                       ","2003-2004",9,"Gymnastics",237124,742928,-505804,0,0,0,237124,742928,-505804,".","16",0,80560
"7507",196413,"SYRACUSE UNIVERSITY                                         ","2003-2004",15,"Soccer",1279422,1785960,-506538,607092,863759,-256667,672330,922201,-249871,"33","30",68170,77272
"7636",172699,"WESTERN MICHIGAN UNIVERSITY                                 ","2003-2004",15,"Soccer",81109,587838,-506729,34722,249865,-215143,46387,337973,-291586,"27","26",56091,58649
"17052",162654,"GOUCHER COLLEGE                                             ","2003-2004",39,"Total Participants",95101,601883,-506782,42662,205962,-163300,52439,395921,-343482,"96","145",85457,152221
"10187",201885,"UNIVERSITY OF CINCINNATI-MAIN CAMPUS                        ","2003-2004",18,"Swimming and Diving",134825,641752,-506927,133853,239061,-105208,972,402691,-401719,"15","21",57396,71985
"5858",229115,"TEXAS TECH UNIVERSITY                                       ","2003-2004",8,"Golf",16300,525060,-508760,2700,250632,-247932,13600,274428,-260828,"15","10",71990,82529
"16776",144892,"EASTERN ILLINOIS UNIVERSITY                                 ","2003-2004",39,"Total Participants",1645268,2154351,-509083,684359,906027,-221668,960909,1248324,-287415,"347","238",638918,424170
"9138",207388,"OKLAHOMA STATE UNIVERSITY-MAIN CAMPUS                       ","2003-2004",16,"Softball",169359,678480,-509121,0,0,0,169359,678480,-509121,".","18",0,168532
"7747",110705,"UNIVERSITY OF CALIFORNIA-SANTA BARBARA                      ","2003-2004",15,"Soccer",173141,682329,-509188,130299,342648,-212349,42842,339681,-296839,"25","25",46851,49207
"4058",243744,"STANFORD UNIVERSITY                                         ","2003-2004",6,"Field hocky",42080,551454,-509374,0,0,0,42080,551454,-509374,".","19",0,79383
"16040",207740,"SEMINOLE STATE COLLEGE                                      ","2003-2004",39,"Total Participants",194792,704204,-509412,91075,356946,-265871,103717,347258,-243541,"68","58",126794,93232
"9385",217402,"PROVIDENCE COLLEGE                                          ","2003-2004",16,"Softball",750,510713,-509963,0,0,0,750,510713,-509963,".","17",0,79818
"16937",198969,"METHODIST COLLEGE                                           ","2003-2004",39,"Total Participants",76083,586184,-510101,48484,303214,-254730,27599,282970,-255371,"309","144",182396,102917
"878",110608,"CALIFORNIA STATE UNIVERSITY-NORTHRIDGE                      ","2003-2004",1,"Baseball",56041,566221,-510180,56041,566221,-510180,0,0,0,"35",".",208526,0
"3495",110422,"CALIFORNIA POLYTECHNIC STATE UNIV-SAN LUIS OBISPO           ","2003-2004",3,"All Track Combined",28434,538892,-510458,17976,206413,-188437,10458,332479,-322021,"46","86",39901,53508
"115",182281,"UNIVERSITY OF NEVADA-LAS VEGAS                              ","2003-2004",1,"Baseball",163511,674502,-510991,163511,674502,-510991,0,0,0,"33",".",201082,0
"16915",217633,"ANDERSON COLLEGE                                            ","2003-2004",39,"Total Participants",671548,1182891,-511343,389673,659262,-269589,281875,523629,-241754,"180","120",201446,168497
"4012",152080,"UNIVERSITY OF NOTRE DAME                                    ","2003-2004",5,"Fencing",26508,539322,-512814,13189,207864,-194675,13319,331458,-318139,"27","22",41647,71151
"1881",237525,"MARSHALL UNIVERSITY                                         ","2003-2004",2,"Basketball",1597005,2109871,-512866,1070775,1249801,-179026,526230,860070,-333840,"13","17",282165,151385
"14570",153603,"IOWA STATE UNIVERSITY                                       ","2003-2004",26,"Volleyball",206509,719537,-513028,0,0,0,206509,719537,-513028,".","15",0,224245
"11004",131159,"AMERICAN UNIVERSITY                                         ","2003-2004",22,"Tennis",2300,516207,-513907,1225,241821,-240596,1075,274386,-273311,"11","11",47224,38195
"9684",225511,"UNIVERSITY OF HOUSTON-UNIVERSITY PARK                       ","2003-2004",16,"Softball",5466,520354,-514888,0,0,0,5466,520354,-514888,".","19",0,124261
"3783",233374,"UNIVERSITY OF RICHMOND                                      ","2003-2004",3,"All Track Combined",81353,596264,-514911,42000,126568,-84568,39353,469696,-430343,"20","39",51627,77976
"6324",238032,"WEST VIRGINIA UNIVERSITY                                    ","2003-2004",9,"Gymnastics",63333,578244,-514911,0,0,0,63333,578244,-514911,".","17",0,103865
"10097",206084,"UNIVERSITY OF TOLEDO                                        ","2003-2004",18,"Swimming and Diving",18052,533545,-515493,0,0,0,18052,533545,-515493,".","27",0,35844
"10532",230764,"UNIVERSITY OF UTAH                                          ","2003-2004",19,"Swimming",126300,642727,-516427,54752,302636,-247884,71548,340091,-268543,"23","26",79813,86464
"11337",157289,"UNIVERSITY OF LOUISVILLE                                    ","2003-2004",22,"Tennis",54155,570814,-516659,36277,255735,-219458,17878,315079,-297201,"11","10",51607,36409
"3632",230728,"UTAH STATE UNIVERSITY                                       ","2003-2004",3,"All Track Combined",30500,548321,-517821,15250,236061,-220811,15250,312260,-297010,"49","42",57000,49330
"2909",149772,"WESTERN ILLINOIS UNIVERSITY                                 ","2003-2004",2,"Basketball",711995,1229888,-517893,445746,681332,-235586,266249,548556,-282307,"16","18",185055,171946
"2363",200004,"WESTERN CAROLINA UNIVERSITY                                 ","2003-2004",2,"Basketball",447396,965309,-517913,419285,545600,-126315,28111,419709,-391598,"12","11",182063,113739
"4321",219471,"UNIVERSITY OF SOUTH DAKOTA                                  ","2003-2004",7,"Football",675263,1193438,-518175,675263,1193438,-518175,0,0,0,"102",".",91518,0
"6319",178396,"UNIVERSITY OF MISSOURI-COLUMBIA                             ","2003-2004",9,"Gymnastics",39416,557591,-518175,0,0,0,39416,557591,-518175,".","20",0,72577
"16188",233426,"ROANOKE COLLEGE                                             ","2003-2004",39,"Total Participants",45168,563896,-518728,24287,266758,-242471,20881,297138,-276257,"180","185",154020,171013
"9023",215293,"UNIVERSITY OF PITTSBURGH-MAIN CAMPUS                        ","2003-2004",16,"Softball",0,518849,-518849,0,0,0,0,518849,-518849,".","16",0,103281
"15596",180814,"BELLEVUE UNIVERSITY                                         ","2003-2004",39,"Total Participants",4200,524630,-520430,1500,245045,-243545,2700,279585,-276885,"71","43",172820,134585
"9687",240444,"UNIVERSITY OF WISCONSIN-MADISON                             ","2003-2004",16,"Softball",223787,744560,-520773,0,0,0,223787,744560,-520773,".","24",0,166793
"3942",149222,"SOUTHERN ILLINOIS UNIVERSITY-CARBONDALE                     ","2003-2004",3,"All Track Combined",256174,777683,-521509,115531,372170,-256639,140643,405513,-264870,"72","77",73581,67685
"2415",223427,"BLINN COLLEGE                                               ","2003-2004",2,"Basketball",6562,528165,-521603,490,242663,-242173,6072,285502,-279430,"14","14",22084,23903
"6984",236939,"WASHINGTON STATE UNIVERSITY                                 ","2003-2004",13,"Rowing",266969,788635,-521666,0,0,0,266969,788635,-521666,".","87",0,272741
"16244",190761,"DOMINICAN COLLEGE OF BLAUVELT                               ","2003-2004",39,"Total Participants",100495,622451,-521956,67034,385338,-318304,33461,237113,-203652,"100","70",89748,59460
"7772",201885,"UNIVERSITY OF CINCINNATI-MAIN CAMPUS                        ","2003-2004",15,"Soccer",312547,835042,-522495,200407,384759,-184352,112140,450283,-338143,"23","25",66792,66042
"15774",101161,"JAMES H FAULKNER STATE COMMUNITY COLLEGE                    ","2003-2004",39,"Total Participants",88456,611998,-523542,53089,352122,-299033,35367,259876,-224509,"72","63",121382,80103
"15614",228981,"TEXAS LUTHERAN UNIVERSITY                                   ","2003-2004",39,"Total Participants",69621,593775,-524154,33806,263499,-229693,35815,330276,-294461,"227","139",286689,159010
"9989",234076,"UNIVERSITY OF VIRGINIA-MAIN CAMPUS                          ","2003-2004",16,"Softball",44020,568904,-524884,0,0,0,44020,568904,-524884,".","18",0,124045
"12294",166629,"UNIVERSITY OF MASSACHUSETTS-AMHERST                         ","2003-2004",25,"Track and Field, X-Country",11849,536760,-524911,10331,211371,-201040,1518,325389,-323871,"75","109",52514,82254
"14285",236939,"WASHINGTON STATE UNIVERSITY                                 ","2003-2004",26,"Volleyball",343203,868416,-525213,0,0,0,343203,868416,-525213,".","18",0,207570
"4961",162007,"BOWIE STATE UNIVERSITY                                      ","2003-2004",7,"Football",26899,552165,-525266,26899,552165,-525266,0,0,0,"61",".",72645,0
"13853",126818,"COLORADO STATE UNIVERSITY                                   ","2003-2004",26,"Volleyball",377973,904264,-526291,0,0,0,377973,904264,-526291,".","18",0,172133
"8688",157289,"UNIVERSITY OF LOUISVILLE                                    ","2003-2004",16,"Softball",24485,551053,-526568,0,0,0,24485,551053,-526568,".","17",0,97234
"11612",145637,"UNIVERSITY OF ILLINOIS AT URBANA-CHAMPAIGN                  ","2003-2004",22,"Tennis",383034,910692,-527658,192308,514936,-322628,190726,395756,-205030,"8","12",119340,105368
"1799",132602,"BETHUNE COOKMAN COLLEGE                                     ","2003-2004",2,"Basketball",589115,1116951,-527836,332315,626288,-293973,256800,490663,-233863,"11","16",260812,157871
"1462",220862,"UNIVERSITY OF MEMPHIS                                       ","2003-2004",1,"Baseball",101406,629673,-528267,101406,629673,-528267,0,0,0,"30",".",195500,0
"5629",163286,"UNIVERSITY OF MARYLAND-COLLEGE PARK                         ","2003-2004",8,"Golf",0,528323,-528323,0,233389,-233389,0,294934,-294934,"11","10",51681,48470
"6886",196088,"SUNY AT BUFFALO                                             ","2003-2004",13,"Rowing",10392,539024,-528632,0,0,0,10392,539024,-528632,".","64",0,138611
"14480",234076,"UNIVERSITY OF VIRGINIA-MAIN CAMPUS                          ","2003-2004",26,"Volleyball",43687,573077,-529390,0,0,0,43687,573077,-529390,".","15",0,65876
"17350",188304,"WESTERN NEW MEXICO UNIVERSITY                               ","2003-2004",39,"Total Participants",45651,577387,-531736,2,138582,-138580,45649,438805,-393156,"103","59",149277,178496
"7681",231624,"COLLEGE OF WILLIAM AND MARY                                 ","2003-2004",15,"Soccer",151863,684108,-532245,82216,307904,-225688,69647,376204,-306557,"26","25",54504,74838
"14471",225511,"UNIVERSITY OF HOUSTON-UNIVERSITY PARK                       ","2003-2004",26,"Volleyball",4891,537148,-532257,0,0,0,4891,537148,-532257,".","14",0,66986
"3726",232186,"GEORGE MASON UNIVERSITY                                     ","2003-2004",3,"All Track Combined",517644,1049952,-532308,252814,472635,-219821,264830,577317,-312487,"23","28",97484,123772
"17099",221740,"THE UNIVERSITY OF TENNESSEE-CHATTANOOGA                     ","2003-2004",39,"Total Participants",221432,754983,-533551,121616,232538,-110922,99816,522445,-422629,"202","100",562732,284125
"6235",157289,"UNIVERSITY OF LOUISVILLE                                    ","2003-2004",8,"Golf",103568,637510,-533942,70255,329495,-259240,33313,308015,-274702,"10","8",64058,78430
"14566",131159,"AMERICAN UNIVERSITY                                         ","2003-2004",26,"Volleyball",4326,539766,-535440,0,0,0,4326,539766,-535440,".","15",0,63728
"14370",164924,"BOSTON COLLEGE                                              ","2003-2004",26,"Volleyball",5458,541110,-535652,0,0,0,5458,541110,-535652,".","11",0,62447
"3633",199139,"UNIVERSITY OF NORTH CAROLINA AT CHARLOTTE                   ","2003-2004",3,"All Track Combined",53147,588971,-535824,30365,271045,-240680,22782,317926,-295144,"39","42",77494,106067
"4277",110617,"CALIFORNIA STATE UNIVERSITY-SACRAMENTO                      ","2003-2004",7,"Football",752301,1289136,-536835,752301,1289136,-536835,0,0,0,"87",".",305968,0
"11039",240444,"UNIVERSITY OF WISCONSIN-MADISON                             ","2003-2004",22,"Tennis",185154,722110,-536956,73811,307230,-233419,111343,414880,-303537,"10","10",65602,81662
"10538",198464,"EAST CAROLINA UNIVERSITY                                    ","2003-2004",19,"Swimming",53850,590821,-536971,7425,232991,-225566,46425,357830,-311405,"24","28",61997,61226
"3865",151324,"INDIANA STATE UNIVERSITY                                    ","2003-2004",3,"All Track Combined",227492,764486,-536994,111192,357288,-246096,116300,407198,-290898,"109","115",58375,74295
"6376",163286,"UNIVERSITY OF MARYLAND-COLLEGE PARK                         ","2003-2004",9,"Gymnastics",167,537673,-537506,0,0,0,167,537673,-537506,".","17",0,80756
"3311",220215,"FREED-HARDEMAN UNIVERSITY                                   ","2003-2004",2,"Basketball",73120,610746,-537626,39000,311775,-272775,34120,298971,-264851,"15","14",35492,30662
"15563",138983,"AUGUSTA STATE UNIVERSITY                                    ","2003-2004",39,"Total Participants",352219,890170,-537951,124303,385079,-260776,227916,505091,-277175,"63","66",124931,135849
"3507",106458,"ARKANSAS STATE UNIVERSITY-MAIN CAMPUS                       ","2003-2004",3,"All Track Combined",5766,544479,-538713,3791,259002,-255211,1975,285477,-283502,"68","67",79120,72799
"6971",164988,"BOSTON UNIVERSITY                                           ","2003-2004",13,"Rowing",365509,904446,-538937,203278,425879,-222601,162231,478567,-316336,"86","79",186118,176135
"6065",134097,"FLORIDA STATE UNIVERSITY                                    ","2003-2004",8,"Golf",57594,596537,-538943,31853,334992,-303139,25741,261545,-235804,"8","11",66210,74231
"3863",142115,"BOISE STATE UNIVERSITY                                      ","2003-2004",3,"All Track Combined",108693,648576,-539883,50301,298858,-248557,58392,349718,-291326,"31","35",47414,47414
"16583",204617,"OHIO DOMINICAN UNIVERSITY                                   ","2003-2004",39,"Total Participants",51879,592349,-540470,31704,309773,-278069,20175,282576,-262401,"80","72",68335,79065
"3653",190150,"COLUMBIA UNIVERSITY IN THE CITY OF NEW YORK                 ","2003-2004",3,"All Track Combined",28550,569332,-540782,14275,279259,-264984,14275,290073,-275798,"135","135",81901,84888
"13427",155317,"UNIVERSITY OF KANSAS MAIN CAMPUS                            ","2003-2004",26,"Volleyball",42236,583129,-540893,0,0,0,42236,583129,-540893,".","17",0,154083
"836",171100,"MICHIGAN STATE UNIVERSITY                                   ","2003-2004",1,"Baseball",88466,629472,-541006,88466,629472,-541006,0,0,0,"30",".",177633,0
"744",199193,"NORTH CAROLINA STATE UNIVERSITY AT RALEIGH                  ","2003-2004",1,"Baseball",25000,566323,-541323,25000,566323,-541323,0,0,0,"37",".",185000,0
"12337",201885,"UNIVERSITY OF CINCINNATI-MAIN CAMPUS                        ","2003-2004",25,"Track and Field, X-Country",245029,787135,-542106,4754,349880,-345126,240275,437255,-196980,"68","95",68475,86347
"13513",182281,"UNIVERSITY OF NEVADA-LAS VEGAS                              ","2003-2004",26,"Volleyball",57149,599399,-542250,0,0,0,57149,599399,-542250,".","15",0,114662
"6304",230764,"UNIVERSITY OF UTAH                                          ","2003-2004",9,"Gymnastics",287426,829885,-542459,0,0,0,287426,829885,-542459,".","12",0,120595
"14945",204796,"OHIO STATE UNIVERSITY-MAIN CAMPUS                           ","2003-2004",28,"Wrestling",659825,1202448,-542623,659825,1202448,-542623,0,0,0,"36",".",96656,0
"14796",104151,"ARIZONA STATE UNIVERSITY-MAIN CAMPUS                        ","2003-2004",28,"Wrestling",75162,617859,-542697,75162,617859,-542697,0,0,0,"30",".",133918,0
"13395",240444,"UNIVERSITY OF WISCONSIN-MADISON                             ","2003-2004",26,"Volleyball",393802,936533,-542731,0,0,0,393802,936533,-542731,".","13",0,214800
"331",207500,"UNIVERSITY OF OKLAHOMA NORMAN CAMPUS                        ","2003-2004",1,"Baseball",231893,775442,-543549,231893,775442,-543549,0,0,0,"36",".",264074,0
"2781",180179,"MONTANA STATE UNIVERSITY-BILLINGS                           ","2003-2004",2,"Basketball",134091,677724,-543633,99882,386917,-287035,34209,290807,-256598,"13","12",87987,99024
"3909",179557,"SOUTHEAST MISSOURI STATE UNIVERSITY                         ","2003-2004",3,"All Track Combined",1814,546574,-544760,907,241381,-240474,907,305193,-304286,"28","32",51184,51560
"3903",232265,"HAMPTON UNIVERSITY                                          ","2003-2004",3,"All Track Combined",312641,857898,-545257,144907,334180,-189273,167734,523718,-355984,"25","32",144907,167734
"10589",238032,"WEST VIRGINIA UNIVERSITY                                    ","2003-2004",19,"Swimming",12476,557868,-545392,6238,249418,-243180,6238,308450,-302212,"26","19",51446,46434
"14385",172699,"WESTERN MICHIGAN UNIVERSITY                                 ","2003-2004",26,"Volleyball",84308,629813,-545505,0,0,0,84308,629813,-545505,".","14",0,110541
"14714",170976,"UNIVERSITY OF MICHIGAN-ANN ARBOR                            ","2003-2004",27,"Water Polo",9371,555038,-545667,0,0,0,9371,555038,-545667,".","36",0,107704
"7808",110608,"CALIFORNIA STATE UNIVERSITY-NORTHRIDGE                      ","2003-2004",15,"Soccer",34176,580164,-545988,27854,313346,-285492,6322,266818,-260496,"28","29",74600,54783
"9206",182290,"UNIVERSITY OF NEVADA-RENO                                   ","2003-2004",16,"Softball",6735,553305,-546570,0,0,0,6735,553305,-546570,".","20",0,154175
"6683",243744,"STANFORD UNIVERSITY                                         ","2003-2004",11,"Lacrosse",72054,618868,-546814,0,0,0,72054,618868,-546814,".","24",0,86265
"9480",216597,"VILLANOVA UNIVERSITY                                        ","2003-2004",16,"Softball",22062,569834,-547772,0,0,0,22062,569834,-547772,".","20",0,69126
"11046",239105,"MARQUETTE UNIVERSITY                                        ","2003-2004",22,"Tennis",22394,570203,-547809,4968,244507,-239539,17426,325696,-308270,"8","10",44576,75245
"7383",213385,"LAFAYETTE COLLEGE                                           ","2003-2004",15,"Soccer",184708,733080,-548372,76041,383379,-307338,108667,349701,-241034,"27","34",48390,42780
"3048",110583,"CALIFORNIA STATE UNIVERSITY-LONG BEACH                      ","2003-2004",2,"Basketball",1304339,1852930,-548591,710708,1041610,-330902,593631,811320,-217689,"17","16",177813,145339
"7879",199193,"NORTH CAROLINA STATE UNIVERSITY AT RALEIGH                  ","2003-2004",15,"Soccer",200,550409,-550209,100,275325,-275225,100,275084,-274984,"28","27",93000,96160
"2514",199111,"UNIVERSITY OF NORTH CAROLINA AT ASHEVILLE                   ","2003-2004",2,"Basketball",338022,888775,-550753,323566,426080,-102514,14456,462695,-448239,"15","14",105374,68119
"14803",209542,"OREGON STATE UNIVERSITY                                     ","2003-2004",28,"Wrestling",22261,573398,-551137,22261,573398,-551137,0,0,0,"27",".",118350,0
"9272",157085,"UNIVERSITY OF KENTUCKY                                      ","2003-2004",16,"Softball",0,551359,-551359,0,0,0,0,551359,-551359,".","20",0,213300
"826",179159,"SAINT LOUIS UNIVERSITY-MAIN CAMPUS                          ","2003-2004",1,"Baseball",3567,555358,-551791,3567,555358,-551791,0,0,0,"35",".",99989,0
"10993",171100,"MICHIGAN STATE UNIVERSITY                                   ","2003-2004",22,"Tennis",123347,675958,-552611,108327,329175,-220848,15020,346783,-331763,"10","13",91564,51978
"8652",176017,"UNIVERSITY OF MISSISSIPPI MAIN CAMPUS                       ","2003-2004",16,"Softball",17325,570705,-553380,0,0,0,17325,570705,-553380,".","18",0,152517
"2025",221740,"THE UNIVERSITY OF TENNESSEE-CHATTANOOGA                     ","2003-2004",2,"Basketball",376272,929849,-553577,339200,615968,-276768,37072,313881,-276809,"14","13",196155,54237
"2270",198215,"CATAWBA COLLEGE                                             ","2003-2004",2,"Basketball",115483,669111,-553628,60075,341316,-281241,55408,327795,-272387,"12","16",35725,38558
"6357",214777,"PENNSYLVANIA STATE UNIVERSITY-MAIN CAMPUS                   ","2003-2004",9,"Gymnastics",629124,1184142,-555018,219175,505120,-285945,409949,679022,-269073,"21","18",103045,103313
"833",122755,"SAN JOSE STATE UNIVERSITY                                   ","2003-2004",1,"Baseball",20531,575567,-555036,20531,575567,-555036,0,0,0,"38",".",151746,0
"2369",145600,"UNIVERSITY OF ILLINOIS AT CHICAGO                           ","2003-2004",2,"Basketball",1028987,1584443,-555456,1004914,956207,48707,24073,628236,-604163,"15","14",171392,117792
"3568",191931,"IONA COLLEGE                                                ","2003-2004",3,"All Track Combined",24740,580322,-555582,18940,390307,-371367,5800,190015,-184215,"33","21",53786,16223
"15440",218964,"WINTHROP UNIVERSITY                                         ","2003-2004",39,"Total Participants",1371680,1927710,-556030,728926,926215,-197289,642754,1001495,-358741,"123","120",364092,318628
"4015",204796,"OHIO STATE UNIVERSITY-MAIN CAMPUS                           ","2003-2004",5,"Fencing",73606,630136,-556530,36928,299452,-262524,36678,330684,-294006,"20","13",20037,21166
"4563",230782,"WEBER STATE UNIVERSITY                                      ","2003-2004",7,"Football",840904,1397477,-556573,840904,1397477,-556573,0,0,0,"99",".",208693,0
"3906",227216,"UNIVERSITY OF NORTH TEXAS                                   ","2003-2004",3,"All Track Combined",0,556945,-556945,0,245646,-245646,0,311299,-311299,"124","135",71354,71354
"10301",155317,"UNIVERSITY OF KANSAS MAIN CAMPUS                            ","2003-2004",18,"Swimming and Diving",21182,578477,-557295,0,0,0,21182,578477,-557295,".","37",0,137177
"1750",151102,"INDIANA UNIVERSITY-PURDUE UNIVERSITY-FORT WAYNE             ","2003-2004",2,"Basketball",346236,904488,-558252,321971,530068,-208097,24265,374420,-350155,"15","15",162255,97368
"6909",130794,"YALE UNIVERSITY                                             ","2003-2004",13,"Rowing",751589,1310341,-558752,501059,945081,-444022,250530,365260,-114730,"98","50",405116,180421
"547",145600,"UNIVERSITY OF ILLINOIS AT CHICAGO                           ","2003-2004",1,"Baseball",31735,590492,-558757,31735,590492,-558757,0,0,0,"28",".",152485,0
"1210",225511,"UNIVERSITY OF HOUSTON-UNIVERSITY PARK                       ","2003-2004",1,"Baseball",188623,747401,-558778,188623,747401,-558778,0,0,0,"35",".",182164,0
"4449",196060,"SUNY AT ALBANY                                              ","2003-2004",7,"Football",58534,617425,-558891,58534,617425,-558891,0,0,0,"89",".",133162,0
"15565",206996,"CONNORS STATE COLLEGE                                       ","2003-2004",39,"Total Participants",585,559934,-559349,582,371192,-370610,3,188742,-188739,"115","32",576982,232024
"13134",176080,"MISSISSIPPI STATE UNIVERSITY                                ","2003-2004",26,"Volleyball",24,559643,-559619,0,0,0,24,559643,-559619,".","12",0,86816
"10312",131159,"AMERICAN UNIVERSITY                                         ","2003-2004",18,"Swimming and Diving",1805,561719,-559914,875,264008,-263133,930,297711,-296781,"13","14",24618,27760
"13063",176017,"UNIVERSITY OF MISSISSIPPI MAIN CAMPUS                       ","2003-2004",26,"Volleyball",25640,585998,-560358,0,0,0,25640,585998,-560358,".","13",0,137341
"16399",156365,"CAMPBELLSVILLE UNIVERSITY                                   ","2003-2004",39,"Total Participants",149977,710531,-560554,80875,389469,-308594,69102,321062,-251960,"248","77",211328,99790
"15971",100830,"AUBURN UNIVERSITY-MONTGOMERY                                ","2003-2004",39,"Total Participants",167687,728765,-561078,105403,491542,-386139,62284,237223,-174939,"79","35",88284,55913
"13857",229115,"TEXAS TECH UNIVERSITY                                       ","2003-2004",26,"Volleyball",70195,632634,-562439,0,0,0,70195,632634,-562439,".","16",0,129942
"13493",144740,"DEPAUL UNIVERSITY                                           ","2003-2004",26,"Volleyball",20774,584092,-563318,0,0,0,20774,584092,-563318,".","12",0,80054
"8475",159391,"LOUISIANA STATE UNIV &amp; AG &amp; MECH &amp; HEBERT LAWS CTR          ","2003-2004",15,"Soccer",7098,570530,-563432,0,0,0,7098,570530,-563432,".","32",0,127576
"10355",135726,"UNIVERSITY OF MIAMI                                         ","2003-2004",18,"Swimming and Diving",452015,1015566,-563551,61118,99639,-38521,390897,915927,-525030,"3","23",12467,73780
"15253",207388,"OKLAHOMA STATE UNIVERSITY-MAIN CAMPUS                       ","2003-2004",34,"Equestrian",131372,694983,-563611,0,0,0,131372,694983,-563611,".","63",0,207354
"4986",221740,"THE UNIVERSITY OF TENNESSEE-CHATTANOOGA                     ","2003-2004",7,"Football",363488,927184,-563696,363488,927184,-563696,0,0,0,"104",".",255155,0
"14195",206084,"UNIVERSITY OF TOLEDO                                        ","2003-2004",26,"Volleyball",10743,574478,-563735,0,0,0,10743,574478,-563735,".","13",0,62897
"13884",163286,"UNIVERSITY OF MARYLAND-COLLEGE PARK                         ","2003-2004",26,"Volleyball",7593,572383,-564790,0,0,0,7593,572383,-564790,".","16",0,118288
"8240",228778,"THE UNIVERSITY OF TEXAS AT AUSTIN                           ","2003-2004",15,"Soccer",509678,1075473,-565795,0,0,0,509678,1075473,-565795,".","26",0,197418
"846",163286,"UNIVERSITY OF MARYLAND-COLLEGE PARK                         ","2003-2004",1,"Baseball",2040,568311,-566271,2040,568311,-566271,0,0,0,"32",".",215204,0
"16183",198871,"LOUISBURG COLLEGE                                           ","2003-2004",39,"Total Participants",7,566697,-566690,3,336453,-336450,4,230244,-230240,"78","68",102654,82643
"5990",104151,"ARIZONA STATE UNIVERSITY-MAIN CAMPUS                        ","2003-2004",8,"Golf",333675,900479,-566804,188969,441941,-252972,144706,458538,-313832,"15","15",126346,115812
"2048",221768,"THE UNIVERSITY OF TENNESSEE-MARTIN                          ","2003-2004",2,"Basketball",277539,844924,-567385,239861,454819,-214958,37678,390105,-352427,"14","15",66481,63239
"2484",142115,"BOISE STATE UNIVERSITY                                      ","2003-2004",2,"Basketball",931693,1499346,-567653,883351,849573,33778,48342,649773,-601431,"16","13",179872,152424
"10448",181464,"UNIVERSITY OF NEBRASKA AT LINCOLN                           ","2003-2004",18,"Swimming and Diving",33692,601714,-568022,0,0,0,33692,601714,-568022,".","26",0,87706
"3596",182281,"UNIVERSITY OF NEVADA-LAS VEGAS                              ","2003-2004",3,"All Track Combined",107135,676078,-568943,0,0,0,107135,676078,-568943,".","39",0,165532
"4035",163286,"UNIVERSITY OF MARYLAND-COLLEGE PARK                         ","2003-2004",6,"Field hocky",3384,572686,-569302,0,0,0,3384,572686,-569302,".","24",0,90610
"8131",131496,"GEORGETOWN UNIVERSITY                                       ","2003-2004",15,"Soccer",192817,762473,-569656,170926,382439,-211513,21891,380034,-358143,"26","22",143852,77821
"9079",106397,"UNIVERSITY OF ARKANSAS MAIN CAMPUS                          ","2003-2004",16,"Softball",124987,695610,-570623,0,0,0,124987,695610,-570623,".","23",0,191105
"16885",164216,"WASHINGTON COLLEGE                                          ","2003-2004",39,"Total Participants",187799,758556,-570757,99209,348098,-248889,88590,410458,-321868,"149","182",126539,184089
"8350",106397,"UNIVERSITY OF ARKANSAS MAIN CAMPUS                          ","2003-2004",15,"Soccer",73370,644482,-571112,0,0,0,73370,644482,-571112,"0","26",0,132397
"14932",147767,"NORTHWESTERN UNIVERSITY                                     ","2003-2004",28,"Wrestling",7976,579104,-571128,7976,579104,-571128,0,0,0,"21",".",81813,0
"6997",132903,"UNIVERSITY OF CENTRAL FLORIDA                               ","2003-2004",13,"Rowing",109429,680582,-571153,0,0,0,109429,680582,-571153,".","98",0,157859
"16386",185590,"MONTCLAIR STATE UNIVERSITY                                  ","2003-2004",39,"Total Participants",208857,780252,-571395,116154,372271,-256117,92703,407981,-315278,"261","152",267268,188600
"14420",236948,"UNIVERSITY OF WASHINGTON-SEATTLE CAMPUS                     ","2003-2004",26,"Volleyball",208543,780031,-571488,0,0,0,208543,780031,-571488,".","15",0,160000
"3381",106245,"UNIVERSITY OF ARKANSAS AT LITTLE ROCK                       ","2003-2004",2,"Basketball",1531290,2103047,-571757,1467036,1467040,-4,64254,636007,-571753,"16","14",224592,106889
"2139",181002,"CREIGHTON UNIVERSITY                                        ","2003-2004",2,"Basketball",2301828,2874209,-572381,2180567,2057589,122978,121261,816620,-695359,"14","14",213993,124360
"3346",137351,"UNIVERSITY OF SOUTH FLORIDA                                 ","2003-2004",2,"Basketball",1684059,2256852,-572793,1542393,1397495,144898,141666,859357,-717691,"16","13",287088,220271
"13849",243780,"PURDUE UNIVERSITY-MAIN CAMPUS                               ","2003-2004",26,"Volleyball",379330,954371,-575041,0,0,0,379330,954371,-575041,".","17",0,212636
"4445",159647,"LOUISIANA TECH UNIVERSITY                                   ","2003-2004",7,"Football",2477909,3053396,-575487,2477909,3053396,-575487,0,0,0,"106",".",597355,0
"2709",190415,"CORNELL UNIVERSITY-ENDOWED COLLEGES                         ","2003-2004",2,"Basketball",278137,853691,-575554,254157,477517,-223360,23980,376174,-352194,"14","15",102796,82704
"14294",239105,"MARQUETTE UNIVERSITY                                        ","2003-2004",26,"Volleyball",41579,617313,-575734,0,0,0,41579,617313,-575734,".","13",0,89196
"2787",157386,"MOREHEAD STATE UNIVERSITY                                   ","2003-2004",2,"Basketball",616555,1193000,-576445,437022,712991,-275969,179533,480009,-300476,"20","14",93429,71764
"8149",126614,"UNIVERSITY OF COLORADO AT BOULDER                           ","2003-2004",15,"Soccer",88198,665073,-576875,0,0,0,88198,665073,-576875,".","30",0,128936
"6728",147767,"NORTHWESTERN UNIVERSITY                                     ","2003-2004",11,"Lacrosse",929,578474,-577545,0,0,0,929,578474,-577545,".","29",0,110513
"1276",207388,"OKLAHOMA STATE UNIVERSITY-MAIN CAMPUS                       ","2003-2004",1,"Baseball",547269,1125684,-578415,547269,1125684,-578415,0,0,0,"35",".",305704,0
"15566",230603,"SOUTHERN UTAH UNIVERSITY                                    ","2003-2004",39,"Total Participants",818338,1396771,-578433,273452,500225,-226773,544886,896546,-351660,"183","99",604743,407428
"14079",104151,"ARIZONA STATE UNIVERSITY-MAIN CAMPUS                        ","2003-2004",26,"Volleyball",60145,639578,-579433,0,0,0,60145,639578,-579433,".","14",0,107451
"7775",155317,"UNIVERSITY OF KANSAS MAIN CAMPUS                            ","2003-2004",15,"Soccer",6496,586510,-580014,0,0,0,6496,586510,-580014,".","26",0,157398
"4999",199847,"WAKE FOREST UNIVERSITY                                      ","2003-2004",7,"Football",7134512,7714751,-580239,7134512,7714751,-580239,0,0,0,"101",".",416410,0
"15293",233912,"VIRGINIA INTERMONT COLLEGE                                  ","2003-2004",34,"Equestrian",28000,608275,-580275,1000,18246,-17246,27000,590029,-563029,"3","97",1000,27000
"4750",175616,"DELTA STATE UNIVERSITY                                      ","2003-2004",7,"Football",39367,619762,-580395,39367,619762,-580395,0,0,0,"118",".",75874,0
"6049",174066,"UNIVERSITY OF MINNESOTA-TWIN CITIES                         ","2003-2004",8,"Golf",56452,637898,-581446,38234,328454,-290220,18218,309444,-291226,"11","9",60986,62427
"6346",157085,"UNIVERSITY OF KENTUCKY                                      ","2003-2004",9,"Gymnastics",19356,601014,-581658,0,0,0,19356,601014,-581658,".","14",0,165053
"9598",155317,"UNIVERSITY OF KANSAS MAIN CAMPUS                            ","2003-2004",16,"Softball",29323,611143,-581820,0,0,0,29323,611143,-581820,".","18",0,198298
"15876",143358,"BRADLEY UNIVERSITY                                          ","2003-2004",39,"Total Participants",2096122,2678575,-582453,1102189,1434095,-331906,993933,1244480,-250547,"111","131",471283,366633
"3952",154095,"UNIVERSITY OF NORTHERN IOWA                                 ","2003-2004",3,"All Track Combined",191461,774584,-583123,94688,382674,-287986,96773,391910,-295137,"93","75",81639,59834
"2869",207403,"OKLAHOMA BAPTIST UNIVERSITY                                 ","2003-2004",2,"Basketball",101762,685155,-583393,55656,348617,-292961,46106,336538,-290432,"12","16",44170,50777
"15535",237118,"ALDERSON BROADDUS COLLEGE                                   ","2003-2004",39,"Total Participants",93923,678345,-584422,46345,385097,-338752,47578,293248,-245670,"63","49",61458,44345
"1644",102614,"UNIVERSITY OF ALASKA FAIRBANKS                              ","2003-2004",2,"Basketball",460170,1044674,-584504,388622,699956,-311334,71548,344718,-273170,"17","12",157616,79140
"1344",178396,"UNIVERSITY OF MISSOURI-COLUMBIA                             ","2003-2004",1,"Baseball",71067,655684,-584617,71067,655684,-584617,0,0,0,"39",".",216731,0
"6547",196060,"SUNY AT ALBANY                                              ","2003-2004",11,"Lacrosse",4806,589931,-585125,4406,331410,-327004,400,258521,-258121,"43","19",85294,59734
"7680",176017,"UNIVERSITY OF MISSISSIPPI MAIN CAMPUS                       ","2003-2004",15,"Soccer",86075,671529,-585454,0,0,0,86075,671529,-585454,".","32",0,168058
"7873",178396,"UNIVERSITY OF MISSOURI-COLUMBIA                             ","2003-2004",15,"Soccer",48865,634858,-585993,0,0,0,48865,634858,-585993,".","23",0,132367
"14013",110705,"UNIVERSITY OF CALIFORNIA-SANTA BARBARA                      ","2003-2004",26,"Volleyball",56351,642376,-586025,30545,221774,-191229,25806,420602,-394796,"29","15",31549,48389
"5070",202480,"UNIVERSITY OF DAYTON                                        ","2003-2004",7,"Football",597970,1184215,-586245,597970,1184215,-586245,0,0,0,"114",".",155843,0
"4042",164924,"BOSTON COLLEGE                                              ","2003-2004",6,"Field hocky",20061,606382,-586321,0,0,0,20061,606382,-586321,".","22",0,68450
"9163",174066,"UNIVERSITY OF MINNESOTA-TWIN CITIES                         ","2003-2004",16,"Softball",48327,634706,-586379,0,0,0,48327,634706,-586379,".","22",0,129051
"3229",110644,"UNIVERSITY OF CALIFORNIA-DAVIS                              ","2003-2004",2,"Basketball",105134,693661,-588527,71941,346233,-274292,33193,347428,-314235,"13","19",70703,55984
"14411",187985,"UNIVERSITY OF NEW MEXICO-MAIN CAMPUS                        ","2003-2004",26,"Volleyball",143933,733107,-589174,0,0,0,143933,733107,-589174,".","17",0,111397
"15866",193292,"MOLLOY COLLEGE                                              ","2003-2004",39,"Total Participants",151500,741000,-589500,68000,412000,-344000,83500,329000,-245500,"92","83",76000,70000
"1463",182290,"UNIVERSITY OF NEVADA-RENO                                   ","2003-2004",1,"Baseball",98345,688125,-589780,98345,688125,-589780,0,0,0,"40",".",201600,0
"8522",209551,"UNIVERSITY OF OREGON                                        ","2003-2004",15,"Soccer",59672,649507,-589835,0,0,0,59672,649507,-589835,".","25",0,103821
"13346",157085,"UNIVERSITY OF KENTUCKY                                      ","2003-2004",26,"Volleyball",0,590394,-590394,0,0,0,0,590394,-590394,".","12",0,179419
"15529",243197,"UNIVERSITY OF PUERTO RICO-MAYAGUEZ                          ","2003-2004",39,"Total Participants",69284,660084,-590800,43609,428667,-385058,25675,231417,-205742,"174","137",112833,62575
"6950",135726,"UNIVERSITY OF MIAMI                                         ","2003-2004",13,"Rowing",647072,1237959,-590887,0,0,0,647072,1237959,-590887,".","43",0,131492
"4324",145813,"ILLINOIS STATE UNIVERSITY                                   ","2003-2004",7,"Football",960782,1551924,-591142,960782,1551924,-591142,0,0,0,"100",".",233029,0
"2487",149222,"SOUTHERN ILLINOIS UNIVERSITY-CARBONDALE                     ","2003-2004",2,"Basketball",1147348,1738531,-591183,1010372,1125146,-114774,136976,613385,-476409,"14","16",263615,103849
"11894",174066,"UNIVERSITY OF MINNESOTA-TWIN CITIES                         ","2003-2004",23,"Track and Field, Indoor",16216,607926,-591710,4236,304675,-300439,11980,303251,-291271,"65","67",81767,82579
"12109",174066,"UNIVERSITY OF MINNESOTA-TWIN CITIES                         ","2003-2004",24,"Track and Field, Outdoor",16216,607926,-591710,4236,304675,-300439,11980,303251,-291271,"62","65",81767,82579
"9041",218663,"UNIVERSITY OF SOUTH CAROLINA-COLUMBIA                       ","2003-2004",16,"Softball",3666,596985,-593319,0,0,0,3666,596985,-593319,".","15",0,89814
"1052",204796,"OHIO STATE UNIVERSITY-MAIN CAMPUS                           ","2003-2004",1,"Baseball",324178,918022,-593844,324178,918022,-593844,0,0,0,"38",".",192210,0
"14666",110662,"UNIVERSITY OF CALIFORNIA-LOS ANGELES                        ","2003-2004",27,"Water Polo",97918,691981,-594063,96597,346462,-249865,1321,345519,-344198,"27","15",34298,45023
"6498",129020,"UNIVERSITY OF CONNECTICUT                                   ","2003-2004",10,"Ice Hockey",155115,749428,-594313,155114,422331,-267217,1,327097,-327096,"30","25",259159,171905
"13739",110556,"CALIFORNIA STATE UNIVERSITY-FRESNO                          ","2003-2004",26,"Volleyball",244158,838479,-594321,0,0,0,244158,838479,-594321,".","17",0,136000
"15463",153825,"LORAS COLLEGE                                               ","2003-2004",39,"Total Participants",102471,698562,-596091,69582,399975,-330393,32889,298587,-265698,"348","190",207885,123093
"8000",198464,"EAST CAROLINA UNIVERSITY                                    ","2003-2004",15,"Soccer",35770,632017,-596247,10370,266508,-256138,25400,365509,-340109,"27","26",69525,78946
"9905",144740,"DEPAUL UNIVERSITY                                           ","2003-2004",16,"Softball",55420,651752,-596332,0,0,0,55420,651752,-596332,".","15",0,127334
"14275",206622,"XAVIER UNIVERSITY                                           ","2003-2004",26,"Volleyball",3803,600366,-596563,0,0,0,3803,600366,-596563,"0","15",0,174081
"2881",233921,"VIRGINIA POLYTECHNIC INSTITUTE AND STATE UNIV               ","2003-2004",2,"Basketball",3987101,4585727,-598626,2354874,2587422,-232548,1632227,1998305,-366078,"16","13",474423,517899
"4732",140960,"SAVANNAH STATE UNIVERSITY                                   ","2003-2004",7,"Football",63249,662179,-598930,63249,662179,-598930,0,0,0,"43",".",395804,0
"10530",209542,"OREGON STATE UNIVERSITY                                     ","2003-2004",19,"Swimming",14610,614023,-599413,0,0,0,14610,614023,-599413,".","17",0,102226
"15465",233912,"VIRGINIA INTERMONT COLLEGE                                  ","2003-2004",39,"Total Participants",211200,811831,-600631,100300,143639,-43339,110900,668192,-557292,"90","186",93714,114220
"13914",110608,"CALIFORNIA STATE UNIVERSITY-NORTHRIDGE                      ","2003-2004",26,"Volleyball",6697,608589,-601892,3469,192633,-189164,3228,415956,-412728,"19","15",28585,80844
"8129",196088,"SUNY AT BUFFALO                                             ","2003-2004",15,"Soccer",98478,700646,-602168,50274,315055,-264781,48204,385591,-337387,"25","31",67293,76218
"13288",179159,"SAINT LOUIS UNIVERSITY-MAIN CAMPUS                          ","2003-2004",26,"Volleyball",18239,620727,-602488,0,0,0,18239,620727,-602488,".","13",0,69047
"5729",110662,"UNIVERSITY OF CALIFORNIA-LOS ANGELES                        ","2003-2004",8,"Golf",219854,823433,-603579,192004,452016,-260012,27850,371417,-343567,"9","11",81944,56915
"4909",219356,"SOUTH DAKOTA STATE UNIVERSITY                               ","2003-2004",7,"Football",166389,770548,-604159,166389,770548,-604159,0,0,0,"107",".",165568,0
"16065",219471,"UNIVERSITY OF SOUTH DAKOTA                                  ","2003-2004",39,"Total Participants",705717,1310583,-604866,252255,486450,-234195,453462,824133,-370671,"300","202",330205,304030
"3796",176372,"UNIVERSITY OF SOUTHERN MISSISSIPPI                          ","2003-2004",3,"All Track Combined",6326,611390,-605064,3324,249046,-245722,3002,362344,-359342,"26","39",54759,59129
"15498",200059,"DICKINSON STATE UNIVERSITY                                  ","2003-2004",39,"Total Participants",206999,812165,-605166,109706,416960,-307254,97293,395205,-297912,"281","103",207384,125612
"17191",215655,"ROBERT MORRIS UNIVERSITY                                    ","2003-2004",39,"Total Participants",1274220,1879996,-605776,444641,623309,-178668,829579,1256687,-427108,"248","180",434110,307165
"4675",219383,"UNIVERSITY OF SIOUX FALLS                                   ","2003-2004",7,"Football",60596,666475,-605879,60596,666475,-605879,0,0,0,"97",".",53689,0
"6912",196413,"SYRACUSE UNIVERSITY                                         ","2003-2004",13,"Rowing",1454601,2060622,-606021,519742,830039,-310297,934859,1230583,-295724,"43","61",164909,179661
"5825",157085,"UNIVERSITY OF KENTUCKY                                      ","2003-2004",8,"Golf",0,606447,-606447,0,280071,-280071,0,326376,-326376,"11","13",130481,117116
"15281",228723,"TEXAS A &amp; M UNIVERSITY                                      ","2003-2004",34,"Equestrian",27148,633815,-606667,0,0,0,27148,633815,-606667,".","75",0,123936
"6106",209542,"OREGON STATE UNIVERSITY                                     ","2003-2004",8,"Golf",45428,652206,-606778,20431,275939,-255508,24997,376267,-351270,"8","10",58519,73415
"3675",156620,"EASTERN KENTUCKY UNIVERSITY                                 ","2003-2004",3,"All Track Combined",5078,612104,-607026,2222,269883,-267661,2856,342221,-339365,"60","78",56447,68667
"8814",176080,"MISSISSIPPI STATE UNIVERSITY                                ","2003-2004",16,"Softball",51862,661192,-609330,0,0,0,51862,661192,-609330,".","24",0,131726
"13050",150136,"BALL STATE UNIVERSITY                                       ","2003-2004",26,"Volleyball",82113,693306,-611193,50297,256766,-206469,31816,436540,-404724,"16","12",50891,57345
"10423",214777,"PENNSYLVANIA STATE UNIVERSITY-MAIN CAMPUS                   ","2003-2004",18,"Swimming and Diving",615517,1227077,-611560,234936,519108,-284172,380581,707969,-327388,"23","30",88330,127334
"8562",236948,"UNIVERSITY OF WASHINGTON-SEATTLE CAMPUS                     ","2003-2004",16,"Softball",248081,860320,-612239,0,0,0,248081,860320,-612239,".","15",0,206533
"4481",175342,"ALCORN STATE UNIVERSITY                                     ","2003-2004",7,"Football",244346,857105,-612759,244346,857105,-612759,0,0,0,"98",".",179754,0
"1160",243744,"STANFORD UNIVERSITY                                         ","2003-2004",1,"Baseball",747085,1360492,-613407,747085,1360492,-613407,0,0,0,"36",".",201801,0
"10223",164924,"BOSTON COLLEGE                                              ","2003-2004",18,"Swimming and Diving",25738,639913,-614175,12869,93894,-81025,12869,546019,-533150,"38","39",40218,40218
"2978",231624,"COLLEGE OF WILLIAM AND MARY                                 ","2003-2004",2,"Basketball",1041348,1655657,-614309,839524,958077,-118553,201824,697580,-495756,"14","15",161708,107942
"12086",176017,"UNIVERSITY OF MISSISSIPPI MAIN CAMPUS                       ","2003-2004",24,"Track and Field, Outdoor",12832,627481,-614649,7342,299182,-291840,5490,328299,-322809,"47","28",108860,101699
"6982",228778,"THE UNIVERSITY OF TEXAS AT AUSTIN                           ","2003-2004",13,"Rowing",180253,795325,-615072,0,0,0,180253,795325,-615072,".","97",0,212582
"15677",152600,"VALPARAISO UNIVERSITY                                       ","2003-2004",39,"Total Participants",2142187,2757265,-615078,984831,1292459,-307628,1157356,1464806,-307450,"324","183",124359,91794
"3232",197197,"WAGNER COLLEGE                                              ","2003-2004",2,"Basketball",728341,1343581,-615240,466673,732032,-265359,261668,611549,-349881,"14","13",109651,88927
"16569",197984,"BELMONT ABBEY COLLEGE                                       ","2003-2004",39,"Total Participants",38916,654240,-615324,31266,326766,-295500,7650,327474,-319824,"95","80",70206,57958
"2968",232566,"LONGWOOD UNIVERSITY                                         ","2003-2004",2,"Basketball",26047,641428,-615381,13936,341949,-328013,12111,299479,-287368,"14","11",41050,41061
"825",110662,"UNIVERSITY OF CALIFORNIA-LOS ANGELES                        ","2003-2004",1,"Baseball",248704,864508,-615804,248704,864508,-615804,0,0,0,"36",".",210289,0
"14695",243744,"STANFORD UNIVERSITY                                         ","2003-2004",27,"Water Polo",208743,825254,-616511,159447,376118,-216671,49296,449136,-399840,"22","18",69339,41663
"14180",181464,"UNIVERSITY OF NEBRASKA AT LINCOLN                           ","2003-2004",26,"Volleyball",704959,1321912,-616953,0,0,0,704959,1321912,-616953,".","18",0,305743
"4830",219000,"AUGUSTANA COLLEGE                                           ","2003-2004",7,"Football",364524,982030,-617506,364524,982030,-617506,0,0,0,"88",".",102212,0
"12365",196088,"SUNY AT BUFFALO                                             ","2003-2004",25,"Track and Field, X-Country",8153,625865,-617712,3889,223202,-219313,4264,402663,-398399,"40","48",68310,76072
"10894",176080,"MISSISSIPPI STATE UNIVERSITY                                ","2003-2004",22,"Tennis",30729,649125,-618396,30728,342906,-312178,1,306219,-306218,"10","7",80870,52263
"14829",181464,"UNIVERSITY OF NEBRASKA AT LINCOLN                           ","2003-2004",28,"Wrestling",45708,664966,-619258,45708,664966,-619258,0,0,0,"35",".",100532,0
"15038",153603,"IOWA STATE UNIVERSITY                                       ","2003-2004",28,"Wrestling",64211,683871,-619660,64211,683871,-619660,0,0,0,"36",".",127504,0
"15474",102094,"UNIVERSITY OF SOUTH ALABAMA                                 ","2003-2004",39,"Total Participants",2076685,2696756,-620071,1086706,1322350,-235644,989979,1374406,-384427,"111","119",442224,380049
"12128",196413,"SYRACUSE UNIVERSITY                                         ","2003-2004",24,"Track and Field, Outdoor",1189320,1809596,-620276,516519,824197,-307678,672801,985399,-312598,"44","45",121020,110913
"5544",182281,"UNIVERSITY OF NEVADA-LAS VEGAS                              ","2003-2004",8,"Golf",280254,902534,-622280,258129,541504,-283375,22125,361030,-338905,"12","9",115069,116095
"9785",229115,"TEXAS TECH UNIVERSITY                                       ","2003-2004",16,"Softball",60912,684311,-623399,0,0,0,60912,684311,-623399,".","27",0,143672
"6361",104151,"ARIZONA STATE UNIVERSITY-MAIN CAMPUS                        ","2003-2004",9,"Gymnastics",44194,668251,-624057,0,0,0,44194,668251,-624057,".","17",0,122248
"1189",157289,"UNIVERSITY OF LOUISVILLE                                    ","2003-2004",1,"Baseball",46122,670259,-624137,46122,670259,-624137,0,0,0,"36",".",183585,0
"16947",203845,"MARIETTA COLLEGE                                            ","2003-2004",39,"Total Participants",388271,1012486,-624215,204964,544144,-339180,183307,468342,-285035,"232","129",205767,125750
"3066",197036,"UNITED STATES MILITARY ACADEMY                              ","2003-2004",2,"Basketball",712889,1337285,-624396,410274,768483,-358209,302615,568802,-266187,"23","20",133821,122097
"7090",139959,"UNIVERSITY OF GEORGIA                                       ","2003-2004",15,"Soccer",260,625104,-624844,0,0,0,260,625104,-624844,".","27",0,100923
"8086",232982,"OLD DOMINION UNIVERSITY                                     ","2003-2004",15,"Soccer",64154,689678,-625524,39665,349606,-309941,24489,340072,-315583,"26","25",43064,43064
"7175",166629,"UNIVERSITY OF MASSACHUSETTS-AMHERST                         ","2003-2004",15,"Soccer",53255,679312,-626057,26258,210257,-183999,26997,469055,-442058,"29","23",65068,67606
"4495",234085,"VIRGINIA MILITARY INSTITUTE                                 ","2003-2004",7,"Football",1464830,2091151,-626321,1464830,2091151,-626321,0,0,0,"83",".",234741,0
"5681",100751,"UNIVERSITY OF ALABAMA                                       ","2003-2004",8,"Golf",38892,666093,-627201,32547,321679,-289132,6345,344414,-338069,"14","11",64329,78053
"7877",132903,"UNIVERSITY OF CENTRAL FLORIDA                               ","2003-2004",15,"Soccer",218789,846016,-627227,97908,382598,-284690,120881,463418,-342537,"29","35",69056,74030
"3400",217864,"CITADEL MILITARY COLLEGE OF SOUTH CAROLINA                  ","2003-2004",2,"Basketball",110373,738615,-628242,110373,738615,-628242,0,0,0,"16",".",156530,0
"17039",154697,"BARTON COUNTY COMMUNITY COLLEGE                             ","2003-2004",39,"Total Participants",212245,841936,-629691,116490,419395,-302905,95755,422541,-326786,"131","97",155840,139601
"16766",141264,"VALDOSTA STATE UNIVERSITY                                   ","2003-2004",39,"Total Participants",389357,1019200,-629843,220543,467967,-247424,168814,551233,-382419,"200","61",345682,125297
"3924",233921,"VIRGINIA POLYTECHNIC INSTITUTE AND STATE UNIV               ","2003-2004",3,"All Track Combined",380132,1010329,-630197,107896,427903,-320007,272236,582426,-310190,"91","107",140307,137232
"16451",195030,"UNIVERSITY OF ROCHESTER                                     ","2003-2004",39,"Total Participants",559384,1189731,-630347,315161,526741,-211580,244223,662990,-418767,"270","213",349358,345410
"5071",181011,"DANA COLLEGE                                                ","2003-2004",7,"Football",26100,657290,-631190,26100,657290,-631190,0,0,0,"94",".",29898,0
"2297",225399,"HOUSTON BAPTIST UNIVERSITY                                  ","2003-2004",2,"Basketball",2500,633959,-631459,1500,346453,-344953,1000,287506,-286506,"13","14",67563,63756
"10432",196088,"SUNY AT BUFFALO                                             ","2003-2004",18,"Swimming and Diving",59819,691699,-631880,8793,213826,-205033,51026,477873,-426847,"23","24",48820,75744
"15707",184782,"ROWAN UNIVERSITY                                            ","2003-2004",39,"Total Participants",101631,735391,-633760,49525,296592,-247067,52106,438799,-386693,"230","178",214227,148538
"5453",207388,"OKLAHOMA STATE UNIVERSITY-MAIN CAMPUS                       ","2003-2004",8,"Golf",1673449,2308114,-634665,1575386,1870697,-295311,98063,437417,-339354,"10","7",218797,114314
"9332",178396,"UNIVERSITY OF MISSOURI-COLUMBIA                             ","2003-2004",16,"Softball",9478,644911,-635433,0,0,0,9478,644911,-635433,".","23",0,172662
"13676",209551,"UNIVERSITY OF OREGON                                        ","2003-2004",26,"Volleyball",121977,757691,-635714,0,0,0,121977,757691,-635714,".","19",0,122841
"41",139755,"GEORGIA INSTITUTE OF TECHNOLOGY-MAIN CAMPUS                 ","2003-2004",1,"Baseball",402484,1038488,-636004,402484,1038488,-636004,0,0,0,"33",".",142662,0
"16803",196176,"SUNY COLLEGE AT NEW PALTZ                                   ","2003-2004",39,"Total Participants",22421,659101,-636680,13777,303287,-289510,8644,355814,-347170,"112","136",110446,124969
"16358",176044,"MISSISSIPPI VALLEY STATE UNIVERSITY                         ","2003-2004",39,"Total Participants",182249,820577,-638328,62741,302439,-239698,119508,518138,-398630,"164","108",830963,452294
"3250",160612,"SOUTHEASTERN LOUISIANA UNIVERSITY                           ","2003-2004",2,"Basketball",347974,987041,-639067,242529,523549,-281020,105445,463492,-358047,"15","18",112008,85425
"13520",220862,"UNIVERSITY OF MEMPHIS                                       ","2003-2004",26,"Volleyball",4574,644244,-639670,0,0,0,4574,644244,-639670,".","13",0,148867
"3943",157289,"UNIVERSITY OF LOUISVILLE                                    ","2003-2004",3,"All Track Combined",10682,650537,-639855,5266,242882,-237616,5416,407655,-402239,"43","78",73478,78767
"3730",243780,"PURDUE UNIVERSITY-MAIN CAMPUS                               ","2003-2004",3,"All Track Combined",873830,1515830,-642000,393959,704154,-310195,479871,811676,-331805,"34","54",127586,129899
"1366",206622,"XAVIER UNIVERSITY                                           ","2003-2004",1,"Baseball",14535,657602,-643067,14535,657602,-643067,0,0,0,"25",".",138259,0
"14127",159391,"LOUISIANA STATE UNIV &amp; AG &amp; MECH &amp; HEBERT LAWS CTR          ","2003-2004",26,"Volleyball",6336,650338,-644002,0,0,0,6336,650338,-644002,".","15",0,114857
"7347",201441,"BOWLING GREEN STATE UNIVERSITY-MAIN CAMPUS                  ","2003-2004",15,"Soccer",101955,746027,-644072,47022,310695,-263673,54933,435332,-380399,"24","26",56941,102306
"9801",164924,"BOSTON COLLEGE                                              ","2003-2004",16,"Softball",18596,663953,-645357,0,0,0,18596,663953,-645357,".","17",0,86428
"2035",162007,"BOWIE STATE UNIVERSITY                                      ","2003-2004",2,"Basketball",15644,661066,-645422,7822,386714,-378892,7822,274352,-266530,"14","12",104541,68249
"6354",171100,"MICHIGAN STATE UNIVERSITY                                   ","2003-2004",9,"Gymnastics",27952,675922,-647970,0,0,0,27952,675922,-647970,".","17",0,88994
"6307",207500,"UNIVERSITY OF OKLAHOMA NORMAN CAMPUS                        ","2003-2004",9,"Gymnastics",32592,680566,-647974,15226,315776,-300550,17366,364790,-347424,"18","17",95765,97770
"8919",100751,"UNIVERSITY OF ALABAMA                                       ","2003-2004",16,"Softball",138164,786235,-648071,0,0,0,138164,786235,-648071,".","17",0,169574
"15627",216764,"WEST CHESTER UNIVERSITY OF PENNSYLVANIA                     ","2003-2004",39,"Total Participants",395068,1043467,-648399,151898,443680,-291782,243170,599787,-356617,"271","235",226883,265948
"10247",110635,"UNIVERSITY OF CALIFORNIA-BERKELEY                           ","2003-2004",18,"Swimming and Diving",731114,1379623,-648509,307948,658736,-350788,423166,720887,-297721,"29","29",139036,155240
"16642",149772,"WESTERN ILLINOIS UNIVERSITY                                 ","2003-2004",39,"Total Participants",1089194,1737943,-648749,499903,747508,-247605,589291,990435,-401144,"333","208",745619,404948
"8862",151351,"INDIANA UNIVERSITY-BLOOMINGTON                              ","2003-2004",16,"Softball",900,649784,-648884,0,0,0,900,649784,-648884,".","22",0,125261
"3950",145637,"UNIVERSITY OF ILLINOIS AT URBANA-CHAMPAIGN                  ","2003-2004",3,"All Track Combined",622187,1272185,-649998,258974,623510,-364536,363213,648675,-285462,"114","85",168150,90055
"1194",229115,"TEXAS TECH UNIVERSITY                                       ","2003-2004",1,"Baseball",432134,1082558,-650424,432134,1082558,-650424,0,0,0,"46",".",262192,0
"4628",128771,"CENTRAL CONNECTICUT STATE UNIVERSITY                        ","2003-2004",7,"Football",74227,724954,-650727,74227,724954,-650727,0,0,0,"75",".",142250,0
"4156",204796,"OHIO STATE UNIVERSITY-MAIN CAMPUS                           ","2003-2004",6,"Field hocky",160105,810961,-650856,0,0,0,160105,810961,-650856,".","23",0,100494
"13224",201885,"UNIVERSITY OF CINCINNATI-MAIN CAMPUS                        ","2003-2004",26,"Volleyball",6173,657316,-651143,0,0,0,6173,657316,-651143,".","11",0,139067
"13766",178396,"UNIVERSITY OF MISSOURI-COLUMBIA                             ","2003-2004",26,"Volleyball",49071,700884,-651813,0,0,0,49071,700884,-651813,".","17",0,181337
"2174",199139,"UNIVERSITY OF NORTH CAROLINA AT CHARLOTTE                   ","2003-2004",2,"Basketball",2177750,2830341,-652591,2149008,1819665,329343,28742,1010676,-981934,"14","13",331714,217421
"1468",174066,"UNIVERSITY OF MINNESOTA-TWIN CITIES                         ","2003-2004",1,"Baseball",99388,753085,-653697,99388,753085,-653697,0,0,0,"37",".",250814,0
"11760",126614,"UNIVERSITY OF COLORADO AT BOULDER                           ","2003-2004",22,"Tennis",85714,740094,-654380,27986,326006,-298020,57728,414088,-356360,"9","10",86741,78009
"2059",160658,"UNIVERSITY OF LOUISIANA AT LAFAYETTE                        ","2003-2004",2,"Basketball",472707,1127227,-654520,451011,743014,-292003,21696,384213,-362517,"15","12",256806,136828
"14099",104179,"UNIVERSITY OF ARIZONA                                       ","2003-2004",26,"Volleyball",288139,943776,-655637,0,0,0,288139,943776,-655637,".","15",0,106602
"5037",169798,"EASTERN MICHIGAN UNIVERSITY                                 ","2003-2004",7,"Football",2472022,3128687,-656665,2472022,3128687,-656665,0,0,0,"94",".",424994,0
"6258",106397,"UNIVERSITY OF ARKANSAS MAIN CAMPUS                          ","2003-2004",8,"Golf",132739,790654,-657915,28316,377428,-349112,104423,413226,-308803,"11","9",97996,74588
"7595",217882,"CLEMSON UNIVERSITY                                          ","2003-2004",15,"Soccer",459515,1119619,-660104,225779,568245,-342466,233736,551374,-317638,"25","32",79805,107167
"8806",139959,"UNIVERSITY OF GEORGIA                                       ","2003-2004",16,"Softball",11587,672923,-661336,0,0,0,11587,672923,-661336,".","20",0,161936
"12730",130794,"YALE UNIVERSITY                                             ","2003-2004",25,"Track and Field, X-Country",201600,863288,-661688,100800,432291,-331491,100800,430997,-330197,"111","135",136712,140023
"3821",199193,"NORTH CAROLINA STATE UNIVERSITY AT RALEIGH                  ","2003-2004",3,"All Track Combined",200,662505,-662305,100,290517,-290417,100,371988,-371888,"92","129",147850,177158
"7646",199139,"UNIVERSITY OF NORTH CAROLINA AT CHARLOTTE                   ","2003-2004",15,"Soccer",40587,703541,-662954,23172,352562,-329390,17415,350979,-333564,"24","24",76296,72458
"7826",137351,"UNIVERSITY OF SOUTH FLORIDA                                 ","2003-2004",15,"Soccer",31443,694563,-663120,20635,356241,-335606,10808,338322,-327514,"24","32",117417,117179
"7569",214777,"PENNSYLVANIA STATE UNIVERSITY-MAIN CAMPUS                   ","2003-2004",15,"Soccer",589155,1252939,-663784,261900,574865,-312965,327255,678074,-350819,"28","28",118338,150797
"13809",126614,"UNIVERSITY OF COLORADO AT BOULDER                           ","2003-2004",26,"Volleyball",132559,796674,-664115,0,0,0,132559,796674,-664115,".","13",0,206502
"8801",204796,"OHIO STATE UNIVERSITY-MAIN CAMPUS                           ","2003-2004",16,"Softball",93096,757955,-664859,0,0,0,93096,757955,-664859,".","21",0,128550
"11785",209551,"UNIVERSITY OF OREGON                                        ","2003-2004",22,"Tennis",12943,678475,-665532,8435,307137,-298702,4508,371338,-366830,"8","8",56441,61054
"7393",153269,"DRAKE UNIVERSITY                                            ","2003-2004",15,"Soccer",13971,679845,-665874,7982,387161,-379179,5989,292684,-286695,"30","25",49338,47519
"227",151351,"INDIANA UNIVERSITY-BLOOMINGTON                              ","2003-2004",1,"Baseball",0,666166,-666166,0,666166,-666166,0,0,0,"41",".",126860,0
"4169",171100,"MICHIGAN STATE UNIVERSITY                                   ","2003-2004",6,"Field hocky",29150,695775,-666625,0,0,0,29150,695775,-666625,".","25",0,104519
"2587",218973,"WOFFORD COLLEGE                                             ","2003-2004",2,"Basketball",367933,1034575,-666642,341072,558842,-217770,26861,475733,-448872,"14","13",121041,68505
"16990",152099,"OAKLAND CITY UNIVERSITY                                     ","2003-2004",39,"Total Participants",90715,758659,-667944,40120,352044,-311924,50595,406615,-356020,"77","82",61438,61396
"177",219718,"BETHEL COLLEGE                                              ","2003-2004",1,"Baseball",64909,732878,-667969,64909,732878,-667969,0,0,0,"28",".",54073,0
"9555",171100,"MICHIGAN STATE UNIVERSITY                                   ","2003-2004",16,"Softball",32613,701049,-668436,0,0,0,32613,701049,-668436,".","18",0,147470
"4846",159966,"NICHOLLS STATE UNIVERSITY                                   ","2003-2004",7,"Football",295843,964838,-668995,295843,964838,-668995,0,0,0,"107",".",184437,0
"5721",218663,"UNIVERSITY OF SOUTH CAROLINA-COLUMBIA                       ","2003-2004",8,"Golf",0,669700,-669700,0,331851,-331851,0,337849,-337849,"14","8",47261,67829
"8126",134097,"FLORIDA STATE UNIVERSITY                                    ","2003-2004",15,"Soccer",96776,767952,-671176,0,0,0,96776,767952,-671176,".","26",0,205494
"15917",110097,"BIOLA UNIVERSITY                                            ","2003-2004",39,"Total Participants",279981,951547,-671566,132433,392746,-260313,147548,558801,-411253,"80","108",69211,98096
"13780",134097,"FLORIDA STATE UNIVERSITY                                    ","2003-2004",26,"Volleyball",42841,715046,-672205,0,0,0,42841,715046,-672205,".","16",0,134108
"8311",233921,"VIRGINIA POLYTECHNIC INSTITUTE AND STATE UNIV               ","2003-2004",15,"Soccer",471121,1143738,-672617,254521,571405,-316884,216600,572333,-355733,"27","28",71099,59578
"4077",147767,"NORTHWESTERN UNIVERSITY                                     ","2003-2004",6,"Field hocky",13369,687718,-674349,0,0,0,13369,687718,-674349,".","19",0,132656
"12683",182290,"UNIVERSITY OF NEVADA-RENO                                   ","2003-2004",25,"Track and Field, X-Country",2455,677090,-674635,0,0,0,2455,677090,-674635,".","147",0,149625
"9994",228723,"TEXAS A &amp; M UNIVERSITY                                      ","2003-2004",16,"Softball",164430,839563,-675133,0,0,0,164430,839563,-675133,".","21",0,247892
"10344",216597,"VILLANOVA UNIVERSITY                                        ","2003-2004",18,"Swimming and Diving",27849,703674,-675825,20738,148492,-127754,7111,555182,-548071,"21","30",46858,45297
"11001",100751,"UNIVERSITY OF ALABAMA                                       ","2003-2004",22,"Tennis",164804,840756,-675952,68281,398766,-330485,96523,441990,-345467,"14","10",96409,106641
"13247",228778,"THE UNIVERSITY OF TEXAS AT AUSTIN                           ","2003-2004",26,"Volleyball",865879,1541936,-676057,0,0,0,865879,1541936,-676057,".","11",0,281399
"11214",104179,"UNIVERSITY OF ARIZONA                                       ","2003-2004",22,"Tennis",154326,830590,-676264,56587,389522,-332935,97739,441068,-343329,"12","8",65033,52489
"4828",178615,"TRUMAN STATE UNIVERSITY                                     ","2003-2004",7,"Football",72900,750255,-677355,72900,750255,-677355,0,0,0,"84",".",63717,0
"9447",159391,"LOUISIANA STATE UNIV &amp; AG &amp; MECH &amp; HEBERT LAWS CTR          ","2003-2004",16,"Softball",54469,733810,-679341,0,0,0,54469,733810,-679341,".","18",0,134491
"3923",150136,"BALL STATE UNIVERSITY                                       ","2003-2004",3,"All Track Combined",14540,694133,-679593,1,281655,-281654,14539,412478,-397939,"127","89",72119,69550
"6198",204796,"OHIO STATE UNIVERSITY-MAIN CAMPUS                           ","2003-2004",8,"Golf",103489,783843,-680354,61131,384241,-323110,42358,399602,-357244,"14","11",49178,44598
"4307",187648,"EASTERN NEW MEXICO UNIVERSITY-MAIN CAMPUS                   ","2003-2004",7,"Football",21836,702346,-680510,21836,702346,-680510,0,0,0,"140",".",113260,0
"11472",228723,"TEXAS A &amp; M UNIVERSITY                                      ","2003-2004",22,"Tennis",627938,1308783,-680845,204750,575733,-370983,423188,733050,-309862,"14","11",197012,162000
"6834",166629,"UNIVERSITY OF MASSACHUSETTS-AMHERST                         ","2003-2004",11,"Lacrosse",87283,768345,-681062,83711,518609,-434898,3572,249736,-246164,"42","27",76396,49918
"10057",209551,"UNIVERSITY OF OREGON                                        ","2003-2004",16,"Softball",111616,793045,-681429,0,0,0,111616,793045,-681429,".","19",0,180990
"17059",219000,"AUGUSTANA COLLEGE                                           ","2003-2004",39,"Total Participants",492659,1175434,-682775,201705,445388,-243683,290954,730046,-439092,"216","132",279988,191571
"6914",152080,"UNIVERSITY OF NOTRE DAME                                    ","2003-2004",13,"Rowing",114899,799667,-684768,0,0,0,114899,799667,-684768,".","82",0,136016
"14223",157289,"UNIVERSITY OF LOUISVILLE                                    ","2003-2004",26,"Volleyball",20501,706306,-685805,0,0,0,20501,706306,-685805,".","14",0,112275
"7960",104179,"UNIVERSITY OF ARIZONA                                       ","2003-2004",15,"Soccer",164281,850104,-685823,0,0,0,164281,850104,-685823,".","25",0,94300
"1749",130794,"YALE UNIVERSITY                                             ","2003-2004",2,"Basketball",422764,1108913,-686149,170147,616352,-446205,252617,492561,-239944,"16","16",97837,101240
"4235",199847,"WAKE FOREST UNIVERSITY                                      ","2003-2004",6,"Field hocky",9282,696335,-687053,0,0,0,9282,696335,-687053,".","17",0,57403
"7566",104151,"ARIZONA STATE UNIVERSITY-MAIN CAMPUS                        ","2003-2004",15,"Soccer",51978,739329,-687351,0,0,0,51978,739329,-687351,".","26",0,140181
"6557",196413,"SYRACUSE UNIVERSITY                                         ","2003-2004",11,"Lacrosse",1910614,2599047,-688433,1200704,1598992,-398288,709910,1000055,-290145,"47","35",340285,110629
"17340",196149,"SUNY COLLEGE AT CORTLAND                                    ","2003-2004",39,"Total Participants",646320,1334870,-688550,291885,581404,-289519,354435,753466,-399031,"352","265",404289,398934
"1023",236948,"UNIVERSITY OF WASHINGTON-SEATTLE CAMPUS                     ","2003-2004",1,"Baseball",151977,841475,-689498,151977,841475,-689498,0,0,0,"37",".",284208,0
"15419",185262,"KEAN UNIVERSITY                                             ","2003-2004",39,"Total Participants",15,690010,-689995,6,281752,-281746,9,408258,-408249,"260","163",214586,192740
"6938",155317,"UNIVERSITY OF KANSAS MAIN CAMPUS                            ","2003-2004",13,"Rowing",7280,697824,-690544,0,0,0,7280,697824,-690544,".","67",0,170521
"6392",102614,"UNIVERSITY OF ALASKA FAIRBANKS                              ","2003-2004",10,"Ice Hockey",486658,1178407,-691749,486658,1178407,-691749,0,0,0,"26",".",345632,0
"15974",219718,"BETHEL COLLEGE                                              ","2003-2004",39,"Total Participants",428399,1121892,-693493,205843,835693,-629850,222556,286199,-63643,"147","102",312847,189851
"5210",243744,"STANFORD UNIVERSITY                                         ","2003-2004",8,"Golf",281562,975626,-694064,164866,485011,-320145,116696,490615,-373919,"11","9",65116,23810
"93",139959,"UNIVERSITY OF GEORGIA                                       ","2003-2004",1,"Baseball",157018,851612,-694594,157018,851612,-694594,0,0,0,"41",".",232158,0
"7424",200800,"UNIVERSITY OF AKRON MAIN CAMPUS                             ","2003-2004",15,"Soccer",46059,740765,-694706,30941,410121,-379180,15118,330644,-315526,"29","22",61485,60791
"8077",128771,"CENTRAL CONNECTICUT STATE UNIVERSITY                        ","2003-2004",15,"Soccer",35247,730073,-694826,13138,362121,-348983,22109,367952,-345843,"25","26",51197,51424
"7300",100751,"UNIVERSITY OF ALABAMA                                       ","2003-2004",15,"Soccer",14312,710918,-696606,0,0,0,14312,710918,-696606,".","28",0,141200
"5228",159391,"LOUISIANA STATE UNIV &amp; AG &amp; MECH &amp; HEBERT LAWS CTR          ","2003-2004",8,"Golf",0,697770,-697770,0,301528,-301528,0,396242,-396242,"15","8",62330,60165
"6306",209542,"OREGON STATE UNIVERSITY                                     ","2003-2004",9,"Gymnastics",100687,799587,-698900,0,0,0,100687,799587,-698900,".","15",0,104750
"3785",198464,"EAST CAROLINA UNIVERSITY                                    ","2003-2004",3,"All Track Combined",36568,736159,-699591,17124,350977,-333853,19444,385182,-365738,"78","91",110886,92976
"6095",104179,"UNIVERSITY OF ARIZONA                                       ","2003-2004",8,"Golf",227645,927353,-699708,133614,526655,-393041,94031,400698,-306667,"14","10",61347,38122
"1123",147767,"NORTHWESTERN UNIVERSITY                                     ","2003-2004",1,"Baseball",94855,794933,-700078,94855,794933,-700078,0,0,0,"28",".",219369,0
"7037",126614,"UNIVERSITY OF COLORADO AT BOULDER                           ","2003-2004",14,"Skiing",138084,838368,-700284,70992,416497,-345505,67092,421871,-354779,"14","11",67236,68436
"5260",147767,"NORTHWESTERN UNIVERSITY                                     ","2003-2004",8,"Golf",64142,765684,-701542,53460,379246,-325786,10682,386438,-375756,"9","9",66740,74541
"6933",243744,"STANFORD UNIVERSITY                                         ","2003-2004",13,"Rowing",321706,1023840,-702134,215214,357146,-141932,106492,666694,-560202,"37","48",65648,62953
"8096",228723,"TEXAS A &amp; M UNIVERSITY                                      ","2003-2004",15,"Soccer",1098677,1801114,-702437,0,0,0,1098677,1801114,-702437,".","25",0,226903
"17104",130943,"UNIVERSITY OF DELAWARE                                      ","2003-2004",39,"Total Participants",4115259,4817768,-702509,1256742,1540743,-284001,2858517,3277025,-418508,"357","347",910315,589700
"10155",243780,"PURDUE UNIVERSITY-MAIN CAMPUS                               ","2003-2004",18,"Swimming and Diving",684189,1387962,-703773,268391,644508,-376117,415798,743454,-327656,"30","32",131997,160268
"552",186380,"RUTGERS UNIVERSITY-NEW BRUNSWICK                            ","2003-2004",1,"Baseball",0,705301,-705301,0,705301,-705301,0,0,0,"37",".",204345,0
"7124",100858,"AUBURN UNIVERSITY MAIN CAMPUS                               ","2003-2004",15,"Soccer",47004,753500,-706496,0,0,0,47004,753500,-706496,".","25",0,103644
"5123",100858,"AUBURN UNIVERSITY MAIN CAMPUS                               ","2003-2004",8,"Golf",84673,792017,-707344,64989,381861,-316872,19684,410156,-390472,"14","9",82874,87721
"15714",112826,"CONTRA COSTA COLLEGE                                        ","2003-2004",39,"Total Participants",12000,719730,-707730,6000,281710,-275710,6000,438020,-432020,"114","48",38300,32500
"3946",110644,"UNIVERSITY OF CALIFORNIA-DAVIS                              ","2003-2004",3,"All Track Combined",7662,715928,-708266,4495,349673,-345178,3167,366255,-363088,"78","104",57472,57343
"1610",190150,"COLUMBIA UNIVERSITY IN THE CITY OF NEW YORK                 ","2003-2004",2,"Basketball",239612,949820,-710208,219123,574278,-355155,20489,375542,-355053,"16","13",142376,86537
"8446",144740,"DEPAUL UNIVERSITY                                           ","2003-2004",15,"Soccer",55940,767000,-711060,28978,352358,-323380,26962,414642,-387680,"23","19",50131,79902
"13991",151351,"INDIANA UNIVERSITY-BLOOMINGTON                              ","2003-2004",26,"Volleyball",13535,725169,-711634,0,0,0,13535,725169,-711634,".","16",0,118653
"9148",104151,"ARIZONA STATE UNIVERSITY-MAIN CAMPUS                        ","2003-2004",16,"Softball",115731,827456,-711725,0,0,0,115731,827456,-711725,".","28",0,208496
"5284",199847,"WAKE FOREST UNIVERSITY                                      ","2003-2004",8,"Golf",22963,734792,-711829,19068,366811,-347743,3895,367981,-364086,"10","10",43766,30419
"15967",144005,"CHICAGO STATE UNIVERSITY                                    ","2003-2004",39,"Total Participants",579671,1291618,-711947,233612,557133,-323521,346059,734485,-388426,"85","54",223730,196365
"11364",106397,"UNIVERSITY OF ARKANSAS MAIN CAMPUS                          ","2003-2004",22,"Tennis",137451,849742,-712291,78965,443030,-364065,58486,406712,-348226,"11","8",174767,96445
"14928",170976,"UNIVERSITY OF MICHIGAN-ANN ARBOR                            ","2003-2004",28,"Wrestling",35632,748759,-713127,35632,748759,-713127,0,0,0,"31",".",122228,0
"17134",181215,"UNIVERSITY OF NEBRASKA AT KEARNEY                           ","2003-2004",39,"Total Participants",296122,1010633,-714511,128616,444881,-316265,167506,565752,-398246,"286","111",274275,200958
"6336",159391,"LOUISIANA STATE UNIV &amp; AG &amp; MECH &amp; HEBERT LAWS CTR          ","2003-2004",9,"Gymnastics",36342,751440,-715098,0,0,0,36342,751440,-715098,".","16",0,131949
"9787",134097,"FLORIDA STATE UNIVERSITY                                    ","2003-2004",16,"Softball",78178,793514,-715336,0,0,0,78178,793514,-715336,".","18",0,202320
"11634",157085,"UNIVERSITY OF KENTUCKY                                      ","2003-2004",22,"Tennis",0,715502,-715502,0,322588,-322588,0,392914,-392914,"12","10",134786,119030
"13929",100751,"UNIVERSITY OF ALABAMA                                       ","2003-2004",26,"Volleyball",13280,729400,-716120,0,0,0,13280,729400,-716120,".","13",0,165215
"11599",234076,"UNIVERSITY OF VIRGINIA-MAIN CAMPUS                          ","2003-2004",22,"Tennis",74475,792413,-717938,54195,407511,-353316,20280,384902,-364622,"13","10",91272,64440
"9224",209542,"OREGON STATE UNIVERSITY                                     ","2003-2004",16,"Softball",119101,837965,-718864,0,0,0,119101,837965,-718864,".","17",0,193888
"8051",215293,"UNIVERSITY OF PITTSBURGH-MAIN CAMPUS                        ","2003-2004",15,"Soccer",0,719245,-719245,0,354034,-354034,0,365211,-365211,"26","29",63566,65544
"13179",209542,"OREGON STATE UNIVERSITY                                     ","2003-2004",26,"Volleyball",35549,754828,-719279,0,0,0,35549,754828,-719279,".","14",0,110771
"7346",221759,"THE UNIVERSITY OF TENNESSEE                                 ","2003-2004",15,"Soccer",55503,774852,-719349,0,0,0,55503,774852,-719349,".","23",0,179653
"13828",100858,"AUBURN UNIVERSITY MAIN CAMPUS                               ","2003-2004",26,"Volleyball",10278,730029,-719751,0,0,0,10278,730029,-719751,".","13",0,121310
"7000",174066,"UNIVERSITY OF MINNESOTA-TWIN CITIES                         ","2003-2004",13,"Rowing",13073,733493,-720420,0,0,0,13073,733493,-720420,".","79",0,192901
"513",209542,"OREGON STATE UNIVERSITY                                     ","2003-2004",1,"Baseball",105124,827578,-722454,105124,827578,-722454,0,0,0,"38",".",215315,0
"1004",155317,"UNIVERSITY OF KANSAS MAIN CAMPUS                            ","2003-2004",1,"Baseball",131727,854753,-723026,131727,854753,-723026,0,0,0,"48",".",262732,0
"6985",155399,"KANSAS STATE UNIVERSITY                                     ","2003-2004",13,"Rowing",35473,758867,-723394,0,0,0,35473,758867,-723394,"0","77",0,175187
"2733",209807,"PORTLAND STATE UNIVERSITY                                   ","2003-2004",2,"Basketball",564257,1288204,-723947,301680,691078,-389398,262577,597126,-334549,"16","15",136599,119455
"10941",176017,"UNIVERSITY OF MISSISSIPPI MAIN CAMPUS                       ","2003-2004",22,"Tennis",111786,837208,-725422,111786,471678,-359892,0,365530,-365530,"11","9",155688,96314
"12840",139755,"GEORGIA INSTITUTE OF TECHNOLOGY-MAIN CAMPUS                 ","2003-2004",25,"Track and Field, X-Country",684876,1410664,-725788,313112,711592,-398480,371764,699072,-327308,"46","40",130683,138645
"11496",228778,"THE UNIVERSITY OF TEXAS AT AUSTIN                           ","2003-2004",22,"Tennis",480160,1208968,-728808,207514,596866,-389352,272646,612102,-339456,"13","9",127929,93908
"6653",221999,"VANDERBILT UNIVERSITY                                       ","2003-2004",11,"Lacrosse",96980,825820,-728840,0,0,0,96980,825820,-728840,".","28",0,136032
"8110",220862,"UNIVERSITY OF MEMPHIS                                       ","2003-2004",15,"Soccer",28812,757882,-729070,22262,346742,-324480,6550,411140,-404590,"24","24",57733,84543
"11206",174066,"UNIVERSITY OF MINNESOTA-TWIN CITIES                         ","2003-2004",22,"Tennis",61556,790903,-729347,45053,429842,-384789,16503,361061,-344558,"13","14",85143,64146
"3577",200800,"UNIVERSITY OF AKRON MAIN CAMPUS                             ","2003-2004",3,"All Track Combined",47281,776670,-729389,42915,324086,-281171,4366,452584,-448218,"38","45",67677,72859
"7622",129020,"UNIVERSITY OF CONNECTICUT                                   ","2003-2004",15,"Soccer",297542,1027767,-730225,208479,623981,-415502,89063,403786,-314723,"29","27",323444,182234
"9376",181464,"UNIVERSITY OF NEBRASKA AT LINCOLN                           ","2003-2004",16,"Softball",94186,824702,-730516,0,0,0,94186,824702,-730516,".","21",0,182337
"7557",217819,"COLLEGE OF CHARLESTON                                       ","2003-2004",15,"Soccer",44693,775895,-731202,9908,352316,-342408,34785,423579,-388794,"31","29",51861,128622
"7769",206622,"XAVIER UNIVERSITY                                           ","2003-2004",15,"Soccer",5241,740588,-735347,2938,279159,-276221,2303,461429,-459126,"28","20",51203,92249
"1457",218663,"UNIVERSITY OF SOUTH CAROLINA-COLUMBIA                       ","2003-2004",1,"Baseball",383872,1119848,-735976,383872,1119848,-735976,0,0,0,"36",".",314276,0
"4455",154590,"WILLIAM PENN UNIVERSITY                                     ","2003-2004",7,"Football",79924,816591,-736667,79924,816591,-736667,0,0,0,"90",".",74790,0
"14104",139959,"UNIVERSITY OF GEORGIA                                       ","2003-2004",26,"Volleyball",400,737391,-736991,0,0,0,400,737391,-736991,".","14",0,92607
"4647",223427,"BLINN COLLEGE                                               ","2003-2004",7,"Football",14718,752462,-737744,14718,752462,-737744,0,0,0,"83",".",91374,0
"17208",222831,"ANGELO STATE UNIVERSITY                                     ","2003-2004",39,"Total Participants",13256,751044,-737788,1603,132157,-130554,11653,618887,-607234,"163","109",173090,182948
"11506",134097,"FLORIDA STATE UNIVERSITY                                    ","2003-2004",22,"Tennis",50464,788557,-738093,23996,378964,-354968,26468,409593,-383125,"8","14",104655,85472
"14573",199847,"WAKE FOREST UNIVERSITY                                      ","2003-2004",26,"Volleyball",3557,743989,-740432,0,0,0,3557,743989,-740432,".","15",0,75287
"13229",214777,"PENNSYLVANIA STATE UNIVERSITY-MAIN CAMPUS                   ","2003-2004",26,"Volleyball",548084,1290727,-742643,128073,333320,-205247,420011,957407,-537396,"17","17",99942,228594
"11658",204796,"OHIO STATE UNIVERSITY-MAIN CAMPUS                           ","2003-2004",22,"Tennis",59077,803033,-743956,17401,342833,-325432,41676,460200,-418524,"8","12",74127,78407
"4814",179566,"SOUTHWEST MISSOURI STATE UNIVERSITY                         ","2003-2004",7,"Football",1384059,2128196,-744137,1384059,2128196,-744137,0,0,0,"90",".",212763,0
"1026",155399,"KANSAS STATE UNIVERSITY                                     ","2003-2004",1,"Baseball",78601,822836,-744235,78601,822836,-744235,0,0,0,"41",".",197355,0
"1515",199847,"WAKE FOREST UNIVERSITY                                      ","2003-2004",1,"Baseball",9452,754747,-745295,9452,754747,-745295,0,0,0,"29",".",119641,0
"3702",172699,"WESTERN MICHIGAN UNIVERSITY                                 ","2003-2004",3,"All Track Combined",27149,772487,-745338,22689,379624,-356935,4460,392863,-388403,"90","106",97066,81038
"10517",236948,"UNIVERSITY OF WASHINGTON-SEATTLE CAMPUS                     ","2003-2004",19,"Swimming",275650,1021317,-745667,69891,481677,-411786,205759,539640,-333881,"24","24",91781,91782
"4680",237969,"WEST VIRGINIA WESLEYAN COLLEGE                              ","2003-2004",7,"Football",236440,982294,-745854,236440,982294,-745854,0,0,0,"88",".",93564,0
"2311",221847,"TENNESSEE TECHNOLOGICAL UNIVERSITY                          ","2003-2004",2,"Basketball",513762,1260652,-746890,372796,770803,-398007,140966,489849,-348883,"12","12",90675,76448
"4812",127741,"UNIVERSITY OF NORTHERN COLORADO                             ","2003-2004",7,"Football",304153,1052003,-747850,304153,1052003,-747850,0,0,0,"96",".",277201,0
"11556",243744,"STANFORD UNIVERSITY                                         ","2003-2004",22,"Tennis",298646,1047204,-748558,168788,473050,-304262,129858,574154,-444296,"11","11",59239,77929
"17308",110495,"CALIFORNIA STATE UNIVERSITY-STANISLAUS                      ","2003-2004",39,"Total Participants",201697,950462,-748765,81741,363036,-281295,119956,587426,-467470,"107","179",176816,225104
"12975",217402,"PROVIDENCE COLLEGE                                          ","2003-2004",25,"Track and Field, X-Country",661,750540,-749879,581,358183,-357602,80,392357,-392277,"20","16",33694,33693
"15910",183062,"KEENE STATE COLLEGE                                         ","2003-2004",39,"Total Participants",687335,1438681,-751346,362826,782131,-419305,324509,656550,-332041,"164","159",242227,219874
"8476",234030,"VIRGINIA COMMONWEALTH UNIVERSITY                            ","2003-2004",15,"Soccer",43038,795055,-752017,32367,415365,-382998,10671,379690,-369019,"25","21",45401,48575
"7839",157289,"UNIVERSITY OF LOUISVILLE                                    ","2003-2004",15,"Soccer",78349,830676,-752327,17465,376951,-359486,60884,453725,-392841,"28","26",66667,64450
"3510",223232,"BAYLOR UNIVERSITY                                           ","2003-2004",3,"All Track Combined",1181620,1934153,-752533,515177,890349,-375172,666443,1043804,-377361,"32","33",272158,272158
"8569",100858,"AUBURN UNIVERSITY MAIN CAMPUS                               ","2003-2004",16,"Softball",34795,788916,-754121,0,0,0,34795,788916,-754121,".","21",0,188149
"11732",181464,"UNIVERSITY OF NEBRASKA AT LINCOLN                           ","2003-2004",22,"Tennis",17609,772993,-755384,5000,337706,-332706,12609,435287,-422678,"10","10",71653,59445
"5968",170976,"UNIVERSITY OF MICHIGAN-ANN ARBOR                            ","2003-2004",8,"Golf",33210,789487,-756277,24734,340506,-315772,8476,448981,-440505,"11","14",75082,80126
"919",157085,"UNIVERSITY OF KENTUCKY                                      ","2003-2004",1,"Baseball",35278,792230,-756952,35278,792230,-756952,0,0,0,"35",".",334738,0
"6431",201441,"BOWLING GREEN STATE UNIVERSITY-MAIN CAMPUS                  ","2003-2004",10,"Ice Hockey",314691,1072587,-757896,314691,1072587,-757896,0,0,0,"30",".",211883,0
"6520",172699,"WESTERN MICHIGAN UNIVERSITY                                 ","2003-2004",10,"Ice Hockey",317383,1078827,-761444,317383,1078827,-761444,0,0,0,"26",".",291004,0
"15779",180179,"MONTANA STATE UNIVERSITY-BILLINGS                           ","2003-2004",39,"Total Participants",65214,828791,-763577,10601,237176,-226575,54613,591615,-537002,"62","77",152349,261457
"17145",110583,"CALIFORNIA STATE UNIVERSITY-LONG BEACH                      ","2003-2004",39,"Total Participants",3608823,4372810,-763987,1576654,1844907,-268253,2032169,2527903,-495734,"177","245",624887,579095
"14119",171100,"MICHIGAN STATE UNIVERSITY                                   ","2003-2004",26,"Volleyball",102142,868153,-766011,0,0,0,102142,868153,-766011,".","18",0,162592
"11466",110662,"UNIVERSITY OF CALIFORNIA-LOS ANGELES                        ","2003-2004",22,"Tennis",168595,936053,-767458,106581,440963,-334382,62014,495090,-433076,"14","13",65599,69086
"14220",221759,"THE UNIVERSITY OF TENNESSEE                                 ","2003-2004",26,"Volleyball",223352,991583,-768231,0,0,0,223352,991583,-768231,".","16",0,147334
"16989",122931,"SANTA CLARA UNIVERSITY                                      ","2003-2004",39,"Total Participants",3897202,4666233,-769031,2008399,2249560,-241161,1888803,2416673,-527870,"155","142",459809,352451
"10137",178396,"UNIVERSITY OF MISSOURI-COLUMBIA                             ","2003-2004",18,"Swimming and Diving",22858,792287,-769429,11429,329265,-317836,11429,463022,-451593,"22","34",45220,51746
"9234",147767,"NORTHWESTERN UNIVERSITY                                     ","2003-2004",16,"Softball",9153,779513,-770360,0,0,0,9153,779513,-770360,".","17",0,142480
"16190",220215,"FREED-HARDEMAN UNIVERSITY                                   ","2003-2004",39,"Total Participants",134080,905246,-771166,70430,495403,-424973,63650,409843,-346193,"82","71",104801,92744
"14691",123961,"UNIVERSITY OF SOUTHERN CALIFORNIA                           ","2003-2004",27,"Water Polo",55810,827343,-771533,27905,341869,-313964,27905,485474,-457569,"21","30",70567,70567
"4518",131496,"GEORGETOWN UNIVERSITY                                       ","2003-2004",7,"Football",390909,1164010,-773101,390909,1164010,-773101,0,0,0,"93",".",346756,0
"16197",154004,"MORNINGSIDE COLLEGE                                         ","2003-2004",39,"Total Participants",152773,926653,-773880,61768,419640,-357872,91005,507013,-416008,"189","119",147043,133745
"17148",227845,"SAINT EDWARD'S UNIVERSITY                                   ","2003-2004",39,"Total Participants",2504,777462,-774958,401,376191,-375790,2103,401271,-399168,"111","80",119388,143144
"16644",218742,"UNIVERSITY OF SOUTH CAROLINA-SPARTANBURG                    ","2003-2004",39,"Total Participants",63214,838757,-775543,34167,398640,-364473,29047,440117,-411070,"89","87",119859,127411
"3327",226091,"LAMAR UNIVERSITY                                            ","2003-2004",2,"Basketball",473398,1249810,-776412,379589,743601,-364012,93809,506209,-412400,"15","15",121335,87416
"2356",219709,"BELMONT UNIVERSITY                                          ","2003-2004",2,"Basketball",553887,1330608,-776721,446934,758393,-311459,106953,572215,-465262,"15","13",125070,78601
"13833",215293,"UNIVERSITY OF PITTSBURGH-MAIN CAMPUS                        ","2003-2004",26,"Volleyball",2537,779823,-777286,0,0,0,2537,779823,-777286,".","13",0,128403
"14058",155399,"KANSAS STATE UNIVERSITY                                     ","2003-2004",26,"Volleyball",81623,859545,-777922,0,0,0,81623,859545,-777922,"0","16",0,229671
"17068",106412,"UNIVERSITY OF ARKANSAS AT PINE BLUFF                        ","2003-2004",39,"Total Participants",562,782225,-781663,80,245643,-245563,482,536582,-536100,"183","123",433360,247339
"4648",227881,"SAM HOUSTON STATE UNIVERSITY                                ","2003-2004",7,"Football",522877,1304623,-781746,522877,1304623,-781746,0,0,0,"112",".",347128,0
"2767",223232,"BAYLOR UNIVERSITY                                           ","2003-2004",2,"Basketball",3096514,3878657,-782143,1567394,1963299,-395905,1529120,1915358,-386238,"16","14",379589,369141
"15585",157386,"MOREHEAD STATE UNIVERSITY                                   ","2003-2004",39,"Total Participants",714052,1499716,-785664,289002,535644,-246642,425050,964072,-539022,"291","158",325667,233615
"10667",199847,"WAKE FOREST UNIVERSITY                                      ","2003-2004",22,"Tennis",2785,793600,-790815,2784,329442,-326658,1,464158,-464157,"10","9",52806,54325
"10402",182281,"UNIVERSITY OF NEVADA-LAS VEGAS                              ","2003-2004",18,"Swimming and Diving",141558,933953,-792395,38420,431018,-392598,103138,502935,-399797,"24","28",60483,72522
"11581",229115,"TEXAS TECH UNIVERSITY                                       ","2003-2004",22,"Tennis",32687,825346,-792659,21377,399529,-378152,11310,425817,-414507,"13","11",58484,89098
"4932",176372,"UNIVERSITY OF SOUTHERN MISSISSIPPI                          ","2003-2004",7,"Football",4846178,5639258,-793080,4846178,5639258,-793080,0,0,0,"121",".",1296731,0
"16434",127741,"UNIVERSITY OF NORTHERN COLORADO                             ","2003-2004",39,"Total Participants",840333,1634722,-794389,377583,591793,-214210,462750,1042929,-580179,"220","192",526369,277058
"10203",110662,"UNIVERSITY OF CALIFORNIA-LOS ANGELES                        ","2003-2004",18,"Swimming and Diving",43670,838862,-795192,0,0,0,43670,838862,-795192,"0","39",0,115133
"11978",153269,"DRAKE UNIVERSITY                                            ","2003-2004",24,"Track and Field, Outdoor",2035,797809,-795774,1164,319283,-318119,871,478526,-477655,"32","32",33983,40836
"3427",164924,"BOSTON COLLEGE                                              ","2003-2004",2,"Basketball",3610194,4406298,-796104,3163990,2708878,455112,446204,1697420,-1251216,"13","13",381237,356443
"4936",141264,"VALDOSTA STATE UNIVERSITY                                   ","2003-2004",7,"Football",294327,1091597,-797270,294327,1091597,-797270,0,0,0,"120",".",184778,0
"455",170976,"UNIVERSITY OF MICHIGAN-ANN ARBOR                            ","2003-2004",1,"Baseball",182171,980390,-798219,182171,980390,-798219,0,0,0,"35",".",268783,0
"6156",228723,"TEXAS A &amp; M UNIVERSITY                                      ","2003-2004",8,"Golf",125231,925669,-800438,89917,467970,-378053,35314,457699,-422385,"15","12",139679,153419
"13750",228723,"TEXAS A &amp; M UNIVERSITY                                      ","2003-2004",26,"Volleyball",398469,1200088,-801619,0,0,0,398469,1200088,-801619,".","17",0,281515
"6314",100858,"AUBURN UNIVERSITY MAIN CAMPUS                               ","2003-2004",9,"Gymnastics",61065,863962,-802897,0,0,0,61065,863962,-802897,".","17",0,129294
"8441",171100,"MICHIGAN STATE UNIVERSITY                                   ","2003-2004",15,"Soccer",62885,866156,-803271,39456,391694,-352238,23429,474462,-451033,"26","29",68779,84906
"16935",240277,"UNIVERSITY OF WISCONSIN-GREEN BAY                           ","2003-2004",39,"Total Participants",1177443,1981295,-803852,538958,792546,-253588,638485,1188749,-550264,"104","118",457708,419459
"6783",164076,"TOWSON UNIVERSITY                                           ","2003-2004",11,"Lacrosse",122076,926850,-804774,94956,531616,-436660,27120,395234,-368114,"56","28",76048,55439
"17257",216667,"WASHINGTON &amp; JEFFERSON COLLEGE                              ","2003-2004",39,"Total Participants",737906,1543291,-805385,366424,766092,-399668,371482,777199,-405717,"324","178",282548,160487
"17076",200332,"NORTH DAKOTA STATE UNIVERSITY-MAIN CAMPUS                   ","2003-2004",39,"Total Participants",895204,1700996,-805792,319585,692166,-372581,575619,1008830,-433211,"269","116",552895,350255
"9172",170976,"UNIVERSITY OF MICHIGAN-ANN ARBOR                            ","2003-2004",16,"Softball",36747,843284,-806537,0,0,0,36747,843284,-806537,".","22",0,162919
"10673",100858,"AUBURN UNIVERSITY MAIN CAMPUS                               ","2003-2004",22,"Tennis",25651,833040,-807389,22891,414463,-391572,2760,418577,-415817,"9","12",98150,70236
"8742",134130,"UNIVERSITY OF FLORIDA                                       ","2003-2004",16,"Softball",71050,880608,-809558,0,0,0,71050,880608,-809558,".","23",0,302080
"10807",236948,"UNIVERSITY OF WASHINGTON-SEATTLE CAMPUS                     ","2003-2004",22,"Tennis",225835,1037057,-811222,64109,480878,-416769,161726,556179,-394453,"9","9",121114,109491
"9024",243744,"STANFORD UNIVERSITY                                         ","2003-2004",16,"Softball",72541,885923,-813382,0,0,0,72541,885923,-813382,".","19",0,131421
"3896",220862,"UNIVERSITY OF MEMPHIS                                       ","2003-2004",3,"All Track Combined",2735,816725,-813990,2734,357515,-354781,1,459210,-459209,"24","32",54118,66624
"7806",217402,"PROVIDENCE COLLEGE                                          ","2003-2004",15,"Soccer",14612,828783,-814171,13262,430674,-417412,1350,398109,-396759,"23","20",55125,46192
"1914",120883,"UNIVERSITY OF THE PACIFIC                                   ","2003-2004",2,"Basketball",1464056,2278626,-814570,866796,1265560,-398764,597260,1013066,-415806,"16","17",212489,138282
"2624",196097,"SUNY AT STONY BROOK                                         ","2003-2004",2,"Basketball",1150710,1966120,-815410,723991,1073721,-349730,426719,892399,-465680,"19","14",102812,102515
"10757",104151,"ARIZONA STATE UNIVERSITY-MAIN CAMPUS                        ","2003-2004",22,"Tennis",124769,940254,-815485,77237,411531,-334294,47532,528723,-481191,"7","11",119303,114530
"5464",134130,"UNIVERSITY OF FLORIDA                                       ","2003-2004",8,"Golf",89827,905760,-815933,64935,496724,-431789,24892,409036,-384144,"10","9",140747,115290
"9367",152080,"UNIVERSITY OF NOTRE DAME                                    ","2003-2004",16,"Softball",53853,872330,-818477,0,0,0,53853,872330,-818477,".","15",0,143235
"3572",153603,"IOWA STATE UNIVERSITY                                       ","2003-2004",3,"All Track Combined",235197,1054894,-819697,18243,507887,-489644,216954,547007,-330053,"126","101",80711,86656
"285",152080,"UNIVERSITY OF NOTRE DAME                                    ","2003-2004",1,"Baseball",365665,1186417,-820752,365665,1186417,-820752,0,0,0,"38",".",272290,0
"3707",207388,"OKLAHOMA STATE UNIVERSITY-MAIN CAMPUS                       ","2003-2004",3,"All Track Combined",80348,902240,-821892,56092,438892,-382800,24256,463348,-439092,"59","108",104547,111085
"10910",147767,"NORTHWESTERN UNIVERSITY                                     ","2003-2004",22,"Tennis",21045,845159,-824114,11803,347589,-335786,9242,497570,-488328,"9","15",75148,71620
"13549",147767,"NORTHWESTERN UNIVERSITY                                     ","2003-2004",26,"Volleyball",19786,844144,-824358,0,0,0,19786,844144,-824358,".","12",0,154948
"7408",182281,"UNIVERSITY OF NEVADA-LAS VEGAS                              ","2003-2004",15,"Soccer",124585,949678,-825093,60718,490474,-429756,63867,459204,-395337,"26","29",90820,85459
"1861",217165,"BRYANT COLLEGE                                              ","2003-2004",2,"Basketball",140581,967672,-827091,72482,487744,-415262,68099,479928,-411829,"14","16",51604,54576
"12281",126818,"COLORADO STATE UNIVERSITY                                   ","2003-2004",25,"Track and Field, X-Country",64834,892095,-827261,42277,402504,-360227,22557,489591,-467034,"112","146",109186,106825
"4855",219806,"CARSON-NEWMAN COLLEGE                                       ","2003-2004",7,"Football",42301,870709,-828408,42301,870709,-828408,0,0,0,"208",".",141440,0
"3501",156125,"WICHITA STATE UNIVERSITY                                    ","2003-2004",3,"All Track Combined",22844,851482,-828638,11422,399977,-388555,11422,451505,-440083,"74","82",120037,117883
"10437",186380,"RUTGERS UNIVERSITY-NEW BRUNSWICK                            ","2003-2004",18,"Swimming and Diving",18314,847644,-829330,0,397700,-397700,18314,449944,-431630,"28","21",51208,48019
"6341",110662,"UNIVERSITY OF CALIFORNIA-LOS ANGELES                        ","2003-2004",9,"Gymnastics",213141,1042663,-829522,0,0,0,213141,1042663,-829522,"0","18",0,101410
"4980",154095,"UNIVERSITY OF NORTHERN IOWA                                 ","2003-2004",7,"Football",1054967,1888145,-833178,1054967,1888145,-833178,0,0,0,"107",".",228282,0
"11488",159391,"LOUISIANA STATE UNIV &amp; AG &amp; MECH &amp; HEBERT LAWS CTR          ","2003-2004",22,"Tennis",5099,838964,-833865,5099,414151,-409052,0,424813,-424813,"11","8",113398,102179
"2259",198136,"CAMPBELL UNIVERSITY INC                                     ","2003-2004",2,"Basketball",789512,1626903,-837391,463242,890687,-427445,326270,736216,-409946,"14","15",204040,174755
"3677",110608,"CALIFORNIA STATE UNIVERSITY-NORTHRIDGE                      ","2003-2004",3,"All Track Combined",49845,888180,-838335,25478,391443,-365965,24367,496737,-472370,"76","96",120081,127503
"13363",218663,"UNIVERSITY OF SOUTH CAROLINA-COLUMBIA                       ","2003-2004",26,"Volleyball",3874,843771,-839897,0,0,0,3874,843771,-839897,".","12",0,170235
"13021",174066,"UNIVERSITY OF MINNESOTA-TWIN CITIES                         ","2003-2004",26,"Volleyball",118339,958325,-839986,0,0,0,118339,958325,-839986,".","14",0,191817
"7795",181464,"UNIVERSITY OF NEBRASKA AT LINCOLN                           ","2003-2004",15,"Soccer",24909,867187,-842278,0,0,0,24909,867187,-842278,".","25",0,169843
"1764",228459,"TEXAS STATE UNIVERSITY-SAN MARCOS                           ","2003-2004",2,"Basketball",175067,1019598,-844531,110526,505425,-394899,64541,514173,-449632,"12","16",104790,98498
"16172",129215,"EASTERN CONNECTICUT STATE UNIVERSITY                        ","2003-2004",39,"Total Participants",164418,1009217,-844799,113169,471663,-358494,51249,537554,-486305,"156","182",214827,163112
"43",100751,"UNIVERSITY OF ALABAMA                                       ","2003-2004",1,"Baseball",474968,1320426,-845458,474968,1320426,-845458,0,0,0,"38",".",305256,0
"9167",221759,"THE UNIVERSITY OF TENNESSEE                                 ","2003-2004",16,"Softball",34537,880915,-846378,0,0,0,34537,880915,-846378,".","20",0,329823
"3679",163286,"UNIVERSITY OF MARYLAND-COLLEGE PARK                         ","2003-2004",3,"All Track Combined",0,847892,-847892,0,267244,-267244,0,580648,-580648,"24","42",84663,122699
"16054",219383,"UNIVERSITY OF SIOUX FALLS                                   ","2003-2004",39,"Total Participants",22619,871109,-848490,9575,380644,-371069,13044,490465,-477421,"258","171",139110,98901
"2982",142276,"IDAHO STATE UNIVERSITY                                      ","2003-2004",2,"Basketball",474520,1323755,-849235,364501,713726,-349225,110019,610029,-500010,"13","14",232474,208051
"7988",240444,"UNIVERSITY OF WISCONSIN-MADISON                             ","2003-2004",15,"Soccer",369930,1219561,-849631,167735,596617,-428882,202195,622944,-420749,"22","34",116758,102642
"5024",110644,"UNIVERSITY OF CALIFORNIA-DAVIS                              ","2003-2004",7,"Football",170836,1023370,-852534,170836,1023370,-852534,0,0,0,"106",".",189567,0
"9664",110662,"UNIVERSITY OF CALIFORNIA-LOS ANGELES                        ","2003-2004",16,"Softball",96107,953527,-857420,0,0,0,96107,953527,-857420,".","19",0,164692
"17147",187648,"EASTERN NEW MEXICO UNIVERSITY-MAIN CAMPUS                   ","2003-2004",39,"Total Participants",52043,912247,-860204,30490,287430,-256940,21553,624817,-603264,"244","134",243011,163510
"16790",230782,"WEBER STATE UNIVERSITY                                      ","2003-2004",39,"Total Participants",806885,1673662,-866777,251491,515615,-264124,555394,1158047,-602653,"174","122",479089,377492
"15620",120184,"NOTRE DAME DE NAMUR UNIVERSITY                              ","2003-2004",39,"Total Participants",553169,1422222,-869053,230423,615478,-385055,322746,806744,-483998,"82","87",210650,238975
"15534",174844,"SAINT OLAF COLLEGE                                          ","2003-2004",39,"Total Participants",74315,943748,-869433,37245,506975,-469730,37070,436773,-399703,"383","348",288600,192977
"13932",152080,"UNIVERSITY OF NOTRE DAME                                    ","2003-2004",26,"Volleyball",28852,898433,-869581,0,0,0,28852,898433,-869581,".","14",0,131841
"5084",198215,"CATAWBA COLLEGE                                             ","2003-2004",7,"Football",160202,1029858,-869656,160202,1029858,-869656,0,0,0,"123",".",102000,0
"15418",123651,"VANGUARD UNIVERSITY OF SOUTHERN CALIFORNIA                  ","2003-2004",39,"Total Participants",373911,1244378,-870467,177988,589035,-411047,195923,655343,-459420,"77","77",69440,82840
"2239",159939,"UNIVERSITY OF NEW ORLEANS                                   ","2003-2004",2,"Basketball",382546,1256003,-873457,363086,781021,-417935,19460,474982,-455522,"15","15",201763,191089
"4637",151324,"INDIANA STATE UNIVERSITY                                    ","2003-2004",7,"Football",631885,1506202,-874317,631885,1506202,-874317,0,0,0,"96",".",154749,0
"4823",206695,"YOUNGSTOWN STATE UNIVERSITY                                 ","2003-2004",7,"Football",1451631,2326588,-874957,1451631,2326588,-874957,0,0,0,"105",".",279865,0
"7003",209542,"OREGON STATE UNIVERSITY                                     ","2003-2004",13,"Rowing",32658,913111,-880453,14104,260037,-245933,18554,653074,-634520,"19","31",117597,96168
"2453",224147,"TEXAS A &amp; M UNIVERSITY-CORPUS CHRISTI                       ","2003-2004",2,"Basketball",331470,1213029,-881559,246499,636185,-389686,84971,576844,-491873,"17","14",152154,152043
"12234",203517,"KENT STATE UNIVERSITY-MAIN CAMPUS                           ","2003-2004",25,"Track and Field, X-Country",28097,911212,-883115,11758,409720,-397962,16339,501492,-485153,"87","123",93224,89516
"5239",139959,"UNIVERSITY OF GEORGIA                                       ","2003-2004",8,"Golf",300,884314,-884014,200,431012,-430812,100,453302,-453202,"13","8",48307,44916
"2683",220075,"EAST TENNESSEE STATE UNIVERSITY                             ","2003-2004",2,"Basketball",359002,1243659,-884657,345254,799331,-454077,13748,444328,-430580,"12","14",87202,37570
"6905",171100,"MICHIGAN STATE UNIVERSITY                                   ","2003-2004",13,"Rowing",59504,946732,-887228,0,0,0,59504,946732,-887228,".","91",0,155232
"6981",123961,"UNIVERSITY OF SOUTHERN CALIFORNIA                           ","2003-2004",13,"Rowing",39359,926779,-887420,0,0,0,39359,926779,-887420,".","61",0,187825
"5805",123961,"UNIVERSITY OF SOUTHERN CALIFORNIA                           ","2003-2004",8,"Golf",479678,1371076,-891398,239839,693101,-453262,239839,677975,-438136,"8","8",293781,293781
"11722",151351,"INDIANA UNIVERSITY-BLOOMINGTON                              ","2003-2004",22,"Tennis",0,891868,-891868,0,361773,-361773,0,530095,-530095,"9","11",80025,89632
"15461",175616,"DELTA STATE UNIVERSITY                                      ","2003-2004",39,"Total Participants",68585,961585,-893000,57831,527544,-469713,10754,434041,-423287,"244","91",216852,105066
"7008",204796,"OHIO STATE UNIVERSITY-MAIN CAMPUS                           ","2003-2004",13,"Rowing",31001,925620,-894619,0,0,0,31001,925620,-894619,".","86",0,145463
"3520",135726,"UNIVERSITY OF MIAMI                                         ","2003-2004",3,"All Track Combined",651898,1546583,-894685,79633,324840,-245207,572265,1221743,-649478,"68","73",83622,154158
"16991",159966,"NICHOLLS STATE UNIVERSITY                                   ","2003-2004",39,"Total Participants",112546,1009584,-897038,46012,319696,-273684,66534,689888,-623354,"204","162",341314,183425
"17165",121345,"POMONA COLLEGE                                              ","2003-2004",39,"Total Participants",246420,1144618,-898198,108477,475044,-366567,137943,669574,-531631,"220","167",196118,128732
"1647",139931,"GEORGIA SOUTHERN UNIVERSITY                                 ","2003-2004",2,"Basketball",394468,1293466,-898998,160125,721067,-560942,234343,572399,-338056,"16","16",144849,93982
"10733",218663,"UNIVERSITY OF SOUTH CAROLINA-COLUMBIA                       ","2003-2004",22,"Tennis",0,899245,-899245,0,456612,-456612,0,442633,-442633,"9","10",143075,105018
"15868",207403,"OKLAHOMA BAPTIST UNIVERSITY                                 ","2003-2004",39,"Total Participants",145328,1044908,-899580,81750,554928,-473178,63578,489980,-426402,"122","118",136586,121977
"17139",234085,"VIRGINIA MILITARY INSTITUTE                                 ","2003-2004",39,"Total Participants",996386,1897178,-900792,745143,1425756,-680613,251243,471422,-220179,"417","53",548666,66029
"3846",214777,"PENNSYLVANIA STATE UNIVERSITY-MAIN CAMPUS                   ","2003-2004",3,"All Track Combined",794033,1695797,-901764,308481,697808,-389327,485552,997989,-512437,"120","153",201376,128158
"10457",234076,"UNIVERSITY OF VIRGINIA-MAIN CAMPUS                          ","2003-2004",18,"Swimming and Diving",105664,1007678,-902014,52832,475829,-422997,52832,531849,-479017,"29","29",66225,66225
"6968",186380,"RUTGERS UNIVERSITY-NEW BRUNSWICK                            ","2003-2004",13,"Rowing",51453,953897,-902444,0,636683,-636683,51453,317214,-265761,"80","59",135312,36990
"2772",183044,"UNIVERSITY OF NEW HAMPSHIRE-MAIN CAMPUS                     ","2003-2004",2,"Basketball",718452,1621156,-902704,410613,827049,-416436,307839,794107,-486268,"15","13",168077,134558
"6958",221759,"THE UNIVERSITY OF TENNESSEE                                 ","2003-2004",13,"Rowing",1122,905203,-904081,0,0,0,1122,905203,-904081,".","54",0,227060
"5208",221759,"THE UNIVERSITY OF TENNESSEE                                 ","2003-2004",8,"Golf",5084,909401,-904317,0,475452,-475452,5084,433949,-428865,"12","8",167119,122493
"15737",230038,"BRIGHAM YOUNG UNIVERSITY                                    ","2003-2004",39,"Total Participants",6336160,7240791,-904631,2492740,2791868,-299128,3843420,4448923,-605503,"383","318",2361206,1308286
"16212",220516,"KING COLLEGE                                                ","2003-2004",39,"Total Participants",144219,1049831,-905612,85002,683041,-598039,59217,366790,-307573,"88","61",64672,40230
"7901",216597,"VILLANOVA UNIVERSITY                                        ","2003-2004",15,"Soccer",22209,929148,-906939,6223,365158,-358935,15986,563990,-548004,"31","24",52257,61760
"3064",197869,"APPALACHIAN STATE UNIVERSITY                                ","2003-2004",2,"Basketball",258228,1165621,-907393,226100,608661,-382561,32128,556960,-524832,"17","15",203867,157136
"4193",170976,"UNIVERSITY OF MICHIGAN-ANN ARBOR                            ","2003-2004",6,"Field hocky",23276,931518,-908242,0,0,0,23276,931518,-908242,".","24",0,163220
"13856",170976,"UNIVERSITY OF MICHIGAN-ANN ARBOR                            ","2003-2004",26,"Volleyball",41944,951949,-910005,0,0,0,41944,951949,-910005,".","15",0,175976
"7245",181002,"CREIGHTON UNIVERSITY                                        ","2003-2004",15,"Soccer",145517,1057065,-911548,88430,579324,-490894,57087,477741,-420654,"32","23",81655,66759
"4698",190415,"CORNELL UNIVERSITY-ENDOWED COLLEGES                         ","2003-2004",7,"Football",749092,1660814,-911722,749092,1660814,-911722,0,0,0,"98",".",149791,0
"17228",170639,"LAKE SUPERIOR STATE UNIVERSITY                              ","2003-2004",39,"Total Participants",349622,1262179,-912557,319316,884545,-565229,30306,377634,-347328,"112","95",214882,137057
"4792",220075,"EAST TENNESSEE STATE UNIVERSITY                             ","2003-2004",7,"Football",285233,1198169,-912936,285233,1198169,-912936,0,0,0,"66",".",147298,0
"1986",227368,"THE UNIVERSITY OF TEXAS-PAN AMERICAN                        ","2003-2004",2,"Basketball",254733,1171468,-916735,217229,655891,-438662,37504,515577,-478073,"17","18",154651,124015
"8136",238032,"WEST VIRGINIA UNIVERSITY                                    ","2003-2004",15,"Soccer",93348,1010291,-916943,17166,318628,-301462,76182,691663,-615481,"31","28",80731,169685
"6994",236948,"UNIVERSITY OF WASHINGTON-SEATTLE CAMPUS                     ","2003-2004",13,"Rowing",425219,1343115,-917896,149226,590900,-441674,275993,752215,-476222,"69","126",145781,145782
"11286",123961,"UNIVERSITY OF SOUTHERN CALIFORNIA                           ","2003-2004",22,"Tennis",215356,1133678,-918322,127467,539704,-412237,87889,593974,-506085,"13","11",176160,151825
"16038",174233,"UNIVERSITY OF MINNESOTA-DULUTH                              ","2003-2004",39,"Total Participants",1921888,2842011,-920123,1448273,1278332,169941,473615,1563679,-1090064,"280","299",483999,336953
"895",221999,"VANDERBILT UNIVERSITY                                       ","2003-2004",1,"Baseball",422736,1346226,-923490,422736,1346226,-923490,0,0,0,"34",".",251912,0
"4516",221768,"THE UNIVERSITY OF TENNESSEE-MARTIN                          ","2003-2004",7,"Football",280465,1205715,-925250,280465,1205715,-925250,0,0,0,"62",".",161535,0
"3014",151324,"INDIANA STATE UNIVERSITY                                    ","2003-2004",2,"Basketball",1496680,2428466,-931786,1001765,1458287,-456522,494915,970179,-475264,"16","18",262582,142144
"16821",200004,"WESTERN CAROLINA UNIVERSITY                                 ","2003-2004",39,"Total Participants",178533,1111229,-932696,107914,462634,-354720,70619,648595,-577976,"181","82",617317,270164
"4270",181394,"UNIVERSITY OF NEBRASKA AT OMAHA                             ","2003-2004",7,"Football",203961,1137872,-933911,203961,1137872,-933911,0,0,0,"110",".",298982,0
"8451",179159,"SAINT LOUIS UNIVERSITY-MAIN CAMPUS                          ","2003-2004",15,"Soccer",116856,1057166,-940310,85300,528409,-443109,31556,528757,-497201,"27","30",71426,83529
"7780",221999,"VANDERBILT UNIVERSITY                                       ","2003-2004",15,"Soccer",302942,1243968,-941026,149532,403010,-253478,153410,840958,-687548,"32","18",45977,98529
"7512",233374,"UNIVERSITY OF RICHMOND                                      ","2003-2004",15,"Soccer",40543,983465,-942922,21945,443308,-421363,18598,540157,-521559,"24","18",54381,57668
"2458",159647,"LOUISIANA TECH UNIVERSITY                                   ","2003-2004",2,"Basketball",744520,1689756,-945236,304671,827527,-522856,439849,862229,-422380,"14","14",197327,217800
"14094",204796,"OHIO STATE UNIVERSITY-MAIN CAMPUS                           ","2003-2004",26,"Volleyball",276537,1222380,-945843,93737,363600,-269863,182800,858780,-675980,"20","15",49913,113222
"3967",164924,"BOSTON COLLEGE                                              ","2003-2004",3,"All Track Combined",11296,957223,-945927,5648,177071,-171423,5648,780152,-774504,"110","121",49047,77447
"15872",160038,"NORTHWESTERN STATE UNIVERSITY OF LOUISIANA                  ","2003-2004",39,"Total Participants",651374,1598356,-946982,215301,497894,-282593,436073,1100462,-664389,"244","146",400212,327465
"16266",225399,"HOUSTON BAPTIST UNIVERSITY                                  ","2003-2004",39,"Total Participants",1601,948589,-946988,800,322480,-321680,801,626109,-625308,"35","38",120510,145741
"1725",106458,"ARKANSAS STATE UNIVERSITY-MAIN CAMPUS                       ","2003-2004",2,"Basketball",670710,1618239,-947529,608142,1003204,-395062,62568,615035,-552467,"17","14",278351,217518
"824",221759,"THE UNIVERSITY OF TENNESSEE                                 ","2003-2004",1,"Baseball",396794,1350034,-953240,396794,1350034,-953240,0,0,0,"31",".",384166,0
"10386",171100,"MICHIGAN STATE UNIVERSITY                                   ","2003-2004",18,"Swimming and Diving",59307,1014477,-955170,36272,460990,-424718,23035,553487,-530452,"22","36",70167,86581
"10160",159391,"LOUISIANA STATE UNIV &amp; AG &amp; MECH &amp; HEBERT LAWS CTR          ","2003-2004",18,"Swimming and Diving",0,955342,-955342,0,477669,-477669,0,477673,-477673,"29","26",81063,81065
"6302",134130,"UNIVERSITY OF FLORIDA                                       ","2003-2004",9,"Gymnastics",123135,1080863,-957728,0,0,0,123135,1080863,-957728,".","20",0,227296
"3613",239105,"MARQUETTE UNIVERSITY                                        ","2003-2004",3,"All Track Combined",5608,964498,-958890,1542,471093,-469551,4066,493405,-489339,"36","43",86254,78217
"15856",175342,"ALCORN STATE UNIVERSITY                                     ","2003-2004",39,"Total Participants",34559,995849,-961290,13541,374182,-360641,21018,621667,-600649,"173","101",354671,210615
"3876",234076,"UNIVERSITY OF VIRGINIA-MAIN CAMPUS                          ","2003-2004",3,"All Track Combined",99146,1062828,-963682,49573,447737,-398164,49573,615091,-565518,"134","108",133631,133631
"16112",219806,"CARSON-NEWMAN COLLEGE                                       ","2003-2004",39,"Total Participants",29936,996735,-966799,7332,540354,-533022,22604,456381,-433777,"384","100",258868,95864
"316",104151,"ARIZONA STATE UNIVERSITY-MAIN CAMPUS                        ","2003-2004",1,"Baseball",418702,1388627,-969925,418702,1388627,-969925,0,0,0,"35",".",334947,0
"1984",198516,"ELON UNIVERSITY                                             ","2003-2004",2,"Basketball",227690,1198414,-970724,217693,660250,-442557,9997,538164,-528167,"15","15",89347,73534
"8153",123961,"UNIVERSITY OF SOUTHERN CALIFORNIA                           ","2003-2004",15,"Soccer",16331,987110,-970779,0,0,0,16331,987110,-970779,".","25",0,200176
"17072",180489,"THE UNIVERSITY OF MONTANA-MISSOULA                          ","2003-2004",39,"Total Participants",1073624,2048867,-975243,233571,447812,-214241,840053,1601055,-761002,"184","117",922387,529411
"2986",154095,"UNIVERSITY OF NORTHERN IOWA                                 ","2003-2004",2,"Basketball",667677,1644186,-976509,625886,984737,-358851,41791,659449,-617658,"16","16",236657,125176
"15693",237969,"WEST VIRGINIA WESLEYAN COLLEGE                              ","2003-2004",39,"Total Participants",511640,1488884,-977244,241039,777153,-536114,270601,711731,-441130,"228","127",221277,128941
"7550",236948,"UNIVERSITY OF WASHINGTON-SEATTLE CAMPUS                     ","2003-2004",15,"Soccer",257003,1234936,-977933,52370,568866,-516496,204633,666070,-461437,"26","26",89885,106950
"15785",198808,"LEES-MCRAE COLLEGE                                          ","2003-2004",39,"Total Participants",241566,1224883,-983317,124568,648823,-524255,116998,576060,-459062,"133","106",159991,129263
"2111",221999,"VANDERBILT UNIVERSITY                                       ","2003-2004",2,"Basketball",7608760,8598500,-989740,6370931,5289983,1080948,1237829,3308517,-2070688,"13","16",546388,344704
"7132",131159,"AMERICAN UNIVERSITY                                         ","2003-2004",15,"Soccer",2935,996009,-993074,2885,552407,-549522,50,443602,-443552,"23","26",45444,43786
"6323",174066,"UNIVERSITY OF MINNESOTA-TWIN CITIES                         ","2003-2004",9,"Gymnastics",54960,1051135,-996175,8495,430753,-422258,46465,620382,-573917,"15","13",56005,77336
"7911",239105,"MARQUETTE UNIVERSITY                                        ","2003-2004",15,"Soccer",39255,1039179,-999924,17583,454305,-436722,21672,584874,-563202,"30","31",90550,103015
"6335",139959,"UNIVERSITY OF GEORGIA                                       ","2003-2004",9,"Gymnastics",193013,1193995,-1000982,0,0,0,193013,1193995,-1000982,".","18",0,201945
"16875",196246,"SUNY COLLEGE AT PLATTSBURGH                                 ","2003-2004",39,"Total Participants",136538,1140341,-1003803,91900,641266,-549366,44638,499075,-454437,"237","191",314632,252989
"6952",234076,"UNIVERSITY OF VIRGINIA-MAIN CAMPUS                          ","2003-2004",13,"Rowing",43174,1047805,-1004631,0,0,0,43174,1047805,-1004631,".","81",0,211074
"2507",133669,"FLORIDA ATLANTIC UNIVERSITY-BOCA RATON                      ","2003-2004",2,"Basketball",90017,1095716,-1005699,82499,552895,-470396,7518,542821,-535303,"13","17",173779,155958
"1656",195164,"SAINT BONAVENTURE UNIVERSITY                                ","2003-2004",2,"Basketball",885020,1890746,-1005726,864121,1249552,-385431,20899,641194,-620295,"12","12",262826,112953
"16710",201104,"ASHLAND UNIVERSITY                                          ","2003-2004",39,"Total Participants",3122998,4129855,-1006857,1732312,2195809,-463497,1390686,1934046,-543360,"293","140",213972,121617
"11425",139959,"UNIVERSITY OF GEORGIA                                       ","2003-2004",22,"Tennis",34179,1042259,-1008080,4044,479858,-475814,30135,562401,-532266,"12","8",77616,78106
"7947",218663,"UNIVERSITY OF SOUTH CAROLINA-COLUMBIA                       ","2003-2004",15,"Soccer",14704,1023424,-1008720,14704,463543,-448839,0,559881,-559881,"26","26",66792,87365
"1018",123961,"UNIVERSITY OF SOUTHERN CALIFORNIA                           ","2003-2004",1,"Baseball",571972,1583230,-1011258,571972,1583230,-1011258,0,0,0,"42",".",643153,0
"4654",160658,"UNIVERSITY OF LOUISIANA AT LAFAYETTE                        ","2003-2004",7,"Football",1574181,2585509,-1011328,1574181,2585509,-1011328,0,0,0,"71",".",511514,0
"11215",170976,"UNIVERSITY OF MICHIGAN-ANN ARBOR                            ","2003-2004",22,"Tennis",58897,1072067,-1013170,12952,427257,-414305,45945,644810,-598865,"9","9",86341,134147
"16211",109785,"AZUSA PACIFIC UNIVERSITY                                    ","2003-2004",39,"Total Participants",360565,1376748,-1016183,170538,624048,-453510,190027,752700,-562673,"210","99",281649,150640
"6681",186380,"RUTGERS UNIVERSITY-NEW BRUNSWICK                            ","2003-2004",11,"Lacrosse",36106,1052291,-1016185,12559,621009,-608450,23547,431282,-407735,"42","27",63740,89621
"15777",223427,"BLINN COLLEGE                                               ","2003-2004",39,"Total Participants",8159,1026695,-1018536,490,438975,-438485,7669,587720,-580051,"121","41",159729,82062
"16844",151290,"INDIANA INSTITUTE OF TECHNOLOGY                             ","2003-2004",39,"Total Participants",5658,1024912,-1019254,5408,602015,-596607,250,422897,-422647,"137","88",181075,99012
"15733",209807,"PORTLAND STATE UNIVERSITY                                   ","2003-2004",39,"Total Participants",853979,1875059,-1021080,149834,309607,-159773,704145,1565452,-861307,"160","114",550095,423022
"2442",110705,"UNIVERSITY OF CALIFORNIA-SANTA BARBARA                      ","2003-2004",2,"Basketball",621264,1643505,-1022241,229972,787429,-557457,391292,856076,-464784,"16","12",223140,172775
"7172",164924,"BOSTON COLLEGE                                              ","2003-2004",15,"Soccer",26618,1054619,-1028001,9560,444379,-434819,17058,610240,-593182,"26","26",51689,101708
"7487",134130,"UNIVERSITY OF FLORIDA                                       ","2003-2004",15,"Soccer",279811,1309863,-1030052,0,0,0,279811,1309863,-1030052,".","35",0,283331
"11048",152080,"UNIVERSITY OF NOTRE DAME                                    ","2003-2004",22,"Tennis",59933,1091873,-1031940,45298,492443,-447145,14635,599430,-584795,"15","11",97847,100891
"3864",217882,"CLEMSON UNIVERSITY                                          ","2003-2004",3,"All Track Combined",527457,1563164,-1035707,261925,861909,-599984,265532,701255,-435723,"93","94",283357,180882
"3130",135726,"UNIVERSITY OF MIAMI                                         ","2003-2004",2,"Basketball",4863784,5899609,-1035825,4366337,3729662,636675,497447,2169947,-1672500,"15","16",417237,300975
"2575",110422,"CALIFORNIA POLYTECHNIC STATE UNIV-SAN LUIS OBISPO           ","2003-2004",2,"Basketball",268940,1305799,-1036859,248544,720511,-471967,20396,585288,-564892,"16","18",119005,104468
"10172",240444,"UNIVERSITY OF WISCONSIN-MADISON                             ","2003-2004",18,"Swimming and Diving",389425,1427306,-1037881,171704,673395,-501691,217721,753911,-536190,"22","23",158568,156953
"16973",199111,"UNIVERSITY OF NORTH CAROLINA AT ASHEVILLE                   ","2003-2004",39,"Total Participants",106833,1144894,-1038061,61487,592223,-530736,45346,552671,-507325,"124","113",250572,182667
"17181",232566,"LONGWOOD UNIVERSITY                                         ","2003-2004",39,"Total Participants",102158,1142336,-1040178,39102,453877,-414775,63056,688459,-625403,"85","118",130320,212623
"16121",181011,"DANA COLLEGE                                                ","2003-2004",39,"Total Participants",69250,1111846,-1042596,34175,810846,-776671,35075,301000,-265925,"254","82",110321,66752
"2706",156620,"EASTERN KENTUCKY UNIVERSITY                                 ","2003-2004",2,"Basketball",463116,1505737,-1042621,326909,788432,-461523,136207,717305,-581098,"14","18",163840,100551
"10690",134130,"UNIVERSITY OF FLORIDA                                       ","2003-2004",22,"Tennis",184326,1228196,-1043870,91749,634202,-542453,92577,593994,-501417,"12","7",173890,124714
"10234",218663,"UNIVERSITY OF SOUTH CAROLINA-COLUMBIA                       ","2003-2004",18,"Swimming and Diving",2000,1046718,-1044718,980,512892,-511912,1020,533826,-532806,"22","23",80747,84043
"2713",206695,"YOUNGSTOWN STATE UNIVERSITY                                 ","2003-2004",2,"Basketball",295288,1340688,-1045400,274092,756181,-482089,21196,584507,-563311,"18","15",127691,96543
"4794",230764,"UNIVERSITY OF UTAH                                          ","2003-2004",7,"Football",4726994,5781984,-1054990,4726994,5781984,-1054990,0,0,0,"115",".",1138007,0
"15819",224147,"TEXAS A &amp; M UNIVERSITY-CORPUS CHRISTI                       ","2003-2004",39,"Total Participants",308745,1364374,-1055629,135364,543904,-408540,173381,820470,-647089,"100","148",281386,328577
"66",100858,"AUBURN UNIVERSITY MAIN CAMPUS                               ","2003-2004",1,"Baseball",598652,1654793,-1056141,598652,1654793,-1056141,0,0,0,"39",".",278951,0
"5078",232265,"HAMPTON UNIVERSITY                                          ","2003-2004",7,"Football",1131716,2194767,-1063051,1131716,2194767,-1063051,0,0,0,"88",".",410916,0
"16713",208488,"CONCORDIA UNIVERSITY                                        ","2003-2004",39,"Total Participants",247418,1313187,-1065769,118069,652461,-534392,129349,660726,-531377,"78","72",90158,114745
"4686",110422,"CALIFORNIA POLYTECHNIC STATE UNIV-SAN LUIS OBISPO           ","2003-2004",7,"Football",481947,1550215,-1068268,481947,1550215,-1068268,0,0,0,"80",".",240889,0
"6321",204796,"OHIO STATE UNIVERSITY-MAIN CAMPUS                           ","2003-2004",9,"Gymnastics",49993,1124364,-1074371,28014,510001,-481987,21979,614363,-592384,"18","19",58085,71898
"16542",123572,"SONOMA STATE UNIVERSITY                                     ","2003-2004",39,"Total Participants",452663,1529789,-1077126,351860,801118,-449258,100803,728671,-627868,"103","151",254113,235381
"15841",207324,"OKLAHOMA CHRISTIAN UNIVERSITY                               ","2003-2004",39,"Total Participants",26377,1104171,-1077794,17662,481347,-463685,8715,622824,-614109,"78","75",106122,111642
"4665",221847,"TENNESSEE TECHNOLOGICAL UNIVERSITY                          ","2003-2004",7,"Football",359160,1437000,-1077840,359160,1437000,-1077840,0,0,0,"120",".",143625,0
"6366",100751,"UNIVERSITY OF ALABAMA                                       ","2003-2004",9,"Gymnastics",357842,1435845,-1078003,0,0,0,357842,1435845,-1078003,".","17",0,326659
"3345",200800,"UNIVERSITY OF AKRON MAIN CAMPUS                             ","2003-2004",2,"Basketball",542427,1620490,-1078063,515588,882229,-366641,26839,738261,-711422,"15","16",204700,136014
"10343",204796,"OHIO STATE UNIVERSITY-MAIN CAMPUS                           ","2003-2004",18,"Swimming and Diving",108015,1195485,-1087470,95334,548071,-452737,12681,647414,-634733,"37","33",89760,94192
"10106",152080,"UNIVERSITY OF NOTRE DAME                                    ","2003-2004",18,"Swimming and Diving",397085,1485059,-1087974,243206,583670,-340464,153879,901389,-747510,"29","31",91127,128240
"10311",163286,"UNIVERSITY OF MARYLAND-COLLEGE PARK                         ","2003-2004",18,"Swimming and Diving",0,1093686,-1093686,0,421263,-421263,0,672423,-672423,"28","37",66244,70499
"1660",105330,"NORTHERN ARIZONA UNIVERSITY                                 ","2003-2004",2,"Basketball",241482,1338148,-1096666,227243,720740,-493497,14239,617408,-603169,"17","17",303648,230897
"10205",134097,"FLORIDA STATE UNIVERSITY                                    ","2003-2004",18,"Swimming and Diving",89215,1186753,-1097538,40830,541698,-500868,48385,645055,-596670,"30","23",111430,150690
"2959",150136,"BALL STATE UNIVERSITY                                       ","2003-2004",2,"Basketball",589407,1688738,-1099331,566315,969126,-402811,23092,719612,-696520,"14","14",127160,89926
"15958",227368,"THE UNIVERSITY OF TEXAS-PAN AMERICAN                        ","2003-2004",39,"Total Participants",265184,1365058,-1099874,248237,651959,-403722,16947,713099,-696152,"116","139",329545,255456
"2892",188030,"NEW MEXICO STATE UNIVERSITY-MAIN CAMPUS                     ","2003-2004",2,"Basketball",957735,2058782,-1101047,820096,1352071,-531975,137639,706711,-569072,"13","14",269568,176134
"3535",110635,"UNIVERSITY OF CALIFORNIA-BERKELEY                           ","2003-2004",3,"All Track Combined",428846,1530260,-1101414,217360,775611,-558251,211486,754649,-543163,"111","108",178101,189975
"6493",166629,"UNIVERSITY OF MASSACHUSETTS-AMHERST                         ","2003-2004",10,"Ice Hockey",423729,1525251,-1101522,423729,1525251,-1101522,0,0,0,"30","0",407463,0
"8021",147767,"NORTHWESTERN UNIVERSITY                                     ","2003-2004",15,"Soccer",33590,1138701,-1105111,21614,453453,-431839,11976,685248,-673272,"24","25",113971,88471
"16331",234207,"WASHINGTON AND LEE UNIVERSITY                               ","2003-2004",39,"Total Participants",133308,1239690,-1106382,74569,671635,-597066,58739,568055,-509316,"266","196",247411,125472
"6383",181464,"UNIVERSITY OF NEBRASKA AT LINCOLN                           ","2003-2004",9,"Gymnastics",16219,1130284,-1114065,11313,434567,-423254,4906,695717,-690811,"14","16",63774,75664
"15815",138275,"WARNER SOUTHERN COLLEGE                                     ","2003-2004",39,"Total Participants",20287,1140010,-1119723,15514,663320,-647806,4773,476690,-471917,"126","88",115351,105652
"7814",157085,"UNIVERSITY OF KENTUCKY                                      ","2003-2004",15,"Soccer",7112,1128617,-1121505,3206,561009,-557803,3906,567608,-563702,"40","28",220239,206566
"10338",157085,"UNIVERSITY OF KENTUCKY                                      ","2003-2004",18,"Swimming and Diving",0,1124648,-1124648,0,540072,-540072,0,584576,-584576,"25","21",199775,184461
"2654",144740,"DEPAUL UNIVERSITY                                           ","2003-2004",2,"Basketball",2131890,3259883,-1127993,1975355,2098518,-123163,156535,1161365,-1004830,"12","14",362862,245764
"4515",183044,"UNIVERSITY OF NEW HAMPSHIRE-MAIN CAMPUS                     ","2003-2004",7,"Football",1399952,2528401,-1128449,1399952,2528401,-1128449,0,0,0,"100",".",377174,0
"4718",149222,"SOUTHERN ILLINOIS UNIVERSITY-CARBONDALE                     ","2003-2004",7,"Football",693804,1823437,-1129633,693804,1823437,-1129633,0,0,0,"96",".",303136,0
"10315",174066,"UNIVERSITY OF MINNESOTA-TWIN CITIES                         ","2003-2004",18,"Swimming and Diving",181344,1313782,-1132438,11275,655913,-644638,170069,657869,-487800,"38","39",117637,118696
"2756",164076,"TOWSON UNIVERSITY                                           ","2003-2004",2,"Basketball",221694,1354904,-1133210,185756,710286,-524530,35938,644618,-608680,"14","15",113887,82588
"3733",178396,"UNIVERSITY OF MISSOURI-COLUMBIA                             ","2003-2004",3,"All Track Combined",29772,1165079,-1135307,14886,533074,-518188,14886,632005,-617119,"52","47",115827,119648
"6685",234076,"UNIVERSITY OF VIRGINIA-MAIN CAMPUS                          ","2003-2004",11,"Lacrosse",295886,1438363,-1142477,230099,725946,-495847,65787,712417,-646630,"37","29",78078,133429
"3499",215293,"UNIVERSITY OF PITTSBURGH-MAIN CAMPUS                        ","2003-2004",3,"All Track Combined",0,1150596,-1150596,0,483046,-483046,0,667550,-667550,"80","102",101902,109642
"10441",215293,"UNIVERSITY OF PITTSBURGH-MAIN CAMPUS                        ","2003-2004",18,"Swimming and Diving",0,1154519,-1154519,0,533929,-533929,0,620590,-620590,"31","29",92481,91875
"3684",236939,"WASHINGTON STATE UNIVERSITY                                 ","2003-2004",3,"All Track Combined",246203,1402346,-1156143,29340,659250,-629910,216863,743096,-526233,"55","45",205802,194109
"16043",219356,"SOUTH DAKOTA STATE UNIVERSITY                               ","2003-2004",39,"Total Participants",20354,1183617,-1163263,7843,451669,-443826,12511,731948,-719437,"257","125",424076,264760
"6401",195216,"ST LAWRENCE UNIVERSITY                                      ","2003-2004",10,"Ice Hockey",947713,2117191,-1169478,604857,1155278,-550421,342856,961913,-619057,"30","25",186587,138628
"13860",110662,"UNIVERSITY OF CALIFORNIA-LOS ANGELES                        ","2003-2004",26,"Volleyball",242669,1412446,-1169777,164471,569869,-405398,78198,842577,-764379,"29","17",80492,137188
"2702",110608,"CALIFORNIA STATE UNIVERSITY-NORTHRIDGE                      ","2003-2004",2,"Basketball",99762,1274942,-1175180,90950,705277,-614327,8812,569665,-560853,"13","17",254942,145048
"6700",152080,"UNIVERSITY OF NOTRE DAME                                    ","2003-2004",11,"Lacrosse",230096,1407381,-1177285,113400,635237,-521837,116696,772144,-655448,"44","29",159402,174968
"4570",156620,"EASTERN KENTUCKY UNIVERSITY                                 ","2003-2004",7,"Football",613143,1793373,-1180230,613143,1793373,-1180230,0,0,0,"98",".",277110,0
"8331",110662,"UNIVERSITY OF CALIFORNIA-LOS ANGELES                        ","2003-2004",15,"Soccer",156189,1337384,-1181195,108004,628798,-520794,48185,708586,-660401,"28","26",85592,86778
"17275",179043,"ROCKHURST UNIVERSITY                                        ","2003-2004",39,"Total Participants",42766,1226197,-1183431,29116,615025,-585909,13650,611172,-597522,"132","75",913053,791057
"2444",132903,"UNIVERSITY OF CENTRAL FLORIDA                               ","2003-2004",2,"Basketball",338258,1523840,-1185582,228379,736960,-508581,109879,786880,-677001,"16","19",191338,111338
"3963",176080,"MISSISSIPPI STATE UNIVERSITY                                ","2003-2004",3,"All Track Combined",7410,1195427,-1188017,4710,595270,-590560,2700,600157,-597457,"50","69",133283,125606
"8273",204796,"OHIO STATE UNIVERSITY-MAIN CAMPUS                           ","2003-2004",15,"Soccer",282574,1470596,-1188022,164146,762115,-597969,118428,708481,-590053,"31","31",102573,102956
"17321",221731,"TENNESSEE WESLEYAN COLLEGE                                  ","2003-2004",39,"Total Participants",147025,1337825,-1190800,74000,698800,-624800,73025,639025,-566000,"105","86",51550,45100
"4863",133669,"FLORIDA ATLANTIC UNIVERSITY-BOCA RATON                      ","2003-2004",7,"Football",589883,1781535,-1191652,589883,1781535,-1191652,0,0,0,"108",".",512254,0
"4849",197869,"APPALACHIAN STATE UNIVERSITY                                ","2003-2004",7,"Football",516119,1708435,-1192316,516119,1708435,-1192316,0,0,0,"80",".",362779,0
"16864",195216,"ST LAWRENCE UNIVERSITY                                      ","2003-2004",39,"Total Participants",2323477,3516313,-1192836,1245672,1801758,-556086,1077805,1714555,-636750,"403","365",444680,382345
"10289",139959,"UNIVERSITY OF GEORGIA                                       ","2003-2004",18,"Swimming and Diving",39281,1232875,-1193594,19640,639162,-619522,19641,593713,-574072,"28","30",70174,69619
"3615",236948,"UNIVERSITY OF WASHINGTON-SEATTLE CAMPUS                     ","2003-2004",3,"All Track Combined",270449,1464484,-1194035,36245,655285,-619040,234204,809199,-574995,"54","60",213358,213359
"6826",163286,"UNIVERSITY OF MARYLAND-COLLEGE PARK                         ","2003-2004",11,"Lacrosse",99192,1293765,-1194573,86674,740566,-653892,12518,553199,-540681,"48","35",96028,70103
"17169",218973,"WOFFORD COLLEGE                                             ","2003-2004",39,"Total Participants",307939,1510588,-1202649,209021,770525,-561504,98918,740063,-641145,"239","119",517187,176160
"2195",164988,"BOSTON UNIVERSITY                                           ","2003-2004",2,"Basketball",469405,1673097,-1203692,389006,992101,-603095,80399,680996,-600597,"14","16",169046,153382
"10972",221759,"THE UNIVERSITY OF TENNESSEE                                 ","2003-2004",22,"Tennis",500,1204994,-1204494,500,601093,-600593,0,603901,-603901,"10","11",189261,153395
"6450",152080,"UNIVERSITY OF NOTRE DAME                                    ","2003-2004",10,"Ice Hockey",340402,1550329,-1209927,340402,1550329,-1209927,0,0,0,"24",".",270310,0
"3901",225511,"UNIVERSITY OF HOUSTON-UNIVERSITY PARK                       ","2003-2004",3,"All Track Combined",23487,1233856,-1210369,11743,566339,-554596,11744,667517,-655773,"97","96",127967,121760
"15721",178615,"TRUMAN STATE UNIVERSITY                                     ","2003-2004",39,"Total Participants",120896,1332102,-1211206,56797,509237,-452440,64099,822865,-758766,"289","193",243407,231747
"6316",243744,"STANFORD UNIVERSITY                                         ","2003-2004",9,"Gymnastics",79008,1291169,-1212161,28534,461383,-432849,50474,829786,-779312,"15","13",38472,83771
"4988",164076,"TOWSON UNIVERSITY                                           ","2003-2004",7,"Football",157232,1373174,-1215942,157232,1373174,-1215942,0,0,0,"117",".",193526,0
"6762",131496,"GEORGETOWN UNIVERSITY                                       ","2003-2004",11,"Lacrosse",275400,1493985,-1218585,189380,835077,-645697,86020,658908,-572888,"47","26",110263,116734
"7131",163286,"UNIVERSITY OF MARYLAND-COLLEGE PARK                         ","2003-2004",15,"Soccer",90204,1309051,-1218847,73767,747387,-673620,16437,561664,-545227,"25","24",110048,106474
"14076",243744,"STANFORD UNIVERSITY                                         ","2003-2004",26,"Volleyball",296950,1528345,-1231395,49580,407013,-357433,247370,1121332,-873962,"12","15",47814,135523
"7807",209542,"OREGON STATE UNIVERSITY                                     ","2003-2004",15,"Soccer",59015,1294804,-1235789,24962,630292,-605330,34053,664512,-630459,"26","22",93889,107808
"4763",229115,"TEXAS TECH UNIVERSITY                                       ","2003-2004",7,"Football",14079284,15316778,-1237494,14079284,15316778,-1237494,0,0,0,"133",".",1902498,0
"10404",104179,"UNIVERSITY OF ARIZONA                                       ","2003-2004",18,"Swimming and Diving",378180,1617186,-1239006,187993,782794,-594801,190187,834392,-644205,"21","29",68369,71629
"17201",221768,"THE UNIVERSITY OF TENNESSEE-MARTIN                          ","2003-2004",39,"Total Participants",97234,1339542,-1242308,37552,471635,-434083,59682,867907,-808225,"141","87",317620,191936
"2460",176372,"UNIVERSITY OF SOUTHERN MISSISSIPPI                          ","2003-2004",2,"Basketball",798696,2044123,-1245427,788925,1263713,-474788,9771,780410,-770639,"11","14",406436,181311
"2419",198385,"DAVIDSON COLLEGE                                            ","2003-2004",2,"Basketball",376403,1622359,-1245956,357271,887925,-530654,19132,734434,-715302,"15","15",121255,85839
"10133",100751,"UNIVERSITY OF ALABAMA                                       ","2003-2004",18,"Swimming and Diving",23033,1273399,-1250366,7559,567292,-559733,15474,706107,-690633,"25","29",104418,101799
"6832",204796,"OHIO STATE UNIVERSITY-MAIN CAMPUS                           ","2003-2004",11,"Lacrosse",285325,1536191,-1250866,219822,845255,-625433,65503,690936,-625433,"58","22",97589,77820
"3099",217819,"COLLEGE OF CHARLESTON                                       ","2003-2004",2,"Basketball",300160,1556263,-1256103,283756,949243,-665487,16404,607020,-590616,"17","15",205286,88681
"4878",188030,"NEW MEXICO STATE UNIVERSITY-MAIN CAMPUS                     ","2003-2004",7,"Football",2006652,3263308,-1256656,2006652,3263308,-1256656,0,0,0,"81",".",736176,0
"2785",228723,"TEXAS A &amp; M UNIVERSITY                                      ","2003-2004",2,"Basketball",3634423,4897038,-1262615,3362369,2848339,514030,272054,2048699,-1776645,"15","20",527014,410846
"4320",142276,"IDAHO STATE UNIVERSITY                                      ","2003-2004",7,"Football",878198,2142579,-1264381,878198,2142579,-1264381,0,0,0,"87",".",447089,0
"15640",198215,"CATAWBA COLLEGE                                             ","2003-2004",39,"Total Participants",322754,1587410,-1264656,159571,735524,-575953,163183,851886,-688703,"232","122",258231,173491
"2586",196060,"SUNY AT ALBANY                                              ","2003-2004",2,"Basketball",129792,1396080,-1266288,121406,706613,-585207,8386,689467,-681081,"13","13",146891,108391
"2863",206084,"UNIVERSITY OF TOLEDO                                        ","2003-2004",2,"Basketball",706456,1974809,-1268353,609910,1128889,-518979,96546,845920,-749374,"14","11",270084,171860
"2009",131496,"GEORGETOWN UNIVERSITY                                       ","2003-2004",2,"Basketball",3319738,4588683,-1268945,3282483,3334580,-52097,37255,1254103,-1216848,"13","12",873046,329279
"2590",199218,"UNIVERSITY OF NORTH CAROLINA-WILMINGTON                     ","2003-2004",2,"Basketball",755729,2031995,-1276266,576078,1215042,-638964,179651,816953,-637302,"14","15",175357,142009
"8461",186380,"RUTGERS UNIVERSITY-NEW BRUNSWICK                            ","2003-2004",15,"Soccer",50677,1327107,-1276430,20311,706028,-685717,30366,621079,-590713,"32","27",144043,145825
"16267",217907,"COKER COLLEGE                                               ","2003-2004",39,"Total Participants",165843,1446006,-1280163,100456,794857,-694401,65387,651149,-585762,"106","75",120312,103776
"16051",232265,"HAMPTON UNIVERSITY                                          ","2003-2004",39,"Total Participants",869258,2151799,-1282541,331612,655269,-323657,537646,1496530,-958884,"158","95",830989,589149
"8425",234076,"UNIVERSITY OF VIRGINIA-MAIN CAMPUS                          ","2003-2004",15,"Soccer",246643,1532485,-1285842,182156,738252,-556096,64487,794233,-729746,"33","23",108902,135705
"397",134130,"UNIVERSITY OF FLORIDA                                       ","2003-2004",1,"Baseball",497490,1788041,-1290551,497490,1788041,-1290551,0,0,0,"44",".",480122,0
"15538",227881,"SAM HOUSTON STATE UNIVERSITY                                ","2003-2004",39,"Total Participants",410412,1701900,-1291488,184736,586703,-401967,225676,1115197,-889521,"225","139",687142,307703
"16544",121309,"POINT LOMA NAZARENE UNIVERSITY                              ","2003-2004",39,"Total Participants",149745,1444810,-1295065,64316,687620,-623304,85429,757190,-671761,"113","108",209661,255827
"7631",199847,"WAKE FOREST UNIVERSITY                                      ","2003-2004",15,"Soccer",32959,1332629,-1299670,24511,642348,-617837,8448,690281,-681833,"31","24",59910,67224
"16567",226091,"LAMAR UNIVERSITY                                            ","2003-2004",39,"Total Participants",621006,1922208,-1301202,445182,1097313,-652131,175824,824895,-649071,"111","114",398769,260950
"1907",139940,"GEORGIA STATE UNIVERSITY                                    ","2003-2004",2,"Basketball",40394,1344036,-1303642,34379,668817,-634438,6015,675219,-669204,"14","15",163813,128607
"3053",227216,"UNIVERSITY OF NORTH TEXAS                                   ","2003-2004",2,"Basketball",219113,1524805,-1305692,186808,833027,-646219,32305,691778,-659473,"15","15",263276,210634
"3597",155317,"UNIVERSITY OF KANSAS MAIN CAMPUS                            ","2003-2004",3,"All Track Combined",7720,1317319,-1309599,3860,619066,-615206,3860,698253,-694393,"57","51",100394,97460
"17031",177968,"LINDENWOOD UNIVERSITY                                       ","2003-2004",39,"Total Participants",494384,1805096,-1310712,273450,1043481,-770031,220934,761615,-540681,"702","326",954908,581362
"2326",198464,"EAST CAROLINA UNIVERSITY                                    ","2003-2004",2,"Basketball",1182585,2494092,-1311507,1121580,1580689,-459109,61005,913403,-852398,"11","15",398552,225174
"15479",168342,"WILLIAMS COLLEGE                                            ","2003-2004",39,"Total Participants",929523,2241431,-1311908,499319,1145346,-646027,430204,1096085,-665881,"515","396",464924,344512
"1759",196088,"SUNY AT BUFFALO                                             ","2003-2004",2,"Basketball",272662,1588099,-1315437,156809,841591,-684782,115853,746508,-630655,"14","12",163474,162030
"16080",217165,"BRYANT COLLEGE                                              ","2003-2004",39,"Total Participants",568726,1884573,-1315847,287218,807846,-520628,281508,1076727,-795219,"240","154",443587,305249
"7687",151351,"INDIANA UNIVERSITY-BLOOMINGTON                              ","2003-2004",15,"Soccer",79516,1397891,-1318375,76022,791459,-715437,3494,606432,-602938,"30","31",118971,85950
"4668",220862,"UNIVERSITY OF MEMPHIS                                       ","2003-2004",7,"Football",4878352,6201964,-1323612,4878352,6201964,-1323612,0,0,0,"101",".",1404616,0
"2160",201441,"BOWLING GREEN STATE UNIVERSITY-MAIN CAMPUS                  ","2003-2004",2,"Basketball",481250,1805729,-1324479,427144,1036819,-609675,54106,768910,-714804,"14","15",196563,107370
"10403",228778,"THE UNIVERSITY OF TEXAS AT AUSTIN                           ","2003-2004",18,"Swimming and Diving",910183,2239015,-1328832,485757,1159688,-673931,424426,1079327,-654901,"40","38",247352,124415
"17302",159993,"UNIVERSITY OF LOUISIANA AT MONROE                           ","2003-2004",39,"Total Participants",167043,1501624,-1334581,135279,616753,-481474,31764,884871,-853107,"209","149",667186,269209
"10257",147767,"NORTHWESTERN UNIVERSITY                                     ","2003-2004",18,"Swimming and Diving",24355,1360896,-1336541,6690,568086,-561396,17665,792810,-775145,"18","21",71438,89179
"15494",102614,"UNIVERSITY OF ALASKA FAIRBANKS                              ","2003-2004",39,"Total Participants",554813,1893059,-1338246,507495,1392379,-884884,47318,500680,-453362,"61","43",559172,190400
"3791",134097,"FLORIDA STATE UNIVERSITY                                    ","2003-2004",3,"All Track Combined",238884,1578826,-1339942,124978,693326,-568348,113906,885500,-771594,"44","64",192085,193991
"14295",123961,"UNIVERSITY OF SOUTHERN CALIFORNIA                           ","2003-2004",26,"Volleyball",101274,1441566,-1340292,22749,353781,-331032,78525,1087785,-1009260,"20","16",67827,242756
"3754",171100,"MICHIGAN STATE UNIVERSITY                                   ","2003-2004",3,"All Track Combined",107720,1452492,-1344772,84954,629947,-544993,22766,822545,-799779,"84","124",124323,145116
"17349",159009,"GRAMBLING STATE UNIVERSITY                                  ","2003-2004",39,"Total Participants",2811,1348294,-1345483,2705,454877,-452172,106,893417,-893311,"201","132",1899530,763339
"15832",219602,"AUSTIN PEAY STATE UNIVERSITY                                ","2003-2004",39,"Total Participants",8222,1354869,-1346647,8222,586567,-578345,0,768302,-768302,"155","112",262806,210045
"15943",159647,"LOUISIANA TECH UNIVERSITY                                   ","2003-2004",39,"Total Participants",580113,1929418,-1349305,258538,897477,-638939,321575,1031941,-710366,"241","123",1130902,491502
"14403",134130,"UNIVERSITY OF FLORIDA                                       ","2003-2004",26,"Volleyball",318834,1670411,-1351577,0,0,0,318834,1670411,-1351577,".","14",0,607211
"4606",228459,"TEXAS STATE UNIVERSITY-SAN MARCOS                           ","2003-2004",7,"Football",402658,1757877,-1355219,402658,1757877,-1355219,0,0,0,"78",".",389649,0
"17296",151102,"INDIANA UNIVERSITY-PURDUE UNIVERSITY-FORT WAYNE             ","2003-2004",39,"Total Participants",178170,1534575,-1356405,137378,766226,-628848,40792,768349,-727557,"118","124",421748,302524
"3024",122755,"SAN JOSE STATE UNIVERSITY                                   ","2003-2004",2,"Basketball",298839,1657911,-1359072,290485,911791,-621306,8354,746120,-737766,"16","15",368883,252152
"7108",170976,"UNIVERSITY OF MICHIGAN-ANN ARBOR                            ","2003-2004",15,"Soccer",20759,1380708,-1359949,12561,594484,-581923,8198,786224,-778026,"26","30",94150,131167
"3834",229115,"TEXAS TECH UNIVERSITY                                       ","2003-2004",3,"All Track Combined",18411,1385128,-1366717,600,656982,-656382,17811,728146,-710335,"106","133",158314,160338
"12270",240444,"UNIVERSITY OF WISCONSIN-MADISON                             ","2003-2004",25,"Track and Field, X-Country",432035,1804254,-1372219,228852,962447,-733595,203183,841807,-638624,"117","120",310799,234142
"2278",126818,"COLORADO STATE UNIVERSITY                                   ","2003-2004",2,"Basketball",1628190,3007528,-1379338,1139500,1864241,-724741,488690,1143287,-654597,"15","14",335534,246950
"15486",159939,"UNIVERSITY OF NEW ORLEANS                                   ","2003-2004",39,"Total Participants",116526,1496094,-1379568,94135,831123,-736988,22391,664971,-642580,"87","62",631946,404921
"2324",147703,"NORTHERN ILLINOIS UNIVERSITY                                ","2003-2004",2,"Basketball",641637,2024039,-1382402,485813,1122257,-636444,155824,901782,-745958,"14","14",211716,226360
"6932",170976,"UNIVERSITY OF MICHIGAN-ANN ARBOR                            ","2003-2004",13,"Rowing",5990,1389688,-1383698,0,0,0,5990,1389688,-1383698,".","129",0,348786
"2400",128771,"CENTRAL CONNECTICUT STATE UNIVERSITY                        ","2003-2004",2,"Basketball",162418,1549935,-1387517,130052,865828,-735776,32366,684107,-651741,"13","14",128305,121445
"4677",172699,"WESTERN MICHIGAN UNIVERSITY                                 ","2003-2004",7,"Football",1754840,3152675,-1397835,1754840,3152675,-1397835,0,0,0,"106",".",366175,0
"2292",153269,"DRAKE UNIVERSITY                                            ","2003-2004",2,"Basketball",910253,2310280,-1400027,758962,1340129,-581167,151291,970151,-818860,"20","14",371424,156617
"6915",240444,"UNIVERSITY OF WISCONSIN-MADISON                             ","2003-2004",13,"Rowing",369342,1777120,-1407778,52979,459307,-406328,316363,1317813,-1001450,"70","186",228995,410304
"16387",136172,"UNIVERSITY OF NORTH FLORIDA                                 ","2003-2004",39,"Total Participants",476445,1886430,-1409985,184910,922084,-737174,291535,964346,-672811,"151","157",308318,331162
"2080",172699,"WESTERN MICHIGAN UNIVERSITY                                 ","2003-2004",2,"Basketball",509667,1927317,-1417650,381375,1005541,-624166,128292,921776,-793484,"15","16",230040,213867
"6331",170976,"UNIVERSITY OF MICHIGAN-ANN ARBOR                            ","2003-2004",9,"Gymnastics",73126,1493354,-1420228,27289,593598,-566309,45837,899756,-853919,"18","13",105664,134832
"4326",139931,"GEORGIA SOUTHERN UNIVERSITY                                 ","2003-2004",7,"Football",821247,2242327,-1421080,821247,2242327,-1421080,0,0,0,"130",".",383032,0
"2774",232982,"OLD DOMINION UNIVERSITY                                     ","2003-2004",2,"Basketball",831429,2255519,-1424090,537442,1157899,-620457,293987,1097620,-803633,"16","14",291752,262419
"7199",243744,"STANFORD UNIVERSITY                                         ","2003-2004",15,"Soccer",111020,1537020,-1426000,70494,692870,-622376,40526,844150,-803624,"26","27",71300,62281
"2528",234030,"VIRGINIA COMMONWEALTH UNIVERSITY                            ","2003-2004",2,"Basketball",406479,1835208,-1428729,402766,1146032,-743266,3713,689176,-685463,"16","18",186509,102146
"2229",126614,"UNIVERSITY OF COLORADO AT BOULDER                           ","2003-2004",2,"Basketball",3481119,4912691,-1431572,2880577,2846287,34290,600542,2066404,-1465862,"18","15",691197,498794
"3519",186380,"RUTGERS UNIVERSITY-NEW BRUNSWICK                            ","2003-2004",3,"All Track Combined",94186,1526126,-1431940,0,775149,-775149,94186,750977,-656791,"105","108",109804,108053
"3784",199847,"WAKE FOREST UNIVERSITY                                      ","2003-2004",3,"All Track Combined",2,1434119,-1434117,1,557375,-557374,1,876744,-876743,"31","39",69816,71940
"3953",157085,"UNIVERSITY OF KENTUCKY                                      ","2003-2004",3,"All Track Combined",0,1436431,-1436431,0,675006,-675006,0,761425,-761425,"86","64",289620,275804
"4434",233374,"UNIVERSITY OF RICHMOND                                      ","2003-2004",7,"Football",1521805,2961700,-1439895,1521805,2961700,-1439895,0,0,0,"81",".",390368,0
"3810",152080,"UNIVERSITY OF NOTRE DAME                                    ","2003-2004",3,"All Track Combined",194116,1637339,-1443223,91166,704825,-613659,102950,932514,-829564,"147","114",75865,83244
"15583",199102,"NORTH CAROLINA  A &amp;T STATE UNIVERSITY                       ","2003-2004",39,"Total Participants",211439,1654769,-1443330,88912,523683,-434771,122527,1131086,-1008559,"216","117",324813,196339
"10220",104151,"ARIZONA STATE UNIVERSITY-MAIN CAMPUS                        ","2003-2004",18,"Swimming and Diving",64446,1514567,-1450121,33962,740348,-706386,30484,774219,-743735,"32","31",122321,139830
"2476",203517,"KENT STATE UNIVERSITY-MAIN CAMPUS                           ","2003-2004",2,"Basketball",451761,1907256,-1455495,392582,1074194,-681612,59179,833062,-773883,"15","12",270227,105740
"10102",151351,"INDIANA UNIVERSITY-BLOOMINGTON                              ","2003-2004",18,"Swimming and Diving",865,1458269,-1457404,0,681280,-681280,865,776989,-776124,"35","29",99644,127697
"17258",213543,"LEHIGH UNIVERSITY                                           ","2003-2004",39,"Total Participants",4126202,5585476,-1459274,2144445,2816808,-672363,1981757,2768668,-786911,"407","314",873409,586889
"3970",204796,"OHIO STATE UNIVERSITY-MAIN CAMPUS                           ","2003-2004",3,"All Track Combined",104967,1565880,-1460913,52587,679117,-626530,52380,886763,-834383,"59","58",112585,95145
"7909",152080,"UNIVERSITY OF NOTRE DAME                                    ","2003-2004",15,"Soccer",224555,1691962,-1467407,108913,811040,-702127,115642,880922,-765280,"27","29",138412,161213
"4507",126818,"COLORADO STATE UNIVERSITY                                   ","2003-2004",7,"Football",4684039,6159194,-1475155,4684039,6159194,-1475155,0,0,0,"127",".",1895663,0
"3759",104151,"ARIZONA STATE UNIVERSITY-MAIN CAMPUS                        ","2003-2004",3,"All Track Combined",190903,1666972,-1476069,95449,754404,-658955,95454,912568,-817114,"114","89",228116,226956
"4564",106458,"ARKANSAS STATE UNIVERSITY-MAIN CAMPUS                       ","2003-2004",7,"Football",1565937,3045374,-1479437,1565937,3045374,-1479437,0,0,0,"118",".",818490,0
"17221",179964,"WILLIAM WOODS UNIVERSITY                                    ","2003-2004",39,"Total Participants",206894,1687772,-1480878,102515,939776,-837261,104379,747996,-643617,"75","67",31765,44125
"15706",228796,"THE UNIVERSITY OF TEXAS AT EL PASO                          ","2003-2004",39,"Total Participants",1598418,3086267,-1487849,371863,700948,-329085,1226555,2385319,-1158764,"228","139",1435221,786137
"3879",216597,"VILLANOVA UNIVERSITY                                        ","2003-2004",3,"All Track Combined",6322,1496428,-1490106,4596,650003,-645407,1726,846425,-844699,"109","82",57425,61514
"16032",160658,"UNIVERSITY OF LOUISIANA AT LAFAYETTE                        ","2003-2004",39,"Total Participants",217927,1708666,-1490739,193808,918057,-724249,24119,790609,-766490,"169","94",995100,371813
"10164",123961,"UNIVERSITY OF SOUTHERN CALIFORNIA                           ","2003-2004",18,"Swimming and Diving",53863,1545424,-1491561,26114,713545,-687431,27749,831879,-804130,"22","41",117053,119041
"4694",218973,"WOFFORD COLLEGE                                             ","2003-2004",7,"Football",529416,2022188,-1492772,529416,2022188,-1492772,0,0,0,"86",".",238769,0
"15539",198136,"CAMPBELL UNIVERSITY INC                                     ","2003-2004",39,"Total Participants",1817090,3314365,-1497275,906666,1682283,-775617,910424,1632082,-721658,"153","129",606961,515834
"3855",104179,"UNIVERSITY OF ARIZONA                                       ","2003-2004",3,"All Track Combined",346538,1847537,-1500999,165055,957560,-792505,181483,889977,-708494,"43","45",118226,114234
"15450",160612,"SOUTHEASTERN LOUISIANA UNIVERSITY                           ","2003-2004",39,"Total Participants",384919,1900508,-1515589,286205,828571,-542366,98714,1071937,-973223,"240","125",774249,256970
"7457",202480,"UNIVERSITY OF DAYTON                                        ","2003-2004",15,"Soccer",68378,1594184,-1525806,31402,724450,-693048,36976,869734,-832758,"25","24",54743,99183
"3623",131496,"GEORGETOWN UNIVERSITY                                       ","2003-2004",3,"All Track Combined",150383,1676903,-1526520,65354,839149,-773795,85029,837754,-752725,"34","28",164362,164364
"3574",139959,"UNIVERSITY OF GEORGIA                                       ","2003-2004",3,"All Track Combined",1800,1534992,-1533192,900,717971,-717071,900,817021,-816121,"107","90",100459,98104
"3503",100858,"AUBURN UNIVERSITY MAIN CAMPUS                               ","2003-2004",3,"All Track Combined",32963,1570894,-1537931,16481,733037,-716556,16482,837857,-821375,"96","81",149603,149602
"4333",105330,"NORTHERN ARIZONA UNIVERSITY                                 ","2003-2004",7,"Football",521507,2063980,-1542473,521507,2063980,-1542473,0,0,0,"107",".",741785,0
"16811",154590,"WILLIAM PENN UNIVERSITY                                     ","2003-2004",39,"Total Participants",201648,1761022,-1559374,122083,1044524,-922441,79565,716498,-636933,"305","123",232165,105017
"4696",217864,"CITADEL MILITARY COLLEGE OF SOUTH CAROLINA                  ","2003-2004",7,"Football",844106,2407079,-1562973,844106,2407079,-1562973,0,0,0,"104",".",521106,0
"16832",142276,"IDAHO STATE UNIVERSITY                                      ","2003-2004",39,"Total Participants",406511,1971554,-1565043,117364,484376,-367012,289147,1487178,-1198031,"226","172",793591,559324
"4756",223232,"BAYLOR UNIVERSITY                                           ","2003-2004",7,"Football",6202948,7769732,-1566784,6202948,7769732,-1566784,0,0,0,"169",".",1075550,0
"16986",188030,"NEW MEXICO STATE UNIVERSITY-MAIN CAMPUS                     ","2003-2004",39,"Total Participants",746409,2329284,-1582875,245695,700490,-454795,500714,1628794,-1128080,"153","150",1233424,589925
"10422",170976,"UNIVERSITY OF MICHIGAN-ANN ARBOR                            ","2003-2004",18,"Swimming and Diving",49884,1635800,-1585916,27358,784427,-757069,22526,851373,-828847,"26","31",129587,160209
"4676",227216,"UNIVERSITY OF NORTH TEXAS                                   ","2003-2004",7,"Football",1514116,3131213,-1617097,1514116,3131213,-1617097,0,0,0,"109",".",642478,0
"6404",217402,"PROVIDENCE COLLEGE                                          ","2003-2004",10,"Ice Hockey",550876,2200711,-1649835,543547,1467603,-924056,7329,733108,-725779,"25","22",171697,121636
"1864",152080,"UNIVERSITY OF NOTRE DAME                                    ","2003-2004",2,"Basketball",3606243,5269101,-1662858,3259770,3055454,204316,346473,2213647,-1867174,"11","12",517703,521370
"3731",100751,"UNIVERSITY OF ALABAMA                                       ","2003-2004",3,"All Track Combined",47613,1721880,-1674267,26448,882821,-856373,21165,839059,-817894,"45","32",262608,201701
"17021",164988,"BOSTON UNIVERSITY                                           ","2003-2004",39,"Total Participants",2802170,4484522,-1682352,2429279,2600464,-171185,372891,1884058,-1511167,"333","342",759539,782981
"17242",195164,"SAINT BONAVENTURE UNIVERSITY                                ","2003-2004",39,"Total Participants",222311,1904750,-1682439,141807,934446,-792639,80504,970304,-889800,"115","121",411388,241921
"16272",110361,"CALIFORNIA BAPTIST UNIVERSITY                               ","2003-2004",39,"Total Participants",106020,1791187,-1685167,41353,848398,-807045,64667,942789,-878122,"127","119",119427,116626
"4375",198516,"ELON UNIVERSITY                                             ","2003-2004",7,"Football",285104,1983552,-1698448,285104,1983552,-1698448,0,0,0,"117",".",200114,0
"10255",243744,"STANFORD UNIVERSITY                                         ","2003-2004",18,"Swimming and Diving",137571,1839193,-1701622,87538,857467,-769929,50033,981726,-931693,"35","34",120034,103362
"15778",183044,"UNIVERSITY OF NEW HAMPSHIRE-MAIN CAMPUS                     ","2003-2004",39,"Total Participants",5429219,7133125,-1703906,2638527,2482707,155820,2790692,4650418,-1859726,"357","433",1067871,959769
"17034",145813,"ILLINOIS STATE UNIVERSITY                                   ","2003-2004",39,"Total Participants",1044018,2749235,-1705217,373257,846794,-473537,670761,1902441,-1231680,"197","172",652733,476884
"15749",197036,"UNITED STATES MILITARY ACADEMY                              ","2003-2004",39,"Total Participants",2803027,4512306,-1709279,2292884,3271431,-978547,510143,1240875,-730732,"746","281",3179881,480648
"3976",228723,"TEXAS A &amp; M UNIVERSITY                                      ","2003-2004",3,"All Track Combined",173166,1898343,-1725177,87742,994869,-907127,85424,903474,-818050,"162","135",367881,282960
"4653",182281,"UNIVERSITY OF NEVADA-LAS VEGAS                              ","2003-2004",7,"Football",3358038,5084874,-1726836,3358038,5084874,-1726836,0,0,0,"109",".",1158656,0
"4463",190150,"COLUMBIA UNIVERSITY IN THE CITY OF NEW YORK                 ","2003-2004",7,"Football",642090,2372899,-1730809,642090,2372899,-1730809,0,0,0,"100",".",289982,0
"3629",151351,"INDIANA UNIVERSITY-BLOOMINGTON                              ","2003-2004",3,"All Track Combined",24631,1757675,-1733044,9031,799846,-790815,15600,957829,-942229,"123","117",251434,244998
"17334",139931,"GEORGIA SOUTHERN UNIVERSITY                                 ","2003-2004",39,"Total Participants",611132,2348386,-1737254,275311,915752,-640441,335821,1432634,-1096813,"232","171",729374,357718
"16083",110617,"CALIFORNIA STATE UNIVERSITY-SACRAMENTO                      ","2003-2004",39,"Total Participants",1257210,2995461,-1738251,413252,964905,-551653,843958,2030556,-1186598,"240","255",784959,528112
"16132",120883,"UNIVERSITY OF THE PACIFIC                                   ","2003-2004",39,"Total Participants",3616597,5374262,-1757665,1387016,2189033,-802017,2229581,3185229,-955648,"132","156",566020,545098
"3603",209551,"UNIVERSITY OF OREGON                                        ","2003-2004",3,"All Track Combined",64829,1826776,-1761947,41658,970707,-929049,23171,856069,-832898,"90","65",191641,125640
"3248",218663,"UNIVERSITY OF SOUTH CAROLINA-COLUMBIA                       ","2003-2004",2,"Basketball",2066811,3836528,-1769717,2019789,2154982,-135193,47022,1681546,-1634524,"16","14",608615,463327
"1992",181464,"UNIVERSITY OF NEBRASKA AT LINCOLN                           ","2003-2004",2,"Basketball",2719647,4503307,-1783660,2342927,2816900,-473973,376720,1686407,-1309687,"18","12",579861,376851
"4432",147703,"NORTHERN ILLINOIS UNIVERSITY                                ","2003-2004",7,"Football",3016082,4799786,-1783704,3016082,4799786,-1783704,0,0,0,"115",".",735348,0
"4280",201885,"UNIVERSITY OF CINCINNATI-MAIN CAMPUS                        ","2003-2004",7,"Football",4739787,6525094,-1785307,4739787,6525094,-1785307,0,0,0,"99",".",1010801,0
"3956",110662,"UNIVERSITY OF CALIFORNIA-LOS ANGELES                        ","2003-2004",3,"All Track Combined",109831,1897256,-1787425,71546,900309,-828763,38285,996947,-958662,"89","116",158395,154057
"10320",221759,"THE UNIVERSITY OF TENNESSEE                                 ","2003-2004",18,"Swimming and Diving",44579,1833959,-1789380,0,1053935,-1053935,44579,780024,-735445,"25","23",265559,199188
"16322",198516,"ELON UNIVERSITY                                             ","2003-2004",39,"Total Participants",124622,1915697,-1791075,51600,814748,-763148,73022,1100949,-1027927,"244","180",423436,246094
"16678",179566,"SOUTHWEST MISSOURI STATE UNIVERSITY                         ","2003-2004",39,"Total Participants",2555392,4361079,-1805687,1408429,1909415,-500986,1146963,2451664,-1304701,"235","176",764453,590769
"10109",100858,"AUBURN UNIVERSITY MAIN CAMPUS                               ","2003-2004",18,"Swimming and Diving",210840,2017944,-1807104,105419,1001303,-895884,105421,1016641,-911220,"31","27",160758,160756
"3848",228778,"THE UNIVERSITY OF TEXAS AT AUSTIN                           ","2003-2004",3,"All Track Combined",790201,2601205,-1811004,367649,1192889,-825240,422552,1408316,-985764,"113","99",559992,481995
"16073",207971,"UNIVERSITY OF TULSA                                         ","2003-2004",39,"Total Participants",3214802,5025819,-1811017,960161,1568628,-608467,2254641,3457191,-1202550,"173","143",1355880,743422
"12358",123961,"UNIVERSITY OF SOUTHERN CALIFORNIA                           ","2003-2004",25,"Track and Field, X-Country",360738,2179864,-1819126,180369,1015394,-835025,180369,1164470,-984101,"55","63",267455,267455
"10151",134130,"UNIVERSITY OF FLORIDA                                       ","2003-2004",18,"Swimming and Diving",173519,2005125,-1831606,86760,927778,-841018,86759,1077347,-990588,"38","33",230508,230506
"15564",151324,"INDIANA STATE UNIVERSITY                                    ","2003-2004",39,"Total Participants",693996,2533123,-1839127,293703,924007,-630304,400293,1609116,-1208823,"263","212",581080,382219
"4600",209807,"PORTLAND STATE UNIVERSITY                                   ","2003-2004",7,"Football",720483,2569839,-1849356,720483,2569839,-1849356,0,0,0,"101",".",323219,0
"3806",218663,"UNIVERSITY OF SOUTH CAROLINA-COLUMBIA                       ","2003-2004",3,"All Track Combined",14000,1872359,-1858359,6160,823838,-817678,7840,1048521,-1040681,"37","45",184820,235226
"5015",122755,"SAN JOSE STATE UNIVERSITY                                   ","2003-2004",7,"Football",1778361,3655368,-1877007,1778361,3655368,-1877007,0,0,0,"99",".",1079007,0
"16499",223232,"BAYLOR UNIVERSITY                                           ","2003-2004",39,"Total Participants",5653014,7534951,-1881937,2486847,3360018,-873171,3166167,4174933,-1008766,"296","132",2377651,1240919
"16468",228459,"TEXAS STATE UNIVERSITY-SAN MARCOS                           ","2003-2004",39,"Total Participants",255937,2140291,-1884354,112408,706231,-593823,143529,1434060,-1290531,"191","136",692625,365820
"15496",237525,"MARSHALL UNIVERSITY                                         ","2003-2004",39,"Total Participants",1318690,3211631,-1892941,236578,981247,-744669,1082112,2230384,-1148272,"215","178",1215455,582627
"3604",106397,"UNIVERSITY OF ARKANSAS MAIN CAMPUS                          ","2003-2004",3,"All Track Combined",479900,2376700,-1896800,265399,1342780,-1077381,214501,1033920,-819419,"116","97",408478,213853
"465",106245,"UNIVERSITY OF ARKANSAS AT LITTLE ROCK                       ","2003-2004",1,"Baseball",87262,1988147,-1900885,87262,1988147,-1900885,0,0,0,"31",".",103367,0
"17078",230728,"UTAH STATE UNIVERSITY                                       ","2003-2004",39,"Total Participants",114838,2028063,-1913225,35251,388222,-352971,79587,1639841,-1560254,"186","141",1030794,486635
"16141",132602,"BETHUNE COOKMAN COLLEGE                                     ","2003-2004",39,"Total Participants",1118397,3033669,-1915272,569967,1213173,-643206,548430,1820496,-1272066,"144","88",1349164,624137
"6457",204796,"OHIO STATE UNIVERSITY-MAIN CAMPUS                           ","2003-2004",10,"Ice Hockey",643172,2578012,-1934840,629530,1540537,-911007,13642,1037475,-1023833,"29","24",343179,209432
"16407",221847,"TENNESSEE TECHNOLOGICAL UNIVERSITY                          ","2003-2004",39,"Total Participants",151798,2090691,-1938893,70024,577959,-507935,81774,1512732,-1430958,"198","162",341917,264974
"15424",106458,"ARKANSAS STATE UNIVERSITY-MAIN CAMPUS                       ","2003-2004",39,"Total Participants",54064,1999847,-1945783,41423,762319,-720896,12641,1237528,-1224887,"248","132",1367432,575201
"15934",179557,"SOUTHEAST MISSOURI STATE UNIVERSITY                         ","2003-2004",39,"Total Participants",103838,2057404,-1953566,22930,598998,-576068,80908,1458406,-1377498,"177","126",349476,354349
"16122",139940,"GEORGIA STATE UNIVERSITY                                    ","2003-2004",39,"Total Participants",156493,2110300,-1953807,73072,924331,-851259,83421,1185969,-1102548,"108","114",312207,321191
"15755",232186,"GEORGE MASON UNIVERSITY                                     ","2003-2004",39,"Total Participants",2362553,4326455,-1963902,1094236,1970091,-875855,1268317,2356364,-1088047,"183","207",729831,653224
"16306",197869,"APPALACHIAN STATE UNIVERSITY                                ","2003-2004",39,"Total Participants",206836,2187806,-1980970,127093,969455,-842362,79743,1218351,-1138608,"307","230",845173,478340
"2948",191931,"IONA COLLEGE                                                ","2003-2004",2,"Basketball",134932,2123539,-1988607,129351,1302261,-1172910,5581,821278,-815697,"15","15",248954,151417
"16318",199218,"UNIVERSITY OF NORTH CAROLINA-WILMINGTON                     ","2003-2004",39,"Total Participants",845868,2847170,-2001302,549767,1374705,-824938,296101,1472465,-1176364,"181","250",436731,417424
"3020",229115,"TEXAS TECH UNIVERSITY                                       ","2003-2004",2,"Basketball",9335251,11344384,-2009133,7063436,6169532,893904,2271815,5174852,-2903037,"15","19",712231,542071
"16337",149222,"SOUTHERN ILLINOIS UNIVERSITY-CARBONDALE                     ","2003-2004",39,"Total Participants",1170849,3199772,-2028923,444221,1305386,-861165,726628,1894386,-1167758,"252","180",840404,502531
"16534",220075,"EAST TENNESSEE STATE UNIVERSITY                             ","2003-2004",39,"Total Participants",48016,2081161,-2033145,35914,849707,-813793,12102,1231454,-1219352,"133","97",306327,121909
"12735",170976,"UNIVERSITY OF MICHIGAN-ANN ARBOR                            ","2003-2004",25,"Track and Field, X-Country",98863,2136432,-2037569,27664,961289,-933625,71199,1175143,-1103944,"47","66",247533,351377
"3555",134130,"UNIVERSITY OF FLORIDA                                       ","2003-2004",3,"All Track Combined",190008,2232083,-2042075,99104,1118193,-1019089,90904,1113890,-1022986,"117","137",403703,362834
"4475",196088,"SUNY AT BUFFALO                                             ","2003-2004",7,"Football",1016032,3061377,-2045345,1016032,3061377,-2045345,0,0,0,"99",".",632408,0
"12873",243744,"STANFORD UNIVERSITY                                         ","2003-2004",25,"Track and Field, X-Country",213556,2261176,-2047620,181102,1076724,-895622,32454,1184452,-1151998,"108","77",175877,173219
"10379",228723,"TEXAS A &amp; M UNIVERSITY                                      ","2003-2004",18,"Swimming and Diving",467815,2522218,-2054403,193716,1220344,-1026628,274099,1301874,-1027775,"30","32",236001,190409
"16860",128771,"CENTRAL CONNECTICUT STATE UNIVERSITY                        ","2003-2004",39,"Total Participants",236914,2295496,-2058582,87867,918679,-830812,149047,1376817,-1227770,"184","172",475440,382042
"15825",156620,"EASTERN KENTUCKY UNIVERSITY                                 ","2003-2004",39,"Total Participants",129960,2204543,-2074583,42913,865204,-822291,87047,1339339,-1252292,"226","152",714108,409108
"2678",131159,"AMERICAN UNIVERSITY                                         ","2003-2004",2,"Basketball",188578,2274786,-2086208,180130,1251094,-1070964,8448,1023692,-1015244,"16","15",200547,142372
"3561",159391,"LOUISIANA STATE UNIV &amp; AG &amp; MECH &amp; HEBERT LAWS CTR          ","2003-2004",3,"All Track Combined",63300,2155509,-2092209,31649,1077939,-1046290,31651,1077570,-1045919,"156","120",268879,268881
"15525",219709,"BELMONT UNIVERSITY                                          ","2003-2004",39,"Total Participants",529920,2624382,-2094462,258763,1228543,-969780,271157,1395839,-1124682,"108","106",314731,284891
"15875",206695,"YOUNGSTOWN STATE UNIVERSITY                                 ","2003-2004",39,"Total Participants",225325,2331102,-2105777,48841,626207,-577366,176484,1704895,-1528411,"254","205",559822,357576
"16877",153658,"UNIVERSITY OF IOWA                                          ","2003-2004",39,"Total Participants",2634827,4740873,-2106046,618568,2357216,-1738648,2016259,2383657,-367398,"407","358",1714915,1450213
"3546",181464,"UNIVERSITY OF NEBRASKA AT LINCOLN                           ","2003-2004",3,"All Track Combined",80908,2194420,-2113512,40454,1097210,-1056756,40454,1097210,-1056756,"152","114",154516,154516
"2597",123961,"UNIVERSITY OF SOUTHERN CALIFORNIA                           ","2003-2004",2,"Basketball",3228256,5343026,-2114770,3163748,3162556,1192,64508,2180470,-2115962,"17","14",726164,542550
"2910",225511,"UNIVERSITY OF HOUSTON-UNIVERSITY PARK                       ","2003-2004",2,"Basketball",865182,2998624,-2133442,824812,1910164,-1085352,40370,1088460,-1048090,"20","15",352709,239552
"17023",213385,"LAFAYETTE COLLEGE                                           ","2003-2004",39,"Total Participants",1167800,3309609,-2141809,516064,1264682,-748618,651736,2044927,-1393191,"334","294",567871,359942
"3543",221759,"THE UNIVERSITY OF TENNESSEE                                 ","2003-2004",3,"All Track Combined",27136,2192300,-2165164,27136,1186362,-1159226,0,1005938,-1005938,"32","26",323088,290781
"15623",191931,"IONA COLLEGE                                                ","2003-2004",39,"Total Participants",125150,2313891,-2188741,73665,1304101,-1230436,51485,1009790,-958305,"300","152",684055,356705
"17295",217864,"CITADEL MILITARY COLLEGE OF SOUTH CAROLINA                  ","2003-2004",39,"Total Participants",207619,2448334,-2240715,201666,1434054,-1232388,5953,1014280,-1008327,"307","92",1031144,138596
"2253",100858,"AUBURN UNIVERSITY MAIN CAMPUS                               ","2003-2004",2,"Basketball",4294671,6541804,-2247133,4240700,4343793,-103093,53971,2198011,-2144040,"18","16",695849,545308
"16785",227216,"UNIVERSITY OF NORTH TEXAS                                   ","2003-2004",39,"Total Participants",29630,2283233,-2253603,14244,382303,-368059,15386,1900930,-1885544,"259","250",1014174,684083
"17085",196097,"SUNY AT STONY BROOK                                         ","2003-2004",39,"Total Participants",1239740,3516746,-2277006,613083,1619243,-1006160,626657,1897503,-1270846,"282","160",506023,424803
"3134",233374,"UNIVERSITY OF RICHMOND                                      ","2003-2004",2,"Basketball",839074,3171982,-2332908,822017,1937566,-1115549,17057,1234416,-1217359,"13","12",601645,262521
"4308",201441,"BOWLING GREEN STATE UNIVERSITY-MAIN CAMPUS                  ","2003-2004",7,"Football",2271728,4616267,-2344539,2271728,4616267,-2344539,0,0,0,"102",".",591406,0
"4504",203517,"KENT STATE UNIVERSITY-MAIN CAMPUS                           ","2003-2004",7,"Football",866242,3228287,-2362045,866242,3228287,-2362045,0,0,0,"99",".",369544,0
"15648",110556,"CALIFORNIA STATE UNIVERSITY-FRESNO                          ","2003-2004",39,"Total Participants",3548468,5944303,-2395835,1990057,2394054,-403997,1558411,3550249,-1991838,"249","319",2812159,1260832
"4781",225511,"UNIVERSITY OF HOUSTON-UNIVERSITY PARK                       ","2003-2004",7,"Football",3407761,5831103,-2423342,3407761,5831103,-2423342,0,0,0,"129",".",1502265,0
"2041",166629,"UNIVERSITY OF MASSACHUSETTS-AMHERST                         ","2003-2004",2,"Basketball",1207734,3635658,-2427924,1149018,2542376,-1393358,58716,1093282,-1034566,"15","11",556411,268699
"16599",154095,"UNIVERSITY OF NORTHERN IOWA                                 ","2003-2004",39,"Total Participants",589398,3063194,-2473796,196685,1198148,-1001463,392713,1865046,-1472333,"301","182",749295,450948
"15991",181002,"CREIGHTON UNIVERSITY                                        ","2003-2004",39,"Total Participants",471653,3001494,-2529841,238999,1317716,-1078717,232654,1683778,-1451124,"105","133",415987,398880
"16240",133669,"FLORIDA ATLANTIC UNIVERSITY-BOCA RATON                      ","2003-2004",39,"Total Participants",118627,2656718,-2538091,84357,911173,-826816,34270,1745545,-1711275,"231","165",980826,472378
"15775",232982,"OLD DOMINION UNIVERSITY                                     ","2003-2004",39,"Total Participants",619878,3218582,-2598704,321642,1490408,-1168766,298236,1728174,-1429938,"165","139",540741,485143
"15634",105330,"NORTHERN ARIZONA UNIVERSITY                                 ","2003-2004",39,"Total Participants",93950,2698157,-2604207,5831,506243,-500412,88119,2191914,-2103795,"204","201",1185600,891100
"4933",216597,"VILLANOVA UNIVERSITY                                        ","2003-2004",7,"Football",656432,3285166,-2628734,656432,3285166,-2628734,0,0,0,"90",".",411516,0
"15788",198385,"DAVIDSON COLLEGE                                            ","2003-2004",39,"Total Participants",147000,2776527,-2629527,85391,1302071,-1216680,61609,1474456,-1412847,"248","144",463687,308366
"15715",221999,"VANDERBILT UNIVERSITY                                       ","2003-2004",39,"Total Participants",3914747,6545074,-2630327,2137226,2785806,-648580,1777521,3759268,-1981747,"211","121",1917709,851522
"15896",234030,"VIRGINIA COMMONWEALTH UNIVERSITY                            ","2003-2004",39,"Total Participants",120244,2791574,-2671330,95331,1484982,-1389651,24913,1306592,-1281679,"140","130",447488,291336
"4706",150136,"BALL STATE UNIVERSITY                                       ","2003-2004",7,"Football",926865,3610638,-2683773,926865,3610638,-2683773,0,0,0,"108",".",359257,0
"16675",176372,"UNIVERSITY OF SOUTHERN MISSISSIPPI                          ","2003-2004",39,"Total Participants",502851,3200284,-2697433,373809,1222448,-848639,129042,1977836,-1848794,"213","136",1997243,635136
"16308",110422,"CALIFORNIA POLYTECHNIC STATE UNIV-SAN LUIS OBISPO           ","2003-2004",39,"Total Participants",385332,3119905,-2734573,270768,1450799,-1180031,114564,1669106,-1554542,"299","217",641913,408091
"15530",156125,"WICHITA STATE UNIVERSITY                                    ","2003-2004",39,"Total Participants",1133665,3912818,-2779153,1002159,2201848,-1199689,131506,1710970,-1579464,"145","150",957857,578831
"4304",186380,"RUTGERS UNIVERSITY-NEW BRUNSWICK                            ","2003-2004",7,"Football",5741810,8547564,-2805754,5741810,8547564,-2805754,0,0,0,"112",".",1664803,0
"16087",190415,"CORNELL UNIVERSITY-ENDOWED COLLEGES                         ","2003-2004",39,"Total Participants",3437215,6247152,-2809937,2480403,3303037,-822634,956812,2944115,-1987303,"599","479",1208981,933080
"4954",200800,"UNIVERSITY OF AKRON MAIN CAMPUS                             ","2003-2004",7,"Football",688274,3521051,-2832777,688274,3521051,-2832777,0,0,0,"94",".",534074,0
"16956",199139,"UNIVERSITY OF NORTH CAROLINA AT CHARLOTTE                   ","2003-2004",39,"Total Participants",137882,2993158,-2855276,79607,1378250,-1298643,58275,1614908,-1556633,"121","117",714256,570053
"16010",126818,"COLORADO STATE UNIVERSITY                                   ","2003-2004",39,"Total Participants",714878,3574222,-2859344,129001,655091,-526090,585877,2919131,-2333254,"264","250",2408359,867551
"16827",142115,"BOISE STATE UNIVERSITY                                      ","2003-2004",39,"Total Participants",352743,3230035,-2877292,122334,1025008,-902674,230409,2205027,-1974618,"205","119",1018673,531354
"15805",110705,"UNIVERSITY OF CALIFORNIA-SANTA BARBARA                      ","2003-2004",39,"Total Participants",715086,3595266,-2880180,539428,1803622,-1264194,175658,1791644,-1615986,"239","210",599701,498997
"15548",197197,"WAGNER COLLEGE                                              ","2003-2004",39,"Total Participants",634942,3528508,-2893566,242939,1269994,-1027055,392003,2258514,-1866511,"323","214",405146,284820
"15735",145600,"UNIVERSITY OF ILLINOIS AT CHICAGO                           ","2003-2004",39,"Total Participants",172615,3114166,-2941551,65765,1425413,-1359648,106850,1688753,-1581903,"184","171",497616,405718
"16753",153269,"DRAKE UNIVERSITY                                            ","2003-2004",39,"Total Participants",104268,3070720,-2966452,22348,1028515,-1006167,81920,2042205,-1960285,"205","142",777860,496558
"16180",147703,"NORTHERN ILLINOIS UNIVERSITY                                ","2003-2004",39,"Total Participants",757135,3726970,-2969835,360698,1419490,-1058792,396437,2307480,-1911043,"241","183",1212270,605107
"16384",144740,"DEPAUL UNIVERSITY                                           ","2003-2004",39,"Total Participants",252072,3237263,-2985191,143090,1001568,-858478,108982,2235695,-2126713,"73","103",540393,610643
"16679",201885,"UNIVERSITY OF CINCINNATI-MAIN CAMPUS                        ","2003-2004",39,"Total Participants",1522779,4577378,-3054599,627402,1600759,-973357,895377,2976619,-2081242,"261","245",2193880,728339
"4882",166629,"UNIVERSITY OF MASSACHUSETTS-AMHERST                         ","2003-2004",7,"Football",745038,3806154,-3061116,745038,3806154,-3061116,0,0,0,"90",".",677656,0
"16676",206622,"XAVIER UNIVERSITY                                           ","2003-2004",39,"Total Participants",238759,3381934,-3143175,152004,1620763,-1468759,86755,1761171,-1674416,"130","100",1812039,965077
"4729",206084,"UNIVERSITY OF TOLEDO                                        ","2003-2004",7,"Football",1343825,4492495,-3148670,1343825,4492495,-3148670,0,0,0,"113",".",806109,0
"16927",196060,"SUNY AT ALBANY                                              ","2003-2004",39,"Total Participants",50603,3207929,-3157326,21430,1308695,-1287265,29173,1899234,-1870061,"296","232",636979,542010
"15860",217819,"COLLEGE OF CHARLESTON                                       ","2003-2004",39,"Total Participants",304358,3474452,-3170094,119252,1319558,-1200306,185106,2154894,-1969788,"130","237",470312,627924
"16415",190150,"COLUMBIA UNIVERSITY IN THE CITY OF NEW YORK                 ","2003-2004",39,"Total Participants",402642,3579092,-3176450,306311,1741569,-1435258,96331,1837523,-1741192,"444","356",1071606,726416
"15739",231624,"COLLEGE OF WILLIAM AND MARY                                 ","2003-2004",39,"Total Participants",1235104,4413239,-3178135,763030,1606555,-843525,472074,2806684,-2334610,"358","316",888802,571754
"15954",122409,"SAN DIEGO STATE UNIVERSITY                                  ","2003-2004",39,"Total Participants",2906658,6098465,-3191807,1396581,2033430,-636849,1510077,4065035,-2554958,"235","299",2499304,1130834
"17179",239105,"MARQUETTE UNIVERSITY                                        ","2003-2004",39,"Total Participants",117242,3319372,-3202130,32499,1298084,-1265585,84743,2021288,-1936545,"97","110",1016137,610915
"16028",122755,"SAN JOSE STATE UNIVERSITY                                   ","2003-2004",39,"Total Participants",61635,3295506,-3233871,31759,1071184,-1039425,29876,2224322,-2194446,"193","183",1700075,711368
"17226",137351,"UNIVERSITY OF SOUTH FLORIDA                                 ","2003-2004",39,"Total Participants",309992,3545804,-3235812,60645,1440486,-1379841,249347,2105318,-1855971,"228","227",1684203,876547
"16015",106245,"UNIVERSITY OF ARKANSAS AT LITTLE ROCK                       ","2003-2004",39,"Total Participants",490614,3726919,-3236305,216026,2544771,-2328745,274588,1182148,-907560,"119","140",437186,305545
"16245",187985,"UNIVERSITY OF NEW MEXICO-MAIN CAMPUS                        ","2003-2004",39,"Total Participants",1550562,4813088,-3262526,628553,1824559,-1196006,922009,2988529,-2066520,"362","284",2065667,1195540
"16504",179159,"SAINT LOUIS UNIVERSITY-MAIN CAMPUS                          ","2003-2004",39,"Total Participants",198377,3501547,-3303170,121779,1485323,-1363544,76598,2016224,-1939626,"125","145",535394,411382
"16813",139755,"GEORGIA INSTITUTE OF TECHNOLOGY-MAIN CAMPUS                 ","2003-2004",39,"Total Participants",2806912,6130360,-3323448,1526070,3312357,-1786287,1280842,2818003,-1537161,"243","116",1735997,722425
"16005",202480,"UNIVERSITY OF DAYTON                                        ","2003-2004",39,"Total Participants",427469,3794553,-3367084,366013,1616580,-1250567,61456,2177973,-2116517,"226","245",954973,670012
"16124",164076,"TOWSON UNIVERSITY                                           ","2003-2004",39,"Total Participants",398444,3775763,-3377319,169026,1352315,-1183289,229418,2423448,-2194030,"371","289",590299,434241
"16979",233921,"VIRGINIA POLYTECHNIC INSTITUTE AND STATE UNIV               ","2003-2004",39,"Total Participants",2910731,6309202,-3398471,1299638,2999975,-1700337,1611093,3309227,-1698134,"357","246",3125022,1019725
"16573",200800,"UNIVERSITY OF AKRON MAIN CAMPUS                             ","2003-2004",39,"Total Participants",155525,3561208,-3405683,98663,1297994,-1199331,56862,2263214,-2206352,"211","171",1018479,508451
"16546",198464,"EAST CAROLINA UNIVERSITY                                    ","2003-2004",39,"Total Participants",657993,4093320,-3435327,521697,1900919,-1379222,136296,2192401,-2056105,"317","210",2199968,720453
"16650",220862,"UNIVERSITY OF MEMPHIS                                       ","2003-2004",39,"Total Participants",185268,3643198,-3457930,161875,1728022,-1566147,23393,1915176,-1891783,"219","96",3132853,716699
"15687",199120,"UNIVERSITY OF NORTH CAROLINA AT CHAPEL HILL                 ","2003-2004",39,"Total Participants",5000464,8483260,-3482796,1942510,3438470,-1495960,3057954,5044790,-1986836,"513","393",2415826,1200103
"17313",198419,"DUKE UNIVERSITY                                             ","2003-2004",39,"Total Participants",290236,3816419,-3526183,245183,1646782,-1401599,45053,2169637,-2124584,"356","249",3699910,1624646
"16959",206084,"UNIVERSITY OF TOLEDO                                        ","2003-2004",39,"Total Participants",71702,3660237,-3588535,22019,901248,-879229,49683,2758989,-2709306,"189","203",1259094,520630
"16178",132903,"UNIVERSITY OF CENTRAL FLORIDA                               ","2003-2004",39,"Total Participants",996285,4594099,-3597814,254569,1517929,-1263360,741716,3076170,-2334454,"217","335",1064219,657320
"4797",132903,"UNIVERSITY OF CENTRAL FLORIDA                               ","2003-2004",7,"Football",1744014,5363070,-3619056,1744014,5363070,-3619056,0,0,0,"106",".",533707,0
"16243",145637,"UNIVERSITY OF ILLINOIS AT URBANA-CHAMPAIGN                  ","2003-2004",39,"Total Participants",3951786,7628078,-3676292,1546385,3194356,-1647971,2405401,4433722,-2028321,"353","237",2853288,1401375
"16800",110608,"CALIFORNIA STATE UNIVERSITY-NORTHRIDGE                      ","2003-2004",39,"Total Participants",214540,4049763,-3835223,148207,1703277,-1555070,66333,2346486,-2280153,"197","242",766353,671301
"15806",196413,"SYRACUSE UNIVERSITY                                         ","2003-2004",39,"Total Participants",8859345,12695342,-3835997,3258357,4756301,-1497944,5600988,7939041,-2338053,"321","271",3093779,1193512
"15839",129020,"UNIVERSITY OF CONNECTICUT                                   ","2003-2004",39,"Total Participants",1026962,4884137,-3857175,779806,2247289,-1467483,247156,2636848,-2389692,"301","323",4983457,2014536
"15748",110644,"UNIVERSITY OF CALIFORNIA-DAVIS                              ","2003-2004",39,"Total Participants",128434,3987114,-3858680,61205,1622079,-1560874,67229,2365035,-2297806,"371","373",626893,543698
"15996",153603,"IOWA STATE UNIVERSITY                                       ","2003-2004",39,"Total Participants",1492881,5412326,-3919445,82455,1370711,-1288256,1410426,4041615,-2631189,"322","226",1782299,1271617
"15889",207500,"UNIVERSITY OF OKLAHOMA NORMAN CAMPUS                        ","2003-2004",39,"Total Participants",566581,4518589,-3952008,360525,2260867,-1900342,206056,2257722,-2051666,"344","275",2118709,1407410
"15792",225511,"UNIVERSITY OF HOUSTON-UNIVERSITY PARK                       ","2003-2004",39,"Total Participants",237941,4204168,-3966227,200375,1517493,-1317118,37566,2686675,-2649109,"291","207",2207677,737791
"16175",233374,"UNIVERSITY OF RICHMOND                                      ","2003-2004",39,"Total Participants",316733,4292517,-3975784,177604,1357483,-1179879,139129,2935034,-2795905,"187","154",1268532,657163
"15471",131159,"AMERICAN UNIVERSITY                                         ","2003-2004",39,"Total Participants",140583,4147138,-4006555,127957,1689177,-1561220,12626,2457961,-2445335,"158","169",452154,463135
"17103",135726,"UNIVERSITY OF MIAMI                                         ","2003-2004",39,"Total Participants",4424359,8436346,-4011987,1670901,2561515,-890614,2753458,5874831,-3121373,"232","213",2599950,1010874
"15647",230764,"UNIVERSITY OF UTAH                                          ","2003-2004",39,"Total Participants",1108851,5128127,-4019276,343454,1602622,-1259168,765397,3525505,-2760108,"263","218",1881837,959445
"15519",203517,"KENT STATE UNIVERSITY-MAIN CAMPUS                           ","2003-2004",39,"Total Participants",183845,4226101,-4042256,111203,1421942,-1310739,72642,2804159,-2731517,"272","249",964330,571052
"16588",196088,"SUNY AT BUFFALO                                             ","2003-2004",39,"Total Participants",300777,4383902,-4083125,163778,1542604,-1378826,136999,2841298,-2704299,"270","219",1160982,736271
"16264",176080,"MISSISSIPPI STATE UNIVERSITY                                ","2003-2004",39,"Total Participants",1166087,5251510,-4085423,1085505,2394115,-1308610,80582,2857395,-2776813,"251","160",2048207,805182
"16003",243780,"PURDUE UNIVERSITY-MAIN CAMPUS                               ","2003-2004",39,"Total Participants",3946148,8033852,-4087704,1484013,3254587,-1770574,2462135,4779265,-2317130,"268","189",3888811,1537779
"16695",150136,"BALL STATE UNIVERSITY                                       ","2003-2004",39,"Total Participants",288198,4428490,-4140292,165255,1579028,-1413773,122943,2849462,-2726519,"346","246",852716,470867
"16932",236939,"WASHINGTON STATE UNIVERSITY                                 ","2003-2004",39,"Total Participants",1841541,5985621,-4144080,418866,1710020,-1291154,1422675,4275601,-2852926,"238","227",3195754,1499947
"16177",199193,"NORTH CAROLINA STATE UNIVERSITY AT RALEIGH                  ","2003-2004",39,"Total Participants",41500,4198387,-4156887,25700,1952413,-1926713,15800,2245974,-2230174,"369","294",2784800,1269418
"16693",126614,"UNIVERSITY OF COLORADO AT BOULDER                           ","2003-2004",39,"Total Participants",730368,4899791,-4169423,225698,1509077,-1283379,504670,3390714,-2886044,"274","194",3461533,1177399
"17227",182290,"UNIVERSITY OF NEVADA-RENO                                   ","2003-2004",39,"Total Participants",192095,4383065,-4190970,130960,1239675,-1108715,61135,3143390,-3082255,"203","288",1041380,897685
"16627",217882,"CLEMSON UNIVERSITY                                          ","2003-2004",39,"Total Participants",2914811,7108721,-4193910,1449875,3540546,-2090671,1464936,3568175,-2103239,"325","277",4320691,1118059
"16955",207388,"OKLAHOMA STATE UNIVERSITY-MAIN CAMPUS                       ","2003-2004",39,"Total Participants",3234629,7429400,-4194771,2669680,4422736,-1753056,564949,3006664,-2441715,"270","250",4421159,1212369
"16685",238032,"WEST VIRGINIA UNIVERSITY                                    ","2003-2004",39,"Total Participants",424094,4647712,-4223618,273422,1501490,-1228068,150672,3146222,-2995550,"301","239",4027617,838428
"15610",201441,"BOWLING GREEN STATE UNIVERSITY-MAIN CAMPUS                  ","2003-2004",39,"Total Participants",856995,5144904,-4287909,491955,2107980,-1616025,365040,3036924,-2671884,"227","238",1241609,535962
"16866",174066,"UNIVERSITY OF MINNESOTA-TWIN CITIES                         ","2003-2004",39,"Total Participants",7506556,11841901,-4335345,6872756,5454150,1418606,633800,6387751,-5753951,"461","405",2812776,1645512
"16867",172699,"WESTERN MICHIGAN UNIVERSITY                                 ","2003-2004",39,"Total Participants",771195,5131177,-4359982,479228,2380404,-1901176,291967,2750773,-2458806,"306","271",1183848,827705
"17248",217402,"PROVIDENCE COLLEGE                                          ","2003-2004",39,"Total Participants",594760,5062595,-4467835,575880,2478436,-1902556,18880,2584159,-2565279,"187","199",863115,634012
"16338",155399,"KANSAS STATE UNIVERSITY                                     ","2003-2004",39,"Total Participants",561601,5177594,-4615993,204415,1849727,-1645312,357186,3327867,-2970681,"281","299",4172059,1468221
"17132",182281,"UNIVERSITY OF NEVADA-LAS VEGAS                              ","2003-2004",39,"Total Participants",1120203,5824407,-4704204,534421,2362040,-1827619,585782,3462367,-2876585,"230","163",2103442,1075550
"15431",176017,"UNIVERSITY OF MISSISSIPPI MAIN CAMPUS                       ","2003-2004",39,"Total Participants",813451,5528377,-4714926,678921,2295253,-1616332,134530,3233124,-3098594,"345","169",3176695,1281321
"16106",131496,"GEORGETOWN UNIVERSITY                                       ","2003-2004",39,"Total Participants",1404718,6211614,-4806896,763830,2994189,-2230359,640888,3217425,-2576537,"384","288",1976123,1058856
"16262",229115,"TEXAS TECH UNIVERSITY                                       ","2003-2004",39,"Total Participants",689339,5529861,-4840522,456811,2389701,-1932890,232528,3140160,-2907632,"328","238",3165709,1229572
"16924",216597,"VILLANOVA UNIVERSITY                                        ","2003-2004",39,"Total Participants",315779,5324213,-5008434,198349,1671995,-1473646,117430,3652218,-3534788,"363","352",1432065,773309
"16142",166629,"UNIVERSITY OF MASSACHUSETTS-AMHERST                         ","2003-2004",39,"Total Participants",809171,5978043,-5168872,619448,3007490,-2388042,189723,2970553,-2780830,"349","338",2030898,846729
"15795",209551,"UNIVERSITY OF OREGON                                        ","2003-2004",39,"Total Participants",502484,5780617,-5278133,143223,2048749,-1905526,359261,3731868,-3372607,"263","162",1967319,878650
"16560",155317,"UNIVERSITY OF KANSAS MAIN CAMPUS                            ","2003-2004",39,"Total Participants",767000,6145462,-5378462,625361,1714232,-1088871,141639,4431230,-4289591,"271","260",3350401,1513904
"15975",110635,"UNIVERSITY OF CALIFORNIA-BERKELEY                           ","2003-2004",39,"Total Participants",7273304,12674322,-5401018,3303508,5501248,-2197740,3969796,7173074,-3203278,"506","371",5119199,1908577
"15977",130794,"YALE UNIVERSITY                                             ","2003-2004",39,"Total Participants",3322446,8728907,-5406461,1845541,4428006,-2582465,1476905,4300901,-2823996,"568","468",1837129,1147105
"16747",157289,"UNIVERSITY OF LOUISVILLE                                    ","2003-2004",39,"Total Participants",441393,5956182,-5514789,177385,2026445,-1849060,264008,3929737,-3665729,"276","269",2715700,948649
"15989",215293,"UNIVERSITY OF PITTSBURGH-MAIN CAMPUS                        ","2003-2004",39,"Total Participants",8575,5850905,-5842330,3885,2265072,-2261187,4690,3585833,-3581143,"318","225",3753252,811406
"17345",178396,"UNIVERSITY OF MISSOURI-COLUMBIA                             ","2003-2004",39,"Total Participants",504091,6404211,-5900120,283293,2181607,-1898314,220798,4222604,-4001806,"297","196",2749915,1238511
"15941",134097,"FLORIDA STATE UNIVERSITY                                    ","2003-2004",39,"Total Participants",1412424,7431089,-6018665,980129,2952884,-1972755,432295,4478205,-4045910,"241","187",2781528,1650010
"15523",106397,"UNIVERSITY OF ARKANSAS MAIN CAMPUS                          ","2003-2004",39,"Total Participants",2806747,8846498,-6039751,1350685,3313397,-1962712,1456062,5533101,-4077039,"324","221",4699579,1479343
"17249",240444,"UNIVERSITY OF WISCONSIN-MADISON                             ","2003-2004",39,"Total Participants",6961264,13071332,-6110068,4923807,5800760,-876953,2037457,7270572,-5233115,"440","459",5247472,2232150
"15626",214777,"PENNSYLVANIA STATE UNIVERSITY-MAIN CAMPUS                   ","2003-2004",39,"Total Participants",5574246,11780640,-6206394,2336757,5148502,-2811745,3237489,6632138,-3394649,"481","376",3589286,2010417
"17192",199847,"WAKE FOREST UNIVERSITY                                      ","2003-2004",39,"Total Participants",81000,6490211,-6409211,55816,2650723,-2594907,25184,3839488,-3814304,"225","130",1111055,571259
"16889",164924,"BOSTON COLLEGE                                              ","2003-2004",39,"Total Participants",2406786,8842748,-6435962,2153597,3342981,-1189384,253189,5499767,-5246578,"417","414",1953920,1183032
"17026",228778,"THE UNIVERSITY OF TEXAS AT AUSTIN                           ","2003-2004",39,"Total Participants",7768936,14216828,-6447892,4206886,6221803,-2014917,3562050,7995025,-4432975,"354","319",6232710,2876804
"15957",159391,"LOUISIANA STATE UNIV &amp; AG &amp; MECH &amp; HEBERT LAWS CTR          ","2003-2004",39,"Total Participants",2559922,9242593,-6682671,2424026,4160177,-1736151,135896,5082416,-4946520,"402","256",4274368,1534584
"15893",104179,"UNIVERSITY OF ARIZONA                                       ","2003-2004",39,"Total Participants",2655645,9346285,-6690640,959336,3516884,-2557548,1696309,5829401,-4133092,"240","185",1774537,962819
"16068",209542,"OREGON STATE UNIVERSITY                                     ","2003-2004",39,"Total Participants",534433,7267500,-6733067,186882,2567244,-2380362,347551,4700256,-4352705,"231","149",2558339,1013994
"16214",236948,"UNIVERSITY OF WASHINGTON-SEATTLE CAMPUS                     ","2003-2004",39,"Total Participants",2487049,9846705,-7359656,675941,3970979,-3295038,1811108,5875726,-4064618,"348","311",4586406,1658616
"16111",157085,"UNIVERSITY OF KENTUCKY                                      ","2003-2004",39,"Total Participants",61746,7708634,-7646888,38484,3170976,-3132492,23262,4537658,-4514396,"364","210",8711276,2410755
"13560",217721,"BENEDICT COLLEGE                                            ","2003-2004",26,"Volleyball",1,7931227,-7931226,0,0,0,1,7931227,-7931226,".","9",0,16312
"15908",171100,"MICHIGAN STATE UNIVERSITY                                   ","2003-2004",39,"Total Participants",3442355,11461035,-8018680,2943568,5051183,-2107615,498787,6409852,-5911065,"360","401",2713281,1496874
"15887",218663,"UNIVERSITY OF SOUTH CAROLINA-COLUMBIA                       ","2003-2004",39,"Total Participants",422116,8472801,-8050685,405716,3708584,-3302868,16400,4764217,-4747817,"285","183",2438860,1360204
"16275",228723,"TEXAS A &amp; M UNIVERSITY                                      ","2003-2004",39,"Total Participants",4507325,12702013,-8194688,1999449,4592679,-2593230,2507876,8109334,-5601458,"455","373",3230017,2126473
"16329",100751,"UNIVERSITY OF ALABAMA                                       ","2003-2004",39,"Total Participants",1272908,9484952,-8212044,609803,3490984,-2881181,663105,5993968,-5330863,"287","172",3566206,1710836
"15595",217721,"BENEDICT COLLEGE                                            ","2003-2004",39,"Total Participants",11,8386829,-8386818,5,219392,-219387,6,8167437,-8167431,"167","93",199652,90309
"16341",181464,"UNIVERSITY OF NEBRASKA AT LINCOLN                           ","2003-2004",39,"Total Participants",2028189,10588154,-8559965,1061684,3904337,-2842653,966505,6683817,-5717312,"462","279",3147924,1545763
"16071",147767,"NORTHWESTERN UNIVERSITY                                     ","2003-2004",39,"Total Participants",305044,9029399,-8724355,196398,3122411,-2926013,108646,5906988,-5798342,"220","208",2790755,1366533
"15445",163286,"UNIVERSITY OF MARYLAND-COLLEGE PARK                         ","2003-2004",39,"Total Participants",204229,8944333,-8740104,162594,3497393,-3334799,41635,5446940,-5405305,"344","310",2748032,1356791
"15773",139959,"UNIVERSITY OF GEORGIA                                       ","2003-2004",39,"Total Participants",437839,9225578,-8787739,181802,3119615,-2937813,256037,6105963,-5849926,"354","290",5823072,1400003
"17003",234076,"UNIVERSITY OF VIRGINIA-MAIN CAMPUS                          ","2003-2004",39,"Total Participants",1443518,10301031,-8857513,1004182,4318475,-3314293,439336,5982556,-5543220,"449","354",2592258,1388539
"17219",104151,"ARIZONA STATE UNIVERSITY-MAIN CAMPUS                        ","2003-2004",39,"Total Participants",1511760,10374837,-8863077,889481,4354710,-3465229,622279,6020127,-5397848,"375","267",4287544,1667015
"16717",100858,"AUBURN UNIVERSITY MAIN CAMPUS                               ","2003-2004",39,"Total Participants",1118711,10180961,-9062250,808432,4185457,-3377025,310279,5995504,-5685225,"316","254",3736457,1603548
"17260",186380,"RUTGERS UNIVERSITY-NEW BRUNSWICK                            ","2003-2004",39,"Total Participants",339690,9427425,-9087735,32870,4656938,-4624068,306820,4770487,-4463667,"513","355",2989478,1205684
"17245",151351,"INDIANA UNIVERSITY-BLOOMINGTON                              ","2003-2004",39,"Total Participants",238916,9787447,-9548531,97627,4054017,-3956390,141289,5733430,-5592141,"411","348",2072841,1351454
"16140",110662,"UNIVERSITY OF CALIFORNIA-LOS ANGELES                        ","2003-2004",39,"Total Participants",1596678,11242279,-9645601,987907,4202925,-3215018,608771,7039354,-6430583,"361","380",2713463,1188647
"15481",123961,"UNIVERSITY OF SOUTHERN CALIFORNIA                           ","2003-2004",39,"Total Participants",1894381,11996070,-10101689,1196415,5240624,-4044209,697966,6755446,-6057480,"314","269",6160586,2075976
"16378",221759,"THE UNIVERSITY OF TENNESSEE                                 ","2003-2004",39,"Total Participants",788607,11043241,-10254634,424430,4666876,-4242446,364177,6376365,-6012188,"253","192",7556719,2485595
"17045",134130,"UNIVERSITY OF FLORIDA                                       ","2003-2004",39,"Total Participants",1928000,13100950,-11172950,840038,4964938,-4124900,1087962,8136012,-7048050,"365","294",5542814,3029546
"16209",152080,"UNIVERSITY OF NOTRE DAME                                    ","2003-2004",39,"Total Participants",2330046,13873977,-11543931,1453433,6524303,-5070870,876613,7349674,-6473061,"484","369",3440697,1714757
"16624",170976,"UNIVERSITY OF MICHIGAN-ANN ARBOR                            ","2003-2004",39,"Total Participants",3350963,16799353,-13448390,3031454,7321589,-4290135,319509,9477764,-9158255,"362","400",4202409,2276928
"17087",243744,"STANFORD UNIVERSITY                                         ","2003-2004",39,"Total Participants",3334895,17267816,-13932921,2025792,7018613,-4992821,1309103,10249203,-8940100,"475","443",2321519,1367710
"15521",204796,"OHIO STATE UNIVERSITY-MAIN CAMPUS                           ","2003-2004",39,"Total Participants",3260462,17993378,-14732916,2382884,8455559,-6072675,877578,9537819,-8660241,"503","416",4481796,1916077
